time,open,high,low,close,tick_volume,spread,real_volume,ema_50,lsma,support_trendline_15,resistance_trendline_15,support_gradient_15,resistance_gradient_15,supertrend_dir,Span_A,Span_B,fixed_resistance_gradient_15,fixed_support_gradient_15,fixed_support_trendline_15,fixed_resistance_trendline_15,hourly_time,time2,prev_hour_lsma_slope,prev_hour_macd_line,hour_lsma,fixed_support_gradient,fixed_resistance_gradient,prev_hour_lsma,fixed_support_trendline,fixed_resistance_trendline,prev_fixed_support_trendline,prev_fixed_resistance_trendline,prev_fixed_resistance_gradient,prev_fixed_support_gradient,ema_24,prev_stochk,prev_stochd,prev_hour_macd_signal,prev_psar,prev_psar_direction,prev_nadaraya_watson,prev_nadaraya_watson_trend,nadaraya_upper_envelope,nadaraya_lower_envelope,wma_50,prev_supertrend_dir,HSpan_A,HSpan_B,nadaraya_watson,prev_nadaraya_lower_band,prev_nadaraya_upper_band,prev_HSpan_A,prev_HSpan_B,support_trendline,resistance_trendline,support,resistance,is_buy,is_sell,4_hour_time,time4h,4H_ema_50,prev_4fixed_support_gradient,prev_4fixed_support_trendline,prev_4fixed_resistance_gradient,prev_4fixed_resistance_trendline,prev_4nadaraya_watson_trend,4H_hour_lsma,4lsma_upper_band,4lsma_lower_band,4HSpan_A,4HSpan_B,ema_short,ema_long,macd_line,macd_signal,lsma_stddev,lsma_slope,prev_lsma_slope_1,prev_lsma_slope_2,lsma_upper_band,lsma_lower_band,stoch_k,stoch_d,is_doji,is_doji_star,3whitesoldiers,3blackcrows,engulfing,inverted_hammer,two_crows,three_inside,three_line_strike,three_outside,three_stars_in_south,abandoned_baby,advance_block,belt_hold,breakaway,closing_marubozu,conceal_baby_swallow,counterattack,dark_cloud_cover,doji,doji_star,dragonfly_doji,evening_doji_star,evening_star,gap_side_side_white,gravestone_doji,hammer,hanging_man,harami,harami_cross,high_wave,hikkake,hikkake_mod,homing_pigeon,identical_three_crows,in_neck,kicking,kicking_by_length,ladder_bottom,long_legged_doji,long_line,matching_low,mat_hold,morning_doji_star,morning_star,on_neck,piercing,rickshaw_man,rise_fall_3_methods,separating_lines,shooting_star,short_line,spinning_top,stalled_pattern,stick_sandwich,takuri,tasuki_gap,thrusting,tristar,unique_3_river,upside_gap_two_crows,xside_gap_3_methods,ticket,is_buy2,is_sell2,signal,tp,sl,be,be_condition,order_type,lot,sl_updated,time_to_trail,time_tp_hit,time_sl_hit,entry_time,entry_price,exit_time,exit_price,exit,lot_size,profit,type,duration,account_balance,success,win_streak,losing_streak,Week,Month
2024-04-01 12:30:00,2253.01,2254.42,2249.36,2249.79,1340,27,0,2256.1892654307226,2255.913469230767,2249.380168536024,2254.3980092617057,-0.00043843654200062857,9.905086884085646e-05,,,,-5.413802337679818e-05,-0.0002160467385519863,2254.8490772825953,2263.39205347338,2024-04-01 12:00:00,2024-04-01 12:00:00,-1.7823636363659716,,2257.894787878789,,,2260.9017575757543,,,,,,,2255.154926459381,,,,,,,,,,,,,,,,,,,2223.826658323327,2258.2800000000007,,,,,2024-04-01 12:00:00,2024-04-01 12:00:00,,,,,,,,,,,,2256.4907386677423,2256.585321546047,-0.2610773927481205,1.2081581417990126,3.0713642850361746,-1.484884615386818,-1.160330769228949,-0.4685615384605626,2262.0561978008395,2249.7707406606946,16.078467785387318,18.284763018518706,0,0,0,0,0,0,0,0,0,-100,0,0,0,0,0,0,0,0,0,0,0,0,0,0,0,0,0,0,0,0,0,0,0,0,0,0,0,0,0,0,0,0,0,0,0,0,0,0,0,0,0,0,0,0,0,0,0,0,0,0,0,0,,False,True,1.0,2149.79,2279.79,2219.79,2214.79,1,0.01,False,,,2024-04-02 23:33:59,2024-04-01 12:45:00,2249.79,2024-04-01 23:15:00,2245.56,manual,0.01,74.75,success,0 days 10:30:00,774.75,True,1,0,14,4
2024-04-01 23:00:00,2244.59,2246.2,2242.88,2245.51,965,27,0,2242.297987744268,2242.520123076923,2242.880000000001,2257.329454114909,9.831278739116752e-05,-0.00011296331359498368,,,,9.202412923958053e-05,0.00016602522503187512,2234.5548908868323,2243.868897949508,2024-04-01 23:00:00,2024-04-01 23:00:00,1.3383636363641926,,2242.5114545454544,,,2239.3816969696973,,,,,,,2244.632428589695,35.47360431703974,30.709989468093728,,,,,,,,,,,,,,,,,2237.812158566572,2257.1604549369545,,,,,2024-04-01 20:00:00,2024-04-01 20:00:00,2251.556666666667,,,,,,,,,,,2241.4770987062766,2241.8904614891894,-0.22879059337947183,-1.2583958118126104,2.2725123761881676,1.433261538462375,1.431299999998373,1.1611692307697012,2247.0651478292993,2237.9750983245467,88.62592510413039,80.41984252157465,0,0,0,0,0,0,0,0,0,0,0,0,0,0,0,0,0,0,0,0,0,0,0,0,0,0,0,0,0,0,0,0,0,0,0,0,0,0,0,0,0,0,0,0,0,0,0,0,0,0,0,0,0,0,0,0,0,0,0,0,0,0,,True,False,0.0,2345.51,2275.51,2283.51,2290.51,0,0.01,True,2024-04-03 19:30:00,2024-04-08 05:38:27,2024-04-03 10:18:21,2024-04-01 23:15:00,2245.51,2024-04-03 10:18:21,2275.56,auto,0.01,531.01,even,1 days 11:03:21,1305.76,True,2,0,14,4
2024-04-03 10:30:00,2272.68,2273.66,2270.79,2271.78,2700,27,0,2280.489443212127,2279.502215384615,2267.896046054368,2276.6863581119446,-6.0281539298083676e-05,-5.942483870814703e-05,,,,-7.78310384127035e-05,-0.0002921888459276079,2277.1541101354746,2286.858106354507,2024-04-03 10:00:00,2024-04-03 10:00:00,-0.8060606060594182,5.438180236921653,2280.4583030303015,0.00041525833050402974,0.0006195545597268855,2284.1112121212122,2235.6123299064025,2256.947904958029,2234.687609452626,2265.3290192592804,0.00043328699589098617,0.0004152807956223004,2279.5712588785746,87.46084388978915,88.91617495204208,5.882095383144323,2269.9422352159986,-1.0,2276.8807741106484,bullish,2282.586265647532,2271.2797641878606,,1.0,,,2276.9259968603233,2271.36724453855,2282.4076872553137,,,2262.8788910768612,2301.865724086982,,,,,2024-04-03 08:00:00,2024-04-03 08:00:00,2274.6532628833684,0.0016609062343972522,2257.259825837289,0.0016788763094343724,2287.2549414083696,bullish,2279.256190476191,2298.9930608588024,2259.5193200935796,,,2279.3375152848675,2280.657408918466,-1.3426887917157728,0.16153033726774224,5.14876129348679,-1.774053846154402,-1.8552923076927073,-0.9294846153843537,2289.7997379715885,2269.204692797641,11.194732321464281,13.408573147494439,0,0,0,0,0,0,0,0,0,0,0,0,0,0,0,0,0,0,0,0,0,0,0,0,0,0,0,0,0,0,0,0,0,0,0,0,0,0,0,0,0,0,0,0,0,0,0,0,0,0,0,0,-100,0,0,0,0,0,0,0,0,0,,False,True,1.0,2171.78,2301.78,2241.78,2236.78,1,0.01,False,,,2024-04-04 01:27:20,2024-04-03 10:45:00,2271.78,2024-04-03 17:15:00,2279.28,manual,0.01,-132.57,fail,0 days 06:30:00,1173.19,False,0,1,14,4
2024-04-03 17:00:00,2276.36,2285.21,2275.36,2279.28,5770,27,0,2274.482977860704,2274.564369230769,2271.8633834571033,2285.9828558408294,0.000483205837091639,0.0003984706934800736,,,,0.00024359175739497782,-8.890545984439962e-05,2266.1598053850066,2278.945960641492,2024-04-03 17:00:00,2024-04-03 17:00:00,0.3766060606026258,0.37448409424951024,2275.093515151515,0.0003212690520618933,0.0005329082793192958,2272.2900606060593,2244.097503648179,2269.7595927987804,2243.3753231519254,2267.1452420986725,0.0005708998485445918,0.0003212770223915552,2276.8570606438466,38.27554757527736,31.618618747000877,2.0192771545963346,,-1.0,2276.568936269388,bearish,2282.727226093186,2271.3773471461077,,-1.0,,,2277.045214979653,2270.8946726699496,2282.2573780990115,,,2274.060000000001,2304.3183185176335,2271.0699999999993,2285.880000000001,,,2024-04-03 16:00:00,2024-04-03 16:00:00,2281.031450170386,0.0012851000380087092,2261.6047698262287,0.002051155447698471,2296.4326690688117,bullish,2284.9059523809515,2304.451014992773,2265.36088976913,,,2274.378680918647,2274.3078092484297,0.15434222516933005,-0.7531049787930991,3.0176051881531203,0.9265461538448108,0.41870769230899896,0.39859999999998763,2280.599579607075,2268.529158854463,70.47288149307337,69.81612753555281,0,0,0,0,0,0,0,0,0,0,0,0,0,0,0,0,0,0,0,0,0,0,0,0,0,0,0,0,0,0,0,-100,0,0,0,0,0,0,0,0,0,0,0,0,0,0,0,0,0,0,0,0,0,0,0,0,0,0,0,0,0,0,,True,False,0.0,2379.28,2317.28,2325.28,2334.28,0,0.01,True,2024-04-08 05:45:00,,2024-04-08 01:13:30,2024-04-03 17:15:00,2279.28,2024-04-04 09:15:00,2296.38,manual,0.01,302.18,success,0 days 16:00:00,1475.3700000000001,True,1,0,14,4
2024-04-04 09:00:00,2295.21,2297.27,2295.18,2296.39,1236,27,0,2298.020759665241,2298.0007692307704,2293.082240336548,2299.719999998026,-8.625465640519911e-05,-0.00011599650144504906,,,,-7.252577073651163e-05,-5.970198417130444e-05,2296.338756228252,2301.9887742465176,2024-04-04 09:00:00,2024-04-04 09:00:00,-1.6109090909094448,3.817439756257045,2297.186424242425,0.0003212731117418437,0.00027581514123651543,2298.4518181818185,2254.9444105211956,2288.1355772285374,2254.2202649339915,2287.50543030324,0.00027583186070457265,0.00032126930109985116,2297.2096894587817,74.54432877391979,81.49592063671945,5.002734865497098,,-1.0,2294.468482678994,bullish,2300.9120126378857,2288.9892859866436,,1.0,,,2294.9429066811413,2288.511115120955,2300.4413582360926,,,2251.967484815277,2297.2521300067283,2271.0699999999993,2302.1600000000008,,,2024-04-04 08:00:00,2024-04-04 08:00:00,2293.4695457126686,0.001594843380065593,2275.2212144325194,0.0011092733642424466,2302.916956527742,bullish,2297.8061904761917,2313.593461931388,2282.0189190209953,,,2298.1009053691137,2298.272808645741,-0.25800504803055446,0.3014573283035399,1.602834542811307,-0.5399615384612844,-0.7374615384596837,-0.19658461538756455,2301.206438316393,2294.795100145148,10.320803584457819,14.166780350538202,0,0,0,0,0,0,0,0,0,0,0,0,0,100,0,0,0,0,0,0,0,0,0,0,0,0,0,0,0,0,0,0,0,0,0,0,0,0,0,0,0,0,0,0,0,0,0,0,0,0,0,0,0,0,0,0,0,0,0,0,0,0,,False,True,1.0,2196.39,2326.39,2266.39,2261.39,1,0.01,False,,,2024-04-05 18:20:40,2024-04-04 09:15:00,2296.39,2024-04-04 20:30:00,2289.22,manual,0.01,126.7,success,0 days 11:15:00,1602.0700000000002,True,2,0,14,4
2024-04-04 20:15:00,2290.63,2291.38,2288.28,2289.24,1982,27,0,2291.350309196821,2291.5021076923076,2283.508937292105,2311.376526784821,-0.0001599229919797951,-0.0004221101926187038,,,,-8.308175161217868e-05,8.881553597468196e-05,2284.238903904533,2299.3804378417994,2024-04-04 20:00:00,2024-04-04 20:00:00,-1.008303030301704,-0.8487087195449021,2290.7588484848484,0.0003298907218992039,0.00031441459844257485,2289.6864242424244,2262.861142945238,2293.7567663813634,2262.0894940478433,2293.035107101279,0.00031442261982726804,0.0003325126811043235,2291.5355331935584,42.3190974871566,39.43905501981566,0.35970224428463826,2283.329736000001,-1.0,2293.001079533931,bearish,2298.3777579325433,2287.540897225115,,-1.0,,,2292.9529254965655,2287.266301624209,2298.750236039468,,,2246.7644622358953,2303.930290590196,,2302.1600000000008,,,2024-04-04 20:00:00,2024-04-04 20:00:00,2290.2709765074574,0.0012164859387543258,2281.158914676697,0.0008169482126501818,2308.058924206715,bullish,2289.896071428571,2304.698329364442,2275.0938134926996,,,2290.450626810463,2291.1550247847836,-0.6063647113314801,-0.36562003276319965,2.099223921272572,0.0999615384603203,0.2397461538475909,-0.4414846153858889,2295.700555534853,2287.3036598497624,25.640996150153686,25.92513980058122,0,0,0,0,0,0,0,0,0,0,0,0,0,0,0,0,0,0,0,0,0,0,0,0,0,0,0,0,0,0,0,0,0,0,0,0,0,0,0,0,0,0,0,0,0,0,0,0,0,0,0,0,0,0,0,0,0,0,0,0,0,0,,True,False,0.0,2389.24,2319.24,2327.24,2334.24,0,0.01,True,2024-04-08 05:45:00,2024-04-12 04:07:01,2024-04-08 01:12:41,2024-04-04 20:30:00,2289.24,2024-04-04 23:30:00,2291.3,manual,0.01,36.4,success,0 days 03:00:00,1638.4700000000003,True,3,0,14,4
2024-04-04 23:15:00,2287.54,2291.59,2287.53,2291.22,958,30,0,2292.4711368143353,2292.2759076923085,2287.5525371591443,2301.566138307136,-0.0005351283431268016,-0.00044858675207209764,,,,0.00038671676311317134,-0.000238422009215275,2284.9007292236092,2300.84220645648,2024-04-04 23:00:00,2024-04-04 23:00:00,-2.1087878787889167,-0.15282149303629922,2292.576606060607,0.00021389380672679455,0.00023221541019073001,2292.4367272727272,2265.171125598609,2298.2360840104616,2264.685675079409,2296.329516059283,0.0002773994376002393,0.00021387858001374214,2291.874606152799,58.406530556944965,54.14383029175709,0.26258147988507563,,-1.0,2292.9795470016957,bearish,2296.8102681177156,2288.661288401905,,-1.0,,,2292.732157807583,2288.1306814056516,2297.838688015031,,,2253.073826224742,2291.5708733640017,,2302.1600000000008,1.0,,2024-04-04 20:00:00,2024-04-04 20:00:00,2290.2709765074574,0.0012164859387543258,2281.158914676697,0.0008169482126501818,2308.058924206715,bullish,2289.896071428571,2304.698329364442,2275.0938134926996,,,2292.0387661675304,2292.433330955654,-0.37706862428603927,0.3641800595362473,7.2882723800590545,-0.3299769230752645,-1.1408923076933206,-1.6093615384606892,2306.8524524524264,2277.6993629321905,31.463446305673813,25.06635713559722,0,0,0,0,0,0,0,0,0,0,0,0,0,100,0,100,0,0,0,0,0,0,0,0,0,0,0,0,0,0,0,0,0,0,0,0,0,0,0,0,100,0,0,0,0,0,0,0,0,0,0,0,0,0,0,0,0,0,0,0,0,0,,False,True,1.0,2191.22,2321.22,2261.22,2256.22,1,0.01,False,,,2024-04-05 17:34:17,2024-04-04 23:30:00,2291.22,2024-04-05 00:00:00,2290.27,manual,0.01,16.79,success,0 days 00:30:00,1655.2600000000002,True,4,0,14,4
2024-04-04 23:45:00,2290.91,2291.02,2289.22,2290.74,510,30,0,2292.2658335700894,2292.2795615384616,2289.241604482959,2299.8334838243927,-0.0006642967253822763,-0.0004629942095443544,,,,0.00021188476302320947,-0.00023843216379370704,2283.8117302378287,2303.9363730820855,2024-04-04 23:00:00,2024-04-04 23:00:00,-2.1087878787889167,-0.15282149303629922,2292.576606060607,0.00021389380672679455,0.00023221541019073001,2292.4367272727272,2265.171125598609,2298.2360840104616,2264.685675079409,2296.329516059283,0.0002773994376002393,0.00021387858001374214,2291.874606152799,58.406530556944965,54.14383029175709,0.26258147988507563,,-1.0,2292.9795470016957,bearish,2296.8102681177156,2288.661288401905,,-1.0,,,2292.732157807583,2288.1306814056516,2297.838688015031,,,2253.073826224742,2291.5708733640017,,2302.1600000000008,1.0,,2024-04-04 20:00:00,2024-04-04 20:00:00,2290.2709765074574,0.0012164859387543258,2281.158914676697,0.0008169482126501818,2308.058924206715,bullish,2289.896071428571,2304.698329364442,2275.0938134926996,,,2291.693317788587,2292.2041040429135,-0.4783567792064787,0.06868072820293156,4.5151568158431035,-0.001038461538428237,0.004692307691584574,-0.3299769230752645,2301.3098751701477,2283.2492479067755,43.24113751460731,38.034021555641296,100,0,0,0,0,0,0,0,0,0,0,0,0,0,0,0,0,0,0,100,0,100,0,0,0,0,100,-100,0,0,0,100,0,0,0,0,0,0,0,100,0,100,0,0,0,0,0,0,0,0,0,0,0,0,0,100,0,0,0,0,0,0,,True,False,0.0,2390.74,2320.74,2328.74,2335.74,0,0.01,True,2024-04-08 05:45:00,2024-04-12 04:57:42,2024-04-05 22:14:10,2024-04-05 00:00:00,2290.74,2024-04-05 01:45:00,2289.15,manual,0.01,-28.11,fail,0 days 01:45:00,1627.1500000000003,False,0,1,14,4
2024-04-05 01:30:00,2291.57,2291.73,2288.24,2289.25,586,28,0,2291.998352352755,2291.8832000000007,2285.6598279725754,2295.2796359554104,-0.0007031196509786438,-0.00036654564317385475,,,,-0.00026537426828176787,-0.00023839876154930665,2282.1787408415316,2305.6915408628665,2024-04-05 01:00:00,2024-04-05 01:00:00,0.13987878787975205,-0.2979279221995057,2291.842484848486,0.0002138555804623653,0.00018448768997928136,2292.576606060607,2265.656357355505,2300.0062027788317,2265.171125598609,2298.2360840104616,0.00023221541019073001,0.00021389380672679455,2291.3669158966213,51.68729720367758,56.55114887737329,0.15047959946815936,,-1.0,2292.732157807583,bearish,2296.047620120674,2288.7737741332317,,-1.0,,,2292.407812125325,2288.661288401905,2296.8102681177156,,,2259.051203195525,2293.2889557184394,,2302.1600000000008,,,2024-04-05 00:00:00,2024-04-05 00:00:00,2287.8606510049717,0.0008020849465781412,2277.5733366993886,0.0008169299877725639,2309.9484338454226,bullish,2286.2136904761896,2298.763737886461,2273.663643065918,,,2291.3056103671415,2291.9110209658343,-0.5574926387043888,-0.19939734435753226,2.3962351423372628,-0.37386153846091474,-0.06710769230767255,0.04460769230763617,2296.675670284675,2287.0907297153262,42.7866510842743,43.74323680907179,0,0,0,0,0,0,0,0,0,0,0,0,0,0,0,0,0,0,0,0,0,0,0,0,0,0,0,0,0,0,0,0,0,0,0,0,0,0,0,0,0,0,0,0,0,0,0,0,0,0,0,-100,0,0,0,0,0,0,0,0,0,0,,False,True,1.0,2189.25,2319.25,2259.25,2254.25,1,0.01,False,,,2024-04-05 17:33:52,2024-04-05 01:45:00,2289.25,2024-04-05 10:15:00,2284.52,manual,0.01,83.58,success,0 days 08:30:00,1710.7300000000002,True,1,0,14,4
2024-04-05 10:00:00,2279.08,2285.22,2279.01,2284.57,2687,27,0,2280.520752654663,2281.139530769231,2279.0099999999998,2289.528999220828,0.00024726808194810914,0.00023773721515890961,,,,0.00017212590129839103,0.00014035600111832568,2273.870342645142,2280.792836620126,2024-04-05 10:00:00,2024-04-05 10:00:00,-0.33927272727123636,-3.6176266181196297,2279.5121818181838,-8.473445795127214e-05,1.947009527092971e-05,2275.884060606062,2272.570696249828,2304.665447740198,2270.6764532114703,2304.6218812219145,1.943899810378644e-05,-4.975600335653015e-05,2282.092622569826,29.64235377026068,26.459361052384043,-3.0163319017532593,,-1.0,2284.298970275229,bearish,2289.1601070224715,2279.515293458171,2281.8400950495056,-1.0,,,2284.332610004959,2279.531886766801,2289.07602297308,,,2272.642354396328,2339.0783508561112,2271.739999999999,2304.020000000001,1.0,,2024-04-05 08:00:00,2024-04-05 08:00:00,2285.69695600221,-0.00018800268799781705,2268.250801424971,8.265912706326629e-05,2305.669319924815,bullish,2283.5057142857145,2295.0875811473247,2271.923847424104,,,2279.762670532768,2280.1260649078176,-0.19003418109605263,-1.0342752711931282,1.8826458396089276,1.4717384615387346,0.7065307692305396,0.6014923076922969,2284.904822448449,2277.374239090013,62.536617613810506,57.0990356071675,0,0,0,0,0,0,0,0,0,0,0,0,0,100,0,0,0,0,0,0,0,0,0,0,0,0,0,0,0,0,0,0,0,0,0,0,0,0,0,0,100,0,0,0,0,0,0,0,0,0,0,0,0,0,0,0,0,0,0,0,0,0,,True,False,0.0,2384.57,2314.57,2322.57,2329.57,0,0.01,True,2024-04-08 05:45:00,2024-04-12 04:00:52,2024-04-08 01:17:41,2024-04-05 10:15:00,2284.57,2024-04-08 01:17:41,2315.24,auto,0.01,541.98,even,2 days 15:02:41,2252.71,True,2,0,14,4
2024-04-08 01:45:00,2308.54,2309.54,2306.12,2307.51,1043,30,0,2317.4029977051323,2317.2954692307703,2282.7635540212045,2311.5612571384127,0.0009724452524381186,0.0012145554610099077,,,,-9.6409707944087e-06,-0.0005529043056655196,2315.791306103796,2330.223006479277,2024-04-08 01:00:00,2024-04-08 01:00:00,2.599212121207529,10.529725602710641,2325.370787878788,0.000283903928370947,0.000368072875835505,2331.0010909090893,2260.453851189846,2307.165192979404,2262.852224198775,2306.5711765709098,0.0003641683234751194,0.0001743438120624684,2317.0864140152976,91.56523440811672,91.322654785409,7.7340135789005435,2302.8902372277003,-1.0,2306.8665744200857,bullish,2318.253916072012,2297.4623055403868,2291.1574118811886,1.0,,,2307.834696603471,2296.4636912718834,2317.316582187853,,,2299.3389018529115,2352.5719729475427,2271.739999999999,,,,2024-04-08 00:00:00,2024-04-08 00:00:00,2308.868411062165,0.00018187173939335119,2268.825844513857,0.0015539233285136746,2328.4956488393937,bullish,2313.7371428571428,2340.866493614212,2286.6077921000738,,,2317.861052531247,2318.203484776937,-0.6613157679184951,2.0835763738062925,8.864530847310277,-2.2181769230728605,-2.288576923079745,-2.1977538461537733,2335.024530925391,2299.5664075361497,18.372301009327668,24.12196818215216,0,0,0,0,0,0,0,0,0,0,0,0,0,0,0,0,0,0,0,0,0,0,0,0,0,0,0,0,0,0,0,100,0,0,0,0,0,0,0,0,0,0,0,0,0,0,0,0,0,0,0,0,0,0,0,0,0,0,0,0,0,0,,False,True,1.0,2207.51,2337.51,2277.51,2272.51,1,0.01,False,,,2024-04-08 05:36:50,2024-04-08 02:00:00,2307.51,2024-04-08 05:36:50,2337.18,auto,0.01,-524.46,fail,0 days 03:36:50,1728.25,False,0,1,15,4
2024-04-08 15:45:00,2326.02,2330.88,2324.57,2328.93,3506,27,0,2334.9178445330886,2334.3573846153854,2314.551017644399,2334.922038525774,0.00030711862179230216,9.49914788293522e-05,,,,-5.40111102738118e-05,-0.00031305291396380034,2329.2729104229434,2343.7609780893495,2024-04-08 15:00:00,2024-04-08 15:00:00,-2.1291515151492604,6.339441215727675,2334.3260606060603,0.0007985844819486538,0.0007322271365940051,2336.256666666667,2265.2972399293194,2317.707039312784,2262.9913293359796,2317.9795021769846,0.0006940797411796593,0.0008219240894426405,2334.766969917887,69.1131498470949,68.13715921660484,7.595076290014356,2310.4754103531363,-1.0,2331.4223775205255,bullish,2342.622630984784,2320.9691165288514,2304.097235643565,1.0,,,2331.7707387728424,2320.441393832462,2342.4553263231046,,,2317.0817558083136,2351.7032541300973,2306.13,2348.0599999999995,,,2024-04-08 12:00:00,2024-04-08 12:00:00,2326.547306981382,0.0025613142336025465,2301.3929023272426,0.0026028246189569388,2352.547568851274,bullish,2334.5077380952366,2371.1031264659064,2297.912349724567,,,2333.829965711978,2335.092208436074,-1.286660172861957,0.1899348217830995,6.149814747499294,-1.1999615384597746,-1.666523076921294,-1.873176923079427,2346.657014110384,2322.057755120387,21.56488549618291,24.510470437305315,0,0,0,0,0,0,0,0,0,0,0,0,0,0,0,0,0,0,0,0,0,0,0,0,0,0,0,0,0,0,0,0,0,0,0,0,0,0,0,0,0,0,0,0,0,0,0,0,0,0,0,0,0,0,0,0,0,0,0,0,0,-100,,False,True,1.0,2228.93,2358.93,2298.93,2293.93,1,0.01,False,,,2024-04-09 11:38:18,2024-04-08 16:00:00,2328.93,2024-04-08 21:15:00,2338.36,manual,0.01,-166.69,fail,0 days 05:15:00,1561.56,False,0,2,15,4
2024-04-08 21:00:00,2337.95,2340.1,2336.89,2338.35,2321,27,0,2331.7627263714294,2332.2216153846152,2336.8900000000003,2342.198006282658,-5.231375859200976e-06,-4.440604914114803e-05,,,,0.00010614870786078949,0.00030710917570575454,2321.4971630582654,2337.285859581978,2024-04-08 21:00:00,2024-04-08 21:00:00,2.0361818181822855,1.961439173821418,2332.2224242424236,0.0006676521853177515,0.0010065623108942803,2330.098545454544,2276.857011815432,2318.2213578267383,2275.329806166302,2312.9205559213783,0.0010854550145279072,0.0006676749180227348,2333.657306011146,42.79333997877956,40.03605166729496,3.681639229313493,2315.4509233382414,-1.0,2332.364209260016,bullish,2341.9662778024945,2324.0019888369384,2308.4507287128718,1.0,,,2332.9668423280345,2322.8019004160474,2341.9658833853773,,,2332.4244609790785,2367.7515966282176,2327.2799999999997,2340.0199999999995,,,2024-04-08 20:00:00,2024-04-08 20:00:00,2331.12213643617,0.0024684448964856238,2311.5235553937887,0.0035119205095168245,2368.596845313624,bullish,2333.8497619047625,2363.1986419941327,2304.5008818153924,,,2332.571664972027,2331.744970371614,0.8309901975362664,-0.5565829473969958,4.804544723488121,1.7949692307684018,1.865884615387131,1.859769230767597,2341.8307048315914,2322.612525937639,90.99203341984985,90.57917083540603,0,0,0,0,0,0,0,0,0,0,0,0,0,0,0,0,0,0,0,0,0,0,0,0,0,0,0,0,0,0,100,-100,0,0,0,0,0,0,0,0,0,0,0,0,0,0,0,0,0,0,0,0,100,0,0,0,0,0,0,0,0,0,,True,False,0.0,2438.35,2384.35,2392.35,2403.35,0,0.01,True,2024-04-12 17:00:00,,2024-04-12 06:43:21,2024-04-08 21:15:00,2338.35,2024-04-09 16:45:00,2354.68,manual,0.01,288.57,success,0 days 19:30:00,1850.1299999999999,True,1,0,15,4
2024-04-09 16:30:00,2352.78,2360.89,2352.78,2354.55,6296,27,0,2352.61190443295,2352.545715384616,2341.52461965178,2368.143349488328,-0.00016119994235591872,-0.00042298296062218675,,,,-0.00011529765791139896,-0.00033942134452959985,2350.5398815990557,2363.9504497443972,2024-04-09 16:00:00,2024-04-09 16:00:00,-1.1754545454564322,4.605409616098768,2356.476666666665,0.0005273848250320726,0.00015803756912283252,2356.247757575756,2307.402587147295,2355.089555204051,2306.184823308516,2354.7168366834576,0.0001580409753213028,0.0005273972913215592,2352.810504106079,57.76407844585717,72.30487586136574,4.780743301828316,2340.5653201899527,-1.0,2347.462521082602,bullish,2353.4001404464116,2343.538863992994,2323.867489108912,1.0,,,2348.4643262486948,2342.551797483573,2352.383539099151,,,2339.966446688442,2370.3164759601027,2327.2799999999997,2345.149999999999,,,2024-04-09 16:00:00,2024-04-09 16:00:00,2345.5931619998246,0.002285398408777212,2338.6934146701674,0.0005926586197195692,2363.5127995588696,bullish,2349.8146428571426,2363.0157901557795,2336.6134955585057,,,2353.1416699971,2352.9827420694887,0.007526490790951357,0.6291150061891024,2.706568399279675,-0.3568461538438896,-0.4198307692322487,-1.137753846153828,2357.958852183175,2347.1325785860568,44.18087260780655,33.589348740962066,0,0,0,0,0,0,0,0,0,0,0,0,0,0,0,0,0,0,0,0,0,0,0,0,0,0,0,0,0,0,0,0,0,0,0,0,0,0,0,0,0,0,0,0,0,0,0,0,0,0,0,0,0,0,0,0,0,0,0,0,0,0,,False,True,1.0,2254.55,2384.55,2324.55,2319.55,1,0.01,False,,,2024-04-12 04:00:52,2024-04-09 16:45:00,2354.55,2024-04-09 23:45:00,2353.62,manual,0.01,16.43,success,0 days 07:00:00,1866.56,True,2,0,15,4
2024-04-09 23:30:00,2353.28,2354.43,2352.87,2353.62,354,30,0,2349.5774347553306,2350.6694384615394,2351.9975580185655,2357.5691562555226,-0.00022318498079824782,-9.077686337292571e-05,,,,0.00015463618647674424,0.00021435387147816852,2342.0471212818525,2350.319984688813,2024-04-09 23:00:00,2024-04-09 23:00:00,1.5129090909126717,1.1487144444677142,2348.7507878787906,0.0003489935954304983,0.0002991816797155105,2347.2509090909116,2316.8400545956097,2350.993385332868,2316.0298035107007,2353.9526855692493,0.00022584287799130498,0.0003489915393894715,2349.969737893562,41.19380987472375,32.318021780070154,2.3191818950049576,,-1.0,2349.335828892494,bullish,2354.675427516247,2344.6795631380933,2328.7843504950506,1.0,,,2349.672179841434,2344.238059851893,2354.4446835176345,,,2319.7152611076936,2363.553980260932,2340.2200000000007,2363.159999999999,,,2024-04-09 20:00:00,2024-04-09 20:00:00,2347.8687746665496,0.0016913075531362221,2333.252848475717,0.000592700005391141,2364.912103003091,bullish,2351.5988095238095,2365.8553217200065,2337.3422973276124,,,2350.260693663479,2349.5742397612944,0.6818814513922007,-0.2332788692319859,2.768015986219394,1.7491307692316695,1.666338461540363,1.1870923076885447,2356.205470433978,2345.1334064891007,96.06784383240449,96.19933899813735,0,0,0,0,0,0,0,0,0,0,0,0,0,0,0,0,0,0,0,0,0,0,0,0,0,0,0,0,0,0,0,0,0,0,0,0,0,0,0,0,0,0,0,0,0,0,0,0,0,0,0,0,100,0,0,0,0,0,0,0,0,0,,True,False,0.0,2453.62,2323.62,2383.62,2388.62,0,0.01,False,2024-04-12 05:00:00,,2024-04-10 16:13:36,2024-04-09 23:45:00,2353.62,2024-04-10 05:30:00,2350.3,manual,0.01,-58.69,fail,0 days 05:45:00,1807.87,False,0,1,15,4
2024-04-10 05:15:00,2349.37,2350.52,2348.92,2350.32,640,27,0,2350.4399261953836,2350.1720076923075,2348.9432201427308,2353.69287006782,0.00011475055578405356,0.00021841699646627197,,,,-9.077686337292571e-05,-0.00022318498079824782,2347.9264137192167,2355.9085089144346,2024-04-10 05:00:00,2024-04-10 05:00:00,0.3001212121203025,1.1850707662683817,2352.643696969697,0.000338301689483502,0.00041297221650534496,2353.053454545453,2320.8172938430544,2350.434307623402,2320.030945755103,2349.1665123148887,0.00042074162566156653,0.00033831807432210185,2351.232659397739,51.93253149591385,54.06975626480829,1.7446318337218478,2338.476000000001,-1.0,2350.560166048346,bearish,2355.089328304761,2346.377783544091,2332.220637623764,1.0,,,2350.7295204246843,2346.1935116130226,2354.9349475502836,,,2315.2900696697066,2359.6492951152154,2340.2200000000007,2363.159999999999,,,2024-04-10 04:00:00,2024-04-10 04:00:00,2351.4494554073553,0.0013960088377229908,2340.643978730695,0.0015426217072751407,2371.7108364945266,bullish,2353.321190476189,2366.59558019852,2340.0468007538575,,,2350.00168053684,2350.427710218777,-0.4111177945287636,-0.023492682335151324,2.32241100090234,-0.4479692307691039,-0.3757692307704019,-0.42199999999911597,2354.816829694112,2345.527185690503,46.58000619003594,36.07758176003457,0,0,0,0,0,0,0,0,0,0,0,0,0,0,0,0,0,0,0,0,0,0,0,0,0,0,0,0,0,0,0,0,0,0,0,0,0,0,0,0,0,0,0,0,0,0,0,0,0,0,0,100,0,0,0,0,0,0,0,0,0,0,,False,True,1.0,2250.32,2380.32,2320.32,2315.32,1,0.01,False,,,2024-04-12 04:00:09,2024-04-10 05:30:00,2350.32,2024-04-10 07:45:00,2354.13,manual,0.01,-67.35,fail,0 days 02:15:00,1740.52,False,0,2,15,4
2024-04-10 07:30:00,2354.12,2355.94,2353.82,2354.16,672,27,0,2351.5051586973386,2351.5523307692315,2353.8200000000006,2362.5812767615284,-0.00010110508288164735,-0.00016645715876719292,,,,1.1482345789343378e-05,0.0001355009407832203,2345.5382780049454,2355.612943670072,2024-04-10 07:00:00,2024-04-10 07:00:00,-0.5363636363636033,1.0496872744151915,2353.041636363637,0.0003383047524932676,0.0003287361370029865,2352.1073333333334,2322.3887838675046,2355.001513925757,2321.6032727829675,2352.9312302490816,0.0003673899080060571,0.00033831673887836763,2352.3283988949283,49.070870178136964,50.15057540947137,1.515098725814583,,-1.0,2350.818957736609,bullish,2355.586494768148,2346.9653461999133,2333.5782673267345,1.0,,,2351.2719692109986,2346.5127516137504,2355.133066399592,,,2316.0013133245825,2359.6006929795926,2340.2200000000007,2354.7400000000002,,,2024-04-10 04:00:00,2024-04-10 04:00:00,2351.4494554073553,0.0013960088377229908,2340.643978730695,0.0015426217072751407,2371.7108364945266,bullish,2353.321190476189,2366.59558019852,2340.0468007538575,,,2352.3103927022075,2351.6216882416043,0.6230938237627015,0.29511955024871933,1.0839403976576487,0.4218000000005304,0.40150769230785954,0.3101076923076107,2353.720211564547,2349.384449973916,90.74937278835334,85.0622836729789,100,0,0,0,0,0,0,0,0,0,0,0,-100,0,0,0,0,0,0,100,0,0,0,0,0,0,0,0,0,0,100,0,0,0,0,0,0,0,0,100,0,0,0,0,0,0,0,0,0,0,0,0,100,0,0,0,0,0,0,0,0,0,,True,False,0.0,2454.16,2324.16,2384.16,2389.16,0,0.01,False,2024-04-12 05:00:00,,2024-04-10 16:13:23,2024-04-10 07:45:00,2354.16,2024-04-10 12:45:00,2348.86,manual,0.01,-93.69,fail,0 days 05:00:00,1646.83,False,0,3,15,4
2024-04-10 12:30:00,2349.67,2349.8,2344.85,2348.85,2748,27,0,2353.5334084660685,2353.4566,2340.349164177626,2349.7773242464873,-0.0005673646920816345,5.647394190385196e-05,,,,-0.00019052806563142383,-0.00019991398996635048,2350.1240902746563,2359.0380566904205,2024-04-10 12:00:00,2024-04-10 12:00:00,0.15993939394093104,1.5140925463806525,2353.3099999999995,0.00020798221608846312,4.115708006356733e-05,2354.905515151516,2329.686935757163,2364.4683978021417,2329.680832437096,2362.9776331356848,0.00010499294170570948,0.00023824972591463285,2352.528311067538,68.20756630387052,74.48960459501848,1.6225526297199604,2343.5381800869445,-1.0,2352.6441811190916,bullish,2356.2516793156706,2348.4542265480754,2336.775700990101,1.0,,,2352.349722107639,2348.778696817272,2356.5160270116853,,,2311.557924369047,2354.691923292682,2349.3199999999993,2354.7400000000002,,1.0,2024-04-10 12:00:00,2024-04-10 12:00:00,2347.740869069936,0.0009115009528148187,2344.0501568924315,0.0004592621068451994,2369.3623531082008,bullish,2348.328690476191,2358.2314275978333,2338.4259533545483,,,2352.976776734594,2353.5827337429378,-0.612350793366204,0.19719140256744377,2.1573921922991612,-1.0510153846157664,-0.8946307692312985,-0.5201615384589786,2357.771384384598,2349.141815615402,11.958152401568904,14.010924765165674,0,0,0,0,0,0,0,0,0,0,0,0,0,0,0,0,0,0,0,0,0,0,0,0,0,0,100,0,0,0,0,0,0,0,0,0,0,0,0,0,0,0,0,0,0,0,0,0,0,0,0,0,0,0,0,0,0,0,0,0,0,0,,False,True,1.0,2248.85,2378.85,2318.85,2313.85,1,0.01,False,,,2024-04-12 01:24:06,2024-04-10 12:45:00,2348.85,2024-04-11 04:15:00,2338.5,manual,0.01,182.9,success,0 days 15:30:00,1829.73,True,1,0,15,4
2024-04-11 04:00:00,2335.13,2339.55,2334.0,2338.49,2520,27,0,2335.3894457549586,2335.6997615384626,2334.0,2346.698586538169,0.00010820376229890313,5.934444339359159e-06,,,,0.00016760718563237488,0.00015001397517474388,2330.089942791654,2335.8817788056094,2024-04-11 04:00:00,2024-04-11 04:00:00,-0.2814545454530162,-3.397445832206813,2335.756000000002,-0.0003875601940977096,-0.00020258112190588747,2332.861636363637,2337.4680729220327,2366.1685300977706,2337.5552634341293,2365.4711413154673,-0.0001676256117927853,-0.0003710678570697907,2336.6177081062283,46.547784134218695,42.04232673312311,-3.597358651638124,,-1.0,2339.0127897776865,bearish,2343.45810239374,2334.114757862739,2340.1768831683194,-1.0,,,2338.7817643444714,2334.32870884255,2343.7062698236355,,,2321.1068783845776,2343.399848094166,2333.830000000001,2357.3500000000004,1.0,,2024-04-11 04:00:00,2024-04-11 04:00:00,2340.19486302616,-0.0013564273408981416,2316.82354449684,-0.0008501015219670319,2354.5574517109635,bullish,2336.8564285714297,2349.53828135406,2324.1745757887993,,,2335.244231526855,2335.145529054843,0.18675076110321243,-0.30131042162467675,1.3312769112028948,0.9234230769243368,0.26809999999977663,-0.14463076923084373,2338.3623153608683,2333.037207716057,67.24205769492745,62.34889107177573,0,0,0,0,0,0,0,0,0,0,0,0,0,0,0,0,0,0,0,0,0,0,0,0,0,0,0,0,0,0,0,0,0,0,0,0,0,0,0,0,0,0,0,0,0,0,0,0,0,0,0,0,0,0,0,0,0,0,0,0,0,0,,True,False,0.0,2438.49,2384.49,2392.49,2403.49,0,0.01,True,2024-04-12 17:00:00,,2024-04-12 06:42:58,2024-04-11 04:15:00,2338.49,2024-04-11 10:30:00,2338.69,manual,0.01,3.5300000000000002,success,0 days 06:15:00,1833.26,True,2,0,15,4
2024-04-11 10:15:00,2338.64,2340.67,2336.62,2338.68,2487,27,0,2339.6269372273714,2339.2886846153847,2321.391662421474,2340.670000000001,0.0003011516597069024,-2.619160644530796e-05,,,,-0.00012337346865649404,-0.00018476389260689867,2336.908162512381,2345.727506241596,2024-04-11 10:00:00,2024-04-11 10:00:00,-1.8553939393932524,-0.48720096517899947,2340.1784242424255,-0.00034204884714556655,-0.0002771215777923897,2341.5963030303046,2330.527181339647,2364.5706063612874,2332.9436334355705,2365.2255126411587,-0.00027711861549250963,-0.00038757789649841067,2338.8354907524817,62.20266797005445,68.0654692085139,-1.392175209585354,2325.1262956796154,-1.0,2338.9810748599343,bearish,2343.7272084600672,2333.756082530281,2341.361724752478,-1.0,,,2338.736331555013,2334.0208091483746,2343.9518821381475,,,2325.369051811536,2354.1193219962975,2333.830000000001,,,,2024-04-11 08:00:00,2024-04-11 08:00:00,2336.0999086841066,-0.0013563734567398362,2313.6729464438317,-0.0010525887844427143,2350.760081052227,bullish,2332.726071428571,2347.688122090171,2317.7640207669706,,,2339.3176563874817,2339.6970488015527,-0.4085722483241625,0.29270056635310293,2.292202621318151,-0.5923230769240035,-0.7830999999996493,-1.2185923076917788,2343.873089858021,2334.7042793727483,32.75818035879848,27.906734210423622,100,0,0,0,0,0,0,0,0,0,0,0,0,0,0,0,0,0,0,100,0,0,0,0,0,0,0,0,-100,-100,100,0,0,0,0,0,0,0,0,100,0,0,0,0,0,0,0,100,0,0,0,0,100,0,0,0,0,0,0,0,0,0,,False,True,1.0,2238.68,2368.68,2308.68,2303.68,1,0.01,False,,,2024-04-11 22:42:52,2024-04-11 10:30:00,2338.68,2024-04-11 16:00:00,2341.23,manual,0.01,-45.07,fail,0 days 05:30:00,1788.19,False,0,1,15,4
2024-04-11 15:45:00,2339.78,2342.72,2339.62,2341.26,4984,27,0,2336.693780991978,2336.907876923075,2324.3561991939264,2344.587976871479,0.00048617610989712894,0.00029540219379130646,,,,0.00015206136448156818,0.00018489546605405846,2327.659278061523,2340.659787733825,2024-04-11 15:00:00,2024-04-11 15:00:00,-0.0010303030326213047,-1.3693195716200535,2335.4344848484834,-7.96168544558961e-05,-0.0002269292337784639,2333.6678787878764,2320.907818027751,2361.0087677380416,2322.554797526959,2361.9513102610363,-0.00027712729459041684,-0.00014110563960666788,2337.303306966705,46.52843229657439,35.703005153452324,-1.5601755930160754,,-1.0,2337.1210463957445,bearish,2342.361193977606,2332.3687087612616,2341.5115386138646,-1.0,,,2337.3596114954235,2331.9519996814647,2342.301550911873,,,2331.640000000001,2375.331736926514,2333.830000000001,2343.860000000001,1.0,,2024-04-11 12:00:00,2024-04-11 12:00:00,2337.8199391227377,-0.0014359599898860261,2310.0507500551653,-0.0011023249003220734,2347.7256724333524,bearish,2335.109166666666,2349.222571642089,2320.9957616912434,7.7536186700363805,7.7388500199723325,2337.100329334995,2336.644918112468,0.4677661694536255,-0.2397119771342189,2.008940285688817,1.0590923076902072,0.6755538461529795,0.16380000000026484,2340.9257574944527,2332.8899963516974,70.9869302412051,70.03496699976698,0,0,0,0,0,0,0,0,0,0,0,0,0,100,0,0,0,0,0,0,0,0,0,0,0,0,0,0,0,0,0,0,0,0,0,0,0,0,0,0,0,0,0,0,0,0,0,0,0,0,0,0,0,0,0,0,0,0,0,0,0,0,,True,False,0.0,2441.26,2371.26,2379.26,2386.26,0,0.01,True,2024-04-12 04:15:00,,2024-04-12 01:00:16,2024-04-11 16:00:00,2341.26,2024-04-12 01:00:16,2371.27,auto,0.01,530.31,even,0 days 09:00:16,2318.5,True,1,0,15,4
2024-04-15 03:45:00,2356.5,2356.69,2350.48,2353.16,2489,27,0,2360.489499646964,2360.8073230769223,2348.13184660121,2367.6312478166797,9.715907380299937e-05,-0.000214222742070904,,,,0.00020290871582036784,0.00037390516914156437,2340.6254560473067,2372.946131465692,2024-04-15 03:00:00,2024-04-15 03:00:00,0.6186060606050887,-8.240756508041613,2344.256666666667,0.00010364719037407845,0.0010427484962588583,2344.544363636362,2327.2406764342336,2373.267521174984,2326.999928158601,2370.791334079353,0.0010427902818339134,0.0001036475783506873,2360.171119563195,22.019664072101495,14.906595989078978,-3.5568534288177256,,-1.0,2375.1631976453946,bearish,2387.608720839149,2357.8379416639723,2360.7458950495097,-1.0,,,2372.676638702023,2360.0135013031922,2390.410144829227,,,2300.773294492887,2369.678315917389,2338.68,2426.5700000000006,,,2024-04-15 00:00:00,2024-04-15 00:00:00,2362.6891911208068,0.0003916820656588748,2332.6865793359616,0.004486228354274832,2428.8411699227227,bearish,2363.854285714285,2394.694788669013,2333.013782759557,7.774018386099181,7.75763741891699,2357.3834859953336,2359.2636830805704,-1.3154067398336338,-2.8271871105272304,3.7816238008515586,0.05763076923085464,1.1434923076913037,2.046638461538805,2368.3705706786254,2353.2440754752192,48.51380811737484,59.08357037368389,0,0,0,0,0,0,0,0,0,0,0,0,0,0,0,0,0,0,0,0,0,0,0,0,0,0,0,0,0,0,0,0,0,0,0,0,0,0,0,0,0,0,0,0,0,0,0,0,0,0,0,0,0,0,0,0,0,0,0,0,0,0,,True,False,0.0,2453.16,2383.16,2391.16,2398.16,0,0.01,True,2024-04-19 04:45:00,,2024-04-16 09:27:28,2024-04-15 04:00:00,2353.16,2024-04-15 07:00:00,2358.36,manual,0.01,91.89,success,0 days 03:00:00,2410.39,True,2,0,16,4
2024-04-15 06:45:00,2358.62,2359.45,2358.08,2358.44,853,27,0,2359.234512683244,2358.7277538461517,2354.6371982781693,2366.151509197646,-0.00022303829660143496,-0.0001967561497450768,,,,-6.122049008389458e-05,0.0001311145332920826,2348.2878763097,2365.3246318683427,2024-04-15 06:00:00,2024-04-15 06:00:00,5.576848484846323,-6.997110362618514,2358.7132727272765,4.261131485109636e-05,0.0010427606190147477,2355.4123636363624,2331.4110587406017,2380.696936760609,2329.273983086677,2378.222068368231,0.001042723099910651,7.726105290268677e-05,2359.0480576271275,22.787791888570002,24.112385634302736,-5.552211769770515,,-1.0,2368.79609925773,bearish,2381.317558631093,2353.0897405982955,2360.9320633663415,-1.0,,,2367.161573767495,2354.5975554664305,2383.080262200942,,,2305.797146223409,2377.738542679936,2338.68,2426.5700000000006,,,2024-04-15 04:00:00,2024-04-15 04:00:00,2360.6394607472043,0.00032079806465092097,2333.6648082901656,0.004485877030511256,2439.802105265738,bullish,2357.6413095238104,2385.8481247020723,2329.4344943455485,7.774183406143321,7.75763741891699,2358.288941079326,2358.6475580780675,-0.13235743922359688,-0.5157961957365255,1.8335518808406688,-0.935207692309632,-0.8075461538446689,-0.677676923078252,2362.394857607833,2355.0606500844706,59.64849003925709,57.40321807327637,100,0,0,0,0,0,0,0,0,0,0,0,0,0,0,0,0,0,0,100,0,0,0,0,0,100,0,0,0,0,-100,0,0,0,0,0,0,0,0,100,0,0,0,0,0,0,0,100,0,0,0,-100,-100,0,0,0,0,0,0,0,0,0,,False,True,1.0,2258.44,2388.44,2328.44,2323.44,1,0.01,False,2024-04-23 04:45:00,,2024-04-16 01:15:34,2024-04-15 07:00:00,2358.44,2024-04-15 09:45:00,2357.95,manual,0.01,8.66,success,0 days 02:45:00,2419.0499999999997,True,3,0,16,4
2024-04-15 09:30:00,2358.1,2359.54,2356.12,2357.98,3417,27,0,2358.4718432501895,2358.599753846154,2343.124170367832,2359.516847038614,8.297219938959012e-05,3.7969208609837326e-05,,,,-6.598011139644329e-05,-1.7872673472084664e-05,2352.2335077289113,2363.690651879578,2024-04-15 09:00:00,2024-04-15 09:00:00,0.3846060606106221,-4.947383733193419,2358.639393939394,2.3910973529829654e-05,0.0007565828389005053,2360.4265454545475,2332.6572089034453,2399.9640014911834,2332.20901888518,2391.962844011839,0.000898261289903065,3.1432697652138255e-05,2358.100060035809,25.454048887068026,24.987482361509265,-5.580958450944166,,-1.0,2364.4674976933197,bearish,2376.700164286117,2349.4978565542756,2361.058089108916,-1.0,,,2363.0598684041897,2350.7520685226946,2378.262949338392,,,2310.8303849862173,2386.1747721632805,2338.68,2364.610000000001,,,2024-04-15 08:00:00,2024-04-15 08:00:00,2357.5929738314694,9.56383701503555e-05,2334.0126576954344,0.0031222131967238386,2444.895665171573,bullish,2351.612738095238,2379.502901639051,2323.722574551425,7.774183406143321,7.759550874625394,2358.0762214282977,2358.1616569098783,0.018918317305633536,-0.1997116408718939,2.0022375875229526,0.2922692307702164,0.41489999999976135,0.7749999999991815,2362.6042290212,2354.5952786711077,65.134099616861,69.15688540209844,100,100,0,0,0,0,0,0,0,0,0,0,0,0,0,0,0,0,0,100,100,0,0,0,0,0,0,0,0,0,-100,0,0,0,0,0,0,0,0,100,0,100,0,0,0,0,0,100,0,0,0,0,-100,0,0,0,0,0,0,0,0,0,,True,False,0.0,2457.98,2327.98,2387.98,2392.98,0,0.01,False,2024-04-16 20:00:00,,2024-04-15 17:08:33,2024-04-15 09:45:00,2357.98,2024-04-15 10:00:00,2354.75,manual,0.01,-57.09,fail,0 days 00:15:00,2361.9599999999996,False,0,1,16,4
2024-04-15 09:45:00,2357.95,2358.13,2353.03,2354.75,3339,27,0,2358.2317243308225,2358.1282846153845,2341.8419924114983,2358.106563207175,0.0001730194398811958,7.5372041667321e-05,,,,-6.458169959737464e-05,-5.265271248694715e-05,2352.5380725237924,2363.5342236896518,2024-04-15 09:00:00,2024-04-15 09:00:00,0.3846060606106221,-4.947383733193419,2358.639393939394,2.3910973529829654e-05,0.0007565828389005053,2360.4265454545475,2332.6572089034453,2399.9640014911834,2332.20901888518,2391.962844011839,0.000898261289903065,3.1432697652138255e-05,2358.100060035809,25.454048887068026,24.987482361509265,-5.580958450944166,,-1.0,2364.4674976933197,bearish,2376.700164286117,2349.4978565542756,2361.058089108916,-1.0,,,2363.0598684041897,2350.7520685226946,2378.262949338392,,,2310.8303849862173,2386.1747721632805,2338.68,2364.610000000001,,,2024-04-15 08:00:00,2024-04-15 08:00:00,2357.5929738314694,9.56383701503555e-05,2334.0126576954344,0.0031222131967238386,2444.895665171573,bullish,2351.612738095238,2379.502901639051,2323.722574551425,7.774183406143321,7.759550874625394,2357.5644950547135,2357.9089415832204,-0.22822380739944492,-0.2054140741774041,2.252768138416087,-0.471469230769344,0.2922692307702164,0.41489999999976135,2362.6338208922166,2353.6227483385524,47.477650063859166,62.18426280687058,0,0,0,0,0,0,0,0,0,0,0,0,0,-100,0,0,0,0,0,0,0,0,0,0,0,0,0,0,0,0,0,0,0,0,0,0,0,0,0,0,0,0,0,0,0,0,0,0,0,0,0,0,0,0,0,0,0,0,0,0,0,0,,False,True,1.0,2254.75,2384.75,2324.75,2319.75,1,0.01,False,2024-04-23 04:45:00,,2024-04-15 22:24:01,2024-04-15 10:00:00,2354.75,2024-04-15 15:45:00,2356.79,manual,0.01,-36.06,fail,0 days 05:45:00,2325.8999999999996,False,0,2,16,4
2024-04-15 15:30:00,2354.76,2358.79,2351.08,2356.8,5630,27,0,2354.9916826761746,2355.2844153846163,2313.3031768865103,2360.2667334444695,0.0007911284936636345,0.00015742914546954708,,,,0.00018257100829624048,0.00016976444998720124,2346.6000742529586,2358.851628237499,2024-04-15 15:00:00,2024-04-15 15:00:00,0.6463636363655496,-3.464484471290234,2354.8135151515166,-0.0005109698170609731,-0.0005262931347702997,2353.954303030303,2352.0616612023173,2445.8781838685663,2348.559165421075,2440.683871707333,-0.00030951876356614206,-0.0003871711393129204,2355.9315398005665,44.9074362625712,44.65783174538128,-4.721542287135165,2334.2826,-1.0,2357.844479323345,bearish,2370.88942490213,2344.080380342547,2360.8594732673314,-1.0,,,2357.4467936466153,2344.4854900361374,2371.279588763794,,,2321.6473688673004,2389.0368998727504,2338.68,2364.610000000001,,,2024-04-15 12:00:00,2024-04-15 12:00:00,2357.4653158876463,-0.0010082009656552913,2329.69517010311,0.00011688227672002033,2432.2453020494077,bearish,2349.8864285714303,2378.4111365015847,2321.361720641276,7.774183406143321,7.760854829217725,2355.599288951859,2354.8859281132686,0.7282365530072639,-0.016185535585581168,0.9850226609647791,0.8095769230776568,1.028030769231009,0.9367692307673678,2357.254460706546,2353.3143700626865,72.1417198936572,75.22219252495712,0,0,0,0,0,0,0,0,0,0,0,0,0,0,0,0,0,0,0,0,0,0,0,0,0,0,0,0,0,0,0,0,0,0,0,0,0,0,0,0,0,0,0,0,0,0,0,0,0,0,0,0,0,0,0,0,0,0,0,0,0,0,,True,False,0.0,2456.8,2326.8,2386.8,2391.8,0,0.01,False,2024-04-16 19:45:00,,2024-04-15 17:08:33,2024-04-15 15:45:00,2356.8,2024-04-15 17:08:33,2328.06,auto,0.01,-508.03,fail,0 days 01:23:33,1817.8699999999997,False,0,3,16,4
2024-04-15 17:00:00,2348.57,2349.03,2324.31,2332.13,7037,27,0,2352.5994802096375,2351.9312923076914,2324.3100000000004,2349.03,0.0009345064445592393,0.0006489632379322235,,,,-5.112507437604076e-06,-0.0005210011904794815,2337.9678695732023,2361.097459290232,2024-04-15 17:00:00,2024-04-15 17:00:00,-1.6811515151525782,-3.387419605316609,2351.8443030303015,-0.0006695972757520868,-0.0008977028965274777,2353.132363636364,2354.616301397934,2451.705285847931,2356.1797224085035,2449.328408585763,-0.0007155142178567149,-0.000669565823295847,2353.2185858052812,43.35330617850756,46.519664078973,-4.162775717775484,2336.3874361599997,-1.0,2356.475024358341,bearish,2369.1030344756873,2342.264994821854,2360.56532475248,-1.0,,,2355.645793997611,2343.0636020222096,2369.9632121091727,,,2324.3100000000004,2389.7105456612812,2338.68,2364.610000000001,,,2024-04-15 16:00:00,2024-04-15 16:00:00,2357.3402105917644,-0.0026388360744116737,2316.8520999445773,-0.002928587440697144,2404.7960151761113,bullish,2351.501071428572,2379.9817178836747,2323.020424973469,7.773162608826274,7.760854829217725,2349.797725614343,2352.1932070959692,-2.180337261466775,-0.44664544494043873,8.691777312894747,-2.902553846153751,-0.5963923076942592,-1.0696307692296614,2369.314846933481,2334.5477376819017,21.196263318120767,27.72575262800244,0,0,0,0,0,0,0,0,0,0,0,0,0,-100,0,0,0,0,0,0,0,0,0,0,0,0,0,0,0,0,0,100,0,0,0,0,0,0,0,0,0,0,0,0,0,0,0,0,0,0,0,0,0,0,0,0,0,0,0,0,0,0,,False,True,1.0,2232.13,2362.13,2302.13,2297.13,1,0.01,False,2024-04-23 12:30:00,,2024-04-15 20:27:11,2024-04-15 17:15:00,2332.13,2024-04-15 20:27:11,2362.15,auto,0.01,-530.65,fail,0 days 03:12:11,1287.2199999999998,False,0,4,16,4
2024-04-15 20:30:00,2366.9,2370.49,2362.2,2366.05,4690,27,0,2353.395503520798,2353.448776923076,2361.3167792018044,2383.5288469185157,0.0004959222234925601,0.00023781357534500473,,,,0.00022207051594547118,0.0009344924326009069,2330.3321452267855,2364.5617160055563,2024-04-15 20:00:00,2024-04-15 20:00:00,1.4167878787866357,-2.509835562470016,2356.982848484848,-0.00045362634163063746,-0.0010161501473931638,2353.468969696968,2344.6819836482796,2446.8993452400505,2348.4455274610777,2452.212682082616,-0.0011749139379413631,-0.0005558280416756665,2356.359170001662,71.89458679068127,57.26363837633051,-3.6254231334525846,,-1.0,2354.968685678031,bearish,2368.8470317092906,2342.3892078258104,2360.6538653465395,-1.0,,,2355.580973362208,2341.7055660856263,2368.306925876489,,,2354.0500000000006,2390.687916029735,2338.68,2364.610000000001,1.0,,2024-04-15 20:00:00,2024-04-15 20:00:00,2365.9334737278427,-0.0019474520217366282,2316.7698202735232,-0.004872853008853856,2375.6518505925756,bullish,2364.027261904761,2392.3557526870204,2335.6987711225015,7.773162608826274,7.760854829217725,2355.9126983742462,2353.5148665548927,2.283770084344269,0.23163578096358872,6.895092975634179,2.3125076923065535,2.6871461538462427,0.9488615384611876,2367.2389628743445,2339.6585909718074,92.25858910741515,92.40651450776869,0,0,0,0,0,0,0,0,0,0,0,0,0,0,0,0,0,0,0,0,0,0,0,0,0,0,0,0,0,0,-100,0,0,0,0,0,0,0,0,0,0,0,0,0,0,0,0,0,0,0,0,0,-100,0,0,0,0,0,0,0,0,0,,True,False,0.0,2466.05,2404.05,2412.05,2421.05,0,0.01,True,,,2024-04-19 05:24:57,2024-04-15 20:45:00,2366.05,2024-04-16 10:15:00,2372.23,manual,0.01,109.21,success,0 days 13:30:00,1396.4299999999998,True,1,0,16,4
2024-04-16 10:00:00,2372.76,2375.21,2372.06,2372.22,3384,27,0,2381.2995410544045,2381.0506538461527,2361.5138857244697,2375.2099999999996,0.0001998280082896083,9.22527647777404e-07,,,,-9.693686994349107e-05,-0.00028650390604441605,2374.900891877983,2389.693872616464,2024-04-16 10:00:00,2024-04-16 10:00:00,-3.3112121212107013,4.425453172881134,2377.3350909090937,-0.00011306697681541651,-0.00048745510445064,2382.6570909090906,2328.3165499702345,2423.4458782518163,2332.902392043021,2424.621913401567,-0.00048739920157613937,-0.00022735358228847817,2377.6996782817614,79.18959142154917,87.41805268460666,5.375378963218778,2362.4471464646713,-1.0,2376.6509751942394,bullish,2384.351890031247,2368.332146798532,2366.667635643569,1.0,,,2376.3285190479955,2368.9457850106423,2384.3812271399675,,,2362.9531408641083,2399.3333255518637,2348.6199999999994,2386.3100000000004,,,2024-04-16 08:00:00,2024-04-16 08:00:00,2374.125844067509,-0.0007592419160677948,2321.175552655107,-0.0019462126845885045,2394.9335104488846,bullish,2378.95119047619,2401.660539652257,2356.241841300123,7.769079408800879,7.76138207508005,2379.9343236206846,2381.5327046917178,-1.637901893693197,0.264376632749342,7.152760580937883,-1.6546769230781138,-1.4335692307690806,-2.096538461536511,2395.3561750080285,2366.745132684277,15.141678554569415,14.537047491125819,0,0,0,0,0,0,0,0,0,0,0,0,0,0,0,0,0,0,0,0,0,0,0,0,0,0,0,0,-100,0,0,-100,0,0,0,0,0,0,0,0,0,0,0,0,0,0,0,0,0,0,0,0,0,0,0,0,0,0,0,0,0,0,,False,True,1.0,2272.22,2402.22,2342.22,2337.22,1,0.01,False,2024-04-22 16:00:00,,2024-04-19 04:31:49,2024-04-16 10:15:00,2372.22,2024-04-16 16:30:00,2378.45,manual,0.01,-110.12,fail,0 days 06:15:00,1286.31,False,0,1,16,4
2024-04-16 16:15:00,2371.93,2379.2,2371.86,2378.5,4690,27,0,2374.2340671092306,2374.6241615384615,2358.9113218881084,2387.7051849848713,0.0004860559677163348,0.00031166378464883587,,,,0.00012673044130594565,3.864108528893532e-05,2367.8687708483276,2375.7941333563112,2024-04-16 16:00:00,2024-04-16 16:00:00,0.9418181818173252,0.16148586201188664,2369.0385454545476,0.0006183401003570551,0.0003473218920253946,2370.3226666666656,2311.080364228948,2378.6274872681493,2311.217300461551,2377.8127197145923,0.00034650915146443236,0.0005521875715455974,2372.599348206425,37.528789818403304,31.761484046079953,1.6923953285052957,,-1.0,2375.9233705031106,bullish,2383.6155108562357,2366.813653897282,2367.8913980198067,-1.0,,,2375.1997256516943,2367.6748377867116,2384.2006395522553,,,2363.7891640077864,2398.528549465039,2365.460000000001,2386.3100000000004,,,2024-04-16 16:00:00,2024-04-16 16:00:00,2382.327041807782,0.0022520148831868124,2344.1446435736557,0.0013282360284459444,2397.687995890268,bullish,2386.2683333333325,2409.82439842283,2362.712268243835,7.769716120458048,7.76138207508005,2373.9248824319047,2374.020419434784,0.011630914948000282,-0.8736342460820774,2.4239106536430572,1.069769230770362,0.1819076923056855,0.6289769230784259,2379.471982845748,2369.7763402311753,69.82360840282568,72.22190890601195,0,0,0,0,100,0,0,0,0,0,0,0,0,100,0,0,0,0,0,0,0,0,0,0,0,0,0,0,0,0,0,0,0,0,0,0,0,0,0,0,100,0,0,0,0,0,0,0,0,0,0,0,0,0,0,0,0,0,0,0,0,0,,True,False,0.0,2478.5,2348.5,2408.5,2413.5,0,0.01,False,,,2024-04-22 14:08:18,2024-04-16 16:30:00,2378.5,2024-04-16 17:30:00,2366.56,manual,0.01,-211.06,fail,0 days 01:00:00,1075.25,False,0,2,16,4
2024-04-16 17:15:00,2369.92,2371.85,2363.48,2366.56,6008,27,0,2373.090650953345,2372.677276923077,2363.4800000000005,2390.6834078017146,0.00048737201420849183,0.00031170259050809383,,,,0.00012825355163412056,-8.996861674075987e-05,2365.869314830851,2376.9946080874524,2024-04-16 17:00:00,2024-04-16 17:00:00,-1.2841212121179524,-0.7735067553203407,2373.245151515151,0.0006805288133579567,0.0003473071421644761,2369.0385454545476,2311.3251845555137,2379.4557339355765,2311.080364228948,2378.6274872681493,0.0003473218920253946,0.0006183401003570551,2374.855048604997,33.40713310625568,34.14633715425055,1.1992149117401685,,-1.0,2375.1997256516943,bearish,2384.2147401663506,2367.2753499591086,2368.3095722772323,-1.0,,,2375.729947490868,2366.813653897282,2383.6155108562357,,,2363.4800000000005,2399.7773151699444,2365.460000000001,2386.3100000000004,,,2024-04-16 16:00:00,2024-04-16 16:00:00,2382.327041807782,0.0022520148831868124,2344.1446435736557,0.0013282360284459444,2397.687995890268,bullish,2386.2683333333325,2409.82439842283,2362.712268243835,7.769716120458048,7.76138207508005,2371.563815121512,2372.7755466772655,-1.0423725463447227,-0.7190355346973268,4.684529058477688,-0.9960230769220288,-0.6634153846166555,-0.8178769230776197,2382.0463350400323,2363.3082188061217,19.81164759944087,36.67592645277971,0,0,0,0,0,0,0,0,0,0,0,0,0,0,0,0,0,0,0,0,0,0,0,0,0,0,0,0,0,0,0,0,0,0,0,0,0,0,0,0,0,0,0,0,0,0,0,0,0,0,0,0,0,0,0,0,0,0,0,0,0,0,,False,True,1.0,2266.56,2396.56,2336.56,2331.56,1,0.01,False,2024-04-22 19:30:00,,2024-04-16 19:46:57,2024-04-16 17:30:00,2366.56,2024-04-16 18:00:00,2382.89,manual,0.01,-288.66,fail,0 days 00:30:00,786.5899999999999,False,0,3,16,4
2024-04-16 17:45:00,2373.27,2383.29,2373.04,2382.75,5300,27,0,2373.727676848869,2374.236100000001,2373.039999999999,2397.5114089651365,0.0002322661792753631,3.43325057922071e-05,,,,0.00017812660995790097,-0.0001451982597934095,2366.6475465014423,2378.529869331819,2024-04-16 17:00:00,2024-04-16 17:00:00,-1.2841212121179524,-0.7735067553203407,2373.245151515151,0.0006805288133579567,0.0003473071421644761,2369.0385454545476,2311.3251845555137,2379.4557339355765,2311.080364228948,2378.6274872681493,0.0003473218920253946,0.0006183401003570551,2374.855048604997,33.40713310625568,34.14633715425055,1.1992149117401685,,-1.0,2375.1997256516943,bearish,2384.2147401663506,2367.2753499591086,2368.3095722772323,-1.0,,,2375.729947490868,2366.813653897282,2383.6155108562357,,,2363.4800000000005,2399.7773151699444,2365.460000000001,2386.3100000000004,,,2024-04-16 16:00:00,2024-04-16 16:00:00,2382.327041807782,0.0022520148831868124,2344.1446435736557,0.0013282360284459444,2397.687995890268,bullish,2386.2683333333325,2409.82439842283,2362.712268243835,7.769716120458048,7.76138207508005,2373.513382424278,2373.5517375490963,0.043153182203695906,-0.5842393447924772,5.735493346547285,1.4582923076932275,0.10053076923077242,-0.9960230769220288,2385.7070866930953,2362.7651133069066,59.820799717760245,39.37722680896377,0,0,0,0,0,0,0,0,0,0,0,0,0,100,0,100,0,0,0,0,0,0,0,0,0,0,0,0,0,0,0,0,0,0,0,0,0,0,0,0,100,0,0,0,0,0,0,0,0,0,0,0,0,0,0,0,0,0,0,0,0,0,,True,False,0.0,2482.75,2352.75,2412.75,2417.75,0,0.01,False,,,2024-04-22 09:47:13,2024-04-16 18:00:00,2382.75,2024-04-17 02:15:00,2384.71,manual,0.01,34.64,success,0 days 08:15:00,821.2299999999999,True,1,0,16,4
2024-04-17 02:00:00,2384.88,2386.79,2384.38,2384.72,1358,27,0,2385.3131931908206,2385.2319384615384,2380.8257680211896,2386.7664185222648,-6.346559731416027e-06,-2.1158617308578545e-05,,,,-0.00022017358413991975,-5.1020477715178975e-05,2378.938735434629,2395.4850368609136,2024-04-17 02:00:00,2024-04-17 02:00:00,-0.7123636363653532,3.1002473507769537,2387.583636363636,0.0007270358551489395,0.000164501990696223,2389.135212121211,2323.9312371041074,2389.2297123597855,2322.2418886225378,2387.807524925114,0.0002169125984328831,0.0007270303254486052,2384.416703817537,64.15922466400684,69.65542070714712,3.014294600990103,2369.884721120257,-1.0,2381.782266737285,bullish,2389.0564814325057,2375.127118950859,2372.1354732673312,1.0,,,2382.081618617562,2373.998864101729,2389.5911880693766,,,2363.8742368499097,2397.3446038757493,2365.460000000001,2397.3999999999996,,,2024-04-17 00:00:00,2024-04-17 00:00:00,2383.007574136792,0.002786717346507698,2362.023932610772,0.0013806527191926828,2404.5727126962474,bullish,2384.0808333333316,2403.458908637673,2364.70275802899,7.77026635100162,7.76138207508005,2385.9119560813556,2385.6803542345715,0.0681558079018032,1.0121044823338061,1.0154098396480389,-0.7423923076917163,-0.8711384615394309,-1.250469230769795,2387.2627581408346,2383.2011187822422,37.2179713556993,37.16164647594892,100,0,0,0,0,0,0,0,0,0,0,0,0,0,0,0,0,0,0,100,0,0,0,0,0,100,0,0,0,0,-100,0,0,0,0,0,0,0,0,100,0,0,0,0,0,0,0,0,0,0,0,0,-100,0,0,0,0,0,0,0,0,0,,False,True,1.0,2284.72,2414.72,2354.72,2349.72,1,0.01,False,2024-04-22 14:15:00,,2024-04-19 04:43:44,2024-04-17 02:15:00,2384.72,2024-04-17 12:00:00,2392.88,manual,0.01,-144.24,fail,0 days 09:45:00,676.9899999999999,False,0,1,16,4
2024-04-17 11:45:00,2389.92,2393.47,2389.88,2392.89,2026,27,0,2382.804074560698,2383.618423076924,2389.903343226802,2394.2665914188083,-0.0003225029240393708,-1.6854170458706745e-05,,,,0.0002445668005226933,0.00015907093126789153,2372.119703312858,2386.911376751395,2024-04-17 11:00:00,2024-04-17 11:00:00,0.06357575757192535,0.07690760472542024,2384.125636363636,0.00034451574725474586,0.00014203820375171977,2380.7056363636343,2348.83390831597,2392.651482194825,2334.1091046550673,2392.3317701859123,0.00014097883818282986,0.0005411739140744606,2384.2957684354387,28.872937417846273,33.98210261518543,0.9782478013401092,,-1.0,2382.5901977920967,bullish,2389.251051270101,2377.529548565916,2374.9923980198064,1.0,,,2383.3830941199617,2376.8674092242904,2388.3267651297515,,,2345.722771968375,2393.60915420052,2382.3400000000006,2397.3999999999996,1.0,,2024-04-17 08:00:00,2024-04-17 08:00:00,2386.051144060796,0.002643112652429072,2372.5732543413565,0.0006343368691651434,2400.8499120276138,bullish,2387.379166666665,2399.0717604764577,2375.686572856872,7.774386139403184,7.76138207508005,2384.489347604342,2382.8979484623965,1.51917182293937,-0.007483905167203819,5.184925264610729,1.8554923076931118,1.552484615384401,1.3542769230775775,2393.9882736061454,2373.2485725477027,96.14619659772438,93.75937852938081,0,0,0,0,0,0,0,0,0,0,0,0,0,100,0,0,0,0,0,0,0,0,0,0,0,0,0,0,0,0,0,0,0,0,0,0,0,0,0,0,100,0,0,0,0,0,0,0,0,0,0,0,0,0,0,0,0,0,0,0,0,0,,True,False,0.0,2492.89,2362.89,2422.89,2427.89,0,0.01,False,,,2024-04-17 19:45:22,2024-04-17 12:00:00,2392.89,2024-04-17 19:30:00,2380.01,manual,0.01,-227.67,fail,0 days 07:30:00,449.31999999999994,False,0,2,16,4
2024-04-17 19:15:00,2380.79,2382.68,2378.93,2379.92,3911,27,0,2386.3729854140634,2386.064807692309,2361.872329492066,2382.68,-0.0001734459205242811,-0.00017572290897504604,,,,4.00428003176405e-05,1.6338232752041912e-05,2378.5166879314374,2394.978844345823,2024-04-17 19:00:00,2024-04-17 19:00:00,-2.5354545454551953,1.1750656715230434,2382.916606060604,-2.5430760897813146e-05,-3.9513553787292715e-05,2388.0388484848486,2362.906070219496,2398.949370047578,2359.0988837480895,2398.2451084801264,-3.397001963112908e-06,0.0002568250475855885,2383.54391536146,70.56904174238589,71.1219876893423,1.526154829830062,2373.9287679999993,-1.0,2385.776409489458,bearish,2390.1637529070113,2379.524112628418,2377.315590099014,1.0,,,2384.8379993560707,2380.7237000739015,2390.839842481395,,,2351.769923699087,2384.328686553342,2382.3400000000006,2397.3999999999996,,,2024-04-17 16:00:00,2024-04-17 16:00:00,2380.863841804798,0.00046605032682114797,2367.6431899617874,-4.036181449056355e-05,2397.8045088934737,bullish,2381.80511904762,2394.6866718461297,2368.92356624911,7.774185036927459,7.76138207508005,2385.4298604538394,2386.393143714808,-0.9489909015051126,0.2056188577151571,4.933494668329574,-0.9930769230754777,-0.7243384615399009,-0.6662769230756567,2395.931797028968,2376.19781835565,12.24231100760855,23.58234819857447,0,0,0,0,0,0,0,0,0,0,0,0,0,0,0,0,0,0,0,0,0,0,0,0,0,0,0,0,0,0,0,0,0,0,0,0,0,0,0,0,0,0,0,0,0,0,0,0,0,0,0,0,-100,0,0,0,0,0,0,0,0,0,,False,True,1.0,2279.92,2409.92,2349.92,2344.92,1,0.01,False,2024-04-22 14:30:00,,2024-04-19 04:42:51,2024-04-17 19:30:00,2379.92,2024-04-18 06:30:00,2374.54,manual,0.01,95.07,success,0 days 11:00:00,544.3899999999999,True,1,0,16,4
2024-04-18 06:15:00,2372.84,2375.03,2372.31,2374.44,1889,27,0,2371.082184518677,2371.379361538459,2372.333294057295,2375.0067108130384,5.984097396472106e-05,0.00017462164792024393,,,,0.00017656589776920178,4.1206093531515166e-05,2363.5982299004104,2371.0038723802777,2024-04-18 06:00:00,2024-04-18 06:00:00,2.319393939396832,-3.585010133004289,2370.0995151515144,-0.0001314325900431329,-5.299379466113254e-05,2368.1761212121223,2362.3301161160084,2397.9220413064327,2362.6425407412753,2398.0492439515615,-5.2995871659898954e-05,-0.00013145142730852004,2371.60397601472,37.718655927100315,34.32864155343949,-3.3460759285148383,,-1.0,2374.9075457336435,bearish,2379.871372222345,2369.192403051406,2376.32639405941,-1.0,,,2374.5258843206375,2369.5208202548934,2380.306517068659,,,2367.7857366294993,2402.280479441226,2360.65,2392.890000000001,,,2024-04-18 04:00:00,2024-04-18 04:00:00,2373.450397571792,-0.0005418210190497811,2354.8256714763406,-0.0001854246329628905,2395.1377747064216,bearish,2370.561904761905,2386.9295442527036,2354.194265271107,7.773426978828559,7.765602009671191,2370.963344899838,2370.7614442725157,0.3257796305724696,-0.6791945644906109,2.923766834019807,1.1176384615355346,0.9148384615396026,0.9433230769209331,2377.2268952064983,2365.5318278704194,86.2448319312271,85.35756693749755,0,0,0,0,100,0,0,0,0,0,0,0,0,0,0,0,0,0,0,0,0,0,0,0,0,0,0,0,0,0,0,0,0,0,0,0,0,0,0,0,100,0,0,0,0,0,0,0,0,0,0,0,0,0,0,0,0,0,0,0,0,0,,True,False,0.0,2474.44,2404.44,2412.44,2419.44,0,0.01,True,,,2024-04-19 04:53:40,2024-04-18 06:30:00,2374.44,2024-04-18 23:45:00,2377.74,manual,0.01,58.31,success,0 days 17:15:00,602.6999999999998,True,2,0,16,4
2024-04-18 23:30:00,2378.6,2378.81,2377.73,2377.73,359,30,0,2381.356151461148,2381.028323076924,2362.841441159548,2378.7899729470164,0.0004154302420203107,0.0009575588243717144,,,,-0.0002138292483085204,-1.7183826794361454e-05,2378.2122843938264,2387.783287053106,2024-04-18 23:00:00,2024-04-18 23:00:00,-1.1400606060592509,1.363190178152763,2381.5690909090904,0.00019972766048730406,-5.341670915604005e-05,2382.823393939395,2350.644563243084,2395.764722961731,2351.5541646178035,2395.892298192389,-5.339712631931069e-05,0.00013615722802620654,2381.2833457003408,54.506252695126506,63.60658825395345,1.4822074016570537,,-1.0,2380.5055958622106,bullish,2385.1463801638847,2375.873223591069,2378.0626574257467,1.0,,,2380.5052864836357,2375.2196527922465,2385.803302557533,,,2376.72935305844,2421.8496165347515,2360.65,,,,2024-04-18 20:00:00,2024-04-18 20:00:00,2380.6782266808477,0.000199035823612986,2356.281238416777,-0.00019585506633549177,2393.239287670601,bullish,2382.9891666666676,2397.253112824752,2368.7252205085833,7.77321312572529,7.772493788849543,2380.5732403829593,2381.3636805357196,-0.7680129176642367,-0.16359634361995207,2.035856699195177,-0.9635615384613629,-0.5223461538435004,-0.5106846153871629,2385.1000364753145,2376.956609678534,6.935724962629982,13.403089187841173,0,0,0,0,0,0,0,0,0,0,0,0,0,0,0,0,0,0,0,0,0,0,0,0,0,0,0,0,0,0,0,0,0,0,0,0,0,0,0,0,0,0,0,0,0,0,0,0,0,0,0,-100,0,0,0,0,0,0,0,0,0,0,,False,True,1.0,2277.73,2407.73,2347.73,2342.73,1,0.01,False,2024-04-22 14:30:00,,2024-04-19 04:34:14,2024-04-18 23:45:00,2377.73,2024-04-19 04:30:00,2395.65,manual,0.01,-316.77,fail,0 days 04:45:00,285.92999999999984,False,0,1,16,4
2024-04-19 04:15:00,2389.19,2397.28,2386.82,2395.66,5238,27,0,2381.3463732525615,2381.479999999999,2386.82,2421.715113236356,-0.0002448985968414766,-0.0008027849684332098,,,,0.0003474411590685564,-0.00013025007555242556,2375.8727965399535,2387.954072695242,2024-04-19 04:00:00,2024-04-19 04:00:00,-0.8491515151499698,0.13065256013442195,2387.2401212121217,0.00031158876221312103,0.00025815667803881677,2379.3891515151513,2351.411912300685,2398.4280300959012,2350.6775353741687,2395.380897721052,-5.339903108753948e-05,0.00031160949056651836,2386.736465939113,42.82018111254833,41.90982703272462,0.8176983408308,,-1.0,2380.5846687770863,bullish,2388.0826406309898,2377.6067592490067,2379.0582514851526,1.0,,,2382.8389429437857,2376.9916519990006,2384.1831166931215,,,2378.710000000001,2431.6763766413414,,2387.909999999999,1.0,,2024-04-19 04:00:00,2024-04-19 04:00:00,2381.3281007470437,0.0011573748718417898,2370.298824799067,-0.00019587470036690882,2392.3033638334923,bullish,2383.3389285714284,2395.5104671964627,2371.167389946394,7.774129465493193,7.772493788849543,2382.5538905441776,2381.435335172005,1.0635541554638621,-0.32150112411354165,7.2506984884959715,2.2940923076903346,1.6619923076932537,0.21669230769339265,2395.981396976991,2366.978603023007,83.0462173673991,63.54721865304929,0,0,0,0,0,0,0,0,0,0,0,0,-100,0,0,0,0,0,0,0,0,0,0,0,0,0,0,0,0,0,0,0,0,0,0,0,0,0,0,0,0,0,0,0,0,0,0,0,0,0,0,0,0,0,0,0,0,0,0,0,0,0,,True,False,0.0,2495.66,2365.66,2425.66,2430.66,0,0.01,False,,,2024-04-22 06:16:08,2024-04-19 04:30:00,2395.66,2024-04-19 09:15:00,2383.44,manual,0.01,-216.01,fail,0 days 04:45:00,69.91999999999985,False,0,2,16,4
2024-04-19 09:00:00,2381.2,2385.08,2378.52,2383.43,3790,27,0,2386.7895162138198,2386.7005,2378.5199999999995,2396.6963680993413,-2.741108435135637e-05,-0.00030125922259908295,,,,-0.0008027849684332098,-0.0002448985968414766,2382.2788560087024,2406.6441786860423,2024-04-19 09:00:00,2024-04-19 09:00:00,-2.0972121212112143,1.7864882819976629,2390.6955757575774,0.00031157107565031074,0.000277825873117333,2390.4005454545463,2355.078044214323,2400.2809499449563,2354.344896677393,2399.6140264053315,0.00027779633808202583,0.0003115874103796757,2387.6341466077097,30.276756217052167,46.575227909764955,2.3534500443228774,2373.2519468272,-1.0,2385.2695072509428,bearish,2391.1453000867436,2380.515757523273,2380.44774455446,1.0,,,2385.82460909938,2379.8835998183295,2390.6676035145038,,,2378.5199999999995,2430.4039720350356,2378.2900000000004,2409.2099999999996,1.0,,2024-04-19 08:00:00,2024-04-19 08:00:00,2382.2587338313624,0.0011573383851335361,2373.047798284807,0.0010329368277068006,2414.775803146536,bullish,2383.2949999999983,2395.569867005417,2371.0201329945794,7.775069505474088,7.772612378282703,2385.4150291067112,2386.852074639519,-1.4266701638198356,-0.0703992231066396,1.9801136330153466,-1.557053846153849,-1.8052846153846076,-1.6913846153843224,2390.660727266031,2382.740272733969,10.12072380699845,9.727930062012122,0,0,0,0,0,0,0,0,0,0,0,0,0,0,0,0,0,0,0,0,0,0,0,0,0,0,0,0,0,0,0,0,0,0,0,0,0,0,0,0,0,0,0,0,0,0,0,0,0,0,0,0,0,0,0,0,0,0,0,0,0,0,,False,True,1.0,2283.43,2313.43,2305.43,2288.43,1,0.01,True,,,2024-04-23 15:38:04,2024-04-19 09:15:00,2383.43,2024-04-19 18:00:00,2391.09,manual,0.01,-135.4,fail,0 days 08:45:00,-65.48000000000016,False,0,3,16,4
2024-04-19 17:45:00,2390.37,2391.88,2388.09,2391.1,4624,27,0,2383.4620831261077,2384.095700000001,2388.090000000001,2401.3488162098743,7.032807090163808e-05,2.2724893381988932e-05,,,,0.00022367171665177855,8.757138172646934e-06,2372.891517076098,2386.6128586819127,2024-04-19 17:00:00,2024-04-19 17:00:00,-0.39600000000018554,-1.369928902216543,2382.3731515151508,0.00010818994018771887,0.0006664679443750152,2379.6508484848478,2365.2526736098976,2388.647455937623,2358.1875163497466,2385.9622512269925,0.0006902364813648113,0.00020081093274931458,2383.652335700976,13.632326820603952,14.15894796555768,0.024264135700983458,,-1.0,2383.971383478319,bearish,2389.7234628527076,2379.1316702612176,2381.2728693069353,1.0,,,2384.4216853650664,2378.766459344056,2389.187696387271,,,2378.5499999999997,2409.7149599704976,2378.2900000000004,2409.2099999999996,1.0,,2024-04-19 16:00:00,2024-04-19 16:00:00,2387.8316594806056,0.0004646370961435826,2371.4639199501016,0.0027902522592841033,2423.067083487407,bullish,2387.5663095238083,2397.7353832279773,2377.3972358196393,7.7757160466298965,7.772612378282703,2384.813364430423,2383.4794268169985,1.2981917909305594,-0.093328253651415,5.389271750399322,1.466530769233941,1.2928923076906358,1.1994461538447467,2394.8742435008,2373.3171564992026,90.93588635236249,84.61478167532174,0,0,0,0,0,0,0,0,0,0,0,0,0,0,0,0,0,0,0,0,0,0,0,0,0,0,0,0,0,0,0,-100,0,0,0,0,0,0,0,0,0,0,0,0,0,0,0,0,0,0,0,0,100,0,0,0,0,0,0,0,0,0,,True,False,0.0,2491.1,2361.1,2421.1,2426.1,0,0.01,False,,,2024-04-22 08:44:51,2024-04-19 18:00:00,2391.1,2024-04-22 01:15:00,2382.72,manual,0.01,-148.13,fail,2 days 07:15:00,-213.61000000000016,False,0,4,16,4
2024-04-22 01:00:00,2387.76,2388.27,2381.06,2382.68,2045,30,0,2390.2946384738493,2390.074653846155,2381.06,2391.147895177242,-0.00020061973255220458,-0.00024214241148703877,,,,-0.00019043548384451724,-0.00019168996060410173,2386.2105160463693,2399.6328445925533,2024-04-22 01:00:00,2024-04-22 01:00:00,-0.10145454545317989,2.1915731311287345,2391.9753333333315,6.663783375793787e-05,9.323453456701736e-05,2395.2410303030306,2369.330282110991,2415.3016738080064,2369.171218709335,2411.814783215856,0.00020384075775627767,6.666484079512087e-05,2389.3660452200693,67.02237521514621,73.25155079279224,1.792293831497344,,-1.0,2388.4279544279766,bullish,2394.2696319189076,2382.213931314702,2383.080760396044,1.0,,,2388.2341745484146,2382.430623289002,2394.440382745622,,,2375.4914761446676,2389.414113531361,2378.2900000000004,2399.5499999999993,,,2024-04-22 00:00:00,2024-04-22 00:00:00,2386.6440708802693,0.00024437132435014755,2372.8721639271266,0.0013197412409245448,2426.715569821338,bullish,2388.818571428572,2398.2901768891506,2379.346965967993,7.778894553693576,7.772612378282703,2390.0515992849796,2390.4973158787093,-0.5251575823026542,0.7184864922976308,3.2892584921535324,-1.6603538461536118,-0.4926384615378083,-0.8168307692312737,2396.653170830462,2383.496136861848,22.387882672653763,20.502389224989162,0,0,0,0,0,0,0,0,0,0,0,0,0,0,0,0,0,0,0,0,0,0,0,0,0,0,0,0,0,0,0,-200,0,0,0,0,0,0,0,0,0,0,0,0,0,0,0,0,0,0,0,0,0,0,0,0,0,0,0,0,0,0,,False,True,1.0,2282.68,2312.68,2304.68,2287.68,1,0.01,True,,,2024-04-23 15:37:58,2024-04-22 01:15:00,2382.68,2024-04-23 04:15:00,2333.9,manual,0.01,862.0,success,1 days 03:00:00,648.3899999999999,True,1,0,17,4
2024-04-23 04:00:00,2332.51,2334.27,2331.57,2333.86,2801,27,0,2332.370512532494,2332.526476923077,2293.6914152666454,2335.5531598135294,0.00026708740115924444,-0.0005281341912257832,,,,8.504444496193569e-05,0.00018778427711534432,2325.8365013964176,2332.607948911163,2024-04-23 04:00:00,2024-04-23 04:00:00,0.970363636363345,-7.696519788758906,2321.427636363637,-0.0009042476523415817,-0.000963938386615076,2329.664424242425,2361.345759507989,2405.672037432792,2366.452531935052,2408.4479836623386,-0.0010084832046709893,-0.0007151603018260748,2325.200934061997,19.49778350206153,14.402293780060925,-9.494728227763474,2325.0108000000005,-1.0,2338.925493082787,bearish,2345.6461130683924,2324.6054388550388,2366.9652118811937,-1.0,,,2335.10207744072,2329.3607277883075,2348.529532987698,,,2285.1158818383033,2334.3199999999993,2355.8400000000006,,,1.0,2024-04-23 04:00:00,2024-04-23 04:00:00,2328.0672295714107,-0.002821926898896131,2321.4296126125455,-0.0036884320594967423,2351.3960006683487,bearish,2318.1609523809534,2365.513469103936,2270.8084356579707,7.763013544308269,7.767483105804987,2331.6901588927913,2331.8748933784336,0.0019385309315111954,-0.7078675794163618,1.0895731469789578,0.5993153846152381,0.4852230769242851,0.48775384615282746,2334.705623217035,2330.3473306291194,85.55994729907907,79.54270970575361,0,0,0,0,0,0,0,0,0,0,0,0,0,0,0,0,0,0,0,0,0,0,0,0,0,0,0,0,0,0,0,-100,0,0,0,0,0,0,0,0,0,0,0,0,0,0,0,0,0,0,0,0,0,0,0,0,0,0,0,0,0,0,,True,False,0.0,2433.86,2303.86,2363.86,2368.86,0,0.01,False,,,2024-04-23 04:52:14,2024-04-23 04:15:00,2333.86,2024-04-23 04:45:00,2305.54,manual,0.01,-500.63,fail,0 days 00:30:00,147.75999999999988,False,0,1,17,4
2024-04-23 04:30:00,2329.61,2330.0,2305.24,2305.55,5534,27,0,2330.477170697011,2328.487553846154,2295.2108264024496,2329.9999999999995,0.00013905102036203205,-0.00043984110682047164,,,,3.141153212127463e-05,-0.0005334387739788023,2319.124335931066,2333.5680365174753,2024-04-23 04:00:00,2024-04-23 04:00:00,0.970363636363345,-7.696519788758906,2321.427636363637,-0.0009042476523415817,-0.000963938386615076,2329.664424242425,2361.345759507989,2405.672037432792,2366.452531935052,2408.4479836623386,-0.0010084832046709893,-0.0007151603018260748,2325.200934061997,19.49778350206153,14.402293780060925,-9.494728227763474,2325.0108000000005,-1.0,2338.925493082787,bearish,2345.6461130683924,2324.6054388550388,2366.9652118811937,-1.0,,,2335.10207744072,2329.3607277883075,2348.529532987698,,,2285.1158818383033,2334.3199999999993,2355.8400000000006,,,1.0,2024-04-23 04:00:00,2024-04-23 04:00:00,2328.0672295714107,-0.002821926898896131,2321.4296126125455,-0.0036884320594967423,2351.3960006683487,bearish,2318.1609523809534,2365.513469103936,2270.8084356579707,7.763013544308269,7.767483105804987,2327.4056167220574,2329.773674021291,-2.043004992220631,-0.8852198518200041,9.490395144554327,-3.7865384615383846,-0.2523846153849263,0.5993153846152381,2347.4683441352627,2309.506763557045,45.66470613492405,68.31436963052995,0,0,0,0,0,0,0,0,0,-100,0,0,0,0,0,0,0,0,0,0,0,0,0,0,0,0,0,0,0,0,0,0,0,0,0,0,0,0,0,0,-100,0,0,0,0,0,0,0,0,0,0,0,0,0,0,0,0,0,0,0,0,0,,False,True,1.0,2205.55,2335.55,2275.55,2270.55,1,0.01,False,,,2024-04-24 18:03:56,2024-04-23 04:45:00,2305.55,2024-04-23 16:45:00,2317.34,manual,0.01,-208.42,fail,0 days 12:00:00,-60.66000000000011,False,0,2,17,4
2024-04-23 16:30:00,2311.68,2319.69,2310.52,2317.03,5099,27,0,2307.06398437992,2308.2600384615384,2310.52,2332.1821933926635,0.00033755593347320034,-2.8341940799272205e-05,,,,0.00035028529957756657,0.00038591574331402624,2296.5406202636814,2310.542367859527,2024-04-23 16:00:00,2024-04-23 16:00:00,2.244424242423065,-6.914201370610499,2311.5871515151525,-0.0013371126556839387,-0.0006660286171132673,2304.4724848484825,2355.399022321776,2379.660888606515,2358.565434956796,2381.0754582537993,-0.000921891549771908,-0.0013371865699942115,2311.2361755882566,33.17012512629203,24.25316485589022,-9.47048299717075,2291.43,-1.0,2310.6907044634695,bearish,2321.6903038968326,2301.4582918206074,2351.9803405940647,-1.0,,,2311.55216271294,2301.108865397161,2320.3124423982213,,,2309.489999999999,2331.8110526421797,2298.8500000000004,2309.0099999999998,1.0,,2024-04-23 16:00:00,2024-04-23 16:00:00,2321.484364317455,-0.004042566636732085,2288.6200524540795,-0.003523121945400778,2328.1949909580912,bearish,2315.1076190476188,2347.352561635566,2282.8626764596715,7.758828771637241,7.766589267382177,2308.886075581236,2306.918767505248,1.9561419155429576,0.21708065695277018,4.683138256391296,2.08473076923201,1.1341538461524578,1.2157615384599012,2317.626314974321,2298.893761948756,86.93829931452636,89.32338891825209,0,0,0,0,100,0,0,0,0,0,0,0,0,0,0,0,0,0,0,0,0,0,0,0,0,0,0,0,0,0,0,0,0,0,0,0,0,0,0,0,0,0,0,0,0,0,0,0,0,0,0,0,0,0,0,0,0,0,0,0,0,0,,True,False,0.0,2417.03,2287.03,2347.03,2352.03,0,0.01,False,,,2024-04-30 23:33:07,2024-04-23 16:45:00,2317.03,2024-04-24 02:00:00,2321.7,manual,0.01,82.52,success,0 days 09:15:00,21.859999999999886,True,1,0,17,4
2024-04-24 01:45:00,2322.38,2322.96,2321.62,2321.66,284,27,0,2321.758247652279,2321.482692307693,2316.955192617338,2323.6847419889937,-4.135159603022106e-05,7.490843969168861e-05,,,,-0.00017519672748461036,-0.0001626753245863915,2322.0297383503225,2328.116779699935,2024-04-24 01:00:00,2024-04-24 01:00:00,-1.4584242424243712,1.6185685785039823,2324.0010303030303,-0.00045034432680203317,-0.0004755927998740742,2326.3834545454547,2307.189784272365,2361.6891217570537,2312.724241368425,2363.798875311356,-0.0004903680334166921,-0.0006091663510403742,2321.533748258952,76.94075168225784,81.64833962470543,-0.8007544694075255,2300.8683737927863,-1.0,2316.911090962247,bullish,2326.627596892884,2308.48965765981,2345.8730633663417,1.0,,,2317.540883059697,2307.620637090416,2326.238948093416,,,2316.0736449010074,2331.3909039471982,2298.8500000000004,2330.28,,,2024-04-24 00:00:00,2024-04-24 00:00:00,2321.287495252202,-0.0024297978337153065,2280.242367591949,-0.0018513983631153175,2336.6609878712898,bearish,2318.664880952381,2336.0803312767293,2301.2494306280323,7.755998980999154,7.766589267382177,2322.623717442283,2322.1749063043944,0.260785105683226,0.9323969388249065,0.4522147875685079,-0.7575615384616867,-0.4430230769203263,-0.6849461538481592,2322.38712188283,2320.578262732556,15.129970877735639,12.110191154883113,0,0,0,0,0,0,0,0,0,0,0,0,0,0,0,-100,0,0,0,0,0,0,0,0,0,0,0,0,0,0,0,0,0,0,0,0,0,0,0,0,0,0,0,0,0,0,0,0,0,0,0,0,0,0,0,0,0,0,0,0,0,0,,False,True,1.0,2221.66,2351.66,2291.66,2286.66,1,0.01,False,2024-05-01 00:00:00,,2024-04-26 12:11:25,2024-04-24 02:00:00,2321.66,2024-04-24 07:00:00,2327.92,manual,0.01,-110.66,fail,0 days 05:00:00,-88.80000000000011,False,0,1,17,4
2024-04-24 06:45:00,2325.13,2328.12,2325.01,2327.91,1133,27,0,2322.0984347065432,2322.269738461538,2325.0100000000007,2336.0541049837952,-0.000208458497109967,-0.00023254873450303187,,,,9.894956093105683e-05,-4.134477798825367e-05,2316.1166803900232,2325.5304466712355,2024-04-24 06:00:00,2024-04-24 06:00:00,-0.47496969697021996,0.6722817190866408,2322.239515151516,-0.00022467675823286366,-0.0003640398917926953,2319.8387878787867,2298.778282380929,2354.734763777331,2299.233252096665,2355.472801828959,-0.0004444269666566799,-0.00022225973430806516,2322.5619188637943,64.11577175810343,68.78705185609427,0.4043419988310603,2306.6253533238696,-1.0,2319.4031800359407,bullish,2328.780877665095,2311.7903462120794,2342.331443564362,1.0,,,2320.270060020915,2310.760416969889,2328.0782689774346,,,2309.5793515370397,2333.102099704738,2295.590000000001,2330.28,,,2024-04-24 04:00:00,2024-04-24 04:00:00,2323.0583301681345,-0.0008988133831229195,2287.8292823408997,-0.0017221766851262831,2332.264284667443,bearish,2322.2677380952387,2338.108876706457,2306.4265994840202,7.755036062286181,7.766589267382177,2322.9454177133234,2322.2560787391635,0.6195796483807499,-0.09207876165636175,3.380967475625374,0.9148076923083863,0.5364692307671248,0.5140538461555479,2329.0316734127887,2315.5078035102874,88.06480164535382,85.26113099193894,0,0,0,0,0,0,0,0,0,0,0,0,0,100,0,100,0,0,0,0,0,0,0,0,0,0,0,0,0,0,0,-100,0,0,0,0,0,0,0,0,100,0,0,0,0,0,0,0,0,0,0,0,0,0,0,0,0,0,0,0,0,0,,True,False,0.0,2427.91,2297.91,2357.91,2362.91,0,0.01,False,,,2024-04-30 17:35:38,2024-04-24 07:00:00,2327.91,2024-04-24 11:45:00,2316.68,manual,0.01,-198.51,fail,0 days 04:45:00,-287.3100000000001,False,0,2,17,4
2024-04-24 11:30:00,2318.74,2319.13,2316.22,2316.68,1735,27,0,2322.9169051328568,2322.1312076923086,2310.996391173461,2319.106999873856,3.3270526257012304e-05,0.00015675955505161293,,,,-0.00023254873450303187,-0.000208458497109967,2321.2578756220996,2331.848880757766,2024-04-24 11:00:00,2024-04-24 11:00:00,-1.1712121212108286,1.347986898851559,2323.8941818181843,0.00020520910657669783,-0.00012239241988145196,2325.4683030303054,2287.0834534971877,2339.5097852181407,2288.8888725405814,2341.1742357698677,-0.00014184248502061098,0.00010824800223981,2323.0097253186977,62.4715742733244,71.9536779910191,1.280382011003612,2311.3194372541566,-1.0,2322.505278193025,bullish,2328.4209507070204,2316.4933759449677,2339.2289247524805,1.0,,,2322.4495061732337,2316.52941206041,2328.4965600487676,,,2294.988974565596,2334.853408171806,2318.1799999999994,2330.28,,,2024-04-24 08:00:00,2024-04-24 08:00:00,2321.7388867787563,-0.0008986752112285747,2285.7696069476765,-0.0006504582834751333,2331.9614837125728,bearish,2324.2259523809516,2339.367729027033,2309.0841757348703,7.754991085352801,7.766589267382177,2321.537489096948,2322.8636810417415,-1.2670220138011246,-0.17209358696248,3.3173588353790433,-1.475892307691538,-1.1364999999996144,-1.3989769230793172,2328.765925363067,2315.4964900215505,6.628446698808527,4.135007183311335,0,0,0,0,0,0,0,0,0,0,0,0,0,0,0,0,0,0,0,0,0,0,0,0,0,0,0,0,0,0,0,0,0,0,0,0,0,0,0,0,-100,0,0,0,0,0,0,0,0,0,0,0,0,0,0,0,0,0,0,0,0,0,,False,True,1.0,2216.68,2346.68,2286.68,2281.68,1,0.01,False,,,2024-04-26 10:20:57,2024-04-24 11:45:00,2316.68,2024-04-24 17:15:00,2317.72,manual,0.01,-18.38,fail,0 days 05:30:00,-305.6900000000001,False,0,3,17,4
2024-04-24 17:00:00,2321.19,2321.49,2317.24,2317.6,4324,27,0,2319.2531991057213,2319.322730769231,2316.738731865278,2340.3012548410347,4.37105488422362e-05,-0.0003272291051336112,,,,0.00023411112077288037,3.326394953516224e-05,2311.82301863431,2321.715061398512,2024-04-24 17:00:00,2024-04-24 17:00:00,0.5343030303051819,-0.4189851543901568,2321.130363636363,0.00034490567599325004,9.140526990003168e-05,2318.0640606060615,2288.8612647454293,2335.3112057258563,2288.071583048569,2335.0977751485334,9.143640859335836e-05,0.0003449146173942289,2322.4284527426744,43.480492813141375,33.590006844626835,-0.06087748883868217,,-1.0,2321.3563035251104,bearish,2328.0705088369004,2315.8483841688694,2335.3385643564407,1.0,,,2321.9514047716702,2315.3552161021416,2327.372944954656,,,2295.768762709253,2336.8988613518904,2318.1799999999994,2330.28,1.0,,2024-04-24 16:00:00,2024-04-24 16:00:00,2323.191727457225,0.0014687662527255935,2307.474694221242,0.00018290101591804934,2337.1808587583114,bearish,2323.990357142857,2337.556439941506,2310.4242743442082,7.755303614826926,7.766589267382177,2319.187038728906,2319.1149766295125,0.13347531206181884,-0.4242443464802507,2.66311009103472,0.22075384615391158,0.776453846154709,0.9422538461531076,2324.6489509513003,2313.9965105871615,59.40355940355903,64.93527698523975,0,0,0,0,0,0,0,0,0,0,0,0,0,-100,0,-100,0,0,0,0,0,0,0,0,0,0,0,0,0,0,0,0,0,0,0,0,0,0,0,0,-100,0,0,0,0,0,0,0,0,0,0,0,0,0,0,0,0,0,0,0,0,0,,True,False,0.0,2417.6,2287.6,2347.6,2352.6,0,0.01,False,,,2024-04-30 23:33:07,2024-04-24 17:15:00,2317.6,2024-04-24 22:45:00,2319.38,manual,0.01,31.45,success,0 days 05:30:00,-274.2400000000001,True,1,0,17,4
2024-04-24 22:30:00,2321.94,2322.27,2319.4,2319.4,1191,27,0,2322.3636645690954,2322.2841615384627,2312.5738554615464,2322.2699999999995,7.66224006981963e-05,-6.786523382688906e-05,,,,-0.00032721458269001466,-0.00013522821007556893,2320.8370661614485,2332.084152813662,2024-04-24 22:00:00,2024-04-24 22:00:00,-0.5621818181780327,0.45248866726706183,2323.1268484848474,0.00034491556662669327,9.224926719036314e-05,2324.7106666666687,2292.812209581901,2331.3510046341917,2292.021839162445,2331.1363625866275,9.222910823220587e-05,0.0003449350111846759,2321.8665119688076,45.42726679712988,52.12364485985497,0.43322206675199093,2314.9635861504,-1.0,2322.3464645095046,bearish,2325.219673294313,2318.986238360283,2332.5948435643613,1.0,,,2322.1008642033844,2318.8099067637295,2325.8884160741745,,,2295.8025152232694,2333.0015257463033,2318.1799999999994,2328.79,,,2024-04-24 20:00:00,2024-04-24 20:00:00,2320.6044849714835,0.0014686959940065911,2310.8682976507375,0.00013780860584570968,2336.814920415606,bearish,2320.185714285714,2332.0303866112704,2308.3410419601573,7.755303614826926,7.766589267382177,2322.0766210881393,2322.416179781084,-0.35797095105863264,0.26691664390689684,1.6512414160608229,-0.8707999999987805,-0.3495000000007167,-0.3074384615379131,2325.5866443705845,2318.981678706341,21.744022503516145,20.874842389735804,0,0,0,0,0,0,0,0,0,0,0,0,0,0,0,-100,0,0,0,0,0,0,0,0,0,0,0,0,0,0,0,0,0,0,0,0,0,0,0,0,-100,0,0,0,0,0,0,0,0,0,0,0,0,0,0,0,0,0,0,0,0,0,,False,True,1.0,2219.4,2349.4,2289.4,2284.4,1,0.01,False,2024-05-01 07:00:00,,2024-04-26 11:02:06,2024-04-24 22:45:00,2319.4,2024-04-25 06:00:00,2319.69,manual,0.01,-5.13,fail,0 days 07:15:00,-279.3700000000001,False,0,1,17,4
2024-04-25 05:45:00,2321.35,2321.58,2319.52,2319.74,1084,27,0,2319.0932378258585,2319.346023076921,2304.0988334872836,2321.5799999999995,0.00038669965193480053,5.106833803913871e-05,,,,9.009951958407255e-05,4.551146822911202e-05,2315.366628069531,2319.86640200946,2024-04-25 05:00:00,2024-04-25 05:00:00,0.6313333333337141,-0.961759369619358,2317.5631515151526,0.00027998204845880854,9.301543804284973e-05,2317.247878787877,2296.40671153165,2332.624866219943,2295.763569725776,2332.408578248012,9.299991288835875e-05,0.0002800154173987001,2319.2259528463524,24.543577098461242,22.149712198165744,-0.5699334888551887,,-1.0,2320.3713156212593,bearish,2323.2222672779967,2317.2577017170042,2329.1867009901043,1.0,,,2320.238067882341,2317.380358907899,2323.366132651303,,,2304.297400211513,2339.6685098490207,2318.1799999999994,2328.79,,,2024-04-25 04:00:00,2024-04-25 04:00:00,2318.539771098437,0.0011217895679767895,2311.435467008984,0.000372150038726464,2337.8915131932667,bearish,2318.087738095239,2325.243226198774,2310.9322499917034,7.756778680131963,7.766589267382177,2319.130938652513,2319.0019064536596,0.16674926237828913,-0.3097394286148871,1.5158584318970192,0.3910692307667887,0.8058692307681667,0.6066307692312876,2322.377739940715,2316.314306213127,81.89443060883936,80.85976973992638,0,0,0,0,0,0,0,0,0,0,0,0,0,0,0,-100,0,0,0,0,0,0,0,0,0,0,0,0,0,0,0,0,0,0,0,0,0,0,0,0,-100,0,0,0,0,0,0,0,0,0,0,0,0,0,0,0,0,0,0,0,0,100,,True,False,0.0,2419.74,2289.74,2349.74,2354.74,0,0.01,False,,,2024-04-30 22:00:28,2024-04-25 06:00:00,2319.74,2024-04-25 06:15:00,2306.94,manual,0.01,-226.28,fail,0 days 00:15:00,-505.6500000000001,False,0,2,17,4
2024-04-25 06:00:00,2319.69,2320.63,2304.99,2306.69,2571,27,0,2318.293028933868,2317.8556384615385,2304.9900000000007,2320.63,0.00038669603116927594,0.00012251217010286666,,,,9.66739921085686e-05,-0.0002756257793708936,2312.1524810485985,2319.9330644901906,2024-04-25 06:00:00,2024-04-25 06:00:00,0.31527272727544187,-0.7814619097757713,2316.399939393938,0.00010712930050307315,9.302375746681261e-05,2317.5631515151526,2297.304787769986,2332.8413244185303,2296.40671153165,2332.624866219943,9.301543804284973e-05,0.00027998204845880854,2317.864629991607,28.94005557760984,25.551561556825515,-0.6122391730393052,,-1.0,2320.238067882341,bearish,2322.720111038065,2316.5048903616275,2328.5689485148564,1.0,,,2319.610419049065,2317.2577017170042,2323.2222672779967,,,2304.9900000000007,2340.094999652338,2314.9400000000005,2328.79,,1.0,2024-04-25 04:00:00,2024-04-25 04:00:00,2318.539771098437,0.0011217895679767895,2311.435467008984,0.000372150038726464,2337.8915131932667,bearish,2318.087738095239,2325.243226198774,2310.9322499917034,7.756778680131963,7.766589267382177,2317.216948090588,2318.089913383018,-0.7653061483360943,-0.40085277255912855,4.680051129129919,-1.4903846153824816,0.3910692307667887,0.8058692307681667,2327.2157407197983,2308.495536203279,55.739054927109386,73.66392634839364,0,0,0,0,0,0,0,0,0,0,0,0,0,0,0,0,0,0,0,0,0,0,0,0,0,0,0,0,0,0,0,-200,0,0,0,0,0,0,0,0,0,0,0,0,0,0,0,0,0,0,0,0,0,0,0,0,0,0,0,0,0,0,,False,True,1.0,2206.69,2336.69,2276.69,2271.69,1,0.01,False,,,2024-04-25 17:35:38,2024-04-25 06:15:00,2306.69,2024-04-25 10:15:00,2320.69,manual,0.01,-247.49,fail,0 days 04:00:00,-753.1400000000001,False,0,3,17,4
2024-04-25 10:00:00,2322.55,2323.01,2320.3,2320.75,2056,27,0,2317.8044164980593,2318.0863692307685,2319.812332581826,2328.251103278519,0.00015416757791075953,5.356416203548658e-05,,,,3.717407538298618e-05,0.00039471938477555915,2309.3153960636105,2322.592692895299,2024-04-25 10:00:00,2024-04-25 10:00:00,1.7111515151491403,-0.43078616933507874,2320.9173333333347,-0.00011666844751365622,9.192804116231133e-05,2318.976363636364,2312.329883340187,2333.7515800188594,2308.5253330071178,2333.492856424088,9.302018321482931e-05,-5.391913802804027e-05,2320.362130256036,48.906712242365906,37.46167786309241,-0.843126583077259,,-1.0,2319.2502268052253,bullish,2322.9892729094813,2316.345265760413,2326.8329821782227,1.0,,,2319.6648906072837,2316.0595401417813,2322.4453090730176,,,2309.434457383109,2341.757781674111,2314.9400000000005,2329.560000000001,,,2024-04-25 08:00:00,2024-04-25 08:00:00,2321.2998473989583,-0.0002156209468041096,2305.6352402442544,0.0002937174473617881,2338.439840478292,bearish,2320.1917857142857,2326.436175196039,2313.9473962325324,7.756778680131963,7.76377853923575,2318.7526617310787,2317.8142776197215,0.9088902906273688,0.1294908021104374,1.833357088549158,0.691707692307773,0.9723692307675265,0.5496307692328628,2321.7530834078666,2314.4196550536703,88.86147324123134,91.12437965942978,0,0,0,0,0,0,0,0,0,0,0,0,0,0,0,0,0,0,0,0,0,0,0,0,0,0,0,0,0,0,0,0,0,0,0,0,0,0,0,0,-100,0,0,0,0,0,0,0,0,0,0,0,0,0,0,0,0,0,0,0,0,0,,True,False,0.0,2420.75,2290.75,2350.75,2355.75,0,0.01,False,,,2024-04-30 21:56:29,2024-04-25 10:15:00,2320.75,2024-04-25 17:15:00,2321.06,manual,0.01,5.48,success,0 days 07:00:00,-747.6600000000001,True,1,0,17,4
2024-04-25 17:00:00,2318.79,2322.41,2316.92,2321.01,5373,27,0,2323.8021547101093,2323.7823153846157,2316.920000000001,2346.1049483780057,0.0002922726817395772,-0.0002824516968161428,,,,0.00022817212878758664,-0.0003133207121836555,2318.66594597335,2331.282913096363,2024-04-25 17:00:00,2024-04-25 17:00:00,-2.7344242424233016,1.4181990168658558,2328.812848484849,-0.00017132212418868617,0.0001468342797723796,2327.127818181817,2313.0013218399044,2334.048865832952,2313.3982627118494,2338.208141778476,-4.0420035455249145e-05,-0.00017132034784104615,2326.5534168875956,75.07270848941347,85.93160379200309,1.1410064841229668,2311.461337537619,-1.0,2322.5280158807204,bearish,2327.291433621061,2319.7931564212454,2325.1788336633713,1.0,,,2323.5392703184352,2319.040559141833,2326.020717182692,,,2316.920000000001,2355.238877132957,2315.4300000000007,2329.560000000001,1.0,,2024-04-25 16:00:00,2024-04-25 16:00:00,2325.83548773287,-0.0007280693418880966,2303.725182428036,-0.000181775595900837,2335.6456938459696,bearish,2325.9219047619044,2334.105140063413,2317.738669460396,7.7559250554862675,7.76377853923575,2323.534244889281,2323.967808787134,-0.49656560092171276,0.592985069051639,5.1169431443684275,-0.7172538461536533,-1.2602230769221023,-0.5213538461548524,2334.0162016733525,2313.548429095879,39.67168262653943,32.28724039659402,0,0,0,0,0,0,0,0,0,0,0,0,0,0,0,0,0,0,0,0,0,0,0,0,0,0,0,0,0,0,0,0,0,0,0,0,0,0,0,0,0,0,0,0,0,0,0,0,0,0,0,0,0,0,0,0,0,0,0,0,0,0,,False,True,1.0,2221.01,2351.01,2291.01,2286.01,1,0.01,False,2024-05-01 00:00:00,,2024-04-26 12:11:22,2024-04-25 17:15:00,2321.01,2024-04-25 17:45:00,2340.9,manual,0.01,-351.6,fail,0 days 00:30:00,-1099.2600000000002,False,0,1,17,4
2024-04-25 17:30:00,2324.89,2344.78,2324.56,2340.75,6591,27,0,2324.9594090647265,2325.7815923076923,2318.9205379633486,2344.780000000001,0.0002510945356430115,-0.00019976139486382714,,,,0.0004153566663239347,-0.0003522135421164962,2317.7698743321503,2333.856933703891,2024-04-25 17:00:00,2024-04-25 17:00:00,-2.7344242424233016,1.4181990168658558,2328.812848484849,-0.00017132212418868617,0.0001468342797723796,2327.127818181817,2313.0013218399044,2334.048865832952,2313.3982627118494,2338.208141778476,-4.0420035455249145e-05,-0.00017132034784104615,2326.5534168875956,75.07270848941347,85.93160379200309,1.1410064841229668,2311.461337537619,-1.0,2322.5280158807204,bearish,2327.291433621061,2319.7931564212454,2325.1788336633713,1.0,,,2323.5392703184352,2319.040559141833,2326.020717182692,,,2316.920000000001,2355.238877132957,2315.4300000000007,2329.560000000001,1.0,,2024-04-25 16:00:00,2024-04-25 16:00:00,2325.83548773287,-0.0007280693418880966,2303.725182428036,-0.000181775595900837,2335.6456938459696,bearish,2325.9219047619044,2334.105140063413,2317.738669460396,7.7559250554862675,7.76377853923575,2326.35540610416,2325.2721268751147,0.9260321052524887,0.5072867153268562,7.855701182661601,2.088223076923896,-0.08894615384724602,-0.7172538461536533,2341.4929946730153,2310.0701899423693,60.323444889076576,46.85960094873777,0,0,0,0,0,0,0,0,0,0,0,0,0,100,0,0,0,0,0,0,0,0,0,0,0,0,0,0,0,0,0,0,0,0,0,0,0,0,0,0,0,0,0,0,0,0,0,0,0,0,0,0,0,0,0,0,0,0,0,0,0,0,,True,False,0.0,2440.75,2310.75,2370.75,2375.75,0,0.01,False,,,2024-04-30 11:56:13,2024-04-25 17:45:00,2340.75,2024-04-26 03:45:00,2328.85,manual,0.01,-210.36,fail,0 days 10:00:00,-1309.6200000000003,False,0,2,17,4
2024-04-26 03:30:00,2329.6,2329.78,2328.7,2328.87,624,28,0,2330.788549556432,2330.7867615384607,2325.1370924335924,2334.582591814513,0.00022206824078903323,9.771474090855564e-05,,,,-0.00015342770706459056,-7.128575763096538e-05,2330.5910127099514,2334.6567999007143,2024-04-26 03:00:00,2024-04-26 03:00:00,0.028787878785806242,2.239453466235318,2331.242484848485,0.00018516116145164408,0.00014596803040169511,2332.9859393939378,2300.1948634387513,2337.156147680548,2301.7306647501678,2336.7898669911124,0.0001468446086154684,0.00011554680545698856,2330.741236372166,59.2834890965731,61.076497057805064,2.3498023536273163,2316.9131703827793,-1.0,2328.7598863071466,bullish,2332.483584162854,2325.63432911248,2324.562889108916,1.0,,,2329.0564388654157,2325.235542432758,2332.2895720058445,,,2326.468753404801,2354.2575626299135,2313.0999999999995,2333.8399999999992,,,2024-04-26 00:00:00,2024-04-26 00:00:00,2328.563550103498,5.947245181726119e-05,2305.36763169886,0.000535263611286789,2344.4502469959957,bullish,2330.9900000000007,2340.248083089921,2321.7319169100806,7.7559250554862675,7.76377853923575,2330.8407389150802,2330.947894014853,-0.16574849178232398,0.31962640761984373,1.107403655847502,-0.5793307692320013,-0.6417153846150541,-0.36137692307784164,2333.0015688501558,2328.5719542267657,10.110285853371517,12.247035759840093,0,0,0,0,0,0,0,0,0,0,0,0,0,0,0,0,0,0,0,0,0,0,0,0,0,0,0,0,0,0,0,0,0,0,0,0,0,0,0,0,-100,0,0,0,0,0,0,0,0,0,0,0,0,0,0,0,0,0,0,0,0,0,,False,True,1.0,2228.87,2298.87,2290.87,2283.87,1,0.01,True,2024-05-01 07:15:00,,2024-04-30 18:11:30,2024-04-26 03:45:00,2328.87,2024-04-26 06:00:00,2333.9,manual,0.01,-88.92,fail,0 days 02:15:00,-1398.5400000000004,False,0,3,17,4
2024-04-26 05:45:00,2332.83,2334.97,2331.42,2333.85,1651,27,0,2331.3738509944224,2331.55706923077,2329.7892838566972,2334.947657000318,0.00016064957586990996,0.00029407211086545607,,,,7.824615171464684e-05,-0.0001232477119158532,2327.3872604954977,2334.490702107584,2024-04-26 05:00:00,2024-04-26 05:00:00,0.41593939394078916,1.7924836730708193,2332.2352727272723,0.0002943546378509756,0.00014597900707845503,2331.658424242426,2298.7252997967635,2337.8392958415134,2299.2907399963046,2337.4975421522417,0.00014594816053991886,0.00024157214746053818,2331.647908422668,56.41744548286573,57.53547940463807,2.1600420295316995,2318.0166968356216,-1.0,2329.471450921646,bullish,2333.330722160341,2326.6484535371187,2324.6080178217876,1.0,,,2329.987192304929,2326.144557359529,2332.803102666456,,,2328.183633071145,2353.829575846596,2313.0999999999995,2333.8399999999992,1.0,,2024-04-26 04:00:00,2024-04-26 04:00:00,2330.972366735665,0.0009433021489906238,2313.165818265759,0.0005352175474814339,2345.7035185779755,bullish,2333.3373809523814,2343.934616912757,2322.7401449920058,7.754508591532214,7.76377853923575,2332.1668631729463,2331.5416814743094,0.5476234388902412,0.19265103785180443,2.708424687074734,0.5014307692290458,0.40548461538810443,0.4778615384598197,2336.9739186049196,2326.1402198566207,75.55777555777574,81.77863012873092,0,0,0,0,0,0,0,0,0,0,0,0,0,0,0,0,0,0,0,0,0,0,0,0,0,0,0,0,100,0,0,0,0,0,0,0,0,0,0,0,0,0,0,0,0,0,0,0,0,0,0,0,100,0,0,0,0,0,0,0,0,0,,True,False,0.0,2433.85,2303.85,2363.85,2368.85,0,0.01,False,,,2024-04-30 16:07:59,2024-04-26 06:00:00,2333.85,2024-04-26 17:00:00,2341.16,manual,0.01,129.19,success,0 days 11:00:00,-1269.3500000000004,True,1,0,17,4
2024-04-26 16:45:00,2339.34,2341.63,2336.79,2341.4,4401,27,0,2343.657230477128,2343.4861230769243,2326.867413948165,2345.396447675904,0.00019037518146608162,-9.229043742099503e-05,,,,-3.0284414611002933e-05,-0.00022457579528630006,2342.6968378345396,2351.9145169704143,2024-04-26 16:00:00,2024-04-26 16:00:00,-0.206848484846887,4.231009932670531,2346.2369696969718,0.0004513256483151285,0.0002500574318053461,2347.7527878787887,2304.091688361972,2339.3699173486775,2303.4893696754452,2338.0739129250837,0.0002797741023488489,0.00043085664638016404,2343.3231083985625,74.79736575481327,80.34329128917506,3.939188510024933,2330.1607285657246,-1.0,2339.469535927857,bullish,2343.8045241214627,2336.1350403524516,2327.6891683168374,1.0,,,2339.9666400478345,2335.5726992480754,2343.3728743689044,,,2322.0978418056443,2351.7249047117766,2329.829999999999,2333.8399999999992,,,2024-04-26 16:00:00,2024-04-26 16:00:00,2337.242553106864,0.0015731606437290563,2326.3998685013253,0.001115101997161192,2354.6315309965294,bullish,2339.767976190476,2353.1665119313675,2326.3694404495845,7.75356611003165,7.76377853923575,2343.9492203814825,2343.9833323209527,-0.16555459080473156,0.7791241223317055,3.076751533654442,-0.770592307691004,-1.2044615384606914,-1.1748230769239854,2349.6396261442333,2337.3326200096153,16.605518882355017,27.595209475739196,0,0,0,0,0,0,0,0,0,0,0,0,0,0,0,0,0,0,0,0,0,0,0,0,0,0,100,0,100,0,0,0,0,0,0,0,0,0,0,0,0,0,0,0,0,0,0,0,0,0,0,0,0,0,0,0,0,0,0,0,0,0,,False,True,1.0,2241.4,2311.4,2303.4,2296.4,1,0.01,True,2024-04-30 18:00:00,,2024-04-30 16:42:01,2024-04-26 17:00:00,2341.4,2024-04-26 23:15:00,2339.2,manual,0.01,38.88,success,0 days 06:15:00,-1230.4700000000003,True,2,0,17,4
2024-04-26 23:00:00,2339.93,2340.1,2338.74,2339.19,622,27,0,2339.099986492358,2339.2247615384613,2335.8560923212517,2342.1254738092002,-0.00038175665133415064,-0.00020901830929977137,,,,0.00011980550028079815,0.00016579991411436022,2332.9030021056196,2339.8399477574244,2024-04-26 23:00:00,2024-04-26 23:00:00,0.7424242424253862,0.5770603362761904,2337.2478787878813,0.0002869320671175157,0.0001818395203326878,2336.94696969697,2311.8548063732424,2343.824243302319,2310.368716304486,2343.39834704976,0.0001818231071368155,0.00030050586550576266,2338.9219364875407,46.54088050314567,38.62101094805589,1.5328643168353124,,-1.0,2339.754015318241,bullish,2343.440369568812,2335.841355911405,2329.23785544555,1.0,,,2339.6377775953133,2335.565884001144,2343.949656782686,,,2320.673511018292,2350.3865866566193,2329.829999999999,2349.25,,1.0,2024-04-26 20:00:00,2024-04-26 20:00:00,2337.365035404576,0.0011135510677529313,2324.9815165682535,0.0006545621203969936,2352.0895876765544,bullish,2339.8786904761905,2349.948765575214,2329.808615377167,7.752388225327139,7.76377853923575,2338.800309218804,2338.981908898869,-0.1174632959491646,-0.4849448917685152,1.0271145435469764,0.5039076923085304,0.47032307692188624,0.3779846153847757,2341.2789906255553,2337.1705324513673,74.5977011494258,70.98339719029411,0,0,0,0,0,0,0,0,0,0,0,0,0,0,0,0,0,0,0,0,0,0,0,0,0,0,0,0,-100,0,0,0,0,0,0,0,0,0,0,0,0,0,0,0,0,0,0,0,0,0,0,-100,0,0,0,0,0,0,0,0,0,0,,True,False,0.0,2439.19,2309.19,2369.19,2374.19,0,0.01,False,,,2024-04-30 15:24:12,2024-04-26 23:15:00,2339.19,2024-04-29 01:45:00,2334.74,manual,0.01,-78.67,fail,2 days 02:30:00,-1309.1400000000003,False,0,1,17,4
2024-04-29 01:30:00,2335.2,2336.1,2334.2,2334.71,805,27,0,2338.0979795099684,2337.6805999999997,2334.189561879447,2340.062119480194,-0.0005131590947527052,-0.00026366952673146645,,,,-8.78213021027499e-05,-8.495300420588077e-06,2332.4761325158684,2341.154632196653,2024-04-29 01:00:00,2024-04-29 01:00:00,0.30090909091131834,0.32552302291423985,2336.7046060606076,0.00027237785752470323,0.00018184205011455873,2337.2478787878813,2312.525420417957,2344.249924072661,2311.8548063732424,2343.824243302319,0.0001818395203326878,0.0002869320671175157,2337.9748394903095,45.38085255066499,43.177265315631125,1.291396058051098,,-1.0,2339.6377775953133,bearish,2343.128769848853,2335.3996914917793,2329.4178990099067,1.0,,,2339.2610384970985,2335.841355911405,2343.440369568812,,,2320.470106523008,2350.1954605453125,2329.829999999999,2349.25,,,2024-04-29 00:00:00,2024-04-29 00:00:00,2335.5800236030504,0.001147821842814774,2328.0125081719225,0.0006585383323485806,2353.6628611258434,bullish,2337.4332142857156,2346.766448451854,2328.099980119577,7.752388225327139,7.76377853923575,2336.9423716579577,2337.894270420744,-0.8379264819413947,-0.5443049914095126,2.0051251296545405,-0.6633000000010725,-0.5604461538450778,-0.6160384615395742,2341.6908502593087,2333.6703497406907,29.166666666667652,33.39376737889163,0,0,0,0,-100,0,0,0,0,0,0,0,0,0,0,0,0,0,0,0,0,0,0,0,0,0,0,0,0,0,0,-100,0,0,0,0,0,0,0,0,0,0,0,0,0,0,0,0,0,0,0,0,-100,0,0,0,0,0,0,0,0,0,,False,True,1.0,2234.71,2296.71,2288.71,2279.71,1,0.01,True,,,2024-05-01 14:41:04,2024-04-29 01:45:00,2334.71,2024-04-29 10:15:00,2332.0,manual,0.01,47.89,success,0 days 08:30:00,-1261.2500000000002,True,1,0,18,4
2024-04-29 10:00:00,2329.1,2332.37,2329.07,2331.99,4061,27,0,2331.2025436559948,2331.644407692309,2329.092913218922,2337.877919873678,0.00014097929751210318,0.00024976995147208553,,,,0.000207086331990107,0.00010913952865361718,2324.8289420157657,2334.880191607498,2024-04-29 10:00:00,2024-04-29 10:00:00,-0.07563636363374826,-2.238745344889594,2331.072242424243,3.8701326893489566e-05,-6.48785933162779e-05,2328.634000000002,2317.6153194888675,2354.053873469929,2314.3197018082847,2352.7243297223863,-8.857737741667517e-06,9.142238068850529e-05,2332.43056934121,47.54230235272888,40.302207202871564,-1.5667253640457586,2320.191799999999,-1.0,2334.0216984198287,bearish,2338.202123611654,2329.8885211683246,2330.4455782178275,-1.0,,,2334.041620874442,2329.736043244763,2338.315237252072,,,2318.6402681461473,2348.476024772002,2324.270000000001,2349.25,1.0,,2024-04-29 08:00:00,2024-04-29 08:00:00,2335.7055660458004,0.0003454149864553691,2318.8830315994383,0.0002188317300652018,2353.908550111198,bullish,2334.940476190476,2343.4231681275905,2326.4577842533618,7.753163178781323,7.76377853923575,2330.60583865391,2330.95646861829,-0.24275669700273284,-0.471028034830734,1.6307907809720672,0.5679846153848302,0.1432000000008884,0.1690692307693098,2334.905989254253,2328.3828261303647,40.95636588081225,43.92553682499943,0,0,0,0,0,0,0,0,0,0,0,0,0,100,0,0,0,0,0,0,0,0,0,0,0,0,0,0,0,0,0,0,0,0,0,0,0,0,0,0,100,0,0,0,0,0,0,0,0,0,0,0,0,0,0,0,0,0,0,0,0,0,,True,False,0.0,2431.99,2301.99,2361.99,2366.99,0,0.01,False,,,2024-04-30 17:09:23,2024-04-29 10:15:00,2331.99,2024-04-29 16:45:00,2330.64,manual,0.01,-23.87,fail,0 days 06:30:00,-1285.1200000000001,False,0,1,18,4
2024-04-29 16:30:00,2333.92,2336.5,2325.62,2330.85,5134,27,0,2335.467037693,2334.7181538461537,2325.62,2338.8634946081775,0.0002839635478612952,0.0003013755507929131,,,,-0.00011066774774616424,-0.00026293015604972314,2332.506838974783,2343.611741648407,2024-04-29 16:00:00,2024-04-29 16:00:00,-1.9809090909084262,0.30809667073526725,2337.1101818181796,-0.00011853279947588817,-0.0001478820092277066,2338.2433333333333,2325.158918953817,2353.966770095049,2325.4340409913034,2354.314557402635,-0.00014786542242539702,-0.0001185289325855897,2335.4136431559177,68.73892297205174,80.5888045151848,-0.120973031463877,2324.9971146492153,-1.0,2335.030589553841,bearish,2339.0066709942894,2330.8997955288573,2331.7885009901042,-1.0,,,2334.949714910628,2330.9794576976515,2339.088762085255,,,2317.421177600734,2347.3304331817244,2324.270000000001,,1.0,,2024-04-29 16:00:00,2024-04-29 16:00:00,2337.186918242578,-0.0004543135556158495,2319.0650228550303,-0.0005821681769145009,2345.987615576315,bullish,2336.0064285714307,2344.2746994003282,2327.738157742533,7.753163178781323,7.76377853923575,2334.5869178662883,2335.491113302754,-0.8988403312673654,0.1574053050467566,2.3807921850636182,-1.2881307692309747,-0.8987769230775484,-1.2890923076906802,2339.479738216281,2329.9565694760263,29.802003441985477,25.02009741418948,0,0,0,0,0,0,0,0,0,0,0,0,0,0,0,0,0,0,0,0,0,0,0,0,0,0,0,0,0,0,0,0,0,0,0,0,0,0,0,0,0,0,0,0,0,0,0,0,0,0,0,0,0,0,0,0,0,0,0,0,0,0,,False,True,1.0,2230.85,2292.85,2284.85,2275.85,1,0.01,True,,,2024-05-01 02:40:19,2024-04-29 16:45:00,2330.85,2024-04-29 19:45:00,2344.17,manual,0.01,-235.47,fail,0 days 03:00:00,-1520.5900000000001,False,0,2,18,4
2024-04-29 19:30:00,2343.66,2344.55,2341.88,2344.15,3024,27,0,2337.5173392789457,2338.3091923076922,2336.60166021619,2349.0829358479223,-0.00015155181371128212,-0.00030593790906239984,,,,0.00016592302910763048,0.0003800954981405261,2326.291620297797,2342.624209633589,2024-04-29 19:00:00,2024-04-29 19:00:00,-0.2104242424225049,0.4790039638965027,2337.914,-0.00011853010215694575,-8.345289582138235e-05,2337.168787878788,2324.3307599090267,2352.7333075869774,2324.6058298522876,2353.270331625502,-0.00014788657943258043,-0.00011850540681698207,2337.7484493861175,66.29220938878392,61.69294959630656,0.09162570009195,,-1.0,2335.385071062022,bullish,2339.9222512308174,2332.059300595313,2332.488825742579,-1.0,,,2335.987467571851,2331.3771883959635,2339.399843700044,,,2316.8118727133137,2346.7578469618797,2324.270000000001,2343.1300000000006,1.0,,2024-04-29 16:00:00,2024-04-29 16:00:00,2337.186918242578,-0.0004543135556158495,2319.0650228550303,-0.0005821681769145009,2345.987615576315,bullish,2336.0064285714307,2344.2746994003282,2327.738157742533,7.753163178781323,7.76377853923575,2339.411385220781,2337.7819339544667,1.4794463203993473,0.5873912092280466,3.5262361054357942,1.3634999999999309,1.2945384615381954,1.2950615384625053,2345.361664518564,2331.2567200968206,90.16746463643841,90.59883054922595,0,0,0,0,0,0,0,0,0,0,0,0,-100,0,0,0,0,0,0,0,0,0,0,0,0,0,0,0,0,0,0,0,0,0,0,0,0,0,0,0,0,0,0,0,0,0,0,0,0,0,0,0,0,0,0,0,0,0,0,0,0,0,,True,False,0.0,2444.15,2314.15,2374.15,2379.15,0,0.01,False,,,2024-04-30 11:20:46,2024-04-29 19:45:00,2344.15,2024-04-29 23:45:00,2336.6,manual,0.01,-133.47,fail,0 days 04:00:00,-1654.0600000000002,False,0,3,18,4
2024-04-29 23:30:00,2335.88,2336.82,2335.54,2336.61,407,32,0,2338.1542995220516,2337.9469923076913,2330.9426645250624,2337.6122569305444,-0.00015155181371128212,-0.00030593790906239984,,,,-0.0003125201316940029,-0.0001129174561338533,2334.444506057053,2345.655403058251,2024-04-29 23:00:00,2024-04-29 23:00:00,-0.3706666666644196,1.0199801046792345,2338.884484848488,-8.765274776002434e-05,-8.13201894968262e-05,2339.318242424243,2322.3511124427873,2351.962710010203,2323.8424108586173,2352.15361959512,-8.13238520932309e-05,-0.0001294958217826102,2337.7376721499877,66.73012851023238,73.95466644647483,0.8055412208730386,2329.708949358281,-1.0,2337.0322092520328,bullish,2340.442019288743,2333.573547749271,2333.2496039604007,1.0,,,2337.005260210832,2333.5223916343384,2340.547305936152,,,2315.9997153905297,2345.9946159295223,2331.850000000001,2343.1300000000006,,,2024-04-29 20:00:00,2024-04-29 20:00:00,2336.5312788283854,-0.0004542850729414111,2318.00689794009,-0.0003576289371928063,2347.6497758160876,bullish,2336.691547619046,2344.9947909612583,2328.388304276834,7.75463824408636,7.76377853923575,2337.547252271407,2338.190298900418,-0.6407136955140231,-0.007023459357871187,2.1430152322341405,-0.4659076923089742,-0.8566538461536766,-0.7686076923068867,2342.2330227721595,2333.660961843223,25.14020970494939,21.86247529481717,0,0,0,0,0,0,0,0,0,0,0,0,0,0,0,0,0,0,0,0,0,0,0,0,0,0,0,0,0,0,0,0,0,0,0,0,0,0,0,0,0,0,0,0,0,0,0,0,0,0,0,100,0,0,0,0,0,0,0,0,0,0,,False,True,1.0,2236.61,2306.61,2298.61,2291.61,1,0.01,True,2024-04-30 22:00:00,,2024-04-30 17:18:14,2024-04-29 23:45:00,2336.61,2024-04-30 17:18:14,2306.42,auto,0.01,533.53,even,0 days 17:33:14,-1120.5300000000002,True,1,0,18,4
