time,open,high,low,close,tick_volume,spread,real_volume,hourly_time,time2,prev_hour_lsma_slope,prev_hour_macd_line,hour_lsma,fixed_support_gradient,fixed_resistance_gradient,prev_hour_lsma,fixed_support_trendline,fixed_resistance_trendline,ema_short,ema_long,lsma,macd_line,macd_signal,lsma_stddev,lsma_slope,prev_lsma_slope_1,prev_lsma_slope_2,lsma_upper_band,lsma_lower_band,stoch_k,stoch_d,is_buy2,is_sell2,tp,sl,be,be_condition,time_updated,sl_updated,time_to_trail,time_tp_hit,time_sl_hit,type,success,profit,account_balance,position_close_time,win_streak,losing_streak,Week,Month
2024-01-02 08:00:00,45191.938,45257.539,45136.84,45253.84,1260,40422,0,2024-01-02 08:00:00,2024-01-02 08:00:00,,,45311.52452380951,0.0051210689704244035,0.000953738957206674,45398.7681309524,46004.76256950675,45830.273787384926,45225.11618430448,44922.329785076276,45319.57736291712,198.55107014187524,,232.69866865110401,-31.920393188876915,-28.29940247673221,-17.533319573427434,45633.720565596115,45003.93416023813,35.65660400824434,47.2740165118585,False,True,44753.84,45653.84,45153.84,45103.84,,False,2024-01-02 17:30:00,2024-01-02 22:53:35,2024-01-02 09:25:22,fail,False,-0.0,450.0,,0,1,1,1
2024-01-02 09:00:00,45176.289,45411.438,45174.18,45350.84,976,44922,0,2024-01-02 09:00:00,2024-01-02 09:00:00,-87.24360714288923,,45317.219023809506,0.003197894530747058,0.0010858275349875427,45311.52452380951,45714.886726541445,45932.97267374239,45249.338980792054,45015.16214807556,45241.353800825564,169.10806164749374,199.4279171359643,167.27420637519444,11.159164774682722,-35.94297901617392,-20.557152046851115,45468.673979432075,45015.53362221905,40.0695527910454,34.5185109343874,False,True,44850.84,45750.84,45250.84,45200.84,,False,2024-01-02 17:15:00,2024-01-02 17:19:21,2024-01-02 10:15:17,fail,False,-74.67,375.33,,0,2,1,1
2024-01-02 10:00:00,45473.156,45713.34,45336.961,45673.238,1875,11621,0,2024-01-02 10:00:00,2024-01-02 10:00:00,5.694499999997788,,45490.29098809524,0.0016714140888681828,0.0013186828236956666,45317.219023809506,45532.559291391546,46098.53076155798,45397.23989026212,45156.01192173735,45428.142052631556,165.47649096482928,179.54474997338409,140.00870711375853,74.38099380802305,28.757493980039726,41.81303508774727,45618.65380723513,45239.13029802798,70.37337928373863,64.5340933664098,False,True,45173.238,45573.238,45573.238,45523.238,2024-01-02 13:45:00,True,2024-01-02 13:45:00,2024-01-02 16:50:17,2024-01-02 14:32:52,even,True,18.66,393.99,,1,0,1,1
2024-01-03 00:00:00,45118.738,45298.34,45064.309,45156.738,1587,19879,0,2024-01-03 00:00:00,2024-01-03 00:00:00,19.436988095236302,,44954.24303571429,-0.0010397092017369882,-0.00045615771811164524,44975.977452380954,44346.10883703805,45221.516966483214,44990.75068382698,45067.58278413045,44935.47256243546,-50.095681535945914,-54.72342915346961,150.78088575494908,38.60583660123666,26.683314413494372,7.996199518420326,45140.52675820464,44731.91836666628,66.77211168923385,53.382818672078976,True,False,45656.738,45256.738,45256.738,45306.738,2024-01-03 04:00:00,True,2024-01-03 04:00:00,,2024-01-03 04:16:24,even,True,18.66,412.65000000000003,,2,0,1,1
2024-01-03 06:00:00,45274.137,45280.137,45193.938,45232.84,592,46023,0,2024-01-03 06:00:00,2024-01-03 06:00:00,64.38676190469414,-12.849427280620148,45258.755654761895,0.001766260183959243,0.0006887032365801394,45269.25323809522,45415.42643045674,45602.61504992238,45228.89086658361,45173.93602614737,45321.87025043001,22.981366550528037,15.486462311872607,152.28507722802453,-20.49074750600994,4.195675266571925,-1.8937561059065047,45527.45510468784,45114.78539617218,61.071827564907274,65.65191019633598,False,True,44732.84,45132.84,45132.84,45082.84,2024-01-03 10:00:00,True,2024-01-03 10:00:00,2024-01-03 13:14:50,2024-01-03 10:18:23,even,True,18.66,431.31000000000006,,3,0,1,1
2024-01-03 07:00:00,45192.539,45241.539,45123.84,45237.461,579,11683,0,2024-01-03 07:00:00,2024-01-03 07:00:00,-10.497583333322837,-9.85956195572362,45252.24758333337,0.0012693004083905628,0.0006886323544173285,45258.755654761895,45337.69887938638,45634.0119426566,45216.983345318804,45181.656536642484,45236.36969693843,18.610863035704824,17.817450261694535,141.13898567194227,-6.060403508738091,-33.664917784662975,-25.95288957689627,45426.90732759555,45044.33206628131,28.096951584759537,29.25394671709107,False,True,44737.461,45137.461,45137.461,45087.461,2024-01-03 10:00:00,True,2024-01-03 10:00:00,2024-01-03 13:14:48,2024-01-03 10:18:23,even,True,18.66,449.9700000000001,,4,0,1,1
2024-01-03 09:00:00,45334.77,45396.738,45283.949,45353.238,853,43222,0,2024-01-03 09:00:00,2024-01-03 09:00:00,30.54854761902243,4.8549658399497275,45176.82890476194,0.00021074003531408963,-0.00011692517594589905,45282.79613095239,44969.44159442729,45376.97949887963,45266.76440439077,45225.17812905749,45270.12055417952,22.396315975616744,19.2283797165011,54.71259184162238,23.336748881978565,24.543902992743824,6.4213250773827895,45345.48255316571,45196.25855519333,79.7066520267834,75.59521829104806,False,True,44853.238,45253.238,45253.238,45203.238,2024-01-03 09:45:00,True,2024-01-03 09:45:00,2024-01-03 13:11:31,2024-01-03 11:02:23,even,True,18.66,468.6300000000001,,5,0,1,1
2024-01-03 18:00:00,42982.539,43556.508,42858.137,43256.648,5914,25121,0,2024-01-03 18:00:00,2024-01-03 18:00:00,-188.66451190474618,-605.2903216513077,42492.0904047619,-0.0030660965883383775,-0.007312987057547386,42530.67678571428,39370.767229166144,42399.39394747464,42713.65327902156,43171.69331162639,42547.58048056412,-310.00411719671683,-344.0368103367009,1183.1348472224743,303.47554523562576,216.93298658406275,104.91378087379417,44146.31252431446,40950.34843681377,78.0606271923361,68.56737103809537,True,False,43756.648,43356.648,43356.648,43406.648,2024-01-03 18:30:00,True,2024-01-03 18:30:00,2024-01-04 17:01:01,2024-01-03 18:30:12,even,True,18.66,487.29000000000013,,6,0,1,1
2024-01-03 20:00:00,42885.027,43038.637,42810.617,42858.637,2933,26871,0,2024-01-03 20:00:00,2024-01-03 20:00:00,82.78435714286024,-644.9889530334549,42558.19709523813,0.006440182061877712,-0.006934438492720875,42574.87476190476,42889.33889158756,41956.93761116919,42846.18482747661,43053.73652120716,43031.79563157892,-188.51356478744128,-236.91100652223355,377.4393324534657,22.33303611970041,27.78190677677776,12.257873064962041,43542.8387303911,42522.25253276674,50.75590328596484,50.461954799701466,False,True,42358.637,42758.637,42758.637,42708.637,2024-01-03 20:45:00,True,2024-01-03 20:45:00,2024-01-03 20:56:06,2024-01-03 21:34:41,success,True,93.31,580.6000000000001,,7,0,1,1
2024-01-03 21:00:00,42235.238,42499.453,42137.57,42422.367,5335,33937,0,2024-01-03 21:00:00,2024-01-03 21:00:00,-16.677666666626465,-703.5920544652472,42619.04464285716,0.006346680510074349,-0.0008961526208973508,42558.19709523813,43125.09364139436,43296.59226936758,42671.84486415339,42907.82268100984,42741.91754626761,-182.70212391663517,-204.07628679561392,336.7163277257252,-92.22776745789452,-148.36586480904225,-42.81547506021889,43196.484588697334,42285.85050383788,27.6351918400064,32.95113354766045,True,False,42922.367,42522.367,42522.367,42572.367,2024-01-03 21:30:00,True,2024-01-03 21:30:00,2024-01-03 21:34:43,2024-01-03 22:10:54,success,True,93.31,673.9100000000001,,8,0,1,1
2024-01-03 22:00:00,42570.043,42663.738,42492.977,42584.039,2841,40074,0,2024-01-03 22:00:00,2024-01-03 22:00:00,60.847547619028774,-714.6437600945355,42651.79536904759,-0.0008389093118837713,-0.0006476801534847143,42619.04464285716,41696.19934414047,43340.812961349555,42642.482867409046,42830.21926835428,42481.580568627425,-154.46902090273943,-179.26966640391385,331.9373928587041,-72.92810526321409,-71.68788613688957,-50.41878052973334,42929.696048986676,42031.965088268174,50.66417402935728,46.41574208677908,False,True,42084.039,42984.039,42484.039,42434.039,,False,,,2024-01-04 04:46:28,fail,False,-74.67,599.2400000000001,,0,1,1,1
2024-01-04 02:00:00,42805.371,42925.539,42736.441,42917.043,1342,40332,0,2024-01-04 02:00:00,2024-01-04 02:00:00,56.249976190476445,-626.2212728507948,42808.45814285715,0.003126000110836929,0.0003478709948196285,42727.03347619048,43179.32131074043,43183.20033315898,42747.777198953016,42769.04763427326,42784.56145304442,-46.68402116923971,-70.60100861992038,151.40870529743154,36.39712074305862,18.529204334416136,-24.982141382926784,42990.463205195956,42580.15970089289,65.46164062230457,51.18792376898822,True,False,43417.043,43017.043,43017.043,43067.043,2024-01-04 05:00:00,True,2024-01-04 05:00:00,2024-01-04 15:51:57,2024-01-04 05:28:31,even,True,18.66,617.9000000000001,,1,0,1,1
2024-01-04 03:00:00,42857.137,42916.34,42794.637,42871.84,1414,43465,0,2024-01-04 03:00:00,2024-01-04 03:00:00,81.42466666666587,-592.6331131030747,42827.82382142855,0.002381214828945512,-0.00028070036390190714,42808.45814285715,42971.559858630964,42909.962030187446,42802.36785056094,42792.98238511517,42832.252961472295,-25.1142367986904,-47.30093736866371,128.84022551987084,11.199864121052087,15.771736498143582,5.6681028551538475,43007.68726592412,42658.31865702047,73.06436482368905,75.47459516121027,False,True,42371.84,42771.84,42771.84,42721.84,2024-01-04 03:30:00,True,2024-01-04 03:30:00,2024-01-05 03:48:52,2024-01-04 04:10:34,even,True,18.66,636.5600000000001,,2,0,1,1
2024-01-04 04:00:00,42688.41,42880.34,42669.895,42873.438,1347,43422,0,2024-01-04 04:00:00,2024-01-04 04:00:00,19.365678571404715,-572.8696932083913,42910.490369047606,0.0017947494211928757,0.0006856162418468598,42827.82382142855,42951.60479990007,43318.290400472775,42771.2526536908,42776.657994478424,42782.00245201238,-22.792970395326847,-34.656008291003424,110.33361457506624,25.870547643615282,-14.325074991422298,-39.34221018230892,42932.452831688715,42633.05207233604,44.240100127906736,39.378606898041106,False,True,42373.438,43273.438,42773.438,42723.438,,False,,2024-01-05 03:48:52,2024-01-04 14:15:38,fail,False,-74.67,561.8900000000001,,0,1,1,1
2024-01-04 09:00:00,43135.5,43241.738,43012.039,43072.102,1435,0,0,2024-01-04 09:00:00,2024-01-04 09:00:00,29.798297619097866,-343.17170033686125,43040.97394047619,0.0005503469863951413,0.0004069926893347056,43153.1881071429,42825.47831145997,43362.55885673602,43103.885400569714,43034.0423503546,43135.35262469901,38.31107538967626,36.29067226439672,160.08036641909234,-19.788878568957443,-9.50445545236289,3.6690567595433095,43351.46111936478,42917.744130033236,59.039929788186306,60.4157731625042,False,True,42572.102,42972.102,42972.102,42922.102,2024-01-04 10:00:00,True,2024-01-04 10:00:00,2024-01-05 03:48:52,2024-01-04 11:23:05,even,True,18.66,580.5500000000001,,1,0,1,1
2024-01-04 19:00:00,43886.938,44123.738,43814.141,44123.738,3121,42621,0,2024-01-04 19:00:00,2024-01-04 19:00:00,129.38053571429919,13.804713132813049,43913.954928571446,0.0035287577874105413,0.005614682501501212,43800.898726190484,44259.7207896828,45756.87462266397,43826.95092957444,43585.369177232475,44077.119993120075,126.60112018070504,106.20751851679752,373.6767801152453,63.35968524251075,21.96202442381764,42.89052665976487,44583.083646275656,43572.656339964495,70.34287564484161,65.62307465884356,True,False,44623.738,44223.738,44223.738,44273.738,2024-01-04 21:30:00,True,2024-01-04 21:30:00,2024-01-04 22:38:40,2024-01-04 21:32:45,even,True,18.66,599.21,,2,0,1,1
2024-01-04 21:00:00,44020.949,44229.398,44005.0,44179.207,2616,32086,0,2024-01-04 21:00:00,2024-01-04 21:00:00,86.97208333331946,94.84952259631973,44012.404523809535,0.0030174274431314712,0.0022652397820019056,44000.927011904765,44375.512893919,45096.431356430585,43970.157348753295,43779.07499120295,44038.66745270038,117.56648939025035,116.28313093161866,327.194968831963,3.6877984175807796,-26.409507739939727,-12.311094943230273,44481.88066062353,43596.954244777226,63.992849337730405,56.61720688996524,False,True,43679.207,44079.207,44079.207,44029.207,2024-01-04 22:00:00,True,2024-01-04 22:00:00,2024-01-05 03:47:34,2024-01-04 22:32:16,even,True,18.66,617.87,,3,0,1,1
2024-01-04 22:00:00,43919.492,43996.438,43861.637,43954.238,1671,44250,0,2024-01-04 22:00:00,2024-01-04 22:00:00,11.477511904769926,115.82996499150613,44062.36353571428,0.0020481071565767793,0.0020488935131413727,44012.404523809535,44093.92701115164,45114.00750347141,44009.05116337303,43854.62799877438,44070.61831338148,105.82997947267722,114.89313707887555,257.4967759589941,-0.6625245958275627,-6.599629170923436,-5.857674578663136,44418.23896092612,43721.49766583683,33.78384222328834,55.72409557644746,False,True,43454.238,44354.238,43854.238,43804.238,,False,2024-01-05 04:00:00,2024-01-05 03:48:41,2024-01-04 22:37:58,fail,False,-74.67,543.2,,0,1,1,1
2024-01-04 22:30:00,44044.238,44772.438,44033.25,44311.539,3315,0,0,2024-01-04 22:00:00,2024-01-04 22:00:00,11.477511904769926,115.82996499150613,44062.36353571428,0.0020481071565767793,0.0020488935131413727,44012.404523809535,44093.92701115164,45114.00750347141,44059.95987436767,43901.36825134978,44130.45671689025,106.0082634412538,111.07129413858672,192.94228985716708,49.74803267970128,10.090370829071617,-0.6625245958275627,44392.42880819742,43869.98462558308,39.628972196757566,34.76409926367912,True,False,44811.539,44411.539,44411.539,44461.539,2024-01-05 00:15:00,True,2024-01-05 00:15:00,,2024-01-05 00:30:08,even,True,18.66,561.86,,1,0,1,1
2024-01-04 23:00:00,44090.438,44583.543,44080.477,44281.84,4725,19922,0,2024-01-04 23:00:00,2024-01-04 23:00:00,49.95901190474251,144.23750287957228,44144.62136904758,0.002430136547104047,0.002048765400712673,44062.36353571428,44365.21853585784,45206.11720627312,44098.06284496146,43942.51909066339,44161.99471723429,104.00165458559059,108.25517540618218,148.68024483763924,34.436475060210796,-2.8984747161739506,49.74803267970128,44364.2130477651,43961.276386703474,44.160374378722054,41.62614994374558,True,False,44781.84,44381.84,44381.84,44431.84,2024-01-05 00:15:00,True,2024-01-05 00:15:00,,2024-01-05 00:30:59,even,True,18.66,580.52,,2,0,1,1
2024-01-04 23:15:00,44265.227,44405.039,44172.539,44377.34,3016,61875,0,2024-01-04 23:00:00,2024-01-04 23:00:00,49.95901190474251,144.23750287957228,44144.62136904758,0.002430136547104047,0.002048765400712673,44062.36353571428,44365.21853585784,45206.11720627312,44141.02856112124,43974.72804691054,44206.667895080835,107.50043176331383,108.10422667760851,156.06390398378565,44.67317784654733,34.436475060210796,-2.8984747161739506,44418.85416545894,43995.98162470273,45.65494822439433,43.6348086196245,True,False,44877.34,44477.34,44477.34,44527.34,2024-01-05 00:15:00,True,2024-01-05 00:15:00,,2024-01-05 00:24:41,even,True,18.66,599.18,,3,0,1,1
2024-01-05 00:00:00,44419.449,44592.438,44376.469,44586.941,3468,51297,0,2024-01-05 00:00:00,2024-01-05 00:00:00,82.25783333330037,184.42661657671852,44193.32490476193,0.0012748726255010388,0.0020487667216259053,44144.62136904758,44181.6264178175,45299.09278769222,44243.90273502611,44060.54423670056,44341.99096663224,113.2251871341141,108.45087908718668,197.58936750428634,62.69674819398642,42.95760990709823,29.668713450322684,44610.23661276303,44075.24532050145,57.41527847368917,52.16383234369784,True,False,45086.941,44186.941,44686.941,44736.941,,False,2024-01-08 14:15:00,2024-01-08 14:13:16,2024-01-05 00:47:05,fail,False,-74.67,524.51,,0,1,1,1
2024-01-05 01:15:00,44189.238,44313.238,44175.715,44266.84,1071,64422,0,2024-01-05 01:00:00,2024-01-05 01:00:00,48.703535714354075,209.00174991121457,44201.30849999998,0.0011263417503980023,0.0022155546384342783,44193.32490476193,44193.928944524676,45441.91800606205,44266.66543821912,44134.34798018825,44349.43243928447,94.97335502591159,104.78942150565544,192.90630647660242,-9.716237014115904,-19.654414860713587,-7.722098383201228,44609.85595302789,44087.50892554106,41.966942650845596,46.52683614630259,True,False,44766.84,43866.84,44366.84,44416.84,,False,2024-01-08 14:00:00,2024-01-08 14:01:08,2024-01-05 03:18:27,fail,False,-74.67,449.84,,0,2,1,1
2024-01-05 02:00:00,44107.637,44190.34,44089.867,44166.137,1783,31422,0,2024-01-05 02:00:00,2024-01-05 02:00:00,7.983595238045382,212.4894270261575,44209.90111904761,0.0004838704964621193,-0.0002700057135510569,44201.30849999998,44022.553633348216,44679.48771386533,44214.130470764525,44133.83657656055,44287.90921706222,72.62214426256833,91.75931653180469,171.17705905349933,-22.960476092252065,-11.57370381840883,-26.98904231159395,44518.99824678444,44055.320187339996,19.630011117469188,27.15351867305435,False,True,43666.137,44066.137,44066.137,44016.137,2024-01-05 03:30:00,True,2024-01-05 03:30:00,2024-01-05 03:47:34,2024-01-05 11:01:40,success,True,93.31,543.15,,1,0,1,1
2024-01-05 08:00:00,43616.16,43711.738,43603.844,43656.074,1870,40945,0,2024-01-05 08:00:00,2024-01-05 08:00:00,-5.166285714338301,44.35990621442761,43569.87976190477,0.004673561334920532,-0.0015825826884946193,43472.33161904761,44024.38613389467,43653.15200080937,43584.6999797607,43673.20369082978,43586.16857309942,-55.91680958378129,-61.45812725182377,281.12333175469325,59.75602098384843,45.73268937046669,60.00833470931684,43967.185070968255,43206.65207523059,79.19517668778165,73.68898747508605,True,False,44156.074,43756.074,43756.074,43806.074,2024-01-05 09:00:00,True,2024-01-05 09:00:00,2024-01-05 11:01:43,2024-01-05 09:10:50,even,True,18.66,561.81,,2,0,1,1
2024-01-05 09:00:00,43821.637,43900.84,43713.801,43817.738,2657,45012,0,2024-01-05 09:00:00,2024-01-05 09:00:00,97.54814285715838,50.670557551922684,43644.37759523809,0.005482812467656733,-0.0013505893070864647,43569.87976190477,44579.314429031285,43682.219992133316,43660.62742949044,43688.51490473709,43705.32298520812,-32.74955085130932,-49.94095898671667,191.89384804814904,50.37266632270621,33.109710010292474,37.92201788783859,43965.87968007312,43446.26629034312,88.04987220075766,83.4182870122657,True,False,44317.738,43917.738,43917.738,43967.738,2024-01-05 11:15:00,True,2024-01-05 11:15:00,2024-01-05 22:54:49,2024-01-05 12:26:37,even,True,18.66,580.4699999999999,,3,0,1,1
2024-01-05 12:00:00,44121.637,44133.738,43962.203,43973.84,2019,35430,0,2024-01-05 12:00:00,2024-01-05 12:00:00,132.55042857138324,83.57057448915293,43862.478297619055,0.0010157602104098825,0.002084907830725769,43930.98088095239,43594.79499700477,44736.837724940386,43915.38231965886,43832.89946996718,44023.2490629515,27.847016719686508,7.916532203286847,201.07643110343218,12.030848985232296,47.44401203987945,30.431859649106627,44296.20224494114,43751.795880961865,63.336933718890776,63.11865431800722,False,True,43473.84,44373.84,43873.84,43823.84,,False,2024-01-05 13:00:00,2024-01-05 12:59:10,2024-01-05 22:54:49,success,True,93.31,673.78,,4,0,1,1
2024-01-05 21:00:00,43578.137,43581.539,43493.84,43565.539,1756,45425,0,2024-01-05 21:00:00,2024-01-05 21:00:00,-8.733583333298157,-37.031258831462765,43469.64615476192,3.7416058122255566e-06,-0.001158375515343298,43458.5283809524,43065.18364379117,43593.74947845772,43513.31468961074,43566.36372881111,43474.30933952526,-37.56283982103196,-43.77370331364149,201.6666866445462,24.91037014099129,34.91467148265656,32.16048056416912,43748.05936649539,43202.059312555124,76.16776090314958,68.25080713727355,True,False,44065.539,43665.539,43665.539,43715.539,2024-01-05 22:45:00,True,2024-01-05 22:45:00,2024-01-05 22:54:26,2024-01-05 23:06:22,success,True,93.31,767.0899999999999,,5,0,1,1
2024-01-08 01:00:00,43815.039,43978.438,43772.539,43903.84,1711,61625,0,2024-01-08 01:00:00,2024-01-08 01:00:00,64.33910714288504,12.246317522491154,43873.0724047619,0.0017923606880266344,0.003062265298378398,43805.157226190495,43818.001303202625,45383.11992936795,43823.65744766774,43740.11678410536,43932.901916408686,33.381420962003176,18.35679370560269,195.40195731605945,14.695233918188023,-3.5152270381950075,29.142468868245487,44198.19455878537,43669.109274032,40.61595327378159,44.68835929139498,False,True,43403.84,43803.84,43803.84,43753.84,2024-01-08 01:30:00,True,2024-01-08 01:30:00,2024-01-08 04:38:11,2024-01-08 01:37:45,even,True,18.66,785.7499999999999,,6,0,2,1
2024-01-08 01:45:00,43563.738,43880.637,43563.738,43880.637,1254,58723,0,2024-01-08 01:00:00,2024-01-08 01:00:00,64.33910714288504,12.246317522491154,43873.0724047619,0.0017923606880266344,0.003062265298378398,43805.157226190495,43818.001303202625,45383.11992936795,43784.65394485469,43735.70669093361,43856.66212555902,24.25681410433026,21.463755446805827,167.68349827728179,3.323882008997316,-53.97648572416074,-25.58718713450071,44084.53484823335,43630.28940288469,19.54384516003408,24.038774510586716,True,False,44380.637,43480.637,43980.637,44030.637,,False,2024-01-08 08:30:00,2024-01-08 13:52:00,2024-01-08 04:37:44,fail,False,-74.67,711.0799999999999,,0,1,2,1
2024-01-08 03:00:00,43595.637,43769.738,43573.84,43767.039,1800,37199,0,2024-01-08 03:00:00,2024-01-08 03:00:00,-90.78708333331451,13.626625476848858,43748.143380952366,0.0006371772734325666,-0.0021814995168960294,43782.285321428586,43676.6138182847,43628.001966863296,43747.09695967012,43731.15536603915,43731.642747506026,13.471466686649364,18.61727077701711,143.91208402582689,-10.507392844861897,-49.35318610248942,-33.33097420021659,43925.924060940895,43535.86143407116,23.98017462763264,26.40912517957331,False,True,43267.039,43667.039,43667.039,43617.039,2024-01-08 04:30:00,True,2024-01-08 04:30:00,2024-01-08 04:51:58,2024-01-08 08:21:18,success,True,93.31,804.3899999999999,,1,0,2,1
2024-01-08 04:00:00,43673.039,43767.438,43633.84,43637.637,1307,45523,0,2024-01-08 04:00:00,2024-01-08 04:00:00,-34.14194047622004,10.003658890054794,43593.61826190474,-0.001170760465449802,-0.0026280405978800284,43748.143380952366,42946.81198277244,43345.04182107643,43709.076898166386,43715.55933452828,43642.98920055042,3.8140299073857022,11.957118938917557,129.0015698466098,-33.7038159614458,-23.771353973155783,-34.44840316478076,43817.141319843344,43467.3370812575,24.61194595823407,27.363470538046943,False,True,43137.637,43537.637,43537.637,43487.637,2024-01-08 04:45:00,True,2024-01-08 04:45:00,2024-01-08 04:53:49,2024-01-08 06:07:03,success,True,93.31,897.6999999999998,,2,0,2,1
2024-01-08 07:00:00,43554.469,43613.738,43485.723,43554.539,1063,44723,0,2024-01-08 07:00:00,2024-01-08 07:00:00,-7.720976190496003,-34.62071862418088,43503.66854761906,-0.0017741331106019317,-0.0018405033839002801,43494.485738095216,42623.76460824931,43318.66520262217,43516.11307417215,43567.8037424881,43432.909744410055,-28.511505574737384,-27.446235086216088,167.4356140129006,16.955507051970926,22.339251461962704,10.690318197448505,43660.44782332747,43206.87166549264,64.71321817604576,60.97867370526247,True,False,44054.539,43154.539,43654.539,43704.539,,False,2024-01-08 08:30:00,2024-01-08 08:21:40,,success,True,93.31,991.0099999999998,,3,0,2,1
2024-01-08 08:00:00,43600.941,43648.34,43546.031,43588.457,1151,34297,0,2024-01-08 08:00:00,2024-01-08 08:00:00,9.182809523845208,-32.39594155841769,43617.8347142857,0.00031508189581726926,0.0011594250564872879,43503.66854761906,43236.359498675454,44527.021616757236,43534.38887486274,43562.74363367037,43515.72573477815,-21.008863750626915,-25.7696575228986,140.9912212158071,28.566665290709352,39.53492844856373,21.815943240449997,43707.56388341949,43325.38758613681,84.83413332690719,73.55162558133036,True,False,44088.457,43188.457,43688.457,43738.457,,False,2024-01-08 08:30:00,2024-01-08 08:21:41,,success,True,93.31,1084.3199999999997,,4,0,2,1
2024-01-08 11:00:00,43836.637,43888.738,43800.539,43837.191,1259,29653,0,2024-01-08 11:00:00,2024-01-08 11:00:00,61.4423571428415,24.888776053936454,43832.89300000001,0.001609706643095077,0.0024510001130862913,43821.25432142855,43863.2186916952,45069.359224704756,43850.27252026724,43774.075319917996,43980.79731234947,37.11135742020997,30.141350895856675,242.8670476296496,-14.09473271414754,-12.418224286229815,0.09314757485844893,44308.66782664949,43651.42679804944,43.69971340332821,49.72650895153566,False,True,43337.191,44237.191,43737.191,43687.191,,False,,,2024-01-08 13:41:17,fail,False,-74.67,1009.6499999999997,,0,1,2,1
2024-01-08 12:15:00,43760.391,43992.039,43750.184,43963.738,1160,41023,0,2024-01-08 12:00:00,2024-01-08 12:00:00,11.63867857146397,21.08650802855118,43916.0806547619,0.0015443495568140705,0.0007951186054969562,43832.89300000001,43903.29658256308,44608.51317863808,43834.2574885429,43787.68370769217,43833.78915548676,28.524199180930736,29.523564160158273,190.4005272309409,-2.9208902648242656,-44.06869349849876,-59.83620880632225,44090.82986724853,43575.24844372499,44.75950812406135,33.751899957479765,True,False,44463.738,44063.738,44063.738,44113.738,2024-01-08 13:15:00,True,2024-01-08 13:15:00,2024-01-08 13:55:14,2024-01-08 13:18:35,even,True,18.66,1028.3099999999997,,1,0,2,1
2024-01-08 19:45:00,45362.438,45641.473,45286.082,45633.137,3219,30023,0,2024-01-08 19:00:00,2024-01-08 19:00:00,50.36223809519288,325.12106730157393,45218.45577380951,0.003913309725843063,0.002147147987534415,45012.56940476189,45522.57705397006,46007.96819436318,45126.929805984655,44882.04951633347,45205.42169418649,146.51462423323392,136.10246125516178,229.5939584965144,131.70716924668523,83.55063123498257,70.74309769520914,45516.87353815678,44895.46985021619,92.23334761133971,78.33287194292035,True,False,46133.137,45733.137,45733.137,45783.137,2024-01-08 20:15:00,True,2024-01-08 20:15:00,2024-01-08 20:23:49,2024-01-09 14:56:38,success,True,93.31,1121.6199999999997,,2,0,2,1
2024-01-09 01:00:00,46971.438,47088.738,46863.863,47025.141,1410,59309,0,2024-01-09 01:00:00,2024-01-09 01:00:00,145.96777380954882,839.0736896076851,47157.178642857165,0.0070848434152968685,0.003658792805624909,47129.8231666667,48075.9378646598,48618.80872072197,46890.59196054761,46500.97921982797,46973.307198486415,267.2620486614542,288.2364219069751,638.2414845746913,18.11300378402666,-62.95999346408644,-70.40538183697208,47836.43320266225,46111.68119431058,60.26782910612411,55.67127138038014,False,True,46525.141,46925.141,46925.141,46875.141,2024-01-09 01:45:00,True,2024-01-09 01:45:00,2024-01-09 02:37:24,2024-01-09 01:48:41,even,True,18.66,1140.2799999999997,,3,0,2,1
2024-01-09 02:00:00,46937.438,47094.637,46878.34,47092.34,1879,34825,0,2024-01-09 02:00:00,2024-01-09 02:00:00,27.355476190467016,855.1386133822525,46968.126785714296,0.004290339155411273,0.0005427894574643884,47157.178642857165,46981.8426993452,47483.572049561575,46929.3064613416,46623.56794881332,46977.44023047819,228.64264460297272,258.855169738754,302.1764155698622,17.968309253563348,-19.767424492631108,2.035985896116472,47386.87839149751,46569.502069458875,58.07282435769355,54.00499356112278,False,True,46592.34,46992.34,46992.34,46942.34,2024-01-09 02:30:00,True,2024-01-09 02:30:00,2024-01-09 02:37:24,2024-01-09 14:51:01,success,True,93.31,1233.5899999999997,,4,0,2,1
2024-01-09 03:00:00,46652.602,46750.738,46576.438,46730.039,1479,27910,0,2024-01-09 03:00:00,2024-01-09 03:00:00,-189.05185714286927,835.6197290075434,46742.39057142857,0.0020654665072338415,-0.0004690662077661936,46968.126785714296,46636.72387325744,47042.14059191805,46828.373493662766,46650.81211071258,46830.55392604063,168.7999457208789,216.42061170920266,138.63501017627067,-36.76557447541563,-48.93657516337407,-50.66452734780614,47017.711189778594,46641.896662302664,46.45357389471696,48.72276975270345,False,True,46230.039,46630.039,46630.039,46580.039,2024-01-09 03:30:00,True,2024-01-09 03:30:00,2024-01-09 14:56:34,2024-01-09 04:00:43,even,True,18.66,1252.2499999999998,,5,0,2,1
2024-01-09 04:00:00,46545.469,46644.539,46469.84,46528.539,1376,32523,0,2024-01-09 04:00:00,2024-01-09 04:00:00,-225.7362142857237,802.2369822295514,46721.0969166667,-0.0014669370289348556,-0.0006025719879873815,46742.39057142857,45845.3118415163,46983.980333716405,46664.25257591529,46607.940629102945,46552.31566081866,104.49080967173359,160.2924209472255,201.2274153978927,-29.81069349848258,-60.02231131751614,-107.43600171999424,46823.972671605814,46279.15865003151,26.031740472768963,28.062872523570206,False,True,46028.539,46928.539,46428.539,46378.539,,False,2024-01-09 15:00:00,2024-01-09 14:56:36,2024-01-09 05:06:14,fail,False,-74.66,1177.5899999999997,,0,1,2,1
2024-01-09 09:00:00,46766.66,46799.137,46714.637,46791.238,1281,46824,0,2024-01-09 09:00:00,2024-01-09 09:00:00,22.81503571428766,675.4731856897779,46796.81638095239,0.00095747124220363,-0.0006860165924129931,46752.36592857142,46711.82455099923,46800.52072803914,46743.68624612354,46718.963204191736,46711.7784255246,34.04065486929903,44.687386661059676,129.1182016284151,2.320663570666511,-4.767755761946319,-25.238672514584323,46887.58799772296,46537.46885332624,48.77751423976118,47.5493054553526,True,False,47291.238,46391.238,46891.238,46941.238,,False,2024-01-09 23:15:00,2024-01-09 23:11:57,2024-01-09 11:26:46,fail,False,-74.66,1102.9299999999996,,0,2,2,1
2024-01-09 11:00:00,46526.039,46653.238,46493.84,46568.137,1480,41426,0,2024-01-09 11:00:00,2024-01-09 11:00:00,-83.85117857143632,593.9557447908228,46603.34857142857,-0.0002796283475938609,-0.00016802891456280263,46712.965202380954,46330.43124366925,46876.419308662444,46701.68967728625,46714.41425118011,46710.33440832477,11.963629562545975,27.515960761695798,101.05872155308987,-29.4427519779274,-45.02665325078851,-16.380107327131554,46846.76368242144,46572.4051342281,16.04009993867395,33.27724252805639,False,True,46068.137,46968.137,46468.137,46418.137,,False,2024-01-09 15:00:00,2024-01-09 14:56:36,2024-01-09 14:51:01,fail,False,-74.66,1028.2699999999995,,0,3,2,1
2024-01-09 14:00:00,46595.238,46743.637,46578.039,46698.938,1996,27914,0,2024-01-09 14:00:00,2024-01-09 14:00:00,7.4273452380803064,458.4666624366582,46376.13925000002,-0.0037309513334557766,0.00047972361583545716,46520.158845238075,44747.99094123831,47118.86053509265,46573.40992919628,46612.00689035821,46499.97414413485,-16.655365578990313,-13.613261993225576,137.17493995402248,38.01776711385173,22.465509459914756,-18.516598555172095,46686.66031307278,46314.78797519692,50.8859454813583,35.43446832660478,True,False,47198.938,46298.938,46798.938,46848.938,,False,2024-01-09 17:45:00,2024-01-09 23:11:53,2024-01-09 14:56:32,fail,False,-74.66,953.6099999999996,,0,4,2,1
2024-01-09 20:00:00,46698.238,46706.539,46506.531,46593.039,1938,33024,0,2024-01-09 20:00:00,2024-01-09 20:00:00,21.22871428570943,333.67533731953154,46741.30735714284,0.0039937735398163955,0.0002337204682340644,46767.38177380952,47174.88341089216,47141.297105969,46715.78331800233,46697.16237792654,46739.54763914685,13.182239319408836,16.57254453112904,162.1822498088312,-41.15566150670929,-17.211489164175873,-29.901570347399684,46958.49367638877,46519.10160190493,40.925825571549744,47.5118718297557,False,True,46093.039,46993.039,46493.039,46443.039,,False,2024-01-09 23:30:00,2024-01-09 23:17:12,2024-01-09 23:11:51,fail,False,-74.66,878.9499999999996,,0,5,2,1
2024-01-09 22:00:00,46847.238,46910.738,46738.34,46793.34,1474,35422,0,2024-01-09 22:00:00,2024-01-09 22:00:00,63.50907142860524,301.4959365359973,46709.1242261905,0.0016112471539804492,-0.0004110061832148123,46804.816428571445,46842.34382467138,46837.91934970985,46721.04289579594,46700.86561667339,46674.874131063,10.719398691042443,7.999210880624229,116.0016781736026,27.250190918501175,18.271316477505025,-10.392285173722485,46832.97639659736,46518.27186552864,70.7452505160112,60.44731144299258,False,True,46293.34,46693.34,46693.34,46643.34,2024-01-09 23:00:00,True,2024-01-09 23:00:00,2024-01-09 23:15:53,2024-01-09 23:04:52,even,True,18.66,897.6099999999996,,1,0,2,1
2024-01-10 05:00:00,45963.738,46158.738,45911.258,46149.137,1095,41023,0,2024-01-10 05:00:00,2024-01-10 05:00:00,-29.205428571462107,-13.680769298698578,45955.49241666666,0.004960182148998574,-0.006444148390684731,45865.09748809522,46769.93321053637,45101.42080100167,45972.592881262775,46074.07879188361,45893.3851369109,-76.16146843635943,-89.89199378239557,443.7904487140873,36.25908943921968,-13.133834881242365,-43.47389404884598,46494.00224267492,45294.26803114689,63.866397036018064,60.37089380372129,True,False,46649.137,45749.137,46249.137,46299.137,,False,2024-01-10 20:00:00,2024-01-10 21:07:18,2024-01-10 09:41:32,fail,False,-74.66,822.9499999999996,,0,1,2,1
2024-01-10 08:00:00,45962.137,45968.34,45856.84,45952.137,779,45523,0,2024-01-10 08:00:00,2024-01-10 08:00:00,-45.3409285713642,-51.44104746908124,45981.42910714285,0.0010852302640158543,4.7111212045993045e-06,45956.281380952416,46043.457953950725,46224.47523594806,45985.453322658184,46033.436582052454,45993.81877812182,-40.31825763844245,-46.539060975811665,135.51233013815005,-32.4669071207245,-33.012563811476866,-28.93572961816244,46176.76042380832,45809.37713243532,24.53621552065162,23.32023191645779,False,True,45452.137,45852.137,45852.137,45802.137,2024-01-10 10:00:00,True,2024-01-10 10:00:00,2024-01-10 10:55:45,2024-01-10 19:39:13,success,True,93.31,916.2599999999995,,1,0,2,1
2024-01-10 09:00:00,45987.738,46005.738,45837.961,45870.906,1142,34425,0,2024-01-10 09:00:00,2024-01-10 09:00:00,25.147726190436515,-58.56484595275106,45917.66733333336,0.00036698727185893623,-0.00015240410387412962,45981.42910714285,45772.28952697068,46147.243917712694,45969.06198617129,46012.78408950427,45928.3379301686,-35.61620890301856,-40.26389523390631,126.69952355611896,-38.486477812126395,-2.0091898864411633,-5.498783969786018,46099.38228696936,45755.79357336784,32.30016668201045,35.10983870225245,False,True,45370.906,45770.906,45770.906,45720.906,2024-01-10 10:30:00,True,2024-01-10 10:30:00,2024-01-10 10:59:06,2024-01-10 19:36:32,success,True,93.31,1009.5699999999995,,2,0,2,1
2024-01-10 10:00:00,45740.789,45850.34,45736.84,45766.84,1162,44024,0,2024-01-10 10:00:00,2024-01-10 10:00:00,-63.7617738094923,-83.230410622833,45691.82988095236,-0.0010182931738219644,-0.0012117019820287922,45917.66733333336,45113.937146197924,45742.64323908157,45882.34194557382,45955.16297350525,45814.80175438599,-44.78126373453415,-40.9744573081386,115.15429490983482,-27.773379084952467,-31.347201582379057,-23.737876161052554,45970.26005251427,45657.84345625771,14.293364915080152,14.78052444557253,False,True,45266.84,45666.84,45666.84,45616.84,2024-01-10 11:00:00,True,2024-01-10 11:00:00,2024-01-10 13:53:10,2024-01-10 11:38:39,even,True,18.66,1028.2299999999996,,3,0,2,1
2024-01-10 10:15:00,45759.746,45807.438,45690.039,45717.586,1317,44023,0,2024-01-10 10:00:00,2024-01-10 10:00:00,-63.7617738094923,-83.230410622833,45691.82988095236,-0.0010182931738219644,-0.0012117019820287922,45917.66733333336,45113.937146197924,45742.64323908157,45856.994877024,45937.564679171526,45785.606355005184,-47.73885016728309,-42.32733587996749,126.05824648407912,-29.19539938080561,-27.773379084952467,-31.347201582379057,45955.78498775869,45613.927722251676,9.304799325950126,12.722269335912422,False,True,45217.586,45617.586,45617.586,45567.586,2024-01-10 11:00:00,True,2024-01-10 11:00:00,2024-01-10 13:53:10,2024-01-10 11:34:01,even,True,18.66,1046.8899999999996,,4,0,2,1
2024-01-10 12:45:00,45596.438,45633.738,45508.844,45512.637,1232,44524,0,2024-01-10 12:00:00,2024-01-10 12:00:00,-69.05753571422974,-150.60676888838498,45536.33094047617,-0.002749771954063365,-0.0015024939375182624,45622.77234523813,44577.4084078168,45542.87129878652,45638.69886886187,45745.786984766135,45515.13442174062,-65.62023609890457,-64.100661654984,193.53726057308694,-16.917758857925946,-7.107889920880552,6.908461644336057,45776.40972351429,45252.35911996695,47.42986955880531,51.244000829158665,False,True,45012.637,45912.637,45412.637,45362.637,,False,2024-01-10 14:30:00,2024-01-10 13:53:12,2024-01-10 19:39:48,success,True,93.31,1140.1999999999996,,5,0,2,1
2024-01-10 14:00:00,45503.938,45653.738,45361.191,45454.539,3295,20773,0,2024-01-10 14:00:00,2024-01-10 14:00:00,-41.97524999999587,-182.64746641147212,45181.25051190479,-0.004967391215439021,-0.0015342127189669754,45494.35569047617,43501.35722373703,45393.306154996586,45559.059268348916,45668.43521093312,45507.023418644625,-67.38227411312982,-65.46339661738335,193.43737383254577,-8.164136910927482,0.9064633642701665,-12.341554523540253,45768.16387331856,45244.38296397069,58.49806016061169,49.81559113237078,True,False,45954.539,45054.539,45554.539,45604.539,,False,2024-01-10 19:45:00,2024-01-10 19:41:26,2024-01-10 14:28:34,fail,False,-74.66,1065.5399999999995,,0,1,2,1
2024-01-10 14:15:00,45454.539,45463.039,44853.676,45221.84,4102,30719,0,2024-01-10 14:00:00,2024-01-10 14:00:00,-41.97524999999587,-182.64746641147212,45181.25051190479,-0.004967391215439021,-0.0015342127189669754,45494.35569047617,43501.35722373703,45393.306154996586,45507.179380910624,45635.35408419734,45454.10088235293,-74.35128912545042,-67.24097511899677,205.1085452086147,-52.922536291698634,-8.164136910927482,0.9064633642701665,45730.997418384555,45175.7043463213,61.01762770498507,55.46926681833369,False,True,44721.84,45121.84,45121.84,45071.84,2024-01-10 14:45:00,True,2024-01-10 14:45:00,2024-01-10 14:54:45,2024-01-10 15:13:23,success,True,93.31,1158.8499999999995,,1,0,2,1
2024-01-10 16:30:00,45304.27,45395.961,45045.816,45052.84,2808,33383,0,2024-01-10 16:00:00,2024-01-10 16:00:00,-86.53333333334012,-280.57429633864376,44986.80846428574,-0.0054536105812705606,-0.0015342074917810455,45094.71717857145,42949.565107521084,45254.62814604405,45168.11037411318,45346.14578141971,44972.2917633299,-106.20238339317439,-102.1665606501238,283.7901422147411,-12.357649466779549,22.735903680717456,-56.55791881662299,45355.4084553198,44587.67507134,59.44263227059358,57.33453519083054,False,True,44552.84,44952.84,44952.84,44902.84,2024-01-10 17:00:00,True,2024-01-10 17:00:00,,2024-01-10 17:02:45,even,True,18.66,1177.5099999999995,,2,0,2,1
2024-01-10 22:00:00,46472.637,46491.84,44737.848,45517.434,5314,0,0,2024-01-10 22:00:00,2024-01-10 22:00:00,333.7620476190641,-19.190385801652155,46352.31999999999,0.0014930579846256743,0.005175094844785886,46320.25303571431,44986.25382216271,48063.03513491768,46054.3749261881,45850.89270464989,46374.26921671827,98.71222232544096,82.54077101928802,551.6192590956464,-139.12658238736913,61.061495700021624,24.316240798107174,47118.955216497394,45628.08321693914,64.60610974630531,70.28196536897049,False,True,45017.434,45917.434,45417.434,45367.434,,False,2024-01-12 16:45:00,2024-01-10 22:44:47,2024-01-10 22:37:52,fail,False,-74.66,1102.8499999999995,,0,1,2,1
2024-01-11 05:00:00,46539.203,46573.438,46154.258,46402.438,2448,26136,0,2024-01-11 05:00:00,2024-01-11 05:00:00,49.78975000001083,176.77754494644614,46599.186869047626,0.00445392897484626,-0.001585821967161369,46576.880809523835,46929.84908161435,47080.93016375062,46516.77424743887,46409.370481938,46438.32368317847,85.15142430632841,101.8568878473705,409.0222662109073,-65.64006295155559,-37.09214482285461,-65.83803783971234,46990.50374256319,45884.643623793745,32.92297076198968,25.40946207652553,False,True,45902.438,46802.438,46302.438,46252.438,,False,2024-01-11 07:45:00,2024-01-11 07:44:56,2024-01-11 12:52:41,success,True,93.31,1196.1599999999994,,1,0,2,1
2024-01-11 07:00:00,46379.238,46401.539,46207.805,46263.137,1593,25308,0,2024-01-11 07:00:00,2024-01-11 07:00:00,-63.902642857137835,172.10844443695532,46287.537511904746,0.00046992412425483833,-0.0044718666615283795,46535.28422619049,45950.026199410524,45630.5523609631,46421.91379812735,46403.964939148136,46355.339532851736,38.776613384347,61.49794005046765,221.62103465553653,-39.03732438937732,-37.486470244235534,-19.477702442381997,46654.52792963671,46054.651136066765,35.71503955397891,43.04286884873238,False,True,45763.137,46163.137,46163.137,46113.137,2024-01-11 07:45:00,True,2024-01-11 07:45:00,2024-01-11 08:08:02,2024-01-11 10:14:41,success,True,93.31,1289.4699999999993,,2,0,2,1
2024-01-11 09:00:00,45869.703,46098.039,45846.449,46071.566,1762,33922,0,2024-01-11 09:00:00,2024-01-11 09:00:00,-161.4005476190796,95.01981011856697,46054.327595238086,-0.0025268568913311756,-0.0018439836044965461,46126.136964285666,45043.900001645365,45913.0429235886,46061.127958408644,46190.459373926475,45879.74483969726,-41.14244483976654,-9.62481555791046,287.0385922588903,-4.4530722394702025,-51.9721527347283,-54.316070863416826,46267.24693924676,45490.74274014776,38.31577132320345,27.57557869452604,True,False,46571.566,46171.566,46171.566,46221.566,2024-01-11 10:30:00,True,2024-01-11 10:30:00,2024-01-11 12:37:13,2024-01-11 10:41:24,even,True,18.66,1308.1299999999994,,3,0,2,1
2024-01-11 10:00:00,46065.375,46172.738,46025.039,46167.039,1571,29023,0,2024-01-11 10:00:00,2024-01-11 10:00:00,-71.80936904757982,76.11022121304268,46079.694499999976,-0.0036492242450893,-0.001343871425474832,46054.327595238086,44641.41134921973,46061.47478613645,46074.27732821193,46162.43232017106,45908.53911523906,-37.295760129571136,-27.409309410779272,265.77714670036386,29.861559683457017,5.328037839732133,-17.4457378741281,46268.83826328455,45549.739967193564,54.7571957539077,53.030629190024165,True,False,46667.039,46267.039,46267.039,46317.039,2024-01-11 12:30:00,True,2024-01-11 12:30:00,2024-01-11 12:42:46,2024-01-11 18:08:26,success,True,93.31,1401.4399999999994,,4,0,2,1
2024-01-11 11:00:00,46241.41,46327.738,46182.879,46249.34,2539,34121,0,2024-01-11 11:00:00,2024-01-11 11:00:00,25.3669047618896,74.79852368064167,46085.18883333331,-0.0019787361164742986,-0.000880068262643133,46079.694499999976,44981.89792874216,46175.36092085858,46151.23682673404,46180.75644851793,46118.44411351911,-19.538704221355147,-25.749299248704837,228.17473346900348,59.06222669419367,59.893620227048814,32.996471276230295,46427.980003702265,45810.40822333595,86.34278812381392,82.22481934638482,True,False,46749.34,46349.34,46349.34,46399.34,2024-01-11 12:30:00,True,2024-01-11 12:30:00,2024-01-11 12:46:34,2024-01-11 18:08:22,success,True,93.31,1494.7499999999993,,5,0,2,1
2024-01-11 12:00:00,46186.668,46272.137,46177.391,46215.637,1120,38621,0,2024-01-11 12:00:00,2024-01-11 12:00:00,5.494333333335817,68.19568916173739,46334.985000000044,0.0009378751359630715,0.000843283878183076,46085.18883333331,45917.97723840358,46997.308393763284,46189.05439229064,46194.188515271344,46293.24356277944,-9.291510584953357,-17.210034424859515,202.67404379544698,20.633240798058978,40.424668730585836,51.00885036116961,46568.35352190329,46019.63360365559,82.0083237672626,86.66824302538906,True,False,46715.637,46315.637,46315.637,46365.637,2024-01-11 12:30:00,True,2024-01-11 12:30:00,2024-01-11 12:44:11,2024-01-11 18:08:23,success,True,93.31,1588.0599999999993,,6,0,2,1
2024-01-11 14:15:00,46994.738,47133.738,46919.539,47117.711,2416,36121,0,2024-01-11 14:00:00,2024-01-11 14:00:00,289.94910714281286,165.4981404512946,46993.53726190474,0.003221031284413647,0.0031550988883023703,46624.93410714286,47041.54617410288,48004.950842038605,46796.676554808924,46566.79746244473,47056.15473512217,100.04696499167767,60.825541944508835,427.0011192632458,73.32153078780539,58.726308909586805,93.1737186102473,47634.10624612755,46479.70322411678,89.88817140645996,87.67114184056663,True,False,47617.711,47217.711,47217.711,47267.711,2024-01-11 15:00:00,True,2024-01-11 15:00:00,2024-01-11 16:04:31,2024-01-11 15:12:24,even,True,18.66,1606.7199999999993,,7,0,2,1
2024-01-11 16:00:00,47301.863,47798.539,47183.512,47774.234,4908,0,0,2024-01-11 16:00:00,2024-01-11 16:00:00,219.38908333334257,275.15336595789995,47753.81548809524,0.004067857138589154,0.008548371197666849,47212.926345238084,47659.129016839834,50600.82979433862,47162.342161351575,46874.58633599385,47457.229394220885,145.36488257028395,115.75706976833341,475.8759115758148,106.28506191955967,35.246524251793744,-8.049730994156562,48101.161874848236,46814.796913593535,83.3526943221418,76.98630881211263,True,False,48274.234,47374.234,47874.234,47924.234,,False,2024-01-11 16:45:00,2024-01-11 16:41:16,2024-01-11 17:39:05,success,True,93.31,1700.0299999999993,,8,0,2,1
2024-01-12 01:00:00,46376.738,46443.637,46328.285,46443.637,1221,55304,0,2024-01-12 01:00:00,2024-01-12 01:00:00,161.65269047619222,51.098243803106016,46351.62355952385,0.0020552595084231485,-0.0004018230761428769,46338.07674999999,46495.542740287055,46820.00590026578,46341.155494444654,46444.34523371762,46232.42799828004,-61.73374214008072,-61.86086941731641,229.53199812540242,15.084369109106774,-8.27142414865375,-56.041352941145306,46543.79619574934,45922.55980081075,32.491581746170745,24.382741331271045,True,False,46943.637,46043.637,46543.637,46593.637,,False,,,2024-01-12 02:33:46,fail,False,-74.66,1625.3699999999992,,0,1,2,1
2024-01-12 02:00:00,46301.539,46381.438,46227.539,46237.434,2391,44621,0,2024-01-12 02:00:00,2024-01-12 02:00:00,13.54680952385388,28.11166244024207,46274.1414761905,0.0012497925045489053,-0.0013568835835058857,46351.62355952385,46189.45036003845,46456.59510440562,46312.03131942734,46401.70082598999,46197.89506398353,-57.47844810959214,-59.80145899281351,193.97925590292905,-7.56020433435333,-5.100123495001753,-13.663324045424815,46459.76705945248,45934.52306851458,34.00572530272181,32.946412793371266,False,True,45737.434,46137.434,46137.434,46087.434,2024-01-12 03:30:00,True,2024-01-12 03:30:00,2024-01-12 09:51:47,2024-01-12 03:38:04,even,True,18.66,1644.0299999999993,,1,0,2,1
2024-01-12 06:00:00,45966.336,46043.539,45908.926,45983.637,1818,39621,0,2024-01-12 06:00:00,2024-01-12 06:00:00,-51.11469047614082,-71.73428411770146,46025.651428571415,-0.0011511450831543822,-0.0014228357516138236,46109.677761904786,45513.051235489926,46000.6500974166,46083.928505554184,46184.4191437846,46010.027277949805,-61.74366718081728,-59.33152457481915,139.86896207847713,-17.987045063586265,-28.942019951864495,-3.2379105607251404,46198.85037675575,45819.70417914386,21.141708759378293,24.097345192362372,True,False,46483.637,46083.637,46083.637,46133.637,2024-01-12 08:00:00,True,2024-01-12 08:00:00,,2024-01-12 08:58:27,even,True,18.66,1662.6899999999994,,2,0,2,1
2024-01-12 06:30:00,46056.738,46092.539,45947.637,45947.637,1658,39621,0,2024-01-12 06:00:00,2024-01-12 06:00:00,-51.11469047614082,-71.73428411770146,46025.651428571415,-0.0011511450831543822,-0.0014228357516138236,46109.677761904786,45513.051235489926,46000.6500974166,46059.42098918377,46158.12244563152,45986.62883316136,-61.41018314426037,-59.866955475365195,147.8747683420872,-22.94939215687191,-0.44905263157124864,-17.987045063586265,46186.25977042318,45785.49789589954,27.342074464992777,24.58839907428406,False,True,45447.637,46347.637,45847.637,45797.637,,False,2024-01-12 10:30:00,2024-01-12 16:36:06,2024-01-12 08:26:48,fail,False,-74.66,1588.0299999999993,,0,1,2,1
2024-01-12 08:00:00,46173.156,46255.77,46164.84,46179.137,1669,30824,0,2024-01-12 08:00:00,2024-01-12 08:00:00,9.151178571402852,-95.38174674439506,46036.99157142857,-0.000313112772440799,-0.0005626628623660924,46034.80260714282,45741.39827955539,46255.192722283646,46083.106726883,46130.87506001284,46045.62172721015,-42.36430954804382,-53.72937761555165,121.95476788913288,28.724975232122233,9.611350533232326,6.198010663953028,46211.76066386048,45880.98279055982,74.87687986226676,66.2374927068931,True,False,46679.137,45779.137,46279.137,46329.137,,False,,,2024-01-12 09:51:47,fail,False,-74.66,1513.3699999999992,,0,2,2,1
2024-01-12 22:00:00,43471.238,43707.738,43417.539,43703.84,2797,38832,0,2024-01-12 22:00:00,2024-01-12 22:00:00,-280.0314880951846,-679.6666957158959,43402.6621309524,-0.005535238952974873,-0.0071493268421169475,43484.306238095254,41398.96793098897,42828.421659737614,43673.455100382125,44126.648942034335,43406.05061919502,-285.0396311400691,-291.92401735230516,813.5300947987513,65.89204747163603,36.32497076022264,40.25264705881273,44505.81624717333,42307.78499121671,40.86455083484662,30.51458839287368,True,False,44203.84,43803.84,43803.84,43853.84,2024-01-12 22:45:00,True,2024-01-12 22:45:00,,2024-01-12 22:52:43,even,True,18.66,1532.0299999999993,,1,0,2,1
2024-01-15 00:00:00,42524.738,42623.84,42452.301,42521.84,2509,64223,0,2024-01-15 00:00:00,2024-01-15 00:00:00,-35.46648809522594,-740.8622986027985,43022.09020238095,-0.0045292108885736084,-0.006006138311663385,43367.19564285717,41349.84474320233,42637.51975290074,43440.959210148714,43808.67284603165,43377.65883178535,-240.76944148464827,-242.95893374334136,327.7975298909927,-202.50598383210308,-40.0362242862393,-73.59835156521149,43820.18549713819,42933.632166432515,15.560310462861032,29.428679715310167,False,True,42021.84,42421.84,42421.84,42371.84,2024-01-15 00:30:00,True,2024-01-15 00:30:00,2024-01-15 01:08:39,2024-01-15 05:02:36,success,True,93.31,1625.3399999999992,,2,0,3,1
2024-01-15 04:00:00,42254.637,42343.938,42174.637,42315.84,1539,45324,0,2024-01-15 04:00:00,2024-01-15 04:00:00,-137.42546428564674,-1034.772933956585,42118.011380952354,-0.006692871859027178,-0.006738491036974452,42167.88671428575,39865.60179364391,41364.04013668472,42295.362405985674,42653.95596538329,42096.97904403165,-262.26459874604916,-295.0527699440557,728.4257455052868,89.31400034397666,91.39058651535015,102.16203439971287,43081.85380046379,41113.60428759951,82.14653517632503,69.17186036108926,True,False,42815.84,42415.84,42415.84,42465.84,2024-01-15 05:30:00,True,2024-01-15 05:30:00,2024-01-15 15:49:26,2024-01-15 16:28:14,success,True,93.31,1718.6499999999992,,3,0,3,1
2024-01-15 05:00:00,42379.086,42467.938,42361.613,42414.637,1979,30660,0,2024-01-15 05:00:00,2024-01-15 05:00:00,-49.87533333339525,-1028.6885080857319,42187.29907142858,-0.0017843077147368144,-0.004721717025606779,42118.011380952354,41114.526541110725,41893.038143495905,42323.80499793552,42572.97183651591,42371.54847746816,-210.20012044667237,-254.9742642438904,528.2849075757683,53.941697282389214,50.79963914687687,53.79149914003938,43086.23310269545,41658.36385224087,93.10464946501823,90.29890717869274,True,False,42914.637,42514.637,42514.637,42564.637,2024-01-15 05:30:00,True,2024-01-15 05:30:00,2024-01-15 15:52:56,2024-01-15 05:45:32,even,True,18.66,1737.3099999999993,,4,0,3,1
2024-01-15 06:00:00,42546.539,42611.438,42534.238,42594.664,1246,41676,0,2024-01-15 06:00:00,2024-01-15 06:00:00,69.28769047622336,-998.9912569551743,42347.968928571405,0.00011934716562359682,-0.00408848238054145,42187.29907142858,41722.96704984669,41978.16108201392,42443.49320425664,42571.968270538084,42565.73433058138,-147.8180576954037,-202.1441808536539,221.99658087134858,27.572101479192497,37.88157309942471,44.74725730996579,42866.929714757694,42266.03894640506,88.75988530742903,90.32302988943532,True,False,43094.664,42694.664,42694.664,42744.664,2024-01-15 07:15:00,True,2024-01-15 07:15:00,2024-01-15 20:28:39,2024-01-15 07:16:16,even,True,18.66,1755.9699999999993,,5,0,3,1
2024-01-15 07:00:00,42579.219,42797.039,42543.039,42761.84,2326,36226,0,2024-01-15 07:00:00,2024-01-15 07:00:00,160.66985714282782,-962.1459319160786,42592.28453571425,0.004056557631755571,0.0005779968960959055,42347.968928571405,43174.53746828857,42887.37997768314,42526.920132751715,42581.08364732669,42636.1385617475,-100.17933854198782,-151.37185676948474,254.43010450301935,62.098181286528416,15.856210182319046,0.7609944960859139,42981.11920282658,42292.657920668426,86.44203813570124,84.86314680496582,True,False,43261.84,42361.84,42861.84,42911.84,,False,2024-01-15 20:30:00,2024-01-15 20:34:10,2024-01-15 16:28:14,fail,False,-74.66,1681.3099999999993,,0,1,3,1
2024-01-15 08:00:00,42720.039,42751.738,42665.047,42709.438,1593,38410,0,2024-01-15 08:00:00,2024-01-15 08:00:00,244.3156071428457,-910.4917435587558,42676.94097619046,0.00355917900369674,0.0019779225838021837,42592.28453571425,43142.43409892966,43193.224537081434,42601.684502139906,42606.549203194685,42720.75421706224,-62.00939844179811,-105.39800537213895,201.19750394679775,25.80394943238207,23.262686274480075,7.6228679050764185,42993.87084739042,42449.13758673406,79.17089720331096,78.64527004929498,False,True,42209.438,42609.438,42609.438,42559.438,2024-01-15 13:00:00,True,2024-01-15 13:00:00,2024-01-15 16:52:23,2024-01-15 13:15:41,even,True,18.66,1699.9699999999993,,1,0,3,1
2024-01-15 09:00:00,42626.84,42667.34,42604.258,42666.137,432,47121,0,2024-01-15 09:00:00,2024-01-15 09:00:00,84.65644047621026,-867.0806416428168,42680.57991666666,0.002750643373208778,0.0020337910124841414,42676.94097619046,42924.47153784925,43292.8043964184,42621.41764419419,42615.81542144834,42695.719720674235,-41.01614465426246,-70.97882043441857,173.93792442315507,-8.17392328861024,-12.249923632647551,-6.731891296803951,42930.535918645495,42459.403522702974,53.93139223374623,59.933838758150216,False,True,42166.137,42566.137,42566.137,42516.137,2024-01-15 16:30:00,True,2024-01-15 16:30:00,2024-01-15 16:53:25,2024-01-15 19:04:14,success,True,93.31,1793.2799999999993,,2,0,3,1
2024-01-15 10:00:00,42686.84,42724.938,42616.676,42653.539,1007,36922,0,2024-01-15 10:00:00,2024-01-15 10:00:00,3.638940476201242,-818.486865023282,42696.270571428584,0.0015129114114723892,0.0016814135998778701,42680.57991666666,42795.53381446175,43279.22372412209,42628.61320621292,42620.35948351229,42663.168532507705,-27.535258144242107,-48.11453219217898,132.140032938981,-1.9436780186661053,11.132396628869174,-19.075674578554754,42841.55757697533,42483.27948804008,51.37976083649587,46.46248586407836,False,True,42153.539,42553.539,42553.539,42503.539,2024-01-15 16:30:00,True,2024-01-15 16:30:00,2024-01-15 16:54:38,2024-01-15 19:04:12,success,True,93.31,1886.5899999999992,,3,0,3,1
2024-01-15 11:00:00,42655.867,42673.438,42569.043,42653.238,1566,43422,0,2024-01-15 11:00:00,2024-01-15 11:00:00,15.690654761921905,-773.3633891530117,42712.938130952374,0.0013311251487452113,0.000685076949430073,42696.270571428584,42777.288877874926,43022.302650890066,42644.04008949839,42630.9817796425,42649.128857585165,-16.32464027657261,-31.118082089972617,74.08220104326148,-10.61055727553321,-4.820037151701399,5.9941365669074,42749.13982899357,42547.61788617676,61.42012216799616,59.20173496218573,False,True,42153.238,42553.238,42553.238,42503.238,2024-01-15 16:30:00,True,2024-01-15 16:30:00,2024-01-15 16:54:38,2024-01-15 19:04:12,success,True,93.31,1979.8999999999992,,4,0,3,1
2024-01-15 12:00:00,42733.637,42745.637,42656.84,42656.84,1062,41621,0,2024-01-15 12:00:00,2024-01-15 12:00:00,16.66755952379026,-723.1024734238454,42654.89573809524,0.0005130949147704028,-6.87289234181823e-05,42712.938130952374,42593.89565717237,42771.565218555785,42659.78470979118,42642.881961050894,42662.63856518748,-7.889692164688313,-18.815284693752684,57.18707016405517,-3.5509415204724064,15.214818713451677,6.248828001364018,42739.84110990896,42583.936020466004,68.41787261585159,64.94228464620261,False,True,42156.84,42556.84,42556.84,42506.84,2024-01-15 16:30:00,True,2024-01-15 16:30:00,2024-01-15 16:54:38,2024-01-15 19:04:13,success,True,93.31,2073.209999999999,,5,0,3,1
2024-01-15 19:30:00,42672.34,42700.34,42587.637,42604.039,1642,46621,0,2024-01-15 19:00:00,2024-01-15 19:00:00,-8.263619047640532,-518.33592092662,42484.912952380975,-0.0014258328938011352,-0.0008894644289976868,42413.06830952382,41742.53034729599,42651.02301890267,42515.9704347144,42525.70243185689,42450.70966907464,-15.306964418494317,-25.50825448516584,168.6128678425292,35.426858961094695,47.52250189198094,41.42466322670225,42679.83704066205,42223.08229748723,74.45762775852434,62.279871758132536,False,True,42104.039,43004.039,42504.039,42454.039,,False,2024-01-16 16:45:00,2024-01-16 16:43:03,2024-01-15 20:25:53,fail,False,-74.66,1998.549999999999,,0,1,3,1
2024-01-15 20:00:00,42688.039,42778.637,42688.039,42696.738,2214,38925,0,2024-01-15 20:00:00,2024-01-15 20:00:00,71.84464285715512,-472.411808650475,42636.39592857143,-0.00018932358024540685,0.0018732431064926779,42484.912952380975,42079.96875783066,43646.001259541474,42564.89126982511,42548.82677902683,42567.5198101135,-4.305233851249795,-18.732501716324563,171.66746146043184,61.465726866161276,55.34441417270136,35.426858961094695,42800.77088308508,42335.76873714192,85.47869452995887,80.48529590212813,True,False,43196.738,42796.738,42796.738,42846.738,2024-01-15 20:30:00,True,2024-01-15 20:30:00,2024-01-15 20:33:10,2024-01-15 21:45:34,success,True,93.31,2091.859999999999,,1,0,3,1
2024-01-16 00:00:00,42681.539,42727.039,42363.84,42454.25,2110,5219,0,2024-01-16 00:00:00,2024-01-16 00:00:00,57.370464285726484,-282.5678555339982,42842.86298809522,0.0005819989837202294,0.0003683165333863137,42932.881321428584,42395.51483427591,43468.93691721098,42782.15179671215,42769.18650471659,42768.092474716206,22.06114139379497,38.69349997434338,249.06559769126275,-110.30651049192966,-44.097523219825234,-43.59882765734801,43104.33103159941,42430.353917833,9.773042702708375,10.855162621292443,False,True,41954.25,42854.25,42354.25,42304.25,,False,2024-01-16 16:45:00,,2024-01-16 05:24:48,fail,False,-74.66,2017.1999999999991,,0,1,3,1
2024-01-16 03:00:00,42575.898,42706.938,42568.438,42654.438,1607,44777,0,2024-01-16 03:00:00,2024-01-16 03:00:00,-87.3598333333066,-260.9921066705283,42542.43639285712,-0.001787533268055007,-0.002124546724428418,42613.220011904756,41804.97579967725,42375.55352583087,42613.99576551208,42656.75208247547,42527.819125215,-16.78032142117445,-10.247783455942905,192.5343098836766,25.450973168182827,13.339987616163853,21.079115239015664,42789.24044355796,42267.89780687204,60.1737799755658,54.09092723557606,True,False,43154.438,42754.438,42754.438,42804.438,2024-01-16 05:45:00,True,2024-01-16 05:45:00,2024-01-16 17:33:22,2024-01-16 06:47:49,even,True,18.66,2035.8599999999992,,1,0,3,1
2024-01-16 04:00:00,42561.316,42673.738,42524.84,42655.238,1226,43996,0,2024-01-16 04:00:00,2024-01-16 04:00:00,-70.78361904763733,-249.82405457724963,42559.61227380953,-0.000499144463823528,-0.0014882117080349951,42542.43639285712,42144.08543495525,42472.01190316446,42604.606670314846,42639.63950678435,42583.82480116958,-17.06679979740875,-14.811670063689117,167.63386026977727,27.602842105246964,4.4474709322239505,3.0680075679483707,42811.63051253378,42357.519089805384,48.77161994836134,52.27004327777132,True,False,43155.238,42755.238,42755.238,42805.238,2024-01-16 05:45:00,True,2024-01-16 05:45:00,2024-01-16 17:33:22,2024-01-16 06:36:06,even,True,18.66,2054.519999999999,,2,0,3,1
2024-01-16 05:00:00,42673.789,42713.738,42666.117,42689.438,1061,47121,0,2024-01-16 05:00:00,2024-01-16 05:00:00,17.175880952410807,-229.4204006058426,42663.119083333324,0.0009155615440314121,-0.000570722437234413,42559.61227380953,42642.292752361536,42825.62397031373,42633.17515185322,42645.41539182269,42653.69911007909,-9.715546724532032,-13.329414415052536,93.08250552314429,30.741651874726813,13.861503956009983,-5.427695218459121,42780.860492535336,42528.03772762285,81.33006485250517,76.60262988709978,True,False,43189.438,42789.438,42789.438,42839.438,2024-01-16 06:00:00,True,2024-01-16 06:00:00,2024-01-16 17:33:27,2024-01-16 06:31:34,even,True,18.66,2073.179999999999,,3,0,3,1
2024-01-16 06:00:00,42890.109,42918.738,42824.969,42911.238,1383,33063,0,2024-01-16 06:00:00,2024-01-16 06:00:00,103.5068095237948,-193.7352882281848,42729.88488095241,0.0012952878186104407,-6.794148068526261e-05,42663.119083333324,42838.30627051976,42907.63002001159,42741.31567971299,42699.47310348419,42801.13902683181,11.942708444708842,-2.7355525866842756,118.14408728476427,40.732929136596795,40.47304575161979,33.371129342966015,42962.13354466624,42641.64450899737,90.89181783060643,85.32719620296533,True,False,43411.238,43011.238,43011.238,43061.238,2024-01-16 15:00:00,True,2024-01-16 15:00:00,2024-01-16 18:02:39,2024-01-16 15:07:38,even,True,18.66,2091.839999999999,,4,0,3,1
2024-01-16 08:00:00,42737.422,42752.84,42675.684,42714.238,1027,39144,0,2024-01-16 08:00:00,2024-01-16 08:00:00,38.76209523808211,-156.96092884812242,42777.36286904763,0.0006942222444387073,0.0011385481078969807,42768.646976190495,42729.46153332418,43242.55047561851,42775.35196539192,42742.68059145749,42842.128196078425,16.61497090994817,14.631307521694538,113.07129823190762,-24.9704447884651,-12.976960784311814,16.01722153427545,42994.7744486915,42687.98194346535,55.62404015322295,68.23352963069674,False,True,42214.238,43114.238,42614.238,42564.238,,False,2024-01-16 16:45:00,2024-01-16 16:42:04,2024-01-16 11:23:24,fail,False,-74.66,2017.1799999999987,,0,1,3,1
2024-01-16 09:00:00,42715.227,42740.34,42585.965,42633.738,1004,43586,0,2024-01-16 09:00:00,2024-01-16 09:00:00,8.715892857137078,-144.71391729260358,42776.22038095239,0.0004429115745365021,0.00015679916211544406,42777.36286904763,42644.703320698376,42967.33693354814,42729.927921897106,42727.1005130317,42732.008292741695,6.162909636972472,11.633212781510029,101.50831490697178,-39.68198761606618,-18.520182318512525,-19.841276917839423,42869.04451786611,42593.47206761728,25.61359706652131,27.544062759980374,False,True,42133.738,43033.738,42533.738,42483.738,,False,2024-01-16 16:45:00,2024-01-16 16:42:45,2024-01-16 11:00:40,fail,False,-74.66,1942.5199999999986,,0,2,3,1
2024-01-17 00:00:00,43391.238,43460.438,43312.637,43353.945,1444,64023,0,2024-01-17 00:00:00,2024-01-17 00:00:00,101.7220119047197,82.45057270101825,43209.43095238094,0.0021520134353939005,0.000604074813116495,43251.59048809523,43506.71871624329,43667.105277319526,43262.18841911341,43153.96765441788,43365.117799105596,55.64529986467096,43.90574530800357,145.92931709230785,32.46364327485935,60.62026006188535,43.25426556590537,43563.62237718021,43168.11322103098,78.53824232200736,84.03854802216965,False,True,42853.945,43253.945,43253.945,43203.945,2024-01-17 01:00:00,True,2024-01-17 01:00:00,2024-01-17 05:51:25,,success,True,93.31,2035.8299999999986,,1,0,3,1
2024-01-17 01:00:00,43170.805,43248.738,43164.629,43176.438,1041,64922,0,2024-01-17 01:00:00,2024-01-17 01:00:00,-42.1595357142869,83.98228548380575,43192.2315238095,0.0012543098081651864,0.0006040233831107025,43209.43095238094,43267.36154986407,43693.34981026995,43240.710903268075,43172.490993383995,43330.75327726183,44.35580413383286,47.1326561291193,148.97115435683506,-34.932796009590675,-24.946144478817587,4.091132782908971,43531.86433564356,43128.1422188801,32.27558632510804,45.81069364345546,False,True,42676.438,43076.438,43076.438,43026.438,2024-01-17 04:00:00,True,2024-01-17 04:00:00,2024-01-17 09:47:58,,success,True,93.31,2129.1399999999985,,2,0,3,1
2024-01-17 02:00:00,43096.84,43147.738,43053.84,43062.039,1449,42140,0,2024-01-17 02:00:00,2024-01-17 02:00:00,-17.199428571439057,78.32525948189868,43170.450452380945,0.0008507116958532556,0.0008527109186817029,43192.2315238095,43152.86800126346,43792.29385226107,43172.770645871926,43154.53079846045,43182.13904712761,24.6102632751863,37.628653241399704,145.3851622776837,-42.22086687306728,-38.732284141769924,-36.12651221186388,43378.40901620248,42984.36907805274,10.884020956123152,17.033408627290154,False,True,42562.039,42962.039,42962.039,42912.039,2024-01-17 05:45:00,True,2024-01-17 05:45:00,2024-01-17 10:05:51,,success,True,93.31,2222.4499999999985,,3,0,3,1
2024-01-17 03:00:00,43060.484,43083.938,43032.953,43063.285,1444,46090,0,2024-01-17 03:00:00,2024-01-17 03:00:00,-21.78107142855879,70.10032732105901,43086.91622619048,0.0004201351834740466,-0.0006010660339038051,43170.450452380945,42991.59804768641,43343.48060824292,43115.01612885441,43127.70946306102,43042.92575438597,8.423390123753052,22.7702683760428,123.32475477677764,-33.81003955963388,-28.479556243612024,-33.76227691776876,43209.41417333462,42874.937335437324,8.028168535842758,6.059187192860848,False,True,42563.285,42963.285,42963.285,42913.285,2024-01-17 05:45:00,True,2024-01-17 05:45:00,2024-01-17 10:05:51,,success,True,93.31,2315.7599999999984,,4,0,3,1
2024-01-17 04:00:00,42931.137,43010.738,42883.879,42988.539,1107,44808,0,2024-01-17 04:00:00,2024-01-17 04:00:00,-83.53422619046614,52.53914882102981,43015.02899999999,-9.792892605303493e-05,-0.0018909803375803834,43086.91622619048,42868.901557795296,42835.78387237369,43071.16397214934,43102.302814766284,42977.92574372204,-3.197235111547343,10.416186546922887,135.22209848237927,-12.858960784338706,-25.762236670096172,-15.057925696586608,43160.47557667325,42793.875910770825,15.931182464253956,17.395195332109086,False,True,42488.539,42888.539,42888.539,42838.539,2024-01-17 06:00:00,True,2024-01-17 06:00:00,2024-01-17 14:36:37,2024-01-17 06:02:35,even,True,18.66,2334.4199999999983,,5,0,3,1
2024-01-17 11:00:00,42699.34,42796.34,42671.246,42796.34,1100,44492,0,2024-01-17 11:00:00,2024-01-17 11:00:00,-16.790857142870664,-60.34742852949421,42662.44520238096,-0.0012677081753485883,-0.0007745536632708383,42692.41820238094,42278.42717575982,42682.4221281412,42737.940670461765,42802.5569151771,42694.348503268,-41.25308058260998,-42.77068471705021,82.35189797191273,14.687395252825809,-9.42653250775038,-8.658574475331989,42807.02356553008,42583.173441005914,58.47429843743563,47.46603256279854,True,False,43296.34,42396.34,42896.34,42946.34,,False,,,2024-01-17 14:36:38,fail,False,-74.66,2259.7599999999984,,0,1,3,1
2024-01-17 11:45:00,42752.738,42755.039,42640.34,42650.738,891,41762,0,2024-01-17 11:00:00,2024-01-17 11:00:00,-16.790857142870664,-60.34742852949421,42662.44520238096,-0.0012677081753485883,-0.0007745536632708383,42692.41820238094,42278.42717575982,42682.4221281412,42730.05514537306,42785.86778202724,42699.26893739252,-37.65787101116439,-40.23432544931687,64.75902537196548,-7.821069831428758,4.298840041272342,8.442663914676814,42786.69362164467,42610.34425314036,62.49731254900565,69.4943765238235,False,True,42150.738,42550.738,42550.738,42500.738,2024-01-17 18:00:00,True,2024-01-17 18:00:00,2024-01-18 18:38:56,2024-01-17 20:51:14,even,True,18.66,2278.4199999999983,,1,0,3,1
2024-01-17 13:00:00,42824.793,42827.539,42739.809,42750.539,1265,40047,0,2024-01-17 13:00:00,2024-01-17 13:00:00,51.11755952380918,-65.45835660064768,42693.58127380951,-0.00072344020536941,-0.0002983013006025453,42713.56276190477,42324.52103934572,42780.32365770452,42746.523075052515,42776.00184834342,42742.05968971444,-26.66437635679904,-34.01890807882656,62.481246732239654,11.49722359819134,23.23932817336754,16.264948056392313,42827.90937280297,42657.710006625915,87.49131310300955,78.53157870969106,True,False,43250.539,42350.539,42850.539,42900.539,,False,,,2024-01-17 14:36:38,fail,False,-74.66,2203.7599999999984,,0,1,3,1
2024-01-17 21:00:00,42592.238,42608.539,42541.344,42554.238,1501,41726,0,2024-01-17 21:00:00,2024-01-17 21:00:00,46.71965476190235,-129.7137132799544,42470.49691666666,-0.0008356405891390673,-0.0008072426777861239,42433.816380952376,41974.91196091522,42604.76338773651,42460.14534580302,42501.10652536721,42398.94112727898,-34.45149299444893,-43.64869680727615,128.28128852229634,40.50289783281187,30.690766769868787,14.031745442014653,42573.620866784084,42225.76138777388,74.8431529186039,58.683351772908246,True,False,43054.238,42654.238,42654.238,42704.238,2024-01-17 22:45:00,True,2024-01-17 22:45:00,,2024-01-17 22:55:52,even,True,18.66,2222.4199999999983,,1,0,3,1
2024-01-18 03:00:00,42644.84,42697.539,42573.938,42581.738,985,44605,0,2024-01-18 03:00:00,2024-01-18 03:00:00,-17.682678571436554,-56.77522324205347,42657.90371428572,0.000818993941245624,-0.0003895018871072508,42715.027726190456,42616.68053917597,42698.73764214285,42648.02431907787,42632.09973577926,42648.90049088408,9.98600595217431,11.615840644783912,54.270559314500254,-10.896027175745985,-5.339299277649843,-2.810063639502914,42722.16574595866,42574.1352358095,59.95141686607379,62.576917635580706,False,True,42081.738,42481.738,42481.738,42431.738,2024-01-18 13:00:00,True,2024-01-18 13:00:00,2024-01-18 18:40:48,2024-01-18 13:07:42,even,True,18.66,2241.079999999998,,2,0,3,1
2024-01-18 04:00:00,42569.039,42614.539,42559.969,42611.34,499,47024,0,2024-01-18 04:00:00,2024-01-18 04:00:00,-57.12401190473611,-58.60140397462965,42642.76735714284,0.0003353808422687038,-0.0004247285801336856,42657.90371428572,42516.90756160384,42667.58191802702,42613.50290198589,42617.39369474462,42605.65465256279,2.0458744077623123,7.051058782579022,61.07074850988991,0.3455393877302413,-10.666672170656966,-32.18364671481686,42689.600163051146,42523.20914207444,32.77056672936724,38.75002176206324,False,True,42111.34,42511.34,42511.34,42461.34,2024-01-18 13:00:00,True,2024-01-18 13:00:00,2024-01-18 18:40:45,2024-01-18 13:18:25,even,True,18.66,2259.739999999998,,3,0,3,1
2024-01-18 07:00:00,42646.539,42666.637,42613.84,42665.34,513,47070,0,2024-01-18 07:00:00,2024-01-18 07:00:00,5.009726190466608,-49.5432867171985,42648.3475,0.0005597181904838018,-1.1565537806773821e-05,42609.29785714284,42661.62524616204,42766.027929511314,42622.471688753634,42619.59661332901,42623.748772961815,1.627574999758508,0.8315029629296774,54.2102325225991,15.563453732363996,9.351334365303046,13.648827657430957,42698.432586867326,42550.564959056304,75.97631319715155,65.87406100201424,True,False,43165.34,42765.34,42765.34,42815.34,2024-01-18 08:15:00,True,2024-01-18 08:15:00,,2024-01-18 08:31:01,even,True,18.66,2278.399999999998,,4,0,3,1
2024-01-18 11:00:00,42728.137,42799.738,42698.176,42769.238,1226,43171,0,2024-01-18 11:00:00,2024-01-18 11:00:00,6.319357142892841,-0.7502442859404255,42778.91045238093,0.0006208614846145026,0.0009266131441488122,42788.70126190476,42782.13795849547,43128.45547486798,42789.27092232718,42749.780368828244,42838.471313037495,24.423782784870127,25.412900672698665,106.11331585201097,-13.361115583058563,-24.514384932954272,-9.996565531400847,42981.72428943771,42693.71833663728,41.086894733984316,55.090413708925865,False,True,42269.238,42669.238,42669.238,42619.238,2024-01-18 12:45:00,True,2024-01-18 12:45:00,2024-01-18 18:36:24,2024-01-18 16:57:22,even,True,18.66,2297.0599999999977,,5,0,3,1
2024-01-18 12:00:00,42718.508,42732.637,42678.137,42700.238,1026,41024,0,2024-01-18 12:00:00,2024-01-18 12:00:00,-9.79080952383083,0.543515480858332,42670.25784523809,-0.0005033431964999717,9.155815897137119e-05,42778.91045238093,42299.209284450095,42928.391042851465,42763.96243142019,42747.37368218021,42763.64284279324,15.872345879302884,21.789097538123002,84.554195314466,-24.195722394200857,-22.39135638121661,-15.614542139657715,42877.79100646777,42647.99467911871,21.455424653140753,31.563883608946252,False,True,42200.238,42600.238,42600.238,42550.238,2024-01-18 13:00:00,True,2024-01-18 13:00:00,2024-01-18 18:37:10,2024-01-18 15:49:35,even,True,18.66,2315.7199999999975,,6,0,3,1
2024-01-18 16:00:00,42481.301,42546.84,42403.207,42542.238,1587,45426,0,2024-01-18 16:00:00,2024-01-18 16:00:00,-41.87167857145687,-54.12565360729059,42514.387297619076,-0.0012148056194874217,-0.0007154244897097362,42458.70795238092,41984.834921669506,42610.14368524311,42488.41550381266,42548.20423068459,42413.60023735809,-32.90149659682356,-31.37515954412288,162.35162623435338,29.87352975572867,15.786593395278032,23.482867217011517,42634.27493277447,42194.42554194172,54.769835702566844,38.352312451472294,True,False,43042.238,42642.238,42642.238,42692.238,2024-01-18 17:00:00,True,2024-01-18 17:00:00,,2024-01-18 17:03:39,even,True,18.66,2334.3799999999974,,7,0,3,1
2024-01-18 17:00:00,42716.438,42761.238,42611.402,42702.566,1838,41723,0,2024-01-18 17:00:00,2024-01-18 17:00:00,55.67934523815347,-39.79906175803626,42545.72750000004,-0.0006039782932963279,-0.0003713591067396146,42514.387297619076,42156.45028468993,42736.55440408326,42560.2938546732,42569.528651096116,42579.80936738906,-14.977724681935797,-25.85509189829581,136.84237894982004,48.83278878567944,61.49131888545526,24.85264189884765,42766.04657897132,42395.0721558068,81.83068351470776,75.26915703627311,True,False,43202.566,42302.566,42802.566,42852.566,,False,,,2024-01-18 18:36:13,fail,False,-74.66,2259.7199999999975,,0,1,3,1
2024-01-18 21:45:00,41355.938,41364.84,40783.84,40996.539,4687,0,0,2024-01-18 21:00:00,2024-01-18 21:00:00,-278.92672619048244,-201.39653726722463,41503.976845238096,-0.005304682485099073,-0.004801229098978317,41879.17604761905,40008.98180695652,41254.32054873875,41547.90763571133,41879.42409741986,41175.823155486745,-165.68485570696066,-128.78656039394508,543.5393694590084,-99.13822531820188,-50.91357997934392,-37.0706312350012,41909.60130425641,40440.54500671708,14.730711467443003,12.909665932980436,False,True,40496.539,40896.539,40896.539,40846.539,2024-01-18 22:30:00,True,2024-01-18 22:30:00,2024-01-19 18:30:41,2024-01-18 22:31:03,even,True,18.66,2278.3799999999974,,1,0,3,1
2024-01-19 00:00:00,40996.453,41243.738,40996.453,41211.266,2143,57496,0,2024-01-19 00:00:00,2024-01-19 00:00:00,-125.66426190471975,-390.1848112537482,41040.46866666665,-0.006215370090926408,-0.004820966198597715,41020.704297619064,39139.51076609084,40657.395516244775,41162.59777602076,41454.58626950615,40930.92316167869,-180.85541084700526,-183.7117484441033,478.8360690916169,45.125606123154284,50.79006157548429,-15.589100103199598,41578.85185495237,40284.49446840501,54.016444524694236,42.20953793749077,True,False,41711.266,40811.266,41311.266,41361.266,,False,2024-01-19 09:00:00,2024-01-19 20:50:57,2024-01-19 05:32:09,fail,False,-74.66,2203.7199999999975,,0,1,3,1
2024-01-19 01:00:00,41310.137,41319.738,41158.086,41173.738,1623,45621,0,2024-01-19 01:00:00,2024-01-19 01:00:00,19.764369047588843,-397.60899144172436,41117.39414285715,-0.00315413242191645,-0.00432596014451838,41040.46866666665,39809.03077470465,40675.75799668259,41192.667982798914,41393.382407988545,41094.95216821463,-146.62778727526165,-167.8503886596436,324.5512263099883,34.54205366356473,50.64009047124273,40.578487788101484,41534.596323733116,40656.80801269614,70.42874999851081,64.85055997991772,True,False,41673.738,40773.738,41273.738,41323.738,,False,2024-01-19 08:45:00,2024-01-19 20:50:51,2024-01-19 05:32:09,fail,False,-74.66,2129.0599999999977,,0,2,3,1
2024-01-19 02:00:00,41291.039,41344.738,41193.84,41228.008,2029,38625,0,2024-01-19 02:00:00,2024-01-19 02:00:00,76.92547619049583,-400.74513271218166,41168.99871428569,7.593080886204975e-05,-0.002781766253477957,41117.39414285715,40673.19530891346,40929.02492797314,41227.482872033856,41359.615509809235,41295.89304609566,-114.06318821181048,-141.3230555741419,208.93688403642471,41.348799449602666,63.92840729276941,38.17392225662479,41579.45783954483,41013.82825264649,88.66929047752296,89.1082825620954,True,False,41728.008,40828.008,41328.008,41378.008,,False,2024-01-19 09:00:00,2024-01-19 20:50:58,2024-01-19 05:31:49,fail,False,-74.66,2054.399999999998,,0,3,3,1
2024-01-19 03:00:00,41265.938,41292.238,41177.191,41241.238,1539,41911,0,2024-01-19 03:00:00,2024-01-19 03:00:00,51.60457142854284,-400.71721908973996,41233.05124999998,0.001764264571219516,-0.0020253111674947344,41168.99871428569,41272.846133911225,41003.798310166305,41223.58566504841,41321.26296781247,41301.617927760584,-92.31142187589285,-116.96771758005889,169.93743127877877,-1.1428290333933546,-1.5972452700079884,23.14854867563554,41531.03345998694,41070.70239553423,79.70868631671276,77.004188244456,True,False,41741.238,40841.238,41341.238,41391.238,,False,2024-01-19 09:00:00,2024-01-19 20:51:25,2024-01-19 05:31:30,fail,False,-74.66,1979.7399999999977,,0,4,3,1
2024-01-19 04:00:00,41243.039,41279.539,41175.465,41235.539,1170,45625,0,2024-01-19 04:00:00,2024-01-19 04:00:00,64.05253571429057,-397.77223583467276,41236.1299047619,0.0016466315028420596,-0.0010235045337319267,41233.05124999998,41298.879737760646,41126.12873571741,41218.27840327629,41291.4977300881,41222.040571035446,-74.39745264578232,-95.60128161154265,144.2142107328509,-7.90308221536543,-13.855070175413857,-16.809369109054387,41416.72975552479,41025.8513865461,60.958663524364134,55.88174649365299,True,False,41735.539,40835.539,41335.539,41385.539,,False,2024-01-19 09:00:00,2024-01-19 20:50:58,2024-01-19 05:31:35,fail,False,-74.66,1905.0799999999977,,0,5,3,1
2024-01-19 05:00:00,41085.438,41117.238,40977.238,41039.137,1481,41941,0,2024-01-19 05:00:00,2024-01-19 05:00:00,3.078654761920916,-403.2167961238956,41171.835666666666,0.00022258406440278606,0.00017163333256568292,41236.1299047619,40745.811314563194,41391.35905316591,41152.432048540606,41237.371898870544,41121.925401444794,-70.91100155633467,-81.16576717409556,104.40497635687689,-28.128476436184428,-29.779276229783136,-30.35105366355856,41262.872119526575,40979.47868336301,10.66881421079484,20.991312217372393,False,True,40539.137,41439.137,40939.137,40889.137,,False,2024-01-19 17:30:00,2024-01-19 18:28:06,2024-01-19 08:48:52,fail,False,-74.66,1830.4199999999976,,0,6,3,1
2024-01-19 06:30:00,41156.34,41170.539,41078.785,41097.637,1162,45223,0,2024-01-19 06:00:00,2024-01-19 06:00:00,-64.29423809523723,-407.8812260242994,41097.40469047621,-3.2781083858975546e-05,-0.0007841214581484629,41171.835666666666,40706.859172671786,41097.83540558351,41090.278189816214,41165.994374712485,41034.74401341587,-62.08648855465435,-71.65545147332247,108.75973430510116,2.4310288957422017,16.259829721369897,-12.058249054010957,41183.069654727755,40887.91837210398,63.95061957290983,57.90288855738223,False,True,40597.637,41497.637,40997.637,40947.637,,False,2024-01-19 16:45:00,2024-01-19 18:23:15,2024-01-19 09:01:35,fail,False,-74.66,1755.7599999999975,,0,7,3,1
2024-01-19 08:00:00,41180.84,41240.34,41159.066,41230.238,1038,47023,0,2024-01-19 08:00:00,2024-01-19 08:00:00,0.8589166666497476,-385.87664433079044,41198.31877380952,-0.0009340254390429999,0.0005630635536471006,41098.26360714286,40461.488775200836,41569.187033537906,41142.110990027366,41165.897346517915,41128.796411076706,-35.71848535564641,-51.86718745629864,93.26968226021597,32.943763329873036,14.379565875489789,21.5538083935171,41256.210482128,41002.88234002541,92.5784938886391,86.26531896731338,True,False,41730.238,41330.238,41330.238,41380.238,2024-01-19 09:00:00,True,2024-01-19 09:00:00,2024-01-19 20:50:58,2024-01-19 09:42:12,even,True,18.66,1774.4199999999976,,1,0,3,1
2024-01-19 13:00:00,41456.84,41472.738,41414.938,41415.086,1377,43723,0,2024-01-19 13:00:00,2024-01-19 13:00:00,64.68316666671308,-250.02523275128624,41422.240904761886,0.0009023130661566471,0.000509543627186181,41392.892380952384,41353.08739402642,41707.44276117139,41352.33968384101,41300.628223941545,41367.31819470242,19.939961728072376,10.461775451414283,102.34478418007157,18.898214310254843,21.530871345094056,-0.41233814937004354,41506.983653345516,41229.152736059325,81.84316324000706,74.7761273804635,False,True,40915.086,41315.086,41315.086,41265.086,2024-01-19 16:30:00,True,2024-01-19 16:30:00,2024-01-19 16:40:39,2024-01-19 20:28:54,success,True,93.31,1867.7299999999975,,2,0,3,1
2024-01-19 20:00:00,41210.879,41263.133,41095.438,41128.637,2184,40621,0,2024-01-19 20:00:00,2024-01-19 20:00:00,55.21079761907458,-250.18994557492988,41129.48488095238,-0.004926754300407009,0.0016335842906013886,40861.50035714286,39185.397179299274,42216.79128461781,40884.35469556211,40965.126116505366,40732.222198142415,-56.829187973104126,-68.43665781875598,316.642614704417,83.72910767118447,104.1268555210554,63.959207086365495,41161.18972799338,40304.754668291454,86.9028860579071,67.5323290053038,True,False,41628.637,41228.637,41228.637,41278.637,2024-01-19 20:30:00,True,2024-01-19 20:30:00,2024-01-19 20:50:04,2024-01-22 05:13:52,success,True,93.31,1961.0399999999975,,3,0,3,1
2024-01-22 01:00:00,41598.406,41642.738,41526.68,41543.84,1152,72422,0,2024-01-22 01:00:00,2024-01-22 01:00:00,57.79777380954329,-35.28847314979066,41729.96390476189,0.004854866730958739,0.0023564543802387164,41739.95909523809,42201.97429873862,42829.05234875954,41627.617554155506,41522.41506991486,41619.320249398006,67.95027295882028,74.12423274447876,369.72162900507413,-60.162974544175086,-51.462561403546715,-48.1853742690073,42118.44444855486,41118.69605024115,15.191752464999647,22.146726874739077,False,True,41043.84,41443.84,41443.84,41393.84,2024-01-22 03:30:00,True,2024-01-22 03:30:00,2024-01-22 05:22:52,2024-01-22 03:47:56,even,True,18.66,1979.6999999999975,,4,0,4,1
2024-01-22 02:00:00,41538.188,41623.738,41530.641,41610.539,844,52422,0,2024-01-22 02:00:00,2024-01-22 02:00:00,-9.995190476198331,-23.55587033853226,41637.71021428572,0.004056432143100607,-0.0007412818211555927,41729.96390476189,42048.74243342594,41926.80411408915,41586.92637388014,41526.90366392411,41508.304513243886,49.38447390521469,61.749095136541186,200.35385692429736,1.236815617485263,-28.720135534909787,-46.08920571037743,41780.282220091685,41237.826806396086,16.77712169328285,9.041740734133006,False,True,41110.539,41510.539,41510.539,41460.539,2024-01-22 03:30:00,True,2024-01-22 03:30:00,2024-01-22 05:20:48,,success,True,93.31,2073.0099999999975,,5,0,4,1
2024-01-22 03:00:00,41625.539,41664.34,41378.855,41471.238,1792,52422,0,2024-01-22 03:00:00,2024-01-22 03:00:00,-92.25369047617278,-7.498066194792045,41493.501428571406,0.0008682040689876589,-0.0023900858920054492,41637.71021428572,41365.396134389885,41303.30695874161,41560.37256237454,41528.56310988116,41530.822673890616,35.02957203890401,48.54767845775959,154.24094606090904,0.3887622978872969,23.223199862404726,18.00928379772813,41740.54795107284,41322.59739670839,37.90042638705034,32.89773833544328,False,True,40971.238,41371.238,41371.238,41321.238,2024-01-22 03:30:00,True,2024-01-22 03:30:00,2024-01-22 06:24:19,2024-01-22 03:38:04,even,True,18.66,2091.6699999999973,,6,0,4,1
2024-01-22 04:00:00,41334.164,41369.938,41257.09,41276.34,1332,52422,0,2024-01-22 04:00:00,2024-01-22 04:00:00,-144.2087857143124,-17.861916894777096,41408.111511904746,-0.0012981015730483705,-0.0023902136465262023,41493.501428571406,40988.44425445375,41205.276941098855,41438.820072396826,41471.01719962766,41360.54285724115,5.2781424975182745,27.774808835952854,191.0103162057109,-37.778129342936154,-40.615311317524174,-33.62660302718723,41618.40678411886,41101.178930363436,19.86686670686599,19.292460055196496,False,True,40776.34,41176.34,41176.34,41126.34,2024-01-22 05:45:00,True,2024-01-22 05:45:00,2024-01-22 06:57:45,2024-01-22 05:52:16,even,True,18.66,2110.329999999997,,7,0,4,1
2024-01-22 06:00:00,41168.672,41195.637,40990.266,41085.738,1862,52422,0,2024-01-22 06:00:00,2024-01-22 06:00:00,-94.1169047618896,-47.67720766090497,41088.97113095234,-0.002769838758566431,-0.001602244361283461,41313.99460714286,40323.59437124266,41224.345644239496,41252.324133282105,41347.99376813201,41131.900326797404,-34.28605085996969,-13.214608966596387,186.15996717238036,-41.902698658370355,-31.7635249398445,-44.258518403818016,41383.21628248012,40879.08437111469,16.93434008477752,16.84080845098926,False,True,40585.738,40985.738,40985.738,40935.738,2024-01-22 07:00:00,True,2024-01-22 07:00:00,2024-01-22 11:57:58,2024-01-22 07:29:16,even,True,18.66,2128.989999999997,,8,0,4,1
2024-01-22 08:00:00,41107.738,41155.66,41034.488,41069.738,1441,52422,0,2024-01-22 08:00:00,2024-01-22 08:00:00,-47.76264285710931,-102.70858753238281,41040.69359523811,-0.002126383104391447,-0.001751169472757634,41041.20848809523,40245.85265867306,41039.13046270456,41066.96951249528,41181.739814586326,40937.92946474031,-59.67349835262576,-52.62606189995927,230.8461487757446,8.321134846955829,3.88647506016423,14.189372549080872,41251.07176558756,40626.28716389305,61.19599556515436,52.57135599185258,True,False,41569.738,41169.738,41169.738,41219.738,2024-01-22 08:45:00,True,2024-01-22 08:45:00,,2024-01-22 08:51:37,even,True,18.66,2147.649999999997,,9,0,4,1
2024-01-22 10:00:00,41017.238,41017.238,40802.34,40945.84,2217,52422,0,2024-01-22 10:00:00,2024-01-22 10:00:00,-36.20744047622429,-113.10298655364022,40983.01357142858,-0.0021045220024787812,-0.001754927219068005,41004.486154761886,40081.368140107304,40894.89394884118,41056.46447509801,41128.85316409622,41062.673504299986,-46.003177982122,-47.08435350343701,149.31109666869412,-12.905917440642952,1.8401479187814402,4.325341245305026,41264.243484802726,40859.60352379725,52.8724793562728,59.30417660323514,False,True,40445.84,40845.84,40845.84,40795.84,2024-01-22 10:45:00,True,2024-01-22 10:45:00,2024-01-22 12:27:21,2024-01-22 10:47:11,even,True,18.66,2166.3099999999968,,10,0,4,1
2024-01-22 10:15:00,40942.438,40986.938,40806.645,40877.039,2041,52422,0,2024-01-22 10:00:00,2024-01-22 10:00:00,-36.20744047622429,-113.10298655364022,40983.01357142858,-0.0021045220024787812,-0.001754927219068005,41004.486154761886,40081.368140107304,40894.89394884118,41028.86055585216,41110.20026305205,41044.94536394908,-49.224488752748584,-47.51238055329933,150.82006976729747,-17.72814035090414,-12.905917440642952,1.8401479187814402,41248.55245813493,40839.83826976323,46.11454835255777,53.21547684712045,False,True,40377.039,40777.039,40777.039,40727.039,2024-01-22 12:00:00,True,2024-01-22 12:00:00,2024-01-22 12:27:27,2024-01-22 12:02:55,even,True,18.66,2184.9699999999966,,11,0,4,1
2024-01-22 11:00:00,40931.039,40989.039,40844.828,40914.84,2095,52422,0,2024-01-22 11:00:00,2024-01-22 11:00:00,-21.47258333330683,-127.25435102551273,40889.64159523812,-0.001150621015777642,-0.0008794049967110551,40983.01357142858,40288.969905353275,41060.92879208076,40971.428272116165,41062.618426062494,40975.02284313725,-53.94951841011789,-50.721600339678375,132.2698205499079,-15.13209219127748,-15.907928792577877,-38.88249982797424,41153.58710087963,40794.958585394874,25.690186553931444,27.566104017120903,True,False,41414.84,40514.84,41014.84,41064.84,,False,2024-01-22 15:15:00,,2024-01-22 11:57:59,fail,False,-74.66,2110.3099999999968,,0,1,4,1
2024-01-22 12:15:00,40765.84,40805.34,40327.598,40349.629,3517,52422,0,2024-01-22 12:00:00,2024-01-22 12:00:00,-93.37197619045764,-154.13398585646064,40814.12155952384,-0.0015612498423234907,-0.0017120314868154416,40889.64159523812,40101.27256426897,40765.64908872318,40816.667730909496,40954.52928383636,40711.76654489167,-72.22476506374369,-57.08272188248408,183.28344142323115,-107.09596112829604,-35.53664877879055,-59.9038297213483,40959.19919081303,40462.833898970304,22.679016779697132,30.231048190388453,False,True,39849.629,40749.629,40249.629,40199.629,,False,2024-01-22 21:15:00,2024-01-22 21:17:19,2024-01-22 13:07:22,fail,False,-74.66,2035.6499999999967,,0,2,4,1
2024-01-22 14:00:00,40781.0,40849.438,40673.84,40678.238,2407,52422,0,2024-01-22 14:00:00,2024-01-22 14:00:00,-21.208404761935526,-183.62875580865511,40760.80103571426,-0.0015611093406676334,-0.0016341866970551113,40792.9131547619,39975.77415610378,40656.60831798218,40749.94969607251,40854.49970273125,40654.71819745442,-66.41596416698303,-67.71894334185593,206.8163040996426,-4.879971792230208,17.575342277268646,3.4738768489987706,40933.92020798894,40374.01618691991,58.21587611687317,61.248862043472776,True,False,41178.238,40778.238,40778.238,40828.238,2024-01-22 14:45:00,True,2024-01-22 14:45:00,2024-01-22 15:11:44,2024-01-22 16:13:37,success,True,93.31,2128.959999999997,,1,0,4,1
2024-01-22 15:00:00,40854.438,41214.137,40844.613,41132.938,2984,52422,0,2024-01-22 15:00:00,2024-01-22 15:00:00,-32.11211904764059,-180.91128400916932,40791.94507142856,-0.001619137147272852,-0.0002985014065217407,40760.80103571426,39897.817692767276,41169.54575361846,40831.40471265704,40867.410752157615,40793.5810271758,-40.610061499530275,-58.473327205346116,180.98529766888296,70.77130099758506,27.984651186823612,27.33025696594268,41039.41117902879,40549.25087532281,81.02108450983873,70.79673038383561,True,False,41632.938,40732.938,41232.938,41282.938,,False,,,2024-01-22 16:18:08,fail,False,-74.66,2054.299999999997,,0,1,4,1
2024-01-22 20:30:00,40495.238,40591.738,40433.668,40459.238,1461,52422,0,2024-01-22 20:00:00,2024-01-22 20:00:00,-16.828773809545964,-198.2167588229131,40517.8240833333,-0.002475037217136692,-0.0020672417598031666,40671.08511904761,39586.02858147051,40486.56692637317,40588.16599993437,40651.49406006054,40578.71036291709,-42.99450024883845,-44.64088259513149,189.98885658425257,-9.366176126612118,4.680240798094019,20.01387960093416,40835.19531930583,40320.72540652835,40.43609620426655,55.18512886252201,False,True,39959.238,40859.238,40359.238,40309.238,,False,2024-01-22 21:00:00,2024-01-22 20:49:24,,success,True,93.31,2147.609999999997,,1,0,4,1
2024-01-23 02:00:00,39523.84,39711.738,39481.559,39704.438,2660,52422,0,2024-01-23 02:00:00,2024-01-23 02:00:00,-164.58332142858853,-384.73399823941145,39713.00022619047,-0.0001812847481575609,-0.0037642665643365246,39736.51852380951,39314.61593526743,39330.683172624915,39768.31533107313,39973.94488875965,39647.037432748555,-120.93859279074968,-113.04244259069111,303.93812990374596,-60.661935328484105,-63.50631647746195,-47.645558995551255,40057.35390811861,39235.2209573785,19.554871022264702,20.76151654231521,True,False,40204.438,39804.438,39804.438,39854.438,2024-01-23 04:15:00,True,2024-01-23 04:15:00,2024-01-24 02:52:41,2024-01-23 09:24:35,even,True,18.66,2166.269999999997,,2,0,4,1
2024-01-23 03:00:00,39838.004,39857.438,39755.633,39811.438,1525,52422,0,2024-01-23 03:00:00,2024-01-23 03:00:00,-23.518297619040823,-385.64187223103363,39741.973726190445,0.0003669671436989727,-0.0031475885086311764,39713.00022619047,39514.63657055493,39439.648054554134,39772.89134085786,39920.59314350932,39645.62859064328,-101.75143372260209,-110.71716735401613,206.87996349155716,30.888762297930953,29.739700034362613,-19.975067423452856,39926.416541356884,39366.34063992968,56.1730157489262,46.87662054589581,True,False,40311.438,39911.438,39911.438,39961.438,2024-01-23 04:45:00,True,2024-01-23 04:45:00,2024-01-24 12:43:07,2024-01-23 09:12:15,even,True,18.66,2184.9299999999967,,3,0,4,1
2024-01-23 04:00:00,39792.656,39885.539,39775.141,39882.34,1243,52422,0,2024-01-23 04:00:00,2024-01-23 04:00:00,28.97349999997823,-385.24492026171356,39843.86333333334,0.0003671196672966945,-0.0018165599521668626,39741.973726190445,39529.23772601434,39776.57551291545,39793.833737596724,39891.81914807726,39744.66647127625,-80.40847973598284,-97.23179756506659,183.49102069064003,32.9688968008486,30.513258341939945,9.184927416587016,39993.87934920861,39496.95359334389,73.78994536552466,65.21310669206224,True,False,40382.34,39982.34,39982.34,40032.34,2024-01-23 05:00:00,True,2024-01-23 05:00:00,2024-01-24 12:45:46,2024-01-23 05:25:48,even,True,18.66,2203.5899999999965,,4,0,4,1
2024-01-23 05:00:00,40032.738,40094.938,39996.395,40082.137,1571,52422,0,2024-01-23 05:00:00,2024-01-23 05:00:00,101.88960714289715,-362.1244488297889,39869.41630952379,0.000654038540098724,-0.000724270071304009,39843.86333333334,39641.063038277105,39990.18036818828,39901.7800655493,39922.89983499519,39965.61218335053,-45.30027490917564,-73.34669002938848,150.07624456074134,54.513218094238255,59.95133986931614,61.703332301302,40169.71511350753,39763.00925319353,97.09843619072547,94.2764115989893,True,False,40582.137,39682.137,40182.137,40232.137,,False,2024-01-24 12:45:00,,2024-01-23 09:50:22,fail,False,-74.66,2128.9299999999967,,0,1,4,1
2024-01-23 08:00:00,40038.141,40063.34,39925.137,39994.039,1058,52422,0,2024-01-23 08:00:00,2024-01-23 08:00:00,69.47180952382041,-300.82367549688934,40048.29596428573,0.0018635862388209582,0.0010920317141702779,40023.959142857144,40193.864815674824,40392.26846106272,40020.92473486202,39993.04908413635,40080.13498383213,0.015700972253398504,-11.21072747871488,135.42502171235367,-21.36519504642638,-6.976920880661055,3.7685018919946742,40262.95876314381,39895.811204520454,54.052143750276485,65.56183500450256,False,True,39494.039,39894.039,39894.039,39844.039,2024-01-23 09:30:00,True,2024-01-23 09:30:00,2024-01-23 10:37:45,2024-01-24 02:01:15,success,True,93.31,2222.2399999999966,,1,0,4,1
2024-01-23 09:00:00,39990.191,40004.938,39880.738,39911.438,1404,52422,0,2024-01-23 09:00:00,2024-01-23 09:00:00,24.336821428587427,-284.1911311013755,39942.434761904784,0.0005372207387379614,0.0009073907097865994,40048.29596428573,39706.75962813749,40387.46870291403,40002.75517961958,39991.933811370895,40011.20168627453,-1.2076461330143502,-4.168256592358739,102.52801028938256,-26.596432748548978,-18.497931888516177,-13.981544547641533,40149.6145001652,39871.28887238386,27.289975909395594,38.012328546074,False,True,39411.438,39811.438,39811.438,39761.438,2024-01-23 09:45:00,True,2024-01-23 09:45:00,2024-01-23 10:49:52,2024-01-23 10:05:18,even,True,18.66,2240.8999999999965,,2,0,4,1
2024-01-23 12:45:00,38980.637,39042.039,38881.84,38898.84,2213,36422,0,2024-01-23 12:00:00,2024-01-23 12:00:00,-323.3448809523543,-365.25029544950667,39187.88110714287,-0.004468527921202448,-0.004205983003096946,39443.15127380954,38103.91990085891,38913.40851459743,39178.91357006977,39448.30453776078,38859.06981802547,-132.51024953818705,-101.06021088179392,451.38247952625215,-54.27189439284848,-60.29785104916664,-48.02782662540994,39468.43616538591,38248.20347066503,14.41302029069677,12.694850225014179,False,True,38398.84,38798.84,38798.84,38748.84,2024-01-23 13:45:00,True,2024-01-23 13:45:00,,2024-01-23 13:45:47,even,True,18.66,2259.5599999999963,,3,0,4,1
2024-01-23 13:30:00,38795.512,38914.938,38657.035,38737.031,3587,36422,0,2024-01-23 13:00:00,2024-01-23 13:00:00,-255.27016666666896,-407.53837190947525,38969.390202380986,-0.0055038344538545165,-0.004205931286254669,39187.88110714287,37716.70811601607,38750.555364442684,39038.73635128032,39320.887156455436,38742.70542999657,-146.29176695373462,-120.68880005270125,476.1221546040018,-45.26832404539164,-45.55752149982436,-25.538542483685887,39385.47033871197,38098.44052128116,7.592700947350955,8.800184106060323,False,True,38237.031,39137.031,38637.031,38587.031,,False,,,2024-01-23 17:39:48,fail,False,-74.66,2184.8999999999965,,0,1,4,1
2024-01-23 15:00:00,39047.438,39061.238,38928.137,38942.137,2160,36422,0,2024-01-23 15:00:00,2024-01-23 15:00:00,-70.83007142860879,-445.6425055366781,38818.13765476192,-0.0036309142595221085,-0.003977401795758507,38898.56013095238,37835.205415698176,38510.071981348,38961.04049529296,39168.061888901335,38835.922059167526,-130.39938244717632,-134.28206332038508,373.3674296609803,37.75525558995287,60.870031647798896,11.427265221798734,39341.46808920985,38331.876029125204,50.21421219543282,41.01192129012164,True,False,39442.137,38542.137,39042.137,39092.137,,False,2024-01-23 17:45:00,2024-01-23 17:41:45,2024-01-23 16:21:46,fail,False,-74.66,2110.2399999999966,,0,2,4,1
2024-01-23 17:00:00,38746.566,39048.539,38746.566,39005.539,3828,36422,0,2024-01-23 17:00:00,2024-01-23 17:00:00,-45.56510714288743,-474.0181024711201,38909.108619047605,-0.0009069369894373576,-0.0013547786237936396,38772.572547619035,38370.65682867086,39269.54586771621,38867.53227807801,39014.88579280147,38840.9807354661,-106.41245219577104,-118.66195743136186,119.60565340638091,38.11801100784942,-3.9714434123961837,-36.700987960117345,39003.94836756471,38679.51310336749,51.953972719538264,42.65464599323043,True,False,39505.539,39105.539,39105.539,39155.539,2024-01-23 17:45:00,True,2024-01-23 17:45:00,2024-01-23 19:33:11,2024-01-23 17:54:26,even,True,18.66,2128.8999999999965,,1,0,4,1
2024-01-23 23:00:00,39158.691,39275.637,39075.438,39154.039,1929,36422,0,2024-01-23 23:00:00,2024-01-23 23:00:00,18.9717500000188,-319.2484056186877,39195.84536904761,0.0018505815402743019,0.00015925453399071485,39214.1264047619,39291.083107667226,39674.49078948303,39211.63504153492,39196.944420085114,39167.71214723083,5.231152134037984,5.431165341680643,148.19169281900724,-36.127128310989065,-36.66966701063211,-29.194887856901914,39367.770932536485,38966.15336192517,32.959760658190454,39.44914817585038,False,True,38654.039,39554.039,39054.039,39004.039,,False,,,2024-01-24 01:01:52,fail,False,-74.66,2054.2399999999966,,0,1,4,1
2024-01-24 00:00:00,39182.957,39301.738,39160.809,39277.039,1940,56422,0,2024-01-24 00:00:00,2024-01-24 00:00:00,-18.28103571428801,-300.0988824043816,39240.61991666664,0.0012241748945752006,-0.0006593376249992323,39195.84536904761,39251.44703064626,39435.63070416292,39199.89429701736,39192.88258483961,39146.173691778444,2.7479599661091925,3.158765877866712,138.76783308250614,30.133423804552876,-6.639401100765099,-13.40987478500756,39335.01026643983,38958.83711711706,51.910616923723495,36.405030403771555,False,True,38777.039,39677.039,39177.039,39127.039,,False,,,2024-01-24 01:26:18,fail,False,-74.66,1979.5799999999965,,0,2,4,1
2024-01-24 01:00:00,39440.738,39591.195,39432.086,39546.094,2272,56422,0,2024-01-24 01:00:00,2024-01-24 01:00:00,44.77454761903209,-259.02831142559444,39448.67842857142,0.0008541526976152346,0.0010594809239566324,39240.61991666664,39218.3947247593,40031.46640165004,39333.40834615844,39265.87259715936,39385.065801513556,26.83457587695011,12.52822261609586,145.4316653950647,64.9552923976371,57.13781045752694,80.3008469212291,39582.89854979689,39188.73305323022,90.77285888017171,89.57769777186631,True,False,40046.094,39646.094,39646.094,39696.094,2024-01-24 01:30:00,True,2024-01-24 01:30:00,2024-01-24 02:47:16,2024-01-24 05:22:47,success,True,93.31,2072.8899999999967,,1,0,4,1
2024-01-24 05:00:00,39743.34,39754.34,39647.84,39732.238,1488,36422,0,2024-01-24 05:00:00,2024-01-24 05:00:00,36.05936904762348,-55.24433629625855,39819.85032142858,0.002181057241711379,0.003418624074892883,39865.61136904759,39856.42478306637,41142.38887744373,39771.85347904796,39660.451798835355,39854.764423804634,73.97773082162894,80.78237660226449,294.1405431481918,-34.535768145789916,-41.82814585485903,-30.452730994198646,40251.854157054695,39456.17469055457,22.151774574407455,31.84638507500831,False,True,39232.238,39632.238,39632.238,39582.238,2024-01-24 06:15:00,True,2024-01-24 06:15:00,,2024-01-24 06:23:39,even,True,18.66,2091.5499999999965,,2,0,4,1
2024-01-24 06:00:00,39593.039,39667.34,39531.84,39563.742,1565,36422,0,2024-01-24 06:00:00,2024-01-24 06:00:00,-45.76104761900933,-47.06817742705607,39763.82914285713,0.0018197490309780735,0.00025954620877980024,39819.85032142858,39790.95062195577,40305.05651186002,39686.1751892,39643.89995651833,39631.09012831097,45.8887368960568,65.12452796032946,200.27246591953715,-55.703673546609934,-43.811305813535,-54.52347230822488,39901.457957302344,39359.2222993196,8.565918010246316,10.156967247277784,False,True,39063.742,39963.742,39463.742,39413.742,,False,,,2024-01-24 09:16:11,fail,False,-74.66,2016.8899999999965,,0,1,4,1
2024-01-24 09:00:00,39862.738,39938.637,39791.84,39902.34,1213,36422,0,2024-01-24 09:00:00,2024-01-24 09:00:00,-2.4113333333662013,5.368301147223974,39788.3854404762,-0.0003588582276030179,-0.0002303027497709649,39724.59883333332,39438.442511360365,40127.652225126185,39772.12978798249,39716.13627405681,39803.01830134161,37.43477582412743,36.50361166455846,103.58071839305146,45.10507327145024,38.376579635369126,27.74117096664122,39944.35227117223,39663.18433151099,91.48674273804232,81.6657904141217,True,False,40402.34,40002.34,40002.34,40052.34,2024-01-24 09:30:00,True,2024-01-24 09:30:00,2024-01-24 12:45:54,2024-01-24 09:32:33,even,True,18.66,2035.5499999999965,,1,0,4,1
2024-01-24 11:45:00,39931.898,40031.738,39881.844,39997.438,1857,36422,0,2024-01-24 11:00:00,2024-01-24 11:00:00,90.04003571427893,47.750953793976805,39946.315880952396,0.0013268068596074623,0.0014739004901007328,39878.42547619048,39985.56640108259,40494.11011571224,39943.45701301806,39864.66221400793,40024.93129411765,49.26769340100873,48.51256931065369,155.8002832363475,8.28580976952071,-2.788237358108745,5.5166811145463726,40236.76167648671,39814.60091174858,62.15216605105636,66.79597398066817,True,False,40497.438,40097.438,40097.438,40147.438,2024-01-24 12:45:00,True,2024-01-24 12:45:00,2024-01-24 12:49:32,2024-01-24 13:43:39,success,True,93.31,2128.8599999999965,,2,0,4,1
2024-01-24 12:30:00,40131.395,40326.738,40096.539,40261.973,2597,36422,0,2024-01-24 12:00:00,2024-01-24 12:00:00,67.8904047619144,66.09257618748961,40108.783357142835,0.0020189417331979986,0.002709460470026616,39946.315880952396,40250.19036508288,40932.035477377714,40027.320867695504,39923.37338961916,40095.54716924663,58.84682385173073,51.47040989557257,161.40013269794423,34.70599793599831,26.372575507375586,9.537301685610146,40314.937348388856,39877.656990104406,81.68755164002025,71.96193512572545,True,False,40761.973,39861.973,40361.973,40411.973,,False,2024-01-26 12:45:00,,2024-01-24 15:48:58,fail,False,-74.66,2054.1999999999966,,0,1,4,1
2024-01-24 14:00:00,40176.938,40269.539,40145.496,40215.738,1602,36422,0,2024-01-24 14:00:00,2024-01-24 14:00:00,55.93079761907575,124.16303506273835,40136.346202380955,0.0012836413658153618,0.0030790069554894363,40164.71415476191,40128.87685739787,41239.02134325592,40130.88317190955,40023.41677894163,40216.50018231852,64.32389733152377,61.245950372910634,161.23729657432537,21.373505331925116,24.872522187812137,0.30602339181496063,40435.67053269386,39998.829831943185,47.40540706469297,46.93782321296073,False,True,39715.738,40115.738,40115.738,40065.738,2024-01-24 15:00:00,True,2024-01-24 15:00:00,2024-01-24 20:21:44,2024-01-24 16:32:37,even,True,18.66,2072.8599999999965,,1,0,4,1
2024-01-24 15:00:00,40010.172,40047.34,39955.289,40020.945,1726,36422,0,2024-01-24 15:00:00,2024-01-24 15:00:00,-28.367952380955103,123.76296673538309,40086.79730952383,0.0007725739664806435,0.0017146951613729766,40136.346202380955,39962.99221135378,40994.88756801696,40106.72674464926,40040.50283614564,40168.455823529395,49.95442659078253,58.225569095650066,121.50609300342589,-35.46216030270443,-31.146610939169477,12.518824561448127,40332.48904908402,40002.92259797477,28.934953275043046,37.35378878216387,False,True,39520.945,39920.945,39920.945,39870.945,2024-01-24 16:15:00,True,2024-01-24 16:15:00,2024-01-24 22:50:20,2024-01-24 16:26:47,even,True,18.66,2091.5199999999963,,2,0,4,1
2024-01-24 16:00:00,39958.039,39975.84,39822.84,39843.039,1611,36422,0,2024-01-24 16:00:00,2024-01-24 16:00:00,-49.54889285712852,117.51859449332551,40017.25033333334,-0.00019933166447080284,-0.0005233706634304785,40086.79730952383,39708.31228653499,40372.69243620449,40021.959095074046,40013.759970802756,40001.898080151375,25.308170193762635,43.962081645489576,127.13611860365712,-64.09743756448006,-37.752414172689896,-39.282015823853726,40173.53184026631,39828.76432003644,7.89780183024342,12.714308895219318,False,True,39343.039,39743.039,39743.039,39693.039,2024-01-24 21:45:00,True,2024-01-24 21:45:00,,2024-01-24 21:55:13,even,True,18.66,2110.179999999996,,3,0,4,1
2024-01-24 18:00:00,40024.496,40047.438,39942.137,39960.738,1408,36422,0,2024-01-24 18:00:00,2024-01-24 18:00:00,-11.396809523837874,106.84121260702523,40032.892035714285,-0.0007309635823672149,-0.0014963475005862381,40005.8535238095,39574.58882705748,39955.481086985936,40001.51312556276,40003.58013082527,39940.09756346746,10.394831235891616,18.4884287939589,121.37554476885973,-6.494646714862029,10.612624011002481,14.794310973498796,40103.95454890542,39774.7405780295,58.52121993115989,56.72314694312241,True,False,40460.738,40060.738,40060.738,40110.738,2024-01-24 19:00:00,True,2024-01-24 19:00:00,2024-01-26 12:38:00,2024-01-24 19:09:49,even,True,18.66,2128.839999999996,,4,0,4,1
2024-01-24 19:00:00,40166.965,40190.137,40059.973,40063.105,1531,36422,0,2024-01-24 19:00:00,2024-01-24 19:00:00,27.03851190478599,117.42161315308476,40037.07764285714,-0.0006673397764190899,-0.001217107557055173,40032.892035714285,39562.18169358432,40013.99054862931,40031.77364662877,40018.62862977004,40036.24702373581,12.827209310722537,14.263185276940668,102.41420004862704,27.01126831784495,45.28293636051967,9.872895768821763,40176.006193801455,39897.98785367016,70.54900699262922,63.90377198644739,True,False,40563.105,39663.105,40163.105,40213.105,,False,2024-01-25 13:30:00,2024-01-26 12:40:11,2024-01-24 20:22:05,fail,False,-74.66,2054.179999999996,,0,1,4,1
2024-01-25 01:00:00,39844.34,40001.742,39808.34,39962.84,1325,56422,0,2024-01-25 01:00:00,2024-01-25 01:00:00,-7.251952380953298,18.79135005617718,39801.33904761905,-0.0007268522807491534,-0.00015241457046285235,39713.91035714286,39303.4635224488,40131.01060041786,39811.24311382364,39832.78018195356,39811.77301307187,-20.479329734458588,-29.090431687578995,152.1194543562788,45.608613003038045,16.61751496393117,17.517357413111313,40018.634276452845,39606.411749690895,77.07551639113619,71.50307134541744,True,False,40462.84,40062.84,40062.84,40112.84,2024-01-25 01:45:00,True,2024-01-25 01:45:00,2024-01-26 12:38:00,2024-01-25 01:56:19,even,True,18.66,2072.839999999996,,1,0,4,1
2024-01-25 05:00:00,39913.938,39974.738,39902.676,39973.34,982,36422,0,2024-01-25 05:00:00,2024-01-25 05:00:00,6.210452380946663,47.091215847023705,40029.13246428573,0.0018460287416691595,0.0005610811707339842,40003.92511904762,40168.70651047417,40324.5939856563,39985.49488842937,39963.252355226774,39997.1704471964,13.668167249699763,15.423841263194367,143.42911039234147,-26.41564327484957,-34.682809425576124,-16.725354317153688,40190.79974622606,39802.04114816673,25.932922710976822,35.66188713603489,False,True,39473.34,39873.34,39873.34,39823.34,2024-01-25 07:15:00,True,2024-01-25 07:15:00,,2024-01-25 07:47:07,even,True,18.66,2091.499999999996,,2,0,4,1
2024-01-25 06:00:00,39984.637,40010.039,39935.059,39938.672,681,36422,0,2024-01-25 06:00:00,2024-01-25 06:00:00,25.207345238108246,48.51090574437694,39988.63748809526,0.0015084997461010641,-2.1064525564978473e-05,40029.13246428573,40099.25071314006,40145.768371883634,39987.850544150926,39971.45759239965,39966.23650429995,11.843207005760632,14.36091243782201,95.57667544131424,-7.2850736154432525,-4.298457172335475,-6.505911592685152,40095.26501614573,39835.707992454176,37.77032356484809,45.4390941041241,False,True,39438.672,39838.672,39838.672,39788.672,2024-01-25 17:45:00,True,2024-01-25 17:45:00,,2024-01-25 17:57:32,even,True,18.66,2110.1599999999958,,3,0,4,1
2024-01-25 07:00:00,39930.137,39941.438,39798.238,39810.34,1353,36422,0,2024-01-25 07:00:00,2024-01-25 07:00:00,-40.49497619047179,44.802561296499334,39925.79271428573,0.0001533941233565039,-0.00038277148001042134,39988.63748809526,39782.41561418502,40035.17780743388,39945.40485175287,39954.11991664383,39909.426959752294,1.9003526222077198,9.546282809552194,76.71042054212904,-24.83501238394092,-15.013933264526713,-8.873642930870119,40012.98602748417,39804.36789202042,18.814889965162003,23.308827413391196,False,True,39310.34,40210.34,39710.34,39660.34,,False,2024-01-25 19:15:00,,2024-01-25 13:13:11,fail,False,-74.66,2035.4999999999957,,0,1,4,1
2024-01-25 09:00:00,40005.906,40015.539,39962.539,39971.34,1301,36422,0,2024-01-25 09:00:00,2024-01-25 09:00:00,0.17248809519514907,39.335192862999975,39977.71214285713,-0.0008321184511535394,-0.00015942222201977525,39925.965202380925,39575.437544623404,40090.33799916391,39935.92213438326,39938.41651197896,39909.572945648455,-0.9910184283435228,-1.749556256560317,73.23188898450196,11.610816305474145,20.301925352621765,10.73141038871836,40009.93599577753,39810.70989551938,74.87040342866594,65.2458617188589,True,False,40471.34,40071.34,40071.34,40121.34,2024-01-25 13:15:00,True,2024-01-25 13:15:00,2024-01-26 12:38:03,2024-01-25 14:17:30,even,True,18.66,2054.1599999999958,,1,0,4,1
2024-01-25 10:00:00,40099.313,40156.84,40061.238,40100.906,1507,36422,0,2024-01-25 10:00:00,2024-01-25 10:00:00,51.74694047620869,49.836945880211715,40021.49740476191,-8.269419679502951e-05,1.6734704351586082e-05,39977.71214285713,39738.45411412133,40158.86143120478,40006.10565790782,39975.411893959594,40027.67971757828,11.916652890955447,4.014632273845372,81.39738055301947,36.030161334740114,37.84156621946022,20.40250670792011,40139.06618132485,39917.7932538317,89.22880185654071,89.43236927690502,True,False,40600.906,39700.906,40200.906,40250.906,,False,2024-01-26 11:45:00,2024-01-26 12:40:13,2024-01-25 15:47:21,fail,False,-74.66,1979.4999999999957,,0,1,4,1
2024-01-25 12:45:00,40047.367,40097.039,40022.988,40084.223,1076,36422,0,2024-01-25 12:00:00,2024-01-25 12:00:00,7.319869047612883,51.92122159410792,40053.97265476189,0.0008638107685306899,0.0003893130416427786,40028.81727380952,40056.43039984042,40244.07404940646,40032.542065829446,40011.10274076095,40046.14463501892,12.684614765777951,12.23730738400312,91.56119861288191,0.1325163398651057,-3.3724275885979296,-21.476627794960223,40171.25225314631,39922.53701689153,47.44903703703747,37.36758920667099,True,False,40584.223,40184.223,40184.223,40234.223,2024-01-25 13:30:00,True,2024-01-25 13:30:00,2024-01-26 12:40:13,2024-01-25 13:45:43,even,True,18.66,1998.1599999999958,,1,0,4,1
2024-01-25 20:00:00,39775.137,39937.039,39771.906,39906.34,1680,52422,0,2024-01-25 20:00:00,2024-01-25 20:00:00,-36.566607142864086,-19.39316566990601,39752.72986904763,-0.0013531408021117582,-0.0010098456413901531,39753.83533333332,39236.675036631896,39872.33890926143,39779.70090965153,39834.66104459481,39710.655078087395,-32.32830076868413,-32.4206070505702,115.0789459490577,20.070120399046573,-4.159535259721451,-8.9708937048199,39867.51165511862,39555.29850105617,56.98569303848237,40.85256908110538,True,False,40406.34,40006.34,40006.34,40056.34,2024-01-26 04:30:00,True,2024-01-26 04:30:00,2024-01-26 12:34:32,2024-01-26 08:49:32,even,True,18.66,2016.8199999999958,,2,0,4,1
2024-01-25 20:30:00,39911.691,39964.637,39677.777,39794.84,2028,52422,0,2024-01-25 20:00:00,2024-01-25 20:00:00,-36.566607142864086,-19.39316566990601,39752.72986904763,-0.0013531408021117582,-0.0010098456413901531,39753.83533333332,39236.675036631896,39872.33890926143,39799.478615786014,39837.13499708059,39744.86961128311,-26.216929240777972,-30.35529041311209,96.90002926122722,7.651223942179058,26.563309253535408,20.070120399046573,39877.18465078576,39614.054571780456,71.56784823570874,65.90012414803088,False,True,39294.84,40194.84,39694.84,39644.84,,False,,,2024-01-26 04:31:53,fail,False,-74.66,1942.1599999999958,,0,1,4,1
2024-01-25 22:00:00,39958.238,39960.938,39881.098,39920.539,1612,52422,0,2024-01-25 22:00:00,2024-01-25 22:00:00,74.56999999998516,-15.162535783725616,39816.89024999999,-0.0006394639373886277,-0.0002203857350472019,39827.299869047616,39346.192492724804,39967.728968075506,39854.558317548195,39852.46111103658,39891.78845889231,-9.46288352785632,-19.87879532454752,102.91179081615478,21.139159270715027,37.73885792916553,36.11123873407632,40032.21937649412,39752.857541290505,82.19088416090567,75.27106279313396,True,False,40420.539,40020.539,40020.539,40070.539,2024-01-26 04:30:00,True,2024-01-26 04:30:00,2024-01-26 12:34:34,2024-01-26 08:49:01,even,True,18.66,1960.8199999999958,,1,0,4,1
2024-01-26 04:00:00,39906.301,40080.473,39904.152,40035.637,1577,36422,0,2024-01-26 04:00:00,2024-01-26 04:00:00,-0.036428571424039546,-5.487803990763496,39972.8504047619,0.0009552619421524578,0.0009630128923023048,39908.23064285713,39968.47792024698,40369.94696980105,39904.71426200873,39886.7922506426,39904.58756381148,7.142760962669854,3.56387912831571,59.281211932687214,19.043935328510997,1.894755417961278,-11.917248022014974,39986.11719992061,39824.55792770235,64.84884638074749,52.63999734385743,True,False,40535.637,40135.637,40135.637,40185.637,2024-01-26 11:45:00,True,2024-01-26 11:45:00,2024-01-26 12:40:11,2024-01-26 11:57:11,even,True,18.66,1979.479999999996,,2,0,4,1
2024-01-26 08:00:00,40073.039,40117.266,40073.039,40098.137,815,36422,0,2024-01-26 08:00:00,2024-01-26 08:00:00,21.281154761920334,39.134311804351455,40058.56827380953,0.0008169571569264184,0.0005225416724797269,40077.37125000001,40073.48022379183,40390.222032700476,40082.14424952065,40036.0323928568,40109.21249810803,28.38252239965368,28.80963151610913,109.02067475654496,-15.179994496029394,-15.113522875843046,-12.860157206720032,40256.390409029365,39960.53458718669,29.823310798759035,38.389851780156754,False,True,39598.137,39998.137,39998.137,39948.137,2024-01-26 09:30:00,True,2024-01-26 09:30:00,,2024-01-26 10:08:38,even,True,18.66,1998.139999999996,,3,0,4,1
2024-01-26 09:00:00,39970.938,40000.238,39946.039,39958.137,752,36422,0,2024-01-26 09:00:00,2024-01-26 09:00:00,-18.802976190483605,35.434986039894284,40026.51777380949,0.00029439761962941435,-0.00042523481596353716,40058.56827380953,39905.60607998576,40083.34453927811,40046.33919537943,40030.12905026464,40040.49027554179,17.27654253894434,24.71757771694693,93.58684299862982,-20.993735466123326,-18.309674922580598,-13.146255933941575,40166.83251358994,39912.648037493644,8.49733839325888,17.8632470267311,False,True,39458.137,40358.137,39858.137,39808.137,,False,,,2024-01-26 11:45:17,fail,False,-74.66,1923.479999999996,,0,1,4,1
2024-01-26 20:00:00,41879.035,42131.637,41871.438,41905.438,2227,36422,0,2024-01-26 20:00:00,2024-01-26 20:00:00,102.21132142856368,463.78525945763977,41881.15242857144,0.004107162381058911,0.003441814345266383,41740.22786904761,42293.7249075681,42869.70035062951,41712.25719547628,41423.51376533106,41945.660570691434,175.57752286245523,169.63233415665832,310.3451970109699,36.68565875473723,47.84295906432817,60.40654661166627,42366.126586656246,41526.69455472662,85.13131918774259,85.0142182908262,False,True,41405.438,41805.438,41805.438,41755.438,2024-01-29 00:45:00,True,2024-01-29 00:45:00,,2024-01-29 00:57:41,even,True,18.66,1942.139999999996,,1,0,4,1
2024-01-26 22:00:00,42027.539,42215.738,41981.844,42176.137,1604,36422,0,2024-01-26 22:00:00,2024-01-26 22:00:00,131.51739285714575,532.0188251676809,42049.09838095238,0.003290050092166788,0.0028823041010142235,42012.669821428586,42307.93751373762,42898.960158798174,41967.48697434069,41713.455868744015,42126.966684898565,166.60036165797646,171.56088876723922,320.2432225468046,11.132470932287106,-8.048784657730721,6.651357069131336,42560.79503533675,41694.63833446038,76.92412603809453,76.64543411148651,False,True,41676.137,42076.137,42076.137,42026.137,2024-01-26 22:30:00,True,2024-01-26 22:30:00,2024-01-29 00:39:27,2024-01-29 03:22:51,success,True,93.31,2035.449999999996,,2,0,4,1
2024-01-26 23:00:00,41939.637,41961.738,41835.07,41891.543,1206,36422,0,2024-01-26 23:00:00,2024-01-26 23:00:00,36.42855952379614,538.9292539385715,42016.09417857141,0.0029122221761953603,0.002348161307807742,42049.09838095238,42277.129835524844,42828.7813837612,41952.620897213754,41773.62259040257,42024.67670622638,136.275495685215,156.6952720780066,249.9022613671628,-28.926696938397072,-16.985132782909204,-28.111411420737568,42362.04475907205,41685.808653380715,36.18488624827897,49.24115184814507,False,True,41391.543,41791.543,41791.543,41741.543,2024-01-29 00:45:00,True,2024-01-29 00:45:00,,2024-01-29 00:47:57,even,True,18.66,2054.109999999996,,3,0,4,1
2024-01-29 00:00:00,41933.84,41943.238,41819.684,41869.938,986,52422,0,2024-01-29 00:00:00,2024-01-29 00:00:00,-33.004202380972856,537.7421966629117,41961.85317857144,0.0013478077202072189,0.0005887982830776113,42016.09417857141,41776.398793069835,42355.84452956415,41933.98509163218,41811.65175971369,41942.39345304438,107.92612108360481,133.30192676199397,122.59859003302302,-29.41084657720785,-27.710517027902824,-20.424066047446104,42107.90154958896,41775.3853564998,24.855101667565638,28.45173103805152,False,True,41369.938,42269.938,41769.938,41719.938,,False,,,2024-01-29 03:36:56,fail,False,-74.66,1979.449999999996,,0,1,5,1
2024-01-29 07:00:00,42183.637,42251.238,42183.637,42231.039,600,36422,0,2024-01-29 07:00:00,2024-01-29 07:00:00,39.332940476204385,485.7348700446819,42205.729583333334,0.0017747156673694744,0.0022290089761901897,42206.95853571428,42364.86926908703,43013.176365833795,42222.15180486699,42138.52306158764,42298.00791950462,62.14192110273143,69.79678354586284,166.9577244056394,-15.571522531812661,-22.591623323045496,-20.656363261063234,42523.400847452234,42071.114991557006,34.38887208188396,41.175860417627995,False,True,41731.039,42131.039,42131.039,42081.039,2024-01-29 09:45:00,True,2024-01-29 09:45:00,,2024-01-29 11:24:09,even,True,18.66,1998.109999999996,,1,0,5,1
2024-01-29 08:00:00,42107.438,42173.738,42107.438,42147.438,435,36422,0,2024-01-29 08:00:00,2024-01-29 08:00:00,-1.2289523809449747,463.4164872048932,42182.60623809523,0.0013410823864719633,0.0011964067650377655,42205.729583333334,42305.07675100861,42814.05109328455,42180.41647768138,42138.21868813409,42181.675355693114,43.39690036229149,57.44749393315795,135.62299519692237,-18.649738562155108,-29.40019401437894,-35.56876229791669,42364.76639920896,41997.08431217727,7.194629619640739,12.49634677258747,False,True,41647.438,42047.438,42047.438,41997.438,2024-01-29 10:15:00,True,2024-01-29 10:15:00,,2024-01-29 10:47:20,even,True,18.66,2016.7699999999961,,2,0,5,1
2024-01-29 09:00:00,42132.34,42201.84,42132.34,42197.039,917,36422,0,2024-01-29 09:00:00,2024-01-29 09:00:00,-23.123345238105685,442.6359594847672,42132.11923809523,0.00034537144697551836,-0.00029066168564613286,42182.60623809523,42000.991416280296,42380.391981998044,42166.03513615535,42141.037909808205,42116.83523907814,31.7144496352048,43.8107883244337,88.89938175021356,-3.6632201581815025,-15.616142414859496,-22.888617819065985,42236.84940444092,41995.32107371535,15.666594384535562,12.53160837547595,False,True,41697.039,42097.039,42097.039,42047.039,2024-01-29 10:00:00,True,2024-01-29 10:00:00,,2024-01-29 10:50:30,even,True,18.66,2035.4299999999962,,3,0,5,1
2024-01-29 11:00:00,42089.039,42102.84,41916.133,42047.438,1534,36422,0,2024-01-29 11:00:00,2024-01-29 11:00:00,-39.05194047619443,389.5352652952497,42128.64798809526,-0.00038218352230136424,-0.0006928863780656122,42093.06729761903,41857.80718762841,42191.610643755914,42075.534247144264,42096.88898535523,42029.25800928793,3.2742726621509064,15.497137995960973,118.60777373262759,-5.496821465429093,0.6136050911882194,-7.908964568276133,42189.37850382698,41867.63751474888,43.15255258822034,32.139870638297054,True,False,42547.438,42147.438,42147.438,42197.438,2024-01-29 11:45:00,True,2024-01-29 11:45:00,2024-01-29 17:58:06,2024-01-29 14:39:44,even,True,18.66,2054.089999999996,,4,0,5,1
2024-01-29 12:00:00,42260.34,42302.539,42213.34,42247.637,1628,36422,0,2024-01-29 12:00:00,2024-01-29 12:00:00,35.58069047622848,380.6108094641313,42174.647428571465,-0.0003821765850042958,-0.0004200571586759874,42128.64798809526,41841.71732501134,42285.08071027377,42146.030285369525,42128.48236097025,42135.07642139665,13.565023518065573,12.107641105212194,83.16393080318817,27.341452356391528,35.46255899552489,30.799445820470282,42248.84772798095,42022.80511481234,83.81117004969492,75.7797440475989,True,False,42747.637,41847.637,42347.637,42397.637,,False,2024-01-29 18:00:00,2024-01-29 18:02:43,2024-01-29 16:31:58,fail,False,-74.66,1979.429999999996,,0,1,5,1
2024-01-29 23:00:00,43102.926,43130.039,43013.887,43129.039,1298,36422,0,2024-01-29 23:00:00,2024-01-29 23:00:00,102.88720238094538,413.48773460703524,43174.7790595238,0.004602410311530449,0.0005834894637895389,43133.82804761901,43746.804519802936,43499.34146294934,43019.99839910203,42845.765278830986,43042.90620846231,109.81145095470129,111.7625770261576,352.1181319862503,28.573840385237418,5.348316477473418,-29.070805297538755,43519.76568664375,42567.54673028087,77.94365293029603,61.913108837952954,False,True,42629.039,43529.039,43029.039,42979.039,,False,2024-01-31 01:30:00,2024-01-31 04:23:29,2024-01-30 03:34:00,fail,False,-74.66,1904.769999999996,,0,2,5,1
2024-01-30 00:00:00,43130.238,43165.539,43095.582,43100.039,903,56422,0,2024-01-30 00:00:00,2024-01-30 00:00:00,40.95101190478454,423.0274410988641,43107.0428809524,0.004002707279184267,-5.6017606476196306e-05,43174.7790595238,43668.3770187026,43256.293357045135,43073.42826502057,42921.13544338385,43126.82906879946,101.86061341773893,107.74867077014204,128.97469954148534,8.558801513594517,25.118703130348877,25.756095287302742,43302.444913180465,42952.713224418454,78.51334906290656,81.90808320224748,False,True,42600.039,43500.039,43000.039,42950.039,,False,2024-01-31 01:30:00,2024-01-31 11:59:51,2024-01-30 03:33:57,fail,False,-74.66,1830.1099999999958,,0,3,5,1
2024-01-30 01:00:00,43058.559,43100.039,43028.52,43049.711,1312,56422,0,2024-01-30 01:00:00,2024-01-30 01:00:00,-67.7361785713947,418.3909326112771,43139.54764285716,0.0018440999865145043,0.00013715855484166636,43107.0428809524,43321.111484019304,43343.16158407712,43076.67167984896,42964.00086377945,43118.875597867234,85.25411854633421,97.94609294035894,64.51318270650205,-16.29195459233597,-7.626111799108912,11.136265221852227,43205.96839452101,43030.282801213456,47.17198786310206,55.37950848975283,False,True,42549.711,43449.711,42949.711,42899.711,,False,2024-01-31 01:30:00,2024-01-31 12:46:29,2024-01-30 03:22:56,fail,False,-74.66,1755.4499999999957,,0,4,5,1
2024-01-30 02:00:00,43262.539,43281.238,43093.328,43152.938,1551,36422,0,2024-01-30 02:00:00,2024-01-30 02:00:00,32.50476190475456,426.7092244502128,43165.16550000002,0.0008425889947419925,0.0001677518537641068,43139.54764285716,43198.62482107172,43355.31053815328,43128.251875517955,43021.16568880054,43168.7970240798,79.16129355881276,87.73956503996276,81.55302409094939,8.42332645336137,26.400684210551844,23.690012383900466,43280.393606602585,43058.70044155702,67.91213875459432,62.0723095173985,False,True,42652.938,43552.938,43052.938,43002.938,,False,2024-01-31 01:30:00,2024-01-31 01:46:35,2024-01-30 04:37:44,fail,False,-74.66,1680.7899999999956,,0,5,5,1
2024-01-30 02:15:00,43152.938,43249.137,43146.738,43249.137,862,36422,0,2024-01-30 02:00:00,2024-01-30 02:00:00,32.50476190475456,426.7092244502128,43165.16550000002,0.0008425889947419925,0.0001677518537641068,43139.54764285716,43198.62482107172,43355.31053815328,43146.849586976736,43038.05245259309,43183.42015170282,78.91202593786875,85.97405721954397,88.23258808802456,14.623127623017353,8.42332645336137,26.400684210551844,43304.034145621656,43064.30615778398,68.96194940775861,67.9884165150318,True,False,43749.137,43349.137,43349.137,43399.137,2024-01-30 03:30:00,True,2024-01-30 03:30:00,2024-01-30 04:40:41,2024-01-30 07:27:26,success,True,93.31,1774.0999999999956,,1,0,5,1
2024-01-30 03:00:00,43127.262,43396.539,43114.039,43339.84,932,36422,0,2024-01-30 03:00:00,2024-01-30 03:00:00,25.617857142860885,417.05991777758754,43256.17583333335,0.00098782226463628,0.0014929771898040754,43165.16550000002,43270.69288049377,43782.92632395561,43173.72101423124,43073.2765631137,43201.6556357069,73.2774322194382,79.67689618376137,88.06552750150435,32.79998039211932,-12.18505159956112,-2.3794447884793044,43322.04409783393,43082.767173579865,52.5867269534338,52.02866206364107,True,False,43839.84,43439.84,43439.84,43489.84,2024-01-30 04:15:00,True,2024-01-30 04:15:00,2024-01-30 14:23:36,2024-01-30 05:28:43,even,True,18.66,1792.7599999999957,,2,0,5,1
2024-01-30 07:00:00,43396.645,43417.738,43365.426,43394.539,830,36422,0,2024-01-30 07:00:00,2024-01-30 07:00:00,15.593500000031781,431.61229258372623,43442.26844047619,0.0011080930796108608,0.0017623006763682236,43456.19010714288,43482.320353376526,44286.34981294784,43429.68958202879,43349.81919070366,43485.87432266939,65.10051285216468,77.92568441829559,167.9385708011208,-33.59044341248955,-22.69783453729906,-29.61706398348906,43712.59139325091,43257.657252087876,15.889793703128118,29.54910292341742,False,True,42894.539,43794.539,43294.539,43244.539,,False,2024-01-30 15:15:00,2024-01-31 01:28:45,2024-01-30 14:23:35,fail,False,-74.66,1718.0999999999956,,0,1,5,1
2024-01-30 08:00:00,43333.938,43353.238,43316.738,43345.137,785,36422,0,2024-01-30 08:00:00,2024-01-30 08:00:00,-13.921666666690726,412.64702817630314,43396.625392857175,0.000640161297843633,-0.0002874080478482392,43442.26844047619,43323.546692542965,43671.659782486895,43391.55718821062,43350.49215643997,43358.95995528034,45.80339498211106,62.33279741617294,133.57087821092685,-26.759497420032858,-27.842309597508574,-26.4439652562869,43539.280640865094,43177.13926969559,9.46938471522334,8.742556161629459,False,True,42845.137,43745.137,43245.137,43195.137,,False,2024-01-30 15:30:00,2024-01-31 01:30:01,2024-01-30 14:23:35,fail,False,-74.66,1643.4399999999955,,0,2,5,1
2024-01-30 11:00:00,43396.738,43409.938,43361.84,43388.637,949,36422,0,2024-01-30 11:00:00,2024-01-30 11:00:00,-26.431369047619228,356.919733652001,43309.8477142857,-0.0008275879183956146,-0.0011232907596875343,43345.85075,42983.21967087675,43246.25677216058,43368.24578244891,43354.252924788954,43360.605599243216,18.93038330568379,24.838708265546476,65.47442313704462,8.794200550401001,12.904969384268043,16.065238046081504,43450.49607047823,43272.2151280082,81.9230858376812,79.5594833631727,True,False,43888.637,43488.637,43488.637,43538.637,2024-01-30 14:15:00,True,2024-01-30 14:15:00,,2024-01-30 14:29:32,even,True,18.66,1662.0999999999956,,1,0,5,1
2024-01-30 12:00:00,43293.84,43313.34,43259.879,43293.07,532,36422,0,2024-01-30 12:00:00,2024-01-30 12:00:00,-36.00303571429686,333.5230720306208,43356.26291666668,-0.00045326873996192984,-0.0005827691722487701,43309.8477142857,43071.66949506728,43384.47378730773,43346.78352588615,43347.14744273717,43354.044694530465,10.70222327735246,18.403900023031348,48.708628334402825,-7.83244857237878,-10.421937048500695,6.762437908480933,43419.80134278191,43286.78804627902,54.86342934688388,65.48254874614936,True,False,43793.07,43393.07,43393.07,43443.07,2024-01-30 13:00:00,True,2024-01-30 13:00:00,2024-01-30 14:23:35,2024-01-30 13:08:43,even,True,18.66,1680.7599999999957,,2,0,5,1
2024-01-30 13:00:00,43445.605,43494.539,43384.84,43402.84,1275,36422,0,2024-01-30 13:00:00,2024-01-30 13:00:00,46.41520238098019,323.52469529557857,43412.94055952378,-0.00025779232065641056,-2.14435770294758e-05,43356.26291666668,43108.332528934174,43525.86955695608,43376.14035560726,43362.54422054228,43385.36886584109,13.02467409001838,14.637402916081587,41.96503499289317,2.0216522187838564,15.970779153758485,12.731930856571125,43443.5216630815,43328.71606860068,83.15290109784361,77.69963504449466,True,False,43902.84,43502.84,43502.84,43552.84,2024-01-30 14:15:00,True,2024-01-30 14:15:00,,2024-01-30 14:29:29,even,True,18.66,1699.4199999999958,,3,0,5,1
2024-01-30 21:00:00,43343.238,43383.84,43302.184,43348.539,1250,36422,0,2024-01-30 21:00:00,2024-01-30 21:00:00,-12.378142857189232,197.57573817573575,43422.45480952382,0.0009381784247750707,-0.0010662191641504963,43364.64392857142,43426.88263476007,43369.84935829995,43358.53433816336,43358.69669336849,43341.788328173396,0.801405940677796,1.4977794296842173,96.34087324530107,-5.242985896104074,-9.019983488113212,-9.89768799450394,43471.84850705455,43210.22814929224,47.177879140515046,45.307147944906056,True,False,43848.539,43448.539,43448.539,43498.539,2024-01-30 22:00:00,True,2024-01-30 22:00:00,,2024-01-30 22:01:25,even,True,18.66,1718.0799999999958,,4,0,5,1
2024-01-30 22:00:00,43509.738,43547.738,43437.961,43452.938,1157,36422,0,2024-01-30 22:00:00,2024-01-30 22:00:00,57.81088095239829,195.1481634220254,43466.38332142857,0.0009698561109582724,0.0006266997286383329,43422.45480952382,43481.10133332288,43832.87106265322,43396.66848118237,43378.49617343236,43414.751700722365,7.578234963271825,3.4709956343088892,81.1160540054927,25.8160395596351,35.20103715172445,2.12484348124417,43525.75837362978,43305.24502781495,65.09842988836895,58.887640242283474,True,False,43952.938,43552.938,43552.938,43602.938,2024-01-30 22:30:00,True,2024-01-30 22:30:00,,2024-01-30 22:40:30,even,True,18.66,1736.739999999996,,5,0,5,1
2024-01-30 22:15:00,43452.938,43681.637,43452.938,43650.539,1386,36422,0,2024-01-30 22:00:00,2024-01-30 22:00:00,57.81088095239829,195.1481634220254,43466.38332142857,0.0009698561109582724,0.0006266997286383329,43422.45480952382,43481.10133332288,43832.87106265322,43435.7254840774,43398.64749391885,43464.26739697282,14.694046611919475,5.715605829831007,84.54507811193355,49.51569625045522,25.8160395596351,35.20103715172445,43579.90325242393,43350.13154152171,80.06412090113864,69.1022579869167,True,False,44150.539,43250.539,43750.539,43800.539,,False,,,2024-01-31 01:04:48,fail,False,-74.66,1662.0799999999958,,0,1,5,1
2024-01-30 23:15:00,43512.34,43601.738,43486.539,43601.738,1016,56422,0,2024-01-30 23:00:00,2024-01-30 23:00:00,43.92851190474903,192.31453461587807,43482.44483333332,0.0009697545832304425,0.0006266613401469689,43466.38332142857,43523.24268233237,43860.288735188944,43499.8076430229,43443.57917608925,43555.13785689714,25.134397953326697,15.787403991869253,108.82116308351561,35.45233952529088,8.478728242160287,8.172612659094739,43703.54642705989,43408.22928673439,61.7541474619887,67.98118890770112,True,False,44101.738,43201.738,43701.738,43751.738,,False,,,2024-01-31 01:10:44,fail,False,-74.66,1587.4199999999958,,0,2,5,1
2024-01-31 00:00:00,43502.238,43520.238,43425.09,43471.738,805,54133,0,2024-01-31 00:00:00,2024-01-31 00:00:00,16.06151190475066,187.2964888604547,43429.903642857134,0.0003779574094879129,0.0006266651665433463,43482.44483333332,43337.950414485735,43887.70806828214,43498.71681331974,43454.85221665369,43565.4344864121,22.991716995762545,19.801131797050235,109.40613766337647,-11.12382490537857,7.865591675203177,13.554862745135324,43713.13277225766,43416.23620056654,47.99516731169053,56.077073239487106,False,True,42971.738,43371.738,43371.738,43321.738,2024-01-31 01:00:00,True,2024-01-31 01:00:00,2024-01-31 01:28:43,2024-01-31 17:39:46,success,True,93.31,1680.7299999999957,,1,0,5,1
2024-01-31 01:00:00,43275.84,43306.438,43141.84,43146.238,1200,56422,0,2024-01-31 01:00:00,2024-01-31 01:00:00,-52.541190476185875,162.27685199952975,43246.69688095242,-0.0017744127848043226,0.00024100669904629675,43429.903642857134,42371.04590021612,43802.15788188541,43401.22277286559,43416.52245072989,43420.21310216719,1.9578425088329823,14.663492923532278,117.39058877539352,-64.29427966977528,-48.97610767113656,-17.857604403157893,43578.69039701397,43260.23580732041,7.455757955382353,18.50125863484204,False,True,42646.238,43046.238,43046.238,42996.238,2024-01-31 01:30:00,True,2024-01-31 01:30:00,2024-01-31 04:23:29,2024-01-31 02:02:06,even,True,18.66,1699.3899999999958,,2,0,5,1
2024-01-31 05:00:00,42845.91,42897.637,42823.879,42893.637,1265,36422,0,2024-01-31 05:00:00,2024-01-31 05:00:00,-104.7959523809186,-4.76146011572564,42799.402416666715,-0.0019508317367402028,-0.0026309641331650232,42832.72182142859,42014.21594611248,42551.10658976461,42857.06965423749,42996.47976812671,42744.52948056416,-78.954519484505,-74.74327613721888,311.6688186811688,45.18097626420058,28.326143790851347,0.1394977639793069,43166.782385783736,42323.776575344586,43.11480547826593,30.648549537412833,True,False,43393.637,42493.637,42993.637,43043.637,,False,2024-01-31 17:45:00,2024-01-31 17:42:32,2024-01-31 12:49:46,fail,False,-74.66,1624.7299999999957,,0,1,5,1
2024-01-31 06:00:00,42896.547,42964.84,42863.039,42948.34,733,36422,0,2024-01-31 06:00:00,2024-01-31 06:00:00,-33.319404761874466,-22.45435909806838,42815.660773809526,-0.00017927832271137938,-0.002252882707983951,42799.402416666715,42580.968263916686,42610.82286603001,42891.12764229862,42977.840249180044,42852.69966632267,-61.16242860856437,-69.92136762302913,224.4710550720784,10.042928448565362,11.646922944637481,42.93696078431822,43157.235590669974,42549.66374197536,83.00735070875315,74.77777351533702,True,False,43448.34,42548.34,43048.34,43098.34,,False,2024-01-31 17:45:00,2024-01-31 18:05:28,2024-01-31 12:46:29,fail,False,-74.66,1550.0699999999956,,0,2,5,1
2024-01-31 07:00:00,42934.738,42989.938,42930.473,42944.438,823,36422,0,2024-01-31 07:00:00,2024-01-31 07:00:00,16.258357142811292,-33.396198937814916,42870.44047619047,-0.00017927113025568558,-0.0016865923545096742,42815.660773809526,42573.328835005275,42750.97781855421,42907.75774990001,42963.48470713392,42933.11696078433,-47.36328209038038,-59.25244681119007,99.16312528259117,19.390068799475557,27.541330581341754,20.133546611650672,43068.48717991583,42799.24674165284,86.79523669038603,85.98087008755323,True,False,43444.438,42544.438,43044.438,43094.438,,False,2024-01-31 17:45:00,2024-01-31 18:05:27,2024-01-31 12:46:37,fail,False,-74.66,1475.4099999999955,,0,3,5,1
2024-01-31 08:00:00,42946.738,42989.738,42944.164,42958.938,556,36422,0,2024-01-31 08:00:00,2024-01-31 08:00:00,54.77970238094713,-40.51135893832543,42922.89579761903,0.0010082478690586507,-0.0009104202002943043,42870.44047619047,42954.5633287106,42887.80000511834,42926.883091498414,42958.69148622743,42977.98183763329,-34.59806895885413,-47.1102038932852,83.34975335947668,6.974049535601807,5.307123839040287,20.857136566832196,43092.00400466858,42865.459670598,83.70359342040427,83.82656209496108,True,False,43458.938,42558.938,43058.938,43108.938,,False,2024-01-31 17:45:00,2024-01-31 18:05:28,2024-01-31 12:46:06,fail,False,-74.66,1400.7499999999955,,0,4,5,1
2024-01-31 09:00:00,42938.711,42951.738,42907.637,42930.539,374,36422,0,2024-01-31 09:00:00,2024-01-31 09:00:00,52.45532142855518,-46.15863974855165,42965.93441666671,0.0013196927255303722,-6.705563046048653e-05,42922.89579761903,43114.14962567773,43040.93143096032,42935.83140452464,42955.65455127021,42957.25738527694,-25.539504577645857,-35.55697678469407,83.11750307367805,-13.926952528338006,-4.752515995896829,-11.828679738573555,43069.466014426405,42843.54875612748,49.003069053708224,60.11155290294596,True,False,43430.539,42530.539,43030.539,43080.539,,False,2024-01-31 17:45:00,2024-01-31 17:42:45,2024-01-31 12:49:11,fail,False,-74.66,1326.0899999999954,,0,5,5,1
2024-01-31 10:00:00,43009.262,43057.023,42911.84,42915.938,1190,36422,0,2024-01-31 10:00:00,2024-01-31 10:00:00,43.03861904767837,-44.20974990187824,42979.096142857175,0.0010893713300733929,0.0003196651906336146,42965.93441666671,43075.0671872578,43115.853081170004,42952.890410197295,42960.10816327291,42970.424980736156,-16.66128280515113,-25.514646995880117,74.281177237766,-6.0013123494936735,10.98509219125117,11.209230134190875,43070.70457000714,42868.64539146517,65.8130063163854,69.69086358381797,False,True,42415.938,42815.938,42815.938,42765.938,2024-01-31 11:30:00,True,2024-01-31 11:30:00,2024-01-31 12:57:02,2024-01-31 11:34:01,even,True,18.66,1344.7499999999955,,1,0,5,1
2024-01-31 11:00:00,42943.438,42943.438,42784.82,42807.438,1292,36422,0,2024-01-31 11:00:00,2024-01-31 11:00:00,13.161726190468471,-47.53189318551449,42859.93801190477,-0.00013811266116474174,0.0001278239154059313,42979.096142857175,42561.13665046451,43082.720031211735,42927.16593073416,42945.594653379165,42930.63725593394,-17.208197382969956,-19.626692001496405,42.75889458137705,-30.586733746167738,-3.642722050230077,-5.216685586507083,42988.3617636188,42871.41274824909,25.189363002890843,32.80621807594836,False,True,42307.438,42707.438,42707.438,42657.438,2024-01-31 12:00:00,True,2024-01-31 12:00:00,2024-01-31 23:25:49,2024-01-31 12:25:55,even,True,18.66,1363.4099999999955,,2,0,5,1
2024-01-31 15:00:00,42597.34,42597.34,42495.137,42514.137,970,36422,0,2024-01-31 15:00:00,2024-01-31 15:00:00,-46.68641666666372,-137.597290172278,42597.002702380945,-0.002331283461649083,-0.0007369930939683509,42564.30061904762,41699.643129453005,42782.472780757686,42602.75762214584,42691.27310084946,42508.08818885449,-53.85256923009001,-52.991937108244926,193.0249307201638,-1.4774138287102687,12.468024767833413,11.053409012696648,42768.67184532671,42246.00453238227,47.53953427725694,49.93955736124074,True,False,43014.137,42614.137,42614.137,42664.137,2024-01-31 16:00:00,True,2024-01-31 16:00:00,2024-01-31 17:30:22,2024-01-31 16:06:30,even,True,18.66,1382.0699999999956,,3,0,5,1
2024-01-31 21:00:00,43467.871,43527.039,43352.746,43354.938,2734,36422,0,2024-01-31 21:00:00,2024-01-31 21:00:00,86.96238095239823,73.10768685838411,43508.30972619047,0.0022083288139742234,0.0032768195018338508,43510.501607142876,43353.99226400571,44548.59681071889,43427.1140551143,43245.24210164315,43622.17956690748,99.17478731943265,91.37164331277731,391.5792515639773,-45.92391503267572,-24.132680770555453,-14.703919848652731,44150.81155651885,43092.04757729611,55.21362407397421,72.60656538439027,False,True,42854.938,43254.938,43254.938,43204.938,2024-01-31 21:30:00,True,2024-01-31 21:30:00,2024-01-31 22:05:38,2024-01-31 21:36:11,even,True,18.66,1400.7299999999957,,4,0,5,1
2024-01-31 21:30:00,43136.637,43403.996,43004.137,43358.453,3729,36422,0,2024-01-31 21:00:00,2024-01-31 21:00:00,86.96238095239823,73.10768685838411,43508.30972619047,0.0022083288139742234,0.0032768195018338508,43510.501607142876,43353.99226400571,44548.59681071889,43377.65715188657,43245.61011732094,43474.755047471626,83.13187952688895,89.0582223690277,340.18993303553367,-53.35961403508554,-94.06490540076629,-45.92391503267572,43934.011457069595,43013.99863787366,25.922711211693485,37.57395572328188,True,False,43858.453,42958.453,43458.453,43508.453,,False,,,2024-01-31 22:05:29,fail,False,-74.66,1326.0699999999956,,0,1,5,1
2024-01-31 22:00:00,43294.648,43330.637,42683.84,42869.84,4294,36422,0,2024-01-31 22:00:00,2024-01-31 22:00:00,-2.191880952406791,80.26446128249518,43203.90264285713,-6.53725061240608e-06,0.002482573562852447,43508.30972619047,42485.32432012341,44457.77144684831,43288.6889312324,43221.1193872779,43298.65283660133,59.805161328135,81.33064657420975,312.925469427512,-113.20863192292018,-62.89357894737623,-53.35961403508554,43721.102220328474,42874.703452874186,35.6677738625271,31.16018187665904,False,True,42369.84,42769.84,42769.84,42719.84,2024-01-31 23:00:00,True,2024-01-31 23:00:00,2024-01-31 23:24:48,2024-02-01 17:05:30,success,True,93.31,1419.3799999999956,,1,0,5,1
2024-02-01 06:00:00,41971.938,42017.84,41942.84,41992.438,1479,36422,0,2024-02-01 06:00:00,2024-02-01 06:00:00,-50.741380952364125,-230.6602664252714,42044.5772142857,-0.002286045389380891,-0.002615782747031922,42107.01641666669,41217.68174095362,41811.72994315136,42096.59284648474,42280.38700451642,41938.39618747852,-111.8465331298139,-109.99286247244298,251.47666075800666,-4.916453388352238,-15.254094255244127,-10.74443137254275,42277.88967950182,41597.40269545521,24.85731366835509,24.787874157194192,True,False,42492.438,42092.438,42092.438,42142.438,2024-02-01 08:15:00,True,2024-02-01 08:15:00,2024-02-01 16:39:19,2024-02-01 09:06:52,even,True,18.66,1438.0399999999956,,2,0,5,2
2024-02-01 07:00:00,42044.242,42142.688,41993.977,42119.039,1182,36422,0,2024-02-01 07:00:00,2024-02-01 07:00:00,-62.43920238098508,-248.60708682147379,42018.06891666669,-0.0012286530371566822,-0.002262395320725923,42044.5772142857,41457.05165976414,41830.00819473358,42081.73738403358,42222.736163493646,42013.960569315466,-97.00810212327633,-105.67705077340018,229.14038373354836,28.69638458890404,17.94536394910392,23.83430925353605,42324.800087355754,41704.62105127518,67.74806375168755,50.19289813956718,True,False,42619.039,42219.039,42219.039,42269.039,2024-02-01 16:30:00,True,2024-02-01 16:30:00,2024-02-01 17:02:31,,success,True,93.31,1531.3499999999956,,3,0,5,2
2024-02-01 08:00:00,42133.738,42195.219,42104.043,42169.84,1318,36422,0,2024-02-01 08:00:00,2024-02-01 08:00:00,-26.50829761900968,-252.9604180512979,42052.25189285717,8.864820779991194e-05,-0.0017648316629453832,42018.06891666669,41880.402157966586,41936.29237338518,42095.02533929609,42191.15963165187,42086.160213278315,-77.8064756789463,-93.53907134383215,162.71301414898727,18.397404196759453,10.35754970767448,19.84662332294829,42307.32278237945,41866.49764417718,81.16345593372122,72.56024716318342,True,False,42669.84,42269.84,42269.84,42319.84,2024-02-01 16:30:00,True,2024-02-01 16:30:00,2024-02-01 17:04:33,,success,True,93.31,1624.6599999999955,,4,0,5,2
2024-02-01 09:00:00,42161.281,42164.938,42091.84,42148.137,585,36422,0,2024-02-01 09:00:00,2024-02-01 09:00:00,34.182976190480986,-250.4810802051361,42102.2278690476,8.862891667714499e-05,-0.0012890791564810402,42052.25189285717,41884.10699830582,42074.91435082232,42126.80294564735,42183.02295091273,42144.793798417646,-57.25389849131898,-75.51388344572379,74.43262837271953,14.911742346113897,17.73532026142493,20.73004196761758,42246.77784672082,42044.30975011447,87.82158086875302,88.15541524159228,True,False,42648.137,42248.137,42248.137,42298.137,2024-02-01 16:30:00,True,2024-02-01 16:30:00,2024-02-01 17:03:55,,success,True,93.31,1717.9699999999955,,5,0,5,2
2024-02-01 10:00:00,42164.039,42211.137,42097.09,42100.238,906,36422,0,2024-02-01 10:00:00,2024-02-01 10:00:00,49.9759761904279,-245.96329607831285,42178.31228571427,0.0011239775163621327,-0.0006916614838709751,42102.2278690476,42220.392818879845,42137.67384056224,42147.96559718577,42180.86557276967,42198.20881768145,-41.44112039400352,-57.171011859482675,69.1929072648322,-4.647116615065897,3.093749913961801,28.745350189208693,42291.619242488974,42103.29839287393,69.09199392125474,83.05770978571087,True,False,42600.238,42200.238,42200.238,42250.238,2024-02-01 16:30:00,True,2024-02-01 16:30:00,2024-02-01 16:59:26,,success,True,93.31,1811.2799999999954,,6,0,5,2
2024-02-01 11:00:00,42214.617,42241.34,42093.875,42159.84,1068,36422,0,2024-02-01 11:00:00,2024-02-01 11:00:00,76.08441666667204,-235.328903431051,42165.349345238115,0.0011208714813959902,0.0005919470733084728,42178.31228571427,42266.73968331884,42415.49058381529,42163.710775967105,42180.49803515941,42198.07753491572,-29.236908397746447,-42.81044846666666,76.17547056675,-3.7793040935794124,6.321235638140934,5.681110423072823,42300.91442018083,42093.74064965061,66.07453380004345,62.31479165148563,True,False,42659.84,42259.84,42259.84,42309.84,2024-02-01 16:30:00,True,2024-02-01 16:30:00,2024-02-01 17:04:32,,success,True,93.31,1904.5899999999954,,7,0,5,2
2024-02-01 12:00:00,42117.688,42189.238,42081.84,42189.238,667,36422,0,2024-02-01 12:00:00,2024-02-01 12:00:00,-12.96294047615811,-231.901787785122,42192.22010714286,0.0008864270896665744,0.000635891524817493,42165.349345238115,42218.53149763687,42453.05302229629,42164.29160634902,42176.40519256539,42173.1500994152,-22.08130850444286,-31.786625333832514,67.07855412532534,-3.367259373939305,-18.16290161680081,-2.080059855514264,42263.70614748439,42081.094051346015,36.83156669719231,39.32714273926285,False,True,41689.238,42089.238,42089.238,42039.238,2024-02-01 15:15:00,True,2024-02-01 15:15:00,,2024-02-01 15:22:06,even,True,18.66,1923.2499999999955,,8,0,5,2
2024-02-01 23:00:00,42970.238,43139.137,42917.125,43081.84,1851,36422,0,2024-02-01 23:00:00,2024-02-01 23:00:00,48.653976190478716,75.31532919948222,43045.56541666667,0.0021562380479686165,0.001672490117858998,43007.470773809524,43130.81286093462,43691.66632870408,42972.3458291185,42821.57629298471,43047.116121431056,91.31548895507149,89.15608191875425,197.0262108329299,-3.725592019240139,-17.8841592707613,13.859888200902788,43313.101506055515,42779.6307368066,56.80682737026515,60.337037005649684,False,True,42581.84,42981.84,42981.84,42931.84,2024-02-02 00:30:00,True,2024-02-02 00:30:00,2024-02-02 15:50:47,2024-02-02 01:32:59,even,True,18.66,1941.9099999999955,,9,0,5,2
2024-02-02 01:00:00,42883.723,42926.438,42842.039,42892.137,885,56422,0,2024-02-02 01:00:00,2024-02-02 01:00:00,-13.489083333355666,107.81600296161923,43040.76567857142,0.0017127398015995227,0.00036694899062532095,43032.076333333316,43112.2147904723,43388.48762293321,42948.96732476024,42882.81069157298,42979.4308469212,58.886272127128905,74.81449333974217,101.13674673684666,-31.957610251127335,-24.090817681477347,-29.94070381835627,43115.96545501594,42841.396238826455,14.006615207610132,21.35064365869145,False,True,42392.137,43292.137,42792.137,42742.137,,False,2024-02-02 16:00:00,2024-02-05 00:39:36,2024-02-02 02:19:44,fail,False,-74.66,1867.2499999999955,,0,1,5,2
2024-02-02 02:00:00,43054.34,43145.738,43006.805,43134.238,1497,36422,0,2024-02-02 02:00:00,2024-02-02 02:00:00,8.689345238104579,124.55558265874424,43063.48211904763,0.0009596388355610258,0.000647541614559523,43040.76567857142,43034.837074407485,43509.950726456285,42996.189386219485,42924.04102008256,42966.49786102512,55.892137055066996,63.01547290919446,105.26215678258144,20.430510491925816,0.18269315449288115,-7.590672170648759,43110.101772681606,42824.393949368634,67.83106046295694,48.089450883427524,True,False,43634.238,42734.238,43234.238,43284.238,,False,2024-02-02 18:15:00,,2024-02-02 15:45:47,fail,False,-74.66,1792.5899999999954,,0,2,5,2
2024-02-02 07:00:00,42932.539,42951.738,42911.84,42949.84,471,36422,0,2024-02-02 07:00:00,2024-02-02 07:00:00,-40.99830952384946,139.19002927413385,43034.44051190476,0.0002812854777370619,-0.0013690272647706712,43013.264047619035,42956.54357451479,42894.18262959446,42996.77407295375,43005.69833612957,42938.73235810112,11.338879984832602,24.617409475523075,97.3633884023776,-10.621084279337083,-11.303980048163794,-20.405575851385947,43070.17293244433,42805.791783757915,9.532372002315517,9.863998861758356,False,True,42449.84,42849.84,42849.84,42799.84,2024-02-02 16:00:00,True,2024-02-02 16:00:00,2024-02-05 00:39:34,2024-02-02 16:47:34,even,True,18.66,1811.2499999999955,,1,0,5,2
2024-02-02 08:00:00,43072.227,43135.539,43052.539,43078.438,914,36422,0,2024-02-02 08:00:00,2024-02-02 08:00:00,21.17646428572334,140.81267913907504,43048.831297619065,0.00027296246796116566,-0.0006347592371717247,43034.44051190476,42967.00080177417,43140.695051602976,43013.78054270214,43011.22809382153,42981.67703887165,10.548612819140544,15.568606646036478,90.80025184885078,19.957805641533923,24.608621947023494,7.933787409710931,43105.757378867595,42859.0966988757,62.94438747748882,42.96746779470192,True,False,43578.438,42678.438,43178.438,43228.438,,False,2024-02-02 18:15:00,,2024-02-02 15:46:16,fail,False,-74.66,1736.5899999999954,,0,1,5,2
2024-02-05 00:00:00,42731.379,42781.137,42722.953,42766.34,542,56422,0,2024-02-05 00:00:00,2024-02-05 00:00:00,-34.70072619042912,40.99611724427086,42783.643035714296,-0.0018758222970434568,-0.002029098490660736,42967.12264285716,41864.71283708476,42615.429600690026,42942.14658048084,42969.84204393237,42953.942347781245,-12.419731837093423,-7.510203691027169,133.19711327050018,-33.531776401767274,21.083697970432695,19.952119023037085,43133.75845069642,42772.62624486607,48.320081074825424,65.71508732771075,False,True,42266.34,42666.34,42666.34,42616.34,2024-02-05 00:30:00,True,2024-02-05 00:30:00,2024-02-05 00:39:38,2024-02-05 05:52:38,success,True,93.31,1829.8999999999953,,1,0,6,2
2024-02-05 02:00:00,42548.254,42561.637,42533.773,42550.438,581,36422,0,2024-02-05 02:00:00,2024-02-05 02:00:00,-98.99628571434732,-26.417942362131726,42544.83314285716,-0.003354933073696229,-0.0016369840217921917,42684.64674999995,41360.36932532967,42554.68709791918,42649.91144342392,42774.58789951306,42498.560590987276,-59.76518168472103,-43.98351599905512,198.204289568608,-31.17674200208421,-37.13406501544523,-49.93503887172119,42766.13638190489,42229.48480006966,44.266420627362514,44.76334514968437,True,False,43050.438,42650.438,42650.438,42700.438,2024-02-05 06:30:00,True,2024-02-05 06:30:00,2024-02-05 09:39:35,2024-02-05 07:07:10,even,True,18.66,1848.5599999999954,,2,0,6,2
2024-02-05 05:00:00,42414.887,42520.738,42411.039,42504.238,941,36422,0,2024-02-05 05:00:00,2024-02-05 05:00:00,-72.62001190480078,-102.31657812570484,42470.14634523809,0.00028482715783142304,-0.0012447178362721507,42404.43039285712,42256.30102398893,42506.44535655143,42458.458898557605,42562.33168890817,42396.84097076024,-66.90494652150664,-70.19808858076624,210.82188732793236,8.238557619544736,1.7734554523412953,12.391295837631333,42682.95051865295,42112.23142286753,60.38553149805394,52.955586831421385,True,False,43004.238,42604.238,42604.238,42654.238,2024-02-05 06:00:00,True,2024-02-05 06:00:00,2024-02-05 09:36:51,2024-02-05 17:55:55,success,True,93.31,1941.8699999999953,,3,0,6,2
2024-02-05 06:00:00,42686.871,42695.039,42634.27,42650.84,949,36422,0,2024-02-05 06:00:00,2024-02-05 06:00:00,65.71595238097507,-94.02134547938476,42548.85228571432,0.0005135700751147648,-0.000744097371063041,42470.14634523809,42361.90760841203,42681.10491621634,42536.10178648443,42575.69747586233,42536.435846921246,-41.70184980484919,-58.36590431987105,114.4214393747715,39.24404540767864,52.7636006191824,26.949753353932465,42692.404790077184,42381.96690376531,91.90415624438742,88.53981162621342,True,False,43150.84,42750.84,42750.84,42800.84,2024-02-05 09:30:00,True,2024-02-05 09:30:00,2024-02-05 10:02:50,2024-02-05 17:20:10,success,True,93.31,2035.1799999999953,,4,0,6,2
2024-02-05 15:30:00,43355.461,43554.078,43347.672,43425.539,2061,36422,0,2024-02-05 15:00:00,2024-02-05 15:00:00,57.957119047641754,72.64096473989048,43269.1838571429,0.0016401336205887629,0.001551500005113798,43171.86189285717,43417.75017780555,43803.19855297864,43211.575196133825,43091.653050182635,43286.38860233919,67.1502227224264,59.29280423677254,119.814949857495,42.286398004849616,39.61070347434725,16.281222910220094,43449.638784646806,43124.63842003157,80.26035586394134,82.17468703841371,True,False,43925.539,43025.539,43525.539,43575.539,,False,,,2024-02-05 17:02:46,fail,False,-74.66,1960.5199999999952,,0,1,6,2
2024-02-05 16:00:00,43415.414,43467.738,43341.84,43341.84,1377,36422,0,2024-02-05 16:00:00,2024-02-05 16:00:00,97.32196428573661,103.18809988952125,43247.48716666667,0.0011857939398862852,0.0015544537146570832,43269.1838571429,43301.35451961476,43872.067016870424,43258.15116409581,43132.39124329787,43330.7560474716,70.94574987566739,63.431062532610085,139.48538938184464,10.756134502909845,33.61131062950153,42.286398004849616,43520.56132313709,43142.450771806114,68.43112001337919,75.22797467839294,False,True,42841.84,43241.84,43241.84,43191.84,2024-02-05 17:00:00,True,2024-02-05 17:00:00,2024-02-05 17:19:19,2024-02-06 17:31:19,success,True,93.31,2053.8299999999954,,1,0,6,2
2024-02-05 17:00:00,43156.383,43158.238,42955.309,43004.34,2980,36422,0,2024-02-05 17:00:00,2024-02-05 17:00:00,-21.696690476230287,105.6210166034507,43056.620797619085,-0.0013063035664948903,0.001776547131402886,43247.48716666667,42361.88748760422,43995.22170753486,43214.66367940642,43145.390182547504,43281.27543171658,52.495458904297266,62.36941960549135,137.55330129327874,-46.2718937048121,-17.5620859993287,3.8220853113089106,43466.972388462505,43094.07847497066,23.372505692535896,38.64820404713485,False,True,42504.34,42904.34,42904.34,42854.34,2024-02-05 17:30:00,True,2024-02-05 17:30:00,2024-02-05 18:28:27,2024-02-05 17:33:18,even,True,18.66,2072.4899999999952,,2,0,6,2
2024-02-06 00:00:00,42340.34,42458.738,42283.039,42450.391,1084,56422,0,2024-02-06 00:00:00,2024-02-06 00:00:00,-59.13215476184996,-78.86861811662675,42475.31190476189,-0.0010102607616510099,-0.001805123303100234,42479.32038095241,42054.71995927261,42335.929453205674,42487.30367913755,42611.200113188854,42397.04562607498,-68.56750675787771,-61.48424452455929,148.16882803874788,-4.875260405933659,-38.755984864117636,-17.66451255586435,42597.07354392729,42195.517708222666,23.889844477214677,20.390263886084455,True,False,42950.391,42550.391,42550.391,42600.391,2024-02-06 01:45:00,True,2024-02-06 01:45:00,2024-02-06 10:12:05,2024-02-06 03:00:08,even,True,18.66,2091.149999999995,,3,0,6,2
2024-02-06 01:00:00,42451.414,42480.637,42413.039,42443.254,1053,56422,0,2024-02-06 01:00:00,2024-02-06 01:00:00,-4.008476190523652,-94.30849438558653,42508.13827380953,-0.0010151349796370234,-0.0008944506372374678,42475.31190476189,42010.3567555068,42554.7094756866,42455.93945948155,42560.62182119633,42339.94966735469,-64.41950140319386,-64.61857078010347,158.63512761084382,-7.485882696892077,-7.473802545588114,-20.725747850003245,42554.10708962933,42124.29224508005,26.404309403144286,23.75211926744673,True,False,42943.254,42543.254,42543.254,42593.254,2024-02-06 01:30:00,True,2024-02-06 01:30:00,2024-02-06 10:12:05,2024-02-06 03:00:12,even,True,18.66,2109.809999999995,,4,0,6,2
2024-02-06 02:00:00,42672.5,42701.738,42604.84,42619.039,986,36422,0,2024-02-06 02:00:00,2024-02-06 02:00:00,32.826369047637854,-87.82334337823704,42518.60201190474,-0.00023614148095606863,-0.0006827282997352481,42508.13827380953,42218.71438743801,42594.701619361134,42544.37726915266,42580.79526001722,42531.10949088409,-38.11015168202721,-53.31296548902241,146.1006029702772,49.98784623323445,58.162652562808944,50.176224286195065,42729.84530489396,42333.87367687422,90.03003513913522,79.14869455592729,True,False,43119.039,42719.039,42719.039,42769.039,2024-02-06 04:45:00,True,2024-02-06 04:45:00,2024-02-06 17:20:10,2024-02-06 07:18:36,even,True,18.66,2128.469999999995,,5,0,6,2
2024-02-06 07:00:00,42790.84,42810.238,42735.84,42755.637,789,36422,0,2024-02-06 07:00:00,2024-02-06 07:00:00,39.76482142857276,-40.32031203478982,42791.654095238075,0.0014479637524024826,0.0013694294005685643,42794.94122619047,42940.8940696934,43302.64625495469,42783.66026134746,42731.89820908844,42857.91936429308,23.46115945031488,18.348862058160297,119.99785030674987,-14.760896800849878,-3.948226694119512,2.82395046435704,43019.91646220719,42694.42226637896,56.98922626505648,67.69523945939638,False,True,42255.637,43155.637,42655.637,42605.637,,False,,,2024-02-06 17:21:14,fail,False,-74.66,2053.809999999995,,0,1,6,2
2024-02-06 08:00:00,42744.34,42744.34,42691.938,42697.34,735,36422,0,2024-02-06 08:00:00,2024-02-06 08:00:00,-3.2871309523980017,-34.83787176482292,42777.96665476192,0.0006992679599320035,0.0003069857835748005,42791.654095238075,42730.3782744926,43010.30383640046,42759.14630973664,42732.87334043698,42776.72132920535,16.321910881539225,18.746843581859512,101.07579990357223,-24.276352941204095,-16.382762641871523,-23.8485012040328,42913.173659075175,42638.76899933552,16.23953690834212,29.044163593494634,False,True,42197.34,43097.34,42597.34,42547.34,,False,,,2024-02-06 17:20:08,fail,False,-74.66,1979.1499999999949,,0,2,6,2
2024-02-06 20:00:00,43142.348,43223.637,43131.84,43194.238,859,36422,0,2024-02-06 20:00:00,2024-02-06 20:00:00,79.54359523813037,77.20100748368714,43161.43310714288,0.0014050414278786165,0.0023412738705204054,43113.604011904754,43196.0405448586,43937.069787719236,43133.78458517413,43047.74852916964,43242.62681286553,47.87580821775191,43.50469607089303,177.10139935318367,6.450509115958994,3.632017887888651,3.5155999311973574,43483.213701992325,43003.53992373873,64.69979931094748,64.6449841938488,False,True,42694.238,43094.238,43094.238,43044.238,2024-02-07 02:45:00,True,2024-02-07 02:45:00,,2024-02-07 03:02:42,even,True,18.66,1997.809999999995,,1,0,6,2
2024-02-06 22:00:00,43241.043,43288.992,43152.539,43168.906,1660,36422,0,2024-02-06 22:00:00,2024-02-06 22:00:00,55.359107142838184,102.27817467803106,43177.59983333331,0.001122620663600036,0.00048808614709250125,43216.79221428572,43213.40634706274,43519.97534644395,43152.12328619696,43095.320287645445,43143.443762297895,37.84188181762147,39.74716454218435,121.13954456771846,-0.1676467147990479,15.519066047418164,-19.61274681800569,43306.98214746432,42978.40537713147,59.61892865767535,53.05947178292707,False,True,42668.906,43068.906,43068.906,43018.906,2024-02-07 04:00:00,True,2024-02-07 04:00:00,,2024-02-07 11:35:47,even,True,18.66,2016.469999999995,,2,0,6,2
2024-02-06 23:00:00,43052.445,43144.738,43015.34,43128.539,1105,36426,0,2024-02-06 23:00:00,2024-02-06 23:00:00,-39.19238095240871,97.27924783753406,43162.04636904764,0.0007962143607796656,-0.0003252547648791204,43177.59983333331,43141.5941285535,43235.08403717953,43124.02896030285,43094.82788575872,43124.11635603711,26.392762861687515,33.55521684154209,76.14852777954715,5.727730650098238,-2.947160990726843,-12.712878568949236,43228.416868539505,43021.31584353472,37.71751333517423,39.09891149422768,False,True,42628.539,43028.539,43028.539,42978.539,2024-02-07 05:15:00,True,2024-02-07 05:15:00,,2024-02-07 11:34:28,even,True,18.66,2035.129999999995,,3,0,6,2
2024-02-07 11:00:00,42911.738,42940.137,42864.961,42902.852,644,36422,0,2024-02-07 11:00:00,2024-02-07 11:00:00,6.336642857138941,4.733510203528567,42977.745095238104,0.0004082182049671967,0.00033287581740748155,42903.44036904761,42908.36194150566,43222.12489344631,42912.73008500648,42933.284914445314,42905.4056511868,-15.375484586140374,-17.48480202222806,47.82485503885714,-5.896748194019892,-6.890076711380971,-4.045582043348986,42969.96920548925,42839.34209688434,43.46214194489962,43.06537736422678,True,False,43402.852,43002.852,43002.852,43052.852,2024-02-07 11:45:00,True,2024-02-07 11:45:00,2024-02-07 19:21:29,2024-02-07 12:48:47,even,True,18.66,2053.789999999995,,4,0,6,2
2024-02-07 11:15:00,42902.859,42940.938,42901.656,42930.16,677,36422,0,2024-02-07 11:00:00,2024-02-07 11:00:00,6.336642857138941,4.733510203528567,42977.745095238104,0.0004082182049671967,0.00033287581740748155,42903.44036904761,42908.36194150566,43222.12489344631,42915.411610390096,42933.05343930121,42904.31850464396,-14.146173803128477,-16.817076378408146,46.827201895771964,-1.0871465428353986,-5.896748194019892,-6.890076711380971,42967.535227203254,42839.60178208467,46.12223064251316,45.16912644600149,True,False,43430.16,43030.16,43030.16,43080.16,2024-02-07 11:45:00,True,2024-02-07 11:45:00,2024-02-07 19:23:21,2024-02-07 12:37:32,even,True,18.66,2072.449999999995,,5,0,6,2
2024-02-07 22:00:00,43577.938,43841.539,43577.938,43803.34,2118,36422,0,2024-02-07 22:00:00,2024-02-07 22:00:00,96.83188095236255,128.78660522003338,43741.46951190476,0.002606050653553208,0.0035547275889659174,43492.92864285712,43842.86701758872,44816.58266065758,43519.543152284066,43363.324321670705,43691.49289267286,80.64750939823716,65.86474752147477,248.46679197422807,53.584524595826224,25.88058720328263,14.57756725143554,44028.42306183807,43356.06272350765,86.23444019802686,80.27036492512072,True,False,44303.34,43903.34,43903.34,43953.34,2024-02-07 22:30:00,True,2024-02-07 22:30:00,2024-02-07 23:29:08,,success,True,93.31,2165.7599999999948,,6,0,6,2
2024-02-07 22:15:00,43803.34,44192.238,43803.34,44029.438,3097,36422,0,2024-02-07 22:00:00,2024-02-07 22:00:00,96.83188095236255,128.78660522003338,43741.46951190476,0.002606050653553208,0.0035547275889659174,43492.92864285712,43842.86701758872,44816.58266065758,43597.98851347113,43412.66607562102,43774.65280632957,92.67811944874848,71.22742190692952,283.96511676243256,83.15991365670925,53.584524595826224,25.88058720328263,44159.50571395885,43391.29989870029,87.51208823425571,83.68612036054691,True,False,44529.438,44129.438,44129.438,44179.438,2024-02-07 23:30:00,True,2024-02-07 23:30:00,2024-02-08 02:25:06,2024-02-07 23:40:41,even,True,18.66,2184.4199999999946,,7,0,6,2
2024-02-07 23:15:00,44109.922,44307.34,44084.039,44289.746,1985,56422,0,2024-02-07 23:00:00,2024-02-07 23:00:00,248.54086904763972,187.54655342727347,43937.179988095224,0.0032587925404725243,0.003574153163604662,43741.46951190476,44209.14752803604,44980.29603834406,43871.25635438993,43608.3514759408,44067.31321087035,130.83050569763145,99.65837412666986,372.945059277259,84.98180151357519,56.88353457177436,63.54106432747358,44572.28904089465,43563.83738084605,89.80272971864763,87.19608826772507,True,False,44789.746,44389.746,44389.746,44439.746,2024-02-08 02:30:00,True,2024-02-08 02:30:00,2024-02-08 12:14:12,2024-02-08 09:09:10,even,True,18.66,2203.0799999999945,,8,0,6,2
2024-02-08 05:00:00,44610.34,44659.738,44581.84,44615.438,1050,36422,0,2024-02-08 05:00:00,2024-02-08 05:00:00,85.62417857142282,415.3186154251089,44589.49564285714,0.0029695481533780765,0.0021359195323839664,44603.890630952366,44985.235463618184,45365.95723216845,44520.93945915972,44322.01439525922,44669.856774337786,131.99912830135872,137.38732721044465,199.66125135956082,11.325813553463377,25.484251117995882,21.490879600947665,44940.899463673195,44400.31408500238,75.71300949577808,72.91825376036428,False,True,44115.438,44515.438,44515.438,44465.438,2024-02-08 07:00:00,True,2024-02-08 07:00:00,,2024-02-08 07:15:23,even,True,18.66,2221.7399999999943,,9,0,6,2
2024-02-08 06:00:00,44508.039,44539.438,44505.438,44533.41,645,36422,0,2024-02-08 06:00:00,2024-02-08 06:00:00,-14.394988095227745,420.2748321324034,44576.30901190479,0.0015052225613401947,0.000834973422853126,44589.49564285714,44688.879217029855,45009.279918264634,44529.92560167913,44380.17205429791,44600.41802098377,111.55621459431131,126.17746182019829,184.89975515835818,-22.883118679099425,-27.28456828344497,-16.46312968701386,44850.03269044756,44349.303351519986,35.92819116582253,49.09617535686565,False,True,44033.41,44933.41,44433.41,44383.41,,False,,,2024-02-08 15:58:21,fail,False,-74.66,2147.0799999999945,,0,1,6,2
2024-02-08 07:00:00,44453.137,44511.438,44450.895,44496.938,783,36422,0,2024-02-08 07:00:00,2024-02-08 07:00:00,-13.186630952346604,415.2041092434447,44564.11314285714,0.0012947277108544479,0.00036310886722258,44576.30901190479,44664.9027524953,44862.23563130979,44511.711339245274,44410.4409213217,44512.95708978329,88.07157272020413,108.0283872432239,141.05143904055222,-11.762253181987035,-26.995698658422043,-32.584127966925735,44703.37653248804,44321.03764707854,12.707558349564083,20.015580867507563,False,True,43996.938,44896.938,44396.938,44346.938,,False,,,2024-02-08 15:51:34,fail,False,-74.66,2072.4199999999946,,0,2,6,2
2024-02-08 08:00:00,44519.137,44528.637,44461.035,44461.738,1132,36422,0,2024-02-08 08:00:00,2024-02-08 08:00:00,-12.195869047653105,411.76460715957364,44500.581952380955,0.0009674078113596221,-0.00013853104463814553,44564.11314285714,44566.33531279694,44705.84324351657,44514.59257077448,44439.90747401741,44497.16820158235,71.26770036009111,89.99722197942066,69.03779136230978,-19.49535053323052,-6.781151358780335,-1.1024090127830277,44590.36921992147,44402.467183243236,28.225719110632777,33.91018219318107,False,True,43961.738,44861.738,44361.738,44311.738,,False,,,2024-02-08 15:51:33,fail,False,-74.66,1997.7599999999945,,0,3,6,2
2024-02-08 09:00:00,44431.738,44465.238,44389.516,44451.938,1243,36422,0,2024-02-08 09:00:00,2024-02-08 09:00:00,-63.53119047618384,397.4053664139865,44462.53747619051,0.0003285034728961256,-0.0010288349595913289,44500.581952380955,44443.94068341442,44354.621611280396,44489.12243901506,44446.510014180414,44461.132305125575,52.0531195423755,71.24310118097173,54.127717864309666,-7.727376332986751,-20.160892672851332,-10.734057103589294,44534.204724242394,44386.559886008756,16.77961927011042,17.241392091694134,False,True,43951.938,44851.938,44351.938,44301.938,,False,,,2024-02-08 13:12:05,fail,False,-74.66,1923.0999999999945,,0,4,6,2
2024-02-08 10:00:00,44478.777,44596.039,44478.031,44579.438,1166,36422,0,2024-02-08 10:00:00,2024-02-08 10:00:00,-38.044476190443675,385.686732024551,44526.21554761907,-0.00016047409092063053,-0.00015974079688650932,44462.53747619051,44356.029217386415,44684.23371472251,44502.46074267776,44464.10743478058,44491.266025455814,42.98704967599042,55.49941983421638,54.201154342841456,19.03962848298397,3.346561059508531,9.022863777092425,44565.93758381865,44418.094467092975,63.621027091834264,50.315526427609306,True,False,45079.438,44679.438,44679.438,44729.438,2024-02-08 12:15:00,True,2024-02-08 12:15:00,2024-02-08 16:04:40,2024-02-08 12:21:11,even,True,18.66,1941.7599999999945,,1,0,6,2
2024-02-08 14:00:00,44661.34,44804.238,44657.609,44801.637,960,36422,0,2024-02-08 14:00:00,2024-02-08 14:00:00,24.149928571423516,372.4068710864667,44695.926642857135,0.0007759576317984446,0.0010347145098412451,44689.593976190474,44690.78588503591,45097.099750577065,44719.19162946447,44645.58513716975,44787.175776745826,48.85764363558701,49.675784263611035,125.52436736252204,10.539164430731034,-16.78706742349459,0.21723254215612542,44958.13367268523,44617.71788080642,59.16744220933989,64.72698591941064,True,False,45301.637,44901.637,44901.637,44951.637,2024-02-08 16:15:00,True,2024-02-08 16:15:00,2024-02-08 17:21:59,2024-02-08 16:31:41,even,True,18.66,1960.4199999999946,,2,0,6,2
2024-02-08 15:00:00,44654.457,44758.84,44646.039,44758.637,773,36422,0,2024-02-08 15:00:00,2024-02-08 15:00:00,6.33266666666168,358.14829252369236,44795.80234523808,0.0007759624131783104,0.001348372245587059,44695.926642857135,44725.54350471437,45239.126765787885,44704.22987531912,44656.12175547037,44735.87654145168,38.09987350425217,44.07079367457293,106.2096016048262,7.303478156180063,-17.846184038557112,-22.590472996234894,44880.759503618196,44592.49357928517,41.01558478990399,40.594338684267974,True,False,45258.637,44858.637,44858.637,44908.637,2024-02-08 16:00:00,True,2024-02-08 16:00:00,2024-02-08 17:21:37,2024-02-08 16:31:51,even,True,18.66,1979.0799999999947,,3,0,6,2
2024-02-08 15:30:00,44699.84,44803.738,44648.133,44774.938,1007,36422,0,2024-02-08 15:00:00,2024-02-08 15:00:00,6.33266666666168,358.14829252369236,44795.80234523808,0.0007759624131783104,0.001348372245587059,44695.926642857135,44725.54350471437,45239.126765787885,44715.31765037641,44668.33298925786,44734.06864809081,36.5047998325972,41.31260886453933,90.06267280601496,1.145212934286974,-2.9531062951573404,7.303478156180063,44857.15325637893,44612.48403980269,63.12549038446114,51.22976413508189,True,False,45274.938,44874.938,44874.938,44924.938,2024-02-08 16:00:00,True,2024-02-08 16:00:00,2024-02-08 17:21:37,2024-02-08 16:31:41,even,True,18.66,1997.7399999999948,,4,0,6,2
2024-02-08 17:15:00,44972.039,45419.039,44957.18,45327.738,3371,36422,0,2024-02-08 17:00:00,2024-02-08 17:00:00,93.95033333336323,375.4705424594358,45070.424809523836,0.0018630223751347666,0.002285406380726262,44889.75267857144,45123.70025314578,45820.04741554251,44967.47864671516,44834.89755667305,45056.29737667703,69.98877521195391,55.595637191303396,178.05592363466735,89.95448400411988,25.697776057888404,36.5445703473888,45298.17287358383,44815.92187977023,75.25099512773956,71.8650330767572,True,False,45827.738,44927.738,45427.738,45477.738,,False,2024-02-09 04:15:00,2024-02-09 04:18:58,2024-02-08 18:52:16,fail,False,-74.66,1923.0799999999947,,0,1,6,2
2024-02-08 19:00:00,45030.238,45043.539,44859.84,44965.938,2230,36422,0,2024-02-08 19:00:00,2024-02-08 19:00:00,34.36470238093898,397.1540640171661,45108.29221428571,0.001328102682835152,0.002662114401972507,45104.789511904775,45081.49931421495,46128.72266543606,45093.89556965046,44976.735952307834,45251.22177158577,74.44388146852725,77.05404000555147,236.75088934410908,-45.45394564852177,-23.812742346010054,20.069607499113772,45570.83547220031,44930.108070971226,46.32225004574857,59.062060752169124,False,True,44465.938,45365.938,44865.938,44815.938,,False,,,2024-02-08 21:31:42,fail,False,-74.66,1848.4199999999946,,0,2,6,2
2024-02-08 19:15:00,44964.867,45110.238,44894.84,45101.039,1946,36422,0,2024-02-08 19:00:00,2024-02-08 19:00:00,34.36470238093898,397.1540640171661,45108.29221428571,0.001328102682835152,0.002662114401972507,45104.789511904775,45081.49931421495,46128.72266543606,45094.99455893501,44985.94358547022,45228.15561953909,71.59528838680853,75.96228968180289,237.52130554556643,-23.066152046681964,-45.45394564852177,-23.812742346010054,45548.8093820256,44906.00185705257,39.09145255937296,48.494532702771814,True,False,45601.039,45201.039,45201.039,45251.039,2024-02-08 21:00:00,True,2024-02-08 21:00:00,2024-02-09 04:18:49,2024-02-08 21:13:26,even,True,18.66,1867.0799999999947,,1,0,6,2
2024-02-08 20:15:00,45074.039,45166.637,45022.48,45164.137,1434,36422,0,2024-02-08 20:00:00,2024-02-08 20:00:00,3.50270238093799,384.0020298113159,45195.083404761914,0.0013281641590855097,0.002248945560393204,45108.29221428571,45141.54662770652,46123.62228711319,45095.939283476335,45014.64327745941,45122.077960096314,59.93703529732011,68.04057243322222,218.23160412097647,-6.6809742002005805,-34.45796044036251,-48.23105675949046,45416.690625659634,44825.965294532994,37.710884676745,37.53754713517253,True,False,45664.137,45264.137,45264.137,45314.137,2024-02-08 21:30:00,True,2024-02-08 21:30:00,2024-02-09 04:18:55,2024-02-08 21:33:06,even,True,18.66,1885.7399999999948,,2,0,6,2
2024-02-08 20:45:00,45135.84,45279.738,45118.953,45265.238,1668,36422,0,2024-02-08 20:00:00,2024-02-08 20:00:00,3.50270238093799,384.0020298113159,45195.083404761914,0.0013281641590855097,0.002248945560393204,45108.29221428571,45141.54662770652,46123.62228711319,45126.9708716014,45041.40850536643,45138.99426900585,60.16057779362745,64.89478889880732,194.63133644893205,14.616049191565253,2.300259717972949,-6.6809742002005805,45403.24657321191,44876.241964799796,53.88528774981224,45.004037036089024,True,False,45765.238,45365.238,45365.238,45415.238,2024-02-08 22:15:00,True,2024-02-08 22:15:00,2024-02-09 04:18:57,2024-02-08 22:23:26,even,True,18.66,1904.3999999999949,,3,0,6,2
2024-02-08 21:15:00,45201.559,45331.637,45200.461,45327.637,1120,36422,0,2024-02-08 21:00:00,2024-02-08 21:00:00,86.79119047620043,389.7513474014704,45227.7058452381,0.0013280623224248282,0.0010237084051233256,45195.083404761914,45201.832974208424,45792.36300426453,45167.55228085071,45073.59487497121,45156.412604059195,62.33198916565016,63.53345672637285,169.9180638765072,21.840724802219484,-4.422389748877322,14.616049191565253,45387.30199029248,44927.02321782591,66.5241907840778,58.78128546610974,True,False,45827.637,45427.637,45427.637,45477.637,2024-02-09 04:15:00,True,2024-02-09 04:15:00,2024-02-09 04:18:58,,success,True,93.31,1997.7099999999948,,4,0,6,2
2024-02-09 00:00:00,45272.039,45357.438,45236.422,45278.621,1047,52422,0,2024-02-09 00:00:00,2024-02-09 00:00:00,-0.06783333331986796,388.32716603946756,45276.76929761902,0.001388073763102035,0.0006182204503533008,45295.67088095236,45406.01147364743,45742.27276256461,45315.25942466487,45230.80193317597,45406.07365153076,59.863837581106054,65.61832988426696,137.57026473598043,-12.38222669424431,-13.671370829018997,1.7235466116108,45591.79350892433,45218.85379413718,44.80032180743472,56.42379720389019,False,True,44778.621,45678.621,45178.621,45128.621,,False,,,2024-02-09 04:18:56,fail,False,-74.66,1923.0499999999947,,0,1,6,2
2024-02-09 02:00:00,45248.238,45344.938,45248.238,45299.438,1369,36422,0,2024-02-09 02:00:00,2024-02-09 02:00:00,27.07338095240266,357.40529809799045,45286.07947619048,0.0010771249382754834,-0.00010602015988082366,45303.842678571425,45380.77151369193,45543.43483414929,45278.035951118996,45245.43068035163,45252.13620674235,33.86606395891431,44.18152487713625,92.10627268240638,-0.8315122119311127,-11.826852769176185,-17.594648434824194,45376.47967486359,45126.2927386211,27.621437167253344,23.628730376167976,False,True,44799.438,45699.438,45199.438,45149.438,,False,,,2024-02-09 04:18:56,fail,False,-74.66,1848.3899999999946,,0,2,6,2
2024-02-09 04:00:00,45455.84,45508.438,45398.238,45484.238,1086,36422,0,2024-02-09 04:00:00,2024-02-09 04:00:00,36.32497619049536,341.4337954382718,45635.53155952381,0.0007462965670302416,0.002849822391615899,45322.40445238098,45392.86195274185,46863.848499912485,45336.674201261296,45289.58967412604,45353.66377949771,31.875712339853635,30.794348839243682,80.22406926222311,45.69795665633137,44.21217440656619,11.720950464412454,45463.46627300171,45245.361285993706,88.44934413190866,77.92995024002862,True,False,45984.238,45584.238,45584.238,45634.238,2024-02-09 04:30:00,True,2024-02-09 04:30:00,2024-02-09 04:45:36,,success,True,93.31,1941.6999999999946,,1,0,6,2
2024-02-09 10:00:00,46171.039,46309.738,46163.871,46308.063,1012,36422,0,2024-02-09 10:00:00,2024-02-09 10:00:00,34.89019047619513,465.4905976106893,46353.177940476235,0.002911055340435905,0.001011597831095782,46224.35382142859,46669.67212467552,46826.0358856863,46173.782112607325,46008.8938337332,46268.24309012732,105.72062200505025,107.21485407809749,188.38605992882637,34.553445132420165,8.643943240553199,50.90872961808782,46524.06427103123,46013.921909223405,72.55579061965285,78.65274796382052,False,True,45808.063,46708.063,46208.063,46158.063,,False,,,2024-02-09 11:00:24,fail,False,-74.66,1867.0399999999945,,0,1,6,2
2024-02-09 12:00:00,46484.738,46619.539,46480.082,46580.992,1050,36422,0,2024-02-09 12:00:00,2024-02-09 12:00:00,32.469380952337815,505.5233974867806,46558.985214285734,0.0019479059261091594,0.0014236431719408865,46385.64732142857,46683.53909494498,47043.92869428277,46439.65504587601,46248.03117309797,46567.93346233227,118.83780861607374,116.26229411198621,224.62412298440137,30.976922944588296,10.412079463349073,24.836018231821072,46872.67602836122,46264.69089630333,70.66545280389813,71.05061145352967,False,True,46080.992,46980.992,46480.992,46430.992,,False,,,2024-02-09 13:45:00,fail,False,-74.66,1792.3799999999944,,0,2,6,2
2024-02-09 12:45:00,46558.195,46774.438,46547.469,46741.938,1673,36422,0,2024-02-09 12:00:00,2024-02-09 12:00:00,32.469380952337815,505.5233974867806,46558.985214285734,0.0019479059261091594,0.0014236431719408865,46385.64732142857,46683.53909494498,47043.92869428277,46513.2294374424,46324.75938544204,46653.38894564842,118.25759958537674,116.60748039953582,228.09077729939227,43.07528689368337,17.06483212934836,25.315364293113817,46962.8114950026,46345.466396294236,77.99055157797011,72.71527278092954,True,False,47241.938,46841.938,46841.938,46891.938,2024-02-09 13:45:00,True,2024-02-09 13:45:00,2024-02-09 13:54:59,2024-02-09 16:20:53,success,True,93.31,1885.6899999999944,,1,0,6,2
2024-02-09 13:30:00,46759.188,46980.84,46752.84,46980.84,2754,36422,0,2024-02-09 13:00:00,2024-02-09 13:00:00,173.33789285716193,527.2708783840135,46802.74904761906,0.0023082075109005008,0.003523205785632868,46558.985214285734,46888.76238454125,47902.743968090224,46640.68539246055,46428.65417708337,46783.77551943585,127.51887814417569,119.84017327298923,236.85630601661987,67.0872033023843,30.98729962156358,32.312070863481495,47105.031532558285,46464.01950631341,91.02740474304865,87.83326845111257,True,False,47480.84,47080.84,47080.84,47130.84,2024-02-09 14:00:00,True,2024-02-09 14:00:00,2024-02-09 14:08:12,2024-02-09 16:20:20,success,True,93.31,1978.9999999999943,,2,0,6,2
2024-02-09 14:30:00,47231.238,47474.59,47141.738,47416.75,2765,36422,0,2024-02-09 14:00:00,2024-02-09 14:00:00,243.76383333332342,569.8664502734755,47016.80598809525,0.003369066930303281,0.004307531754669629,46802.74904761906,47387.06986217235,48441.583152668034,46964.90160208028,46659.11033825616,47164.69794805639,167.0886391822787,140.97489427162884,369.4972606094555,98.904178878518,67.74286618514452,123.0373367732609,47665.01924987915,46665.87664623363,74.53189715206378,79.78875260355822,True,False,47916.75,47016.75,47516.75,47566.75,,False,2024-02-09 20:00:00,2024-02-09 20:24:07,2024-02-09 16:20:23,fail,False,-74.66,1904.3399999999942,,0,1,6,2
2024-02-09 15:30:00,47336.238,47603.039,47291.938,47554.637,2532,36422,0,2024-02-09 15:00:00,2024-02-09 15:00:00,214.0569404761918,608.9979159957365,47238.20215476187,0.0033688703359676343,0.005076770676589885,47016.80598809525,47547.344197028026,48829.33964346282,47176.06669983745,46852.51767105532,47456.32200343998,182.32217173648678,162.12530236587614,415.6496429162437,90.49009287924855,66.70376023391145,63.34951599592023,48018.94902137691,46895.19498550305,78.97736678453468,74.91768020529462,True,False,48054.637,47154.637,47654.637,47704.637,,False,2024-02-09 20:15:00,2024-02-09 20:24:51,2024-02-09 16:19:45,fail,False,-74.66,1829.6799999999942,,0,2,6,2
2024-02-09 16:00:00,47427.738,47677.438,47402.637,47548.137,2326,36422,0,2024-02-09 16:00:00,2024-02-09 16:00:00,221.39616666662187,643.6052134590864,47245.72883333331,0.0016714058265470996,0.00534782636775471,47238.20215476187,46922.71932516101,49155.06839990047,47266.0702288777,46943.49772621341,47570.27704231167,185.89620800410194,170.22341776180616,417.3179821929946,62.20249604405399,51.7525428276349,90.49009287924855,48135.15631827221,47006.897766351125,86.35127854679546,82.10031140802656,True,False,48048.137,47148.137,47648.137,47698.137,,False,2024-02-09 20:15:00,2024-02-09 20:24:51,2024-02-09 16:19:45,fail,False,-74.66,1755.019999999994,,0,3,6,2
2024-02-09 16:30:00,46909.016,47311.738,46906.84,47118.738,3950,36422,0,2024-02-09 16:00:00,2024-02-09 16:00:00,221.39616666662187,643.6052134590864,47245.72883333331,0.0016714058265470996,0.00534782636775471,47238.20215476187,46922.71932516101,49155.06839990047,47195.97586801303,46953.61430848201,47449.38882937738,159.25625158769253,167.7817639246016,387.91510692126184,-38.76616649462812,-82.12204643966106,62.20249604405399,47973.07422372108,46924.203435033676,53.73886770433526,68.25449229003806,True,False,47618.738,46718.738,47218.738,47268.738,,False,2024-02-09 18:15:00,2024-02-09 19:59:53,2024-02-09 17:16:03,fail,False,-74.66,1680.359999999994,,0,4,6,2
2024-02-09 17:15:00,46868.598,47179.98,46705.469,47154.93,2699,36422,0,2024-02-09 17:00:00,2024-02-09 17:00:00,7.526678571441153,631.523851489248,47232.51691666667,0.001665059162840053,0.0037228187840509805,47245.72883333331,46998.135491577756,48876.09380540013,47128.89651994782,46967.60855357573,47241.14150051593,126.97979274136014,151.41203279869134,353.2941752036899,-37.91490092888125,-102.89369659442309,-67.43873133814486,47718.08863704091,46762.694363990944,37.080291134928025,36.63829561182259,True,False,47654.93,47254.93,47254.93,47304.93,2024-02-09 18:15:00,True,2024-02-09 18:15:00,2024-02-09 20:00:33,2024-02-09 18:22:19,even,True,18.66,1699.019999999994,,1,0,6,2
2024-02-09 23:45:00,47335.145,47499.238,47312.273,47466.938,1276,56422,0,2024-02-09 23:00:00,2024-02-09 23:00:00,33.629678571429395,610.7153606104694,47531.77215476191,0.0016368050281177964,0.0016332974290650052,47488.55120238098,47458.2915482093,48742.39948619572,47449.82915264883,47403.726566758705,47391.28004196762,57.059272827646055,79.54498831572094,193.19442878150886,-13.051301685620274,-57.496307877561776,-66.58964430684136,47652.092520822654,47128.96756311259,17.441263514467014,14.751750198699627,True,False,47966.938,47566.938,47566.938,47616.938,2024-02-12 00:15:00,True,2024-02-12 00:15:00,,,running,False,0.0,1699.019999999994,2024-02-10 02:45:00,0,1,6,2
2024-02-12 04:00:00,48466.539,48520.938,48374.855,48389.238,1290,36422,0,2024-02-12 04:00:00,2024-02-12 04:00:00,183.0788333333112,703.1180718325413,48389.0334047619,0.0031138388782724043,0.004941260909848663,48374.17984523808,48552.56188950626,50236.16645502492,48352.450594422,48108.96914486803,48568.337545579656,148.91901445807162,146.4661906917248,450.6458065652776,-47.85012143099448,-17.640221878202283,-14.424238046114624,49176.70938444278,47958.46570671653,50.998673484144746,54.60639933680081,False,True,47889.238,48289.238,48289.238,48239.238,2024-02-12 04:45:00,True,2024-02-12 04:45:00,2024-02-12 08:47:36,2024-02-12 09:23:58,success,True,93.31,1792.329999999994,,1,0,7,2
2024-02-12 05:00:00,48127.137,48132.438,48036.43,48108.938,1428,36422,0,2024-02-12 05:00:00,2024-02-12 05:00:00,14.853559523820877,678.7859097819164,48354.315511904744,0.0027777102172570687,0.0035815466676386203,48389.0334047619,48543.89288550625,50019.91732523524,48254.02595612662,48121.511114351495,48337.290783625715,107.61219482280285,131.43297571516868,391.0757864774969,-54.04218472654611,-50.7527915377359,-57.97569728233793,48865.24309537034,47807.83847188109,15.258707492832952,23.773394550302346,False,True,47608.938,48008.938,48008.938,47958.938,2024-02-12 11:45:00,True,2024-02-12 11:45:00,,2024-02-12 12:17:43,even,True,18.66,1810.989999999994,,2,0,7,2
2024-02-12 06:00:00,48115.246,48120.34,48033.316,48036.438,972,36422,0,2024-02-12 06:00:00,2024-02-12 06:00:00,-34.71789285715931,651.4443479498659,48256.650535714245,0.002260425090037063,6.95684391715886e-05,48354.315511904744,48408.14172046879,48845.77521352293,48186.3475974108,48121.092306016195,48111.204122807016,74.79070113987109,104.33243942763917,192.25549151652208,-71.8169067767376,-52.9530894392592,-50.60620364637725,48370.74903635432,47850.15920925971,16.394185018433102,18.75632227568414,False,True,47536.438,47936.438,47936.438,47886.438,2024-02-12 12:00:00,True,2024-02-12 12:00:00,,2024-02-12 12:12:46,even,True,18.66,1829.6499999999942,,3,0,7,2
2024-02-12 07:00:00,48049.172,48131.738,48042.191,48122.637,848,36422,0,2024-02-12 07:00:00,2024-02-12 07:00:00,-97.66497619049915,616.9136730335813,48123.23592857143,-4.6854102304557115e-05,-0.0023888069000455475,48256.650535714245,47969.87319980819,47805.80285761666,48134.43058029101,48109.65373631235,48010.51663536292,48.98835974094982,75.52495492471601,200.36265205212976,8.527808049489977,-9.6192081182744,-48.88450945998193,48282.50621563329,47740.02705509254,17.644860302437905,14.359647429541496,False,True,47622.637,48022.637,48022.637,47972.637,2024-02-12 11:45:00,True,2024-02-12 11:45:00,,2024-02-12 12:30:02,even,True,18.66,1848.3099999999943,,4,0,7,2
2024-02-12 09:00:00,48129.039,48258.738,48101.84,48175.34,2047,36422,0,2024-02-12 09:00:00,2024-02-12 09:00:00,-47.90752380953927,555.6311783795172,48073.110440476215,-0.0013225309852207593,-0.001323075521298333,48075.32840476189,47431.07538927391,48127.561644967056,48116.068671033274,48107.91847905034,48096.44178328174,24.691328719018202,37.136459591121195,140.05867334174425,14.7049174406784,21.455057791528816,8.639359821136168,48287.020992293095,47907.36257427039,63.79860976948989,51.40551393060988,True,False,48675.34,48275.34,48275.34,48325.34,2024-02-12 09:30:00,True,2024-02-12 09:30:00,2024-02-12 16:47:04,2024-02-12 09:37:42,even,True,18.66,1866.9699999999943,,5,0,7,2
2024-02-12 10:00:00,48194.84,48230.738,48138.004,48147.34,866,36422,0,2024-02-12 10:00:00,2024-02-12 10:00:00,-2.217964285671769,533.4659677720629,48085.99792857138,-0.0013224571424270042,-0.0007853832609393737,48073.110440476215,47368.460119248135,48187.82533336214,48167.367962067096,48139.79397584877,48193.71268937051,27.52536917838006,32.38221932449105,92.60780557002877,10.15158720335603,15.198275885770272,26.577609907115402,48320.23322689005,48068.69215185098,73.51374516567348,81.71647809865193,True,False,48647.34,47747.34,48247.34,48297.34,,False,2024-02-12 16:45:00,2024-02-12 16:46:45,2024-02-12 12:04:44,fail,False,-74.66,1792.3099999999943,,0,1,7,2
2024-02-12 15:00:00,48015.203,48036.738,47924.27,47944.039,1169,36422,0,2024-02-12 15:00:00,2024-02-12 15:00:00,6.675535714297439,350.0905504915354,47910.43428571426,-0.00020246731359122093,-0.001153045014767628,47932.22572619047,47627.9074953998,47827.36241914906,47930.592206177746,47977.59280662267,47872.37690196073,-24.511899544137123,-23.0773057368652,154.42262648260274,16.960644306760514,38.3835483316725,-2.977806329545274,48082.34744771224,47663.90635620921,66.87756591222025,59.41537068457825,True,False,48444.039,48044.039,48044.039,48094.039,2024-02-12 16:30:00,True,2024-02-12 16:30:00,2024-02-12 16:39:05,,success,True,93.31,1885.6199999999942,,1,0,7,2
2024-02-12 16:00:00,47928.227,48111.738,47906.637,48088.238,1317,36422,0,2024-02-12 16:00:00,2024-02-12 16:00:00,-21.791440476205025,321.49544345014147,48196.277821428586,0.000807482850707725,0.0012587364829672878,47910.43428571426,47993.759846967965,49031.03254516546,47953.99798790828,47976.177422978246,47952.99994014447,-16.779063392576063,-21.82346417691017,116.68414626587612,36.80413794287597,15.498478844223428,20.007517027792346,48112.0235376034,47795.47634268554,73.44861846174213,66.07596304092901,True,False,48588.238,48188.238,48188.238,48238.238,2024-02-12 16:45:00,True,2024-02-12 16:45:00,2024-02-12 16:46:10,,success,True,93.31,1978.9299999999942,,2,0,7,2
2024-02-12 21:00:00,49739.047,49939.738,49713.039,49873.438,1865,36422,0,2024-02-12 21:00:00,2024-02-12 21:00:00,211.04465476188489,639.7471302206322,49834.34580952381,0.006524130990993283,0.005435880811414727,49799.44513095238,50740.742086988226,52112.247681936584,49715.746255825,49313.61246832432,50011.49573581013,234.25931238198245,225.33179251593197,792.4331793366744,-41.68016511870519,-78.14669453034003,-37.04658307543286,51081.28052791464,48940.21094370562,57.36846596348719,65.02346070790273,False,True,49373.438,49773.438,49773.438,49723.438,2024-02-12 21:45:00,True,2024-02-12 21:45:00,2024-02-13 15:36:47,2024-02-12 22:05:31,even,True,18.66,1997.5899999999942,,3,0,7,2
2024-02-12 22:00:00,49530.34,49863.238,49530.34,49847.84,1437,36422,0,2024-02-12 22:00:00,2024-02-12 22:00:00,34.900678571430035,642.1280636120355,49999.69092857144,0.00555682453314482,0.004412641199342567,49834.34580952381,50590.73193325333,51927.01414211474,49725.62023071789,49425.86654685881,49804.81493326456,200.7471977299574,217.01241650950152,561.3460845993228,1.3324055728298845,-109.81608290340955,-56.835482284091995,50564.13214747365,49046.99771905548,28.47805164046626,33.648241679787624,False,True,49347.84,50247.84,49747.84,49697.84,,False,2024-02-13 15:45:00,2024-02-13 15:36:49,2024-02-12 23:13:26,fail,False,-74.66,1922.9299999999942,,0,1,7,2
2024-02-13 00:00:00,49807.137,49964.938,49803.691,49931.238,1361,56422,0,2024-02-13 00:00:00,2024-02-13 00:00:00,-71.2960238095693,690.7020500652507,49914.73389285712,0.003314711448392532,-0.0006049565749091704,49928.39490476187,50438.08544099194,50118.868585831144,49938.06466743638,49700.49501892712,50012.11302958378,172.55253554274532,192.46117342902278,183.57105145948148,4.09153457175853,5.67616924666072,19.992287925640994,50261.43394905408,49764.29211011348,57.99853178453054,68.74927583600999,False,True,49431.238,50331.238,49831.238,49781.238,,False,2024-02-13 13:15:00,2024-02-13 15:36:31,2024-02-13 03:36:23,fail,False,-74.66,1848.269999999994,,0,2,7,2
2024-02-13 01:00:00,50017.137,50027.238,49899.324,49916.938,1629,56422,0,2024-02-13 01:00:00,2024-02-13 01:00:00,-13.66101190475456,697.6526997381734,49956.60469047622,0.0009645074492415414,-0.0006050535145071682,49914.73389285712,49857.07930265293,50088.520075898705,49963.72023332293,49778.55771511118,50054.47040385274,146.4560619356489,170.83758597052181,150.68935486145742,-10.149173718615202,19.039890608895803,13.984995871964202,50257.90103291571,49849.53977478977,63.8176974438529,66.05221532212867,False,True,49416.938,50316.938,49816.938,49766.938,,False,2024-02-13 13:15:00,2024-02-13 15:36:33,2024-02-13 03:36:23,fail,False,-74.66,1773.609999999994,,0,3,7,2
2024-02-13 03:00:00,50102.613,50243.039,50085.223,50170.438,1952,36422,0,2024-02-13 03:00:00,2024-02-13 03:00:00,55.84499999998661,687.2925397652143,50085.40364285715,0.0017947721038437663,0.0006458055937569264,50012.449690476205,50320.59487701451,50531.10301805273,50038.66844352457,49902.99018480213,50025.9912628139,109.51431593612506,125.27739398857291,154.95798255294198,23.457661162668956,7.6823990368211525,-6.103983488123049,50236.68453926037,49816.797986367426,73.14982912448176,67.02666468786414,True,False,50670.438,49770.438,50270.438,50320.438,,False,2024-02-14 11:00:00,2024-02-14 10:58:02,2024-02-13 05:41:13,fail,False,-74.66,1698.949999999994,,0,4,7,2
2024-02-13 04:00:00,50134.645,50154.039,49988.738,49997.637,1754,36422,0,2024-02-13 04:00:00,2024-02-13 04:00:00,72.95395238094352,681.2344383616291,50063.49455952379,0.0010137153705740182,0.0006458632965886833,50085.40364285715,50025.67933363348,50563.61566786216,50046.81938432279,49943.76935893228,50092.06885517713,90.40443547437462,108.37035292405865,105.70612729780653,-2.888335053343326,30.47193292054726,20.90934090128576,50234.77212702917,49947.86558332509,35.122933425576605,46.80120811587157,False,True,49497.637,49897.637,49897.637,49847.637,2024-02-13 05:45:00,True,2024-02-13 05:45:00,2024-02-13 15:36:11,2024-02-13 06:14:15,even,True,18.66,1717.609999999994,,1,0,7,2
2024-02-13 04:15:00,49996.148,50160.738,49991.813,50081.586,1478,36422,0,2024-02-13 04:00:00,2024-02-13 04:00:00,72.95395238094352,681.2344383616291,50063.49455952379,0.0010137153705740182,0.0006458632965886833,50085.40364285715,50025.67933363348,50563.61566786216,50052.168094426976,49953.97799901137,50090.30616649469,86.69417938263359,104.03511821577364,99.69943893745251,-1.7626886824436951,-2.888335053343326,30.47193292054726,50224.90040906025,49954.21192392913,38.31506872839652,40.159847255646014,True,False,50581.586,49681.586,50181.586,50231.586,,False,2024-02-14 11:00:00,2024-02-14 10:58:00,2024-02-13 13:15:35,fail,False,-74.66,1642.949999999994,,0,1,7,2
2024-02-13 05:00:00,49950.078,49966.039,49856.039,49909.137,1267,36422,0,2024-02-13 05:00:00,2024-02-13 05:00:00,-21.909083333361195,654.0067584772041,49947.27372619048,0.0005925670349109844,0.0006496848865758694,50063.49455952379,49848.76465589132,50597.76780124247,50001.14464710164,49947.550075219864,50024.7016897145,64.29677165266185,87.55549011939095,99.7473876238012,-20.475245957939478,-13.647583075391594,-31.481647746855742,50159.360663006635,49888.542716422366,14.125119411457668,20.512820324740144,False,True,49409.137,49809.137,49809.137,49759.137,2024-02-13 13:15:00,True,2024-02-13 13:15:00,2024-02-13 15:36:34,2024-02-13 13:22:06,even,True,18.66,1661.609999999994,,1,0,7,2
2024-02-13 09:00:00,50001.539,50100.34,49984.34,50099.738,737,36422,0,2024-02-13 09:00:00,2024-02-13 09:00:00,9.290630952396896,538.3743868958991,49962.9332857143,0.00019427713206810095,-0.0009350322179353286,49967.34980952383,49811.33368915138,49946.01539696105,49992.53815830351,49959.67495486661,50027.0993195734,26.425995551719097,27.25022597157745,102.70145936783726,30.863439972439664,27.1098097694412,16.428924664709484,50167.24628971998,49888.452349426814,78.81340533495818,76.43778560791655,True,False,50599.738,49699.738,50199.738,50249.738,,False,2024-02-14 11:00:00,2024-02-14 10:58:00,2024-02-13 13:14:49,fail,False,-74.66,1586.949999999994,,0,1,7,2
2024-02-13 10:00:00,49996.723,50081.738,49972.023,50068.137,1315,36422,0,2024-02-13 10:00:00,2024-02-13 10:00:00,-4.41652380953019,512.1324013445992,50025.870309523794,0.0007031532147095524,-0.0006600706159447818,49962.9332857143,50045.12062708022,50048.01061604604,50002.92187478456,49973.61805466039,50055.810177502615,23.502932897412393,25.253623200843087,89.10687884700953,6.881933952528925,4.937652906824951,-9.066894048846734,50177.60446394608,49935.51589105915,57.64878532017102,62.23307028031235,True,False,50568.137,50168.137,50168.137,50218.137,2024-02-13 12:00:00,True,2024-02-13 12:00:00,2024-02-14 10:58:00,2024-02-13 12:04:21,even,True,18.66,1605.609999999994,,1,0,7,2
2024-02-13 11:45:00,50121.637,50270.938,50053.039,50219.438,1870,36422,0,2024-02-13 11:00:00,2024-02-13 11:00:00,62.93702380949253,496.6032855839512,50119.99914285716,0.0008127904017957875,0.00031215319642828316,50025.870309523794,50130.9320592953,50330.523617915926,50090.77604878068,50036.64078511786,50128.483208118334,31.93594052066328,28.100308616078635,106.43938993995437,24.439591331269185,0.939442724455148,7.710110423082369,50273.67638453727,49984.7900316994,81.41220500184272,74.39888765389662,True,False,50719.438,49819.438,50319.438,50369.438,,False,2024-02-14 11:00:00,2024-02-14 10:58:03,2024-02-13 13:06:19,fail,False,-74.66,1530.949999999994,,0,1,7,2
2024-02-13 13:00:00,49859.137,49913.637,49696.395,49712.137,1701,36422,0,2024-02-13 13:00:00,2024-02-13 13:00:00,-57.32263095241797,442.7701392105373,50030.82428571426,-0.0004451920329173809,0.0008852467288287705,50062.67651190474,49552.845975217555,50530.61680055968,49991.18951820847,50003.99517430496,49997.6196959065,7.590704512942466,22.668101491664068,113.24904934285806,-70.9350667353865,-43.853623667040665,-21.859429308547988,50150.50591251936,49843.23347929364,10.796707750227355,28.690552405546224,False,True,49212.137,50112.137,49612.137,49562.137,,False,2024-02-13 15:45:00,2024-02-13 15:36:57,2024-02-14 10:52:51,success,True,93.31,1624.2599999999939,,1,0,7,2
2024-02-13 20:00:00,48835.938,49165.84,48815.609,48966.156,2707,36422,0,2024-02-13 20:00:00,2024-02-13 20:00:00,-79.91121428566112,-27.890804136244697,48721.72882142855,-0.0025754849671953536,-0.0027019406113423807,48683.16609523813,47389.61112905532,48757.20108805657,48806.60871445384,49052.47279812212,48621.415736154115,-153.7931077470639,-159.6530057627755,518.4135979452869,89.37310182319925,69.37610801507253,53.10508462336293,49322.77409338025,47921.55737892798,62.6063348822922,44.541896134131925,True,False,49466.156,49066.156,49066.156,49116.156,2024-02-13 20:30:00,True,2024-02-13 20:30:00,2024-02-13 22:45:14,2024-02-13 20:49:44,even,True,18.66,1642.919999999994,,2,0,7,2
2024-02-13 21:00:00,49093.211,49093.211,48945.84,48984.039,1636,36422,0,2024-02-13 21:00:00,2024-02-13 21:00:00,38.562726190422836,-41.281360452689114,48799.59917857141,-0.00041472288379778253,-0.002307760696874163,48721.72882142855,48174.62653580967,48814.44366661239,48954.21267617796,49069.833269902876,48994.396824217416,-102.37146844703966,-132.70156399414418,381.31111408515505,45.68779532163899,73.75185552115727,117.37829411763232,49510.66682823237,48479.62682020246,84.11496930826091,88.7828584527408,True,False,49484.039,49084.039,49084.039,49134.039,2024-02-13 21:30:00,True,2024-02-13 21:30:00,2024-02-13 22:45:52,2024-02-13 21:52:33,even,True,18.66,1661.579999999994,,3,0,7,2
2024-02-13 22:00:00,49026.738,49204.539,48998.039,49176.34,1732,36422,0,2024-02-13 22:00:00,2024-02-13 22:00:00,77.87035714285594,-57.05382069545158,49032.58710714287,-0.00014753267784109588,-0.0012853658035007038,48799.59917857141,48241.729849392555,49242.58455689164,49044.425209268644,49088.49599079824,49177.798869625025,-65.5501918973896,-98.9389643505794,241.37112753261073,50.9947327142072,36.907870312927116,39.69344513246324,49505.14989179405,48851.947847456,87.27625792528046,86.2428314701538,True,False,49676.34,49276.34,49276.34,49326.34,2024-02-13 22:45:00,True,2024-02-13 22:45:00,2024-02-13 23:26:23,2024-02-14 06:35:00,success,True,93.31,1754.889999999994,,4,0,7,2
2024-02-13 23:00:00,49377.137,49648.238,49310.84,49594.738,2194,36422,0,2024-02-13 23:00:00,2024-02-13 23:00:00,232.98792857146327,-40.9852944389786,49305.56442857143,0.0034096876100107405,0.00019990811330454473,49032.58710714287,49592.68001678045,49759.19351148933,49221.03470904037,49168.87089575995,49428.94237048509,-17.604031649076205,-61.148217272648125,307.04622840885577,82.52849466809857,64.19940866877732,75.10321018229297,49844.95477883705,49014.42996213314,93.10445057232823,91.64376002233116,True,False,50094.738,49694.738,49694.738,49744.738,2024-02-14 09:30:00,True,2024-02-14 09:30:00,2024-02-14 10:52:50,,success,True,93.31,1848.199999999994,,5,0,7,2
2024-02-14 01:00:00,49489.598,49498.137,49326.129,49423.84,1613,56422,0,2024-02-14 01:00:00,2024-02-14 01:00:00,131.83667857140244,2.7833146317789215,49588.61704761904,0.003539392859093889,0.0030997408245590752,49437.40110714283,49995.629498827955,50625.605885139055,49421.550064367955,49323.40535388549,49581.410133814934,31.007987727207365,10.199804017110088,319.5555523184598,6.467295837668644,18.444214998264215,9.407472652244905,50014.31012944486,49150.01013818501,67.30850059761896,68.27553737033057,False,True,48923.84,49823.84,49323.84,49273.84,,False,,,2024-02-14 09:29:56,fail,False,-74.66,1773.5399999999938,,0,1,7,2
2024-02-14 02:00:00,49674.73,49699.039,49535.316,49561.84,1589,36422,0,2024-02-14 02:00:00,2024-02-14 02:00:00,151.21594047620601,30.255234200471023,49578.82149999997,0.0031207890475144846,0.0026719090653098613,49588.61704761904,49946.546756344775,50635.24715077115,49500.908285788704,49391.836032130595,49620.60153044368,44.44666323891579,28.10083677189234,223.69888105460154,3.3268362572198384,26.9527977296093,5.576871001023392,49924.09501986739,49318.60804101997,74.9648414877694,74.2006917693827,False,True,49061.84,49461.84,49461.84,49411.84,2024-02-14 03:15:00,True,2024-02-14 03:15:00,,2024-02-14 03:18:57,even,True,18.66,1792.199999999994,,1,0,7,2
2024-02-14 03:00:00,49467.938,49510.938,49382.137,49391.277,1006,36422,0,2024-02-14 03:00:00,2024-02-14 03:00:00,-9.795547619069112,35.08609729047021,49544.64683333332,0.001430592776980278,0.0007438305749820214,49578.82149999997,49576.09847105652,50011.42606194638,49474.74256798546,49407.554045101926,49487.3279680083,35.51509303916828,34.7403753053581,194.02082364376423,-31.830502923898166,-39.014901960777934,-35.366628483039676,49749.25607992738,49223.89985608922,30.548478112175417,38.79498214014318,False,True,48891.277,49791.277,49291.277,49241.277,,False,,,2024-02-14 09:29:56,fail,False,-74.66,1717.5399999999938,,0,1,7,2
2024-02-14 06:00:00,49506.238,49580.438,49481.891,49557.969,1099,36422,0,2024-02-14 06:00:00,2024-02-14 06:00:00,-34.62672619050136,43.25308667396166,49442.5308452381,-0.00040258526062905806,-0.0007183202105679066,49498.59076190474,49096.834568373364,49444.395541468904,49494.285866102204,49453.67895941603,49482.1689243206,25.619010283560783,25.79601652769778,70.54644228530105,23.267385964929417,4.636751633923268,-5.136757137835957,49578.90662140575,49386.931227235444,68.64180085441954,61.012825631944445,False,True,49057.969,49457.969,49457.969,49407.969,2024-02-14 06:30:00,True,2024-02-14 06:30:00,,2024-02-14 07:15:26,even,True,18.66,1736.199999999994,,1,0,7,2
2024-02-14 09:00:00,49616.438,49717.238,49616.438,49649.637,1330,36422,0,2024-02-14 09:00:00,2024-02-14 09:00:00,40.781059523811564,54.243570852908306,49633.41614285712,0.00021947226969683194,0.0005170760349810612,49503.96505952383,49271.37361547565,49977.804644597425,49549.945506604454,49502.1679030068,49570.12463536292,25.732824026796152,20.781308661820123,85.79884708309184,26.860127622960135,19.253641210838396,8.86739903686248,49687.45307892509,49454.29619180074,87.24436715934074,87.06374706014988,True,False,50149.637,49749.637,49749.637,49799.637,2024-02-14 09:30:00,True,2024-02-14 09:30:00,2024-02-14 10:53:06,2024-02-14 09:38:18,even,True,18.66,1754.859999999994,,2,0,7,2
2024-02-14 10:45:00,49834.535,50857.637,49792.84,50783.438,3364,36422,0,2024-02-14 10:00:00,2024-02-14 10:00:00,129.45108333328972,79.25763027454377,50043.3323333333,0.0026582778023509657,0.00383486700153517,49633.41614285712,50230.90220290349,51611.46617227549,49870.83422258315,49697.41210732398,50022.665744066064,77.23130850724556,45.29064594331401,279.46680736954266,199.79709838324197,43.343899552797666,26.707483660124126,50401.44593401495,49645.38555411718,84.03261098115001,79.9600433170721,True,False,51283.438,50383.438,50883.438,50933.438,,False,2024-02-14 11:15:00,2024-02-14 11:10:58,,success,True,93.31,1848.169999999994,,3,0,7,2
2024-02-14 13:45:00,51315.039,51807.34,51315.039,51580.059,2516,36422,0,2024-02-14 13:00:00,2024-02-14 13:00:00,382.3398214285553,390.08563496829447,51372.14316666669,0.005214938079519877,0.008405321198092548,51005.66158333335,51529.78222974499,54316.66545371259,51182.825223915715,50707.90347360012,51749.42540213276,257.58986197692866,227.48890634231435,844.9234936886018,59.09591296868166,18.047724114170705,59.628582387384085,52891.57211861237,50608.778685653146,84.47622285611364,81.63174551953504,True,False,52080.059,51680.059,51680.059,51730.059,2024-02-14 15:45:00,True,2024-02-14 15:45:00,2024-02-14 16:37:47,2024-02-14 15:48:41,even,True,18.66,1866.829999999994,,4,0,7,2
2024-02-14 16:00:00,51801.664,51801.664,51607.676,51719.941,2286,36422,0,2024-02-14 16:00:00,2024-02-14 16:00:00,188.95166666668956,587.8935214458907,51893.22426190476,0.006066610833909535,0.002425055069983855,51790.12388095241,52786.267918931146,52831.25121571637,51581.259500363856,51193.633676077654,51717.85348606817,245.34125518963992,249.14776349745037,605.5100179559157,30.131106639259087,38.62635534913716,23.89229274156969,52536.79201030866,50900.41496182768,88.6736444709647,84.91476775092487,False,True,51219.941,51619.941,51619.941,51569.941,2024-02-14 17:15:00,True,2024-02-14 17:15:00,2024-02-14 18:21:33,2024-02-14 17:20:16,even,True,18.66,1885.489999999994,,5,0,7,2
2024-02-14 17:00:00,51917.137,51989.84,51482.141,51542.938,3310,36422,0,2024-02-14 17:00:00,2024-02-14 17:00:00,103.10038095235359,634.8721510981632,51784.06313095237,0.004421961375659579,0.001438022086452494,51893.22426190476,52166.8960447387,52446.47601950575,51649.71039294238,51334.73334655367,51807.35686756112,218.16887606497767,237.00705933550188,216.07112680129185,-25.126405572678777,45.27186652903765,40.12929102169437,52099.05288874286,51514.160846379375,58.54483536178912,69.74603484842532,False,True,51042.938,51942.938,51442.938,51392.938,,False,2024-02-14 21:15:00,,2024-02-14 17:28:01,fail,False,-74.66,1810.829999999994,,0,1,7,2
2024-02-14 18:00:00,51598.238,51723.34,51337.84,51498.16,2892,36422,0,2024-02-14 18:00:00,2024-02-14 18:00:00,-109.16113095239416,639.1800216109259,51701.0077142857,0.0016119494143645792,0.001441714034848785,51784.06313095237,51524.56334513053,52523.18365458437,51646.314372923545,51419.78567499972,51713.2436109391,179.67788403410668,212.29150681391133,184.44421516559436,-63.475368765015446,-33.70651668390201,-17.3507698658359,51962.24330141265,51462.743920465546,40.310237493336146,48.99938307916066,False,True,50998.16,51898.16,51398.16,51348.16,,False,,,2024-02-15 01:41:30,fail,False,-74.66,1736.169999999994,,0,2,7,2
2024-02-14 22:00:00,51686.141,51846.238,51639.742,51786.238,1458,36422,0,2024-02-14 22:00:00,2024-02-14 22:00:00,3.9289642857402214,592.1575565912572,51607.16847619048,-2.2534624846829847e-05,-0.0006524992509470472,51607.6854761905,51196.74942090048,51747.850911261936,51580.240261454775,51522.68686999528,51554.381717234224,64.69215943385643,81.59182457877868,140.84030000367218,57.64709631914593,47.95372996223887,-5.4890897833465715,51746.01612223918,51364.247312229265,80.31645165901199,62.9856899593081,True,False,52286.238,51386.238,51886.238,51936.238,,False,2024-02-15 02:30:00,2024-02-15 02:23:34,2024-02-15 23:42:20,success,True,93.3,1829.469999999994,,1,0,7,2
2024-02-15 01:00:00,51790.637,51839.738,51733.215,51768.84,983,56422,0,2024-02-15 01:00:00,2024-02-15 01:00:00,75.16153571425093,551.2777862436924,51769.25757142857,0.0015446082242329818,0.0005764785679654206,51726.15149999999,51826.7554511262,52083.70458581855,51684.417934250756,51623.26899694961,51746.04559305128,48.08238876904943,51.80771018414557,130.92659689700218,12.933292053676269,22.653153422761534,6.056122463094653,51924.29649886223,51569.29468724033,76.43685353652567,74.15164315734297,True,False,52268.84,51368.84,51868.84,51918.84,,False,2024-02-15 02:30:00,2024-02-15 02:23:32,2024-02-15 23:42:53,success,True,93.3,1922.7699999999938,,2,0,7,2
2024-02-15 01:30:00,51804.137,51899.039,51769.023,51841.34,1059,36422,0,2024-02-15 01:00:00,2024-02-15 01:00:00,75.16153571425093,551.2777862436924,51769.25757142857,0.0015446082242329818,0.0005764785679654206,51726.15149999999,51826.7554511262,52083.70458581855,51723.57187008486,51651.525902734575,51766.297646370855,50.800033260078635,51.16979309097232,141.5979713840595,6.896523219875235,13.355530099695898,12.933292053676269,51958.95490773934,51575.14038500237,80.8161387821544,78.92172470167104,True,False,52341.34,51441.34,51941.34,51991.34,,False,2024-02-15 02:30:00,2024-02-15 02:23:36,2024-02-15 23:42:17,success,True,93.3,2016.0699999999938,,3,0,7,2
2024-02-15 02:00:00,51799.523,51898.34,51767.738,51873.738,1120,36422,0,2024-02-15 02:00:00,2024-02-15 02:00:00,43.10607142857771,535.6823012793975,51974.556214285716,0.002052493235692345,0.002205034593874486,51769.25757142857,52140.88157794673,52992.992335239906,51757.26639219094,51678.50814980673,51785.84665359479,52.607903680283925,51.41258987047075,152.09425318984032,17.86620192641567,1.6828052975179162,6.896523219875235,51992.67389540107,51580.519411788504,86.71008564479776,83.30758244055043,True,False,52373.738,51473.738,51973.738,52023.738,,False,2024-02-15 02:30:00,2024-02-15 02:23:36,2024-02-15 23:41:11,success,True,93.3,2109.369999999994,,4,0,7,2
2024-02-15 02:15:00,51873.043,52460.137,51870.34,52273.539,3043,36422,0,2024-02-15 02:00:00,2024-02-15 02:00:00,43.10607142857771,535.6823012793975,51974.556214285716,0.002052493235692345,0.002205034593874486,51769.25757142857,52140.88157794673,52992.992335239906,51836.69294723849,51722.584509080305,51886.18161953908,65.14775363083754,54.159622622544106,191.67463465028055,100.33496594429016,17.86620192641567,1.6828052975179162,52146.442376316954,51627.4208627612,84.85274183866791,84.6531167927216,True,False,52773.539,51873.539,52373.539,52423.539,,False,2024-02-15 16:30:00,2024-02-15 16:31:33,2024-02-15 03:28:23,fail,False,-74.67,2034.699999999994,,0,1,7,2
2024-02-15 04:00:00,51905.84,52126.637,51868.25,52090.438,1974,36422,0,2024-02-15 04:00:00,2024-02-15 04:00:00,30.744642857156578,538.1510081590241,52043.420642857134,0.0016783272555098779,0.0031820009201498117,52005.30085714287,52143.324379435806,53532.32735498667,51982.7224246888,51866.9335009238,52118.44392844854,73.18866249643906,73.32490795981985,232.81121864447223,9.833899896751973,-28.569811833454878,-30.847734434144513,52434.23907361858,51804.148783278506,32.692524828913,33.322306868722116,True,False,52590.438,52190.438,52190.438,52240.438,2024-02-15 05:30:00,True,2024-02-15 05:30:00,2024-02-15 16:31:24,2024-02-15 06:56:22,even,True,18.66,2053.3599999999938,,1,0,7,2
2024-02-15 04:30:00,52072.238,52241.34,51997.672,52190.637,1251,36422,0,2024-02-15 04:00:00,2024-02-15 04:00:00,30.744642857156578,538.1510081590241,52043.420642857134,0.0016783272555098779,0.0031820009201498117,52005.30085714287,52143.324379435806,53532.32735498667,52027.02636323873,51905.34271066855,52154.61486756105,75.49120888800826,73.6954725503042,245.0979530297687,22.375471276216558,13.795467836294847,9.833899896751973,52486.99710415124,51823.732630970866,49.279903125688975,40.65528005815082,True,False,52690.637,52290.637,52290.637,52340.637,2024-02-15 05:45:00,True,2024-02-15 05:45:00,2024-02-15 16:31:25,2024-02-15 05:54:17,even,True,18.66,2072.0199999999936,,2,0,7,2
2024-02-15 05:00:00,52066.738,52188.539,52043.73,52167.039,816,36422,0,2024-02-15 05:00:00,2024-02-15 05:00:00,38.119785714261525,527.6666938915514,52177.059678571466,0.0012804455785265106,0.00256362981434288,52043.420642857134,52109.06084437044,53475.94493313763,52053.736331076245,51935.79725674602,52152.88541726866,74.46050122221641,73.83834546053055,249.33858461621114,5.924555555560801,-7.654005847951339,22.375471276216558,52490.992506500545,51816.27832803678,51.25302566868393,49.384659270540986,True,False,52667.039,52267.039,52267.039,52317.039,2024-02-15 05:45:00,True,2024-02-15 05:45:00,2024-02-15 16:31:25,2024-02-15 06:05:15,even,True,18.66,2090.6799999999935,,3,0,7,2
2024-02-15 07:00:00,52161.84,52256.84,52127.84,52214.738,919,36422,0,2024-02-15 07:00:00,2024-02-15 07:00:00,27.082535714253027,522.1967847830456,52146.0928809524,0.000600247849213147,-0.00035664159026457256,52204.14221428572,51938.196142957655,52376.93470369578,52215.01697082815,52094.466710147804,52292.26236085311,78.876736230799,81.48153624070054,207.083158086792,25.292299621578422,3.7636099070878117,14.189314757531974,52573.32462427027,52012.70009743594,74.95208751455401,79.71698048608143,False,True,51714.738,52114.738,52114.738,52064.738,2024-02-15 07:45:00,True,2024-02-15 07:45:00,2024-02-15 09:42:50,2024-02-15 09:17:17,even,True,18.66,2109.3399999999933,,4,0,7,2
2024-02-15 16:00:00,52226.102,52271.438,52086.84,52251.84,1686,36422,0,2024-02-15 16:00:00,2024-02-15 16:00:00,22.454869047622196,356.2446753877739,52450.47841666665,0.0014090033769629238,0.0019470086540044726,52309.45520238093,52370.948485999426,53237.58345631222,52256.27589487982,52210.976310664715,52279.629601995155,32.44513838414423,36.85571839059962,160.53501779906833,-12.810948744416237,-24.49305916755111,-28.645835913346673,52496.351876023895,52061.407327966415,34.57026331513919,30.777791188656106,False,True,51751.84,52651.84,52151.84,52101.84,,False,2024-02-15 17:45:00,2024-02-15 17:33:21,2024-02-15 16:31:25,fail,False,-74.67,2034.6699999999933,,0,1,7,2
2024-02-15 16:15:00,52254.84,52489.34,52136.219,52437.238,2352,36422,0,2024-02-15 16:00:00,2024-02-15 16:00:00,22.454869047622196,356.2446753877739,52450.47841666665,0.0014090033769629238,0.0019470086540044726,52309.45520238093,52370.948485999426,53237.58345631222,52284.116218744464,52227.73643580067,52299.42797867224,36.13436760015611,36.71144823251092,145.07721013960375,19.79837667708489,-12.810948744416237,-24.49305916755111,52496.782212360704,52103.573744983776,49.87341621255943,37.13310693784472,True,False,52937.238,52537.238,52537.238,52587.238,2024-02-15 16:45:00,True,2024-02-15 16:45:00,,2024-02-15 17:03:24,even,True,18.66,2053.329999999993,,1,0,7,2
2024-02-16 00:00:00,51322.84,51579.738,51308.965,51571.84,1907,52523,0,2024-02-16 00:00:00,2024-02-16 00:00:00,-167.69069047617813,105.9469515736273,51672.62082142859,-0.0012596261914551753,-0.0022786219431012423,51699.21888095239,51029.914760673244,51382.86088592779,51714.51386119689,51870.02751577844,51598.593018919884,-75.72215976162988,-57.14133995600571,244.26527282657406,-25.583178878456238,-37.528230478215846,-55.69772583419399,51928.35113723576,51267.33490060401,25.204722514090616,22.442977951300094,True,False,52071.84,51671.84,51671.84,51721.84,2024-02-16 01:15:00,True,2024-02-16 01:15:00,2024-02-16 03:25:02,2024-02-16 11:09:36,success,True,93.3,2146.6299999999933,,2,0,7,2
2024-02-16 01:00:00,51633.965,51818.238,51616.012,51818.238,1515,56422,0,2024-02-16 01:00:00,2024-02-16 01:00:00,-26.598059523799748,73.30721114874905,51687.52903571428,-0.0015697507637647315,-0.001149475558988284,51672.62082142859,50872.415977365425,51750.39489672846,51712.52375392261,51826.5581259424,51596.11496697629,-66.74907335501484,-65.38238071062047,206.9644634201587,25.60200722391164,-7.102674922571168,-6.509107671161473,51877.016992593504,51316.712941359074,52.46478405050573,47.87064800084092,True,False,52318.238,51918.238,51918.238,51968.238,2024-02-16 02:45:00,True,2024-02-16 02:45:00,2024-02-16 05:38:38,2024-02-16 02:59:02,even,True,18.66,2165.289999999993,,3,0,7,2
2024-02-16 02:00:00,51877.238,51967.84,51875.773,51927.582,753,36422,0,2024-02-16 02:00:00,2024-02-16 02:00:00,14.908214285693248,65.79289359480026,51765.89761904759,-0.0006507709512187897,-0.0008673829832993934,51687.52903571428,51113.82692671977,51840.43888775505,51799.70750818182,51842.89155815651,51764.70228895767,-40.69583001000865,-55.606453999454075,158.88097372128686,51.10438562093623,36.62039250080852,49.764618507018895,51980.691603481406,51550.21297443393,91.18353434651549,84.56738632261622,True,False,52427.582,52027.582,52027.582,52077.582,2024-02-16 04:15:00,True,2024-02-16 04:15:00,2024-02-16 13:40:56,2024-02-16 04:28:51,even,True,18.66,2183.949999999993,,4,0,7,2
2024-02-16 03:00:00,51915.66,51975.738,51874.539,51968.438,1204,36422,0,2024-02-16 03:00:00,2024-02-16 03:00:00,78.36858333330747,62.23295940187381,51823.54315476192,-0.0002895322275296143,0.0002628125244367028,51765.89761904759,51207.20738554475,52222.419380511805,51864.785862865094,51866.030091511355,51940.991961472326,-20.412067258934258,-38.605324057058155,148.96072734543154,45.04591193673696,33.21646714825329,54.08806329543586,52143.588943388655,51739.894979556,91.06979156187658,88.17658910907328,True,False,52468.438,52068.438,52068.438,52118.438,2024-02-16 04:15:00,True,2024-02-16 04:15:00,2024-02-16 15:59:23,2024-02-16 04:19:23,even,True,18.66,2202.609999999993,,5,0,7,2
2024-02-16 07:00:00,52131.453,52196.738,52131.387,52159.137,505,36422,0,2024-02-16 07:00:00,2024-02-16 07:00:00,56.17701190472144,102.85194428512477,52179.12590476197,0.00198905514109463,0.0017148543562630267,52191.860821428556,52429.30586868167,52885.66517462511,52168.30830736525,52087.39092318482,52264.1125135879,39.94748602530308,33.72737947545035,158.64026645708662,-7.560223254222365,-18.390927072512568,4.51114895073988,52478.27687330497,52048.44815387083,61.91081860338645,68.44436431740412,False,True,51659.137,52059.137,52059.137,52009.137,2024-02-16 09:00:00,True,2024-02-16 09:00:00,2024-02-16 11:09:53,2024-02-16 12:21:01,success,True,93.3,2295.909999999993,,6,0,7,2
2024-02-16 08:00:00,52081.238,52107.637,52052.141,52097.039,688,36422,0,2024-02-16 08:00:00,2024-02-16 08:00:00,-12.734916666588106,99.83704579792538,52091.45057142859,0.0006305148272928071,0.0009790268499499284,52179.12590476197,51970.528483154725,52709.541103933785,52145.25533112057,52097.251384430405,52184.952573099414,30.63748255689279,34.119405839227944,129.2760912820615,-26.581348813204386,-24.92490677672322,-17.778463020302297,52359.475296330194,52008.92984986863,27.65571507028365,42.13808540647165,False,True,51597.039,51997.039,51997.039,51947.039,2024-02-16 09:00:00,True,2024-02-16 09:00:00,2024-02-16 11:12:10,2024-02-16 10:46:45,even,True,18.66,2314.569999999993,,7,0,7,2
2024-02-16 09:00:00,51899.797,51957.34,51831.84,51924.938,1298,36422,0,2024-02-16 09:00:00,2024-02-16 09:00:00,-87.67533333337633,82.17765757236339,51976.74315476189,-0.00018579523689967066,-3.307045701263353e-05,52091.45057142859,51702.66936125053,52342.46641108277,52069.253302718265,52071.117535062454,52024.132265221866,11.565276369547064,25.44982009747355,117.7053109151597,-49.59811627105955,-61.274870313071006,-33.15891606466175,52183.034434957335,51863.7300954864,12.772784435126768,20.22391699950356,False,True,51424.938,51824.938,51824.938,51774.938,2024-02-16 10:00:00,True,2024-02-16 10:00:00,2024-02-20 03:22:02,2024-02-16 10:03:23,even,True,18.66,2333.2299999999927,,8,0,7,2
2024-02-16 12:00:00,51846.586,51933.637,51805.578,51931.738,1053,36422,0,2024-02-16 12:00:00,2024-02-16 12:00:00,-65.68792857143126,32.112661586827016,51964.80049999999,-0.0014238883212099368,-0.00013369271133567513,51840.89478571427,51237.13113786479,52284.816440371535,51892.41611107235,51944.29198258026,51809.88036979704,-23.79493824436213,-18.198191973695206,161.5862500797018,20.112701066384034,4.469098383196979,9.761167526696227,52029.52180740464,51591.738932189444,58.572201758843335,47.70950314945805,True,False,52431.738,52031.738,52031.738,52081.738,2024-02-16 12:45:00,True,2024-02-16 12:45:00,2024-02-16 13:40:56,2024-02-16 16:18:11,success,True,93.3,2426.529999999993,,9,0,7,2
2024-02-16 15:45:00,52292.637,52505.633,52192.258,52476.637,1732,36422,0,2024-02-16 15:00:00,2024-02-16 15:00:00,143.68342857145035,96.4231175591849,52358.80201190476,0.0017288422023285645,0.000992638021854525,52212.43121428572,52298.59483955331,52749.67647169015,52294.29297378607,52189.927682610425,52433.25497660814,49.00467953079351,35.23159567663351,238.0339270807848,22.40739800477604,-7.700862057077757,18.466363949060906,52756.1007781672,52111.909175049084,81.4390734154991,82.3767652926382,True,False,52976.637,52076.637,52576.637,52626.637,,False,2024-02-20 15:45:00,2024-02-20 15:36:35,2024-02-16 16:18:10,fail,False,-74.67,2351.859999999993,,0,1,7,2
2024-02-16 23:00:00,51828.418,51865.738,51749.348,51854.039,924,36422,0,2024-02-16 23:00:00,2024-02-16 23:00:00,-29.425130952404288,0.5759858222372713,51901.068702380944,0.0002500550015165977,-0.0016463168113532202,51843.23771428573,51732.954408643396,51666.3825918126,51878.58075290597,51939.948341676085,51827.24265565875,-32.36021187216829,-27.823201557997955,120.53220819448673,4.953910904667282,-3.6560763673624024,4.925692122502369,51991.46113672131,51664.5241745962,50.96286610746562,45.11162995110562,True,False,52354.039,51954.039,51954.039,52004.039,2024-02-19 00:15:00,True,2024-02-19 00:15:00,2024-02-19 00:21:48,2024-02-19 03:35:45,success,True,93.3,2445.159999999993,,1,0,7,2
2024-02-19 00:00:00,51832.691,52351.84,51826.75,52223.25,1587,54469,0,2024-02-19 00:00:00,2024-02-19 00:00:00,57.83098809521471,-1.1783105302820331,52010.53263095242,0.00024516536568715974,0.0004900288749008362,51901.068702380944,51743.67320870412,52518.16312185308,51956.78408127504,51963.26646197268,51937.23081183351,-13.541286106221378,-24.43638429061462,116.97133349172029,59.513542827662604,18.398106639106118,23.1942693499077,52096.64211204734,51779.31951161969,81.4223096560807,73.52384814562967,True,False,52723.25,52323.25,52323.25,52373.25,2024-02-19 08:30:00,True,2024-02-19 08:30:00,2024-02-20 15:34:57,2024-02-19 08:37:18,even,True,18.66,2463.819999999993,,2,0,8,2
2024-02-19 03:45:00,52011.488,52117.738,52005.309,52110.738,952,36422,0,2024-02-19 03:00:00,2024-02-19 03:00:00,72.06319047621946,40.546547888785426,52163.22926190475,0.0008833387914773572,0.0015125890458165612,52133.38503571428,52092.13245682481,52965.72974924697,52118.46039858689,52091.83508328335,52144.92069143449,16.435298800977762,18.501469326839235,168.03787168987216,-27.17362229097489,-46.86800584799494,-37.91333195727202,52371.77181821582,51916.56956465316,29.10302072806323,35.98067528444858,True,False,52610.738,52210.738,52210.738,52260.738,2024-02-19 08:15:00,True,2024-02-19 08:15:00,2024-02-20 15:34:44,2024-02-19 10:39:05,even,True,18.66,2482.4799999999927,,3,0,8,2
2024-02-19 07:00:00,52120.938,52144.438,52041.84,52057.738,783,36422,0,2024-02-19 07:00:00,2024-02-19 07:00:00,-29.715440476189542,41.3334117769773,52120.571440476226,0.000492246483370829,-0.0010992910596371794,52139.166559523816,52104.5239963958,51962.724478887074,52110.33425645254,52106.905769734185,52102.33124183007,6.57223258974409,10.48457800801017,74.65587722784487,-5.362255933963752,6.3826174750502105,14.638161334718461,52203.11667608766,52000.04580757248,54.01003471128585,63.07764318485979,False,True,51557.738,52457.738,51957.738,51907.738,,False,2024-02-19 19:00:00,2024-02-20 02:42:30,2024-02-19 08:27:34,fail,False,-74.67,2407.8099999999927,,0,1,8,2
2024-02-19 08:00:00,52150.84,52381.738,52150.84,52370.34,1554,36422,0,2024-02-19 08:00:00,2024-02-19 08:00:00,-18.595119047589833,42.82612579804845,52219.21784523808,0.0004364547863728899,0.00010193046883795001,52120.571440476226,52116.12429112875,52524.24639661981,52146.52078480171,52124.50104450431,52136.57311283108,11.697628554822586,8.340770144364866,85.49937504076499,39.2641114551152,3.3233298933701008,-10.836346405274526,52253.49726913611,52021.14895652605,60.528193208871166,43.22760927772,True,False,52870.34,51970.34,52470.34,52520.34,,False,2024-02-20 15:45:00,2024-02-20 15:36:21,2024-02-19 18:52:00,fail,False,-74.67,2333.1399999999926,,0,2,8,2
2024-02-20 06:00:00,51590.637,51741.637,51515.738,51702.938,1237,36422,0,2024-02-20 06:00:00,2024-02-20 06:00:00,-58.02576190474065,-120.77985014676233,51680.71266666665,-0.0012178780312604696,-0.0009190625568745542,51657.8817857143,50886.07140164807,51647.885229532774,51669.572358760815,51729.97915131412,51630.192593395266,-42.64367018239864,-46.880426406901,151.18504579244717,16.26999965597497,-3.4229563123371918,14.037482972125872,51835.79240521507,51426.09278157546,64.44639657985022,63.91307278564875,True,False,52202.938,51802.938,51802.938,51852.938,2024-02-20 07:30:00,True,2024-02-20 07:30:00,2024-02-20 13:01:26,2024-02-20 10:11:43,even,True,18.66,2351.7999999999925,,1,0,8,2
2024-02-20 07:00:00,51795.652,51835.238,51769.527,51817.238,801,36422,0,2024-02-20 07:00:00,2024-02-20 07:00:00,22.830880952351436,-112.99432903586421,51752.06152380954,0.00024912164701927663,-0.000318616099440736,51680.71266666665,51412.841559649096,51937.83086064273,51733.39385457852,51748.16077831797,51762.96346095633,-23.546228168946982,-36.511711266615656,110.94838355469315,21.102605779138685,39.60139456487377,45.769321981453686,51914.24377875517,51613.18314315749,95.15262480997175,91.81913332579931,True,False,52317.238,51917.238,51917.238,51967.238,2024-02-20 07:45:00,True,2024-02-20 07:45:00,2024-02-20 13:03:45,2024-02-20 07:49:34,even,True,18.66,2370.4599999999923,,2,0,8,2
2024-02-20 10:00:00,51850.938,51903.637,51775.738,51799.637,856,36422,0,2024-02-20 10:00:00,2024-02-20 10:00:00,34.169130952388514,-71.7840933397747,51871.96958333337,0.0007801579121063573,0.0010823884626185508,51881.13067857143,51748.57369763772,52389.11999195302,51888.97522214922,51856.05528808751,51969.8609425525,12.974954194229213,9.450247270191113,137.51304580900504,-31.64736154107959,-17.0015792913764,-3.6198916408466175,52155.50355439466,51782.71833071034,36.77687999704273,57.93615561724042,False,True,51299.637,51699.637,51699.637,51649.637,2024-02-20 11:30:00,True,2024-02-20 11:30:00,2024-02-20 19:00:57,2024-02-20 11:36:11,even,True,18.66,2389.119999999992,,3,0,8,2
2024-02-20 21:00:00,51518.637,51540.137,51436.039,51512.84,1069,36422,0,2024-02-20 21:00:00,2024-02-20 21:00:00,-141.78499999995256,-87.11416333241505,51605.850500000015,-0.004976778559195133,-0.002917594349410459,51487.73292857142,49313.68982299467,51557.16136312632,51479.49417430747,51649.596546123255,51288.389427244576,-89.91269822174945,-81.41977598009795,504.5185424356752,32.387833849359595,52.502312349461135,37.65996800822904,51970.989459532735,50607.28939495642,69.26565422554495,59.83619065730772,True,False,52012.84,51612.84,51612.84,51662.84,2024-02-20 21:30:00,True,2024-02-20 21:30:00,2024-02-20 21:50:11,2024-02-21 09:06:09,success,True,93.3,2482.4199999999923,,4,0,8,2
2024-02-20 22:00:00,52110.539,52116.938,51961.84,52058.738,2060,36422,0,2024-02-20 22:00:00,2024-02-20 22:00:00,118.11757142859278,-55.797306389693404,51681.78428571427,-0.00216582975025272,-0.002271011995148935,51605.850500000015,50021.48249287677,51769.07010413266,51711.686685131324,51727.11442330832,51704.94094874438,-35.08260335999512,-65.1902767317642,342.6953511286498,114.79056105943891,115.5300354317369,95.41635706920351,52169.07967276806,51242.3022247207,95.95385707615783,92.91271650971662,True,False,52558.738,52158.738,52158.738,52208.738,2024-02-21 00:45:00,True,2024-02-21 00:45:00,,2024-02-21 02:53:15,even,True,18.66,2501.079999999992,,5,0,8,2
2024-02-20 23:00:00,51998.238,52029.539,51889.934,51981.738,1050,36422,0,2024-02-20 23:00:00,2024-02-20 23:00:00,75.93378571425274,-39.78335515093204,51890.895202380954,0.0022682273125457135,-0.001975099843330434,51681.78428571427,51682.93177017754,51772.02023300845,51873.894869612675,51812.56951583113,52102.07860577918,3.490481663720857,-29.67497386501627,319.619607883208,72.73820811836049,90.14682387345238,122.6296439627913,52535.06507642151,51670.592135136845,86.18027129740057,90.86406889662378,True,False,52481.738,52081.738,52081.738,52131.738,2024-02-20 23:30:00,True,2024-02-20 23:30:00,2024-02-21 01:16:09,2024-02-20 23:32:10,even,True,18.66,2519.739999999992,,6,0,8,2
2024-02-21 00:00:00,52023.84,52163.039,51999.84,52153.695,968,56422,0,2024-02-21 00:00:00,2024-02-21 00:00:00,209.11091666668653,-20.76870554618654,52062.32708333331,0.004623658095052738,0.0005841608154370217,51890.895202380954,52892.807489133214,52431.56494878715,51993.00931409962,51893.42117825221,52236.730629859005,29.320613674339256,1.1292898635937885,361.7014471065101,15.35964705888182,-1.2497856897753081,45.75409838324413,52726.52758345279,51748.43367626522,87.45754279529096,86.9860386531439,True,False,52653.695,52253.695,52253.695,52303.695,2024-02-21 01:15:00,True,2024-02-21 01:15:00,,2024-02-21 01:31:42,even,True,18.66,2538.399999999992,,7,0,8,2
2024-02-21 02:00:00,52279.137,52383.238,52241.84,52361.84,933,36422,0,2024-02-21 02:00:00,2024-02-21 02:00:00,150.485464285739,28.41427190430113,52257.32451190472,0.003815647013209593,0.0019167947781886692,52212.81254761905,52918.39681656446,53035.45904937362,52213.03247547263,52072.633523288365,52304.803504644005,64.90364432177012,47.35031883802242,320.37879911226497,11.836576539484668,-2.5764530443702824,-18.535263845944428,52738.814883445564,51872.29212584245,61.85244400925156,64.27909878515669,False,True,51861.84,52261.84,52261.84,52211.84,2024-02-21 03:00:00,True,2024-02-21 03:00:00,2024-02-21 06:34:51,2024-02-21 03:06:16,even,True,18.66,2557.0599999999918,,8,0,8,2
2024-02-21 03:00:00,52183.539,52310.938,52122.438,52275.137,1183,36422,0,2024-02-21 03:00:00,2024-02-21 03:00:00,44.51196428567346,41.61711714252306,52222.13019047623,0.002259913805932513,0.0019214994189042899,52257.32451190472,52515.02950557098,53139.02853356737,52229.722511095366,52119.231360163256,52323.38494633642,60.51746554676356,56.24276920243029,202.0471912415928,11.64986240111466,-11.40500171999156,-3.532177502565901,52597.648654512566,52050.62123816027,43.7503409846903,51.13401654462975,False,True,51775.137,52175.137,52175.137,52125.137,2024-02-21 03:45:00,True,2024-02-21 03:45:00,2024-02-21 08:06:25,2024-02-21 04:36:41,even,True,18.66,2575.7199999999916,,9,0,8,2
2024-02-21 04:00:00,52117.188,52168.84,52058.738,52082.422,885,36422,0,2024-02-21 04:00:00,2024-02-21 04:00:00,-35.194321428491094,46.29371535318933,52153.87554761903,0.0017013823415361585,0.000787974825558269,52222.13019047623,52395.25737264977,52828.43209165405,52170.77978953634,52116.955639319836,52191.26310870314,41.14863777442224,50.863531365848196,110.66454621397828,-35.03016133468918,-25.633459580363706,-42.257067767459375,52340.66024609201,52040.36597131427,7.446097592353332,16.5280944997708,False,True,51582.422,51982.422,51982.422,51932.422,2024-02-21 06:45:00,True,2024-02-21 06:45:00,2024-02-21 09:06:14,2024-02-21 07:00:08,even,True,18.66,2594.3799999999915,,10,0,8,2
2024-02-21 05:00:00,52077.145,52124.039,52033.84,52040.039,1086,36422,0,2024-02-21 05:00:00,2024-02-21 05:00:00,-68.25464285720227,46.38293941734446,52117.14485714286,0.00036388737237444033,-0.0006386142057454784,52153.87554761903,52076.427886039106,52280.411001836364,52129.57507729426,52109.76644770221,52079.207809769454,25.944322220362665,39.28648879280812,106.09629124054175,-27.871868249167164,-30.231780529691605,-26.383878224980435,52222.43780294419,51934.47781659472,7.355115428896593,10.061125075305837,False,True,51540.039,51940.039,51940.039,51890.039,2024-02-21 07:45:00,True,2024-02-21 07:45:00,2024-02-21 09:08:14,2024-02-22 01:49:07,success,True,93.3,2687.6799999999917,,11,0,8,2
2024-02-21 06:00:00,52018.953,52030.84,52000.137,52029.637,452,36422,0,2024-02-21 06:00:00,2024-02-21 06:00:00,-36.730690476164455,41.161870642339636,52050.43279761902,-0.0001832252782292251,-0.0015887221693886109,52117.14485714286,51786.82655429349,51809.14666028485,52084.82946663861,52091.016860527656,52011.367176470616,11.787696392828366,25.523530943152473,110.0030170430671,-16.2040471275468,-13.28890058484103,-9.37062263504049,52159.871249478754,51861.36310346248,6.863018867571952,6.175063579432529,False,True,51529.637,51929.637,51929.637,51879.637,2024-02-21 07:45:00,True,2024-02-21 07:45:00,2024-02-21 09:08:48,2024-02-22 01:47:48,success,True,93.3,2780.979999999992,,12,0,8,2
2024-02-21 07:00:00,51968.938,52136.84,51968.438,52069.395,805,36422,0,2024-02-21 07:00:00,2024-02-21 07:00:00,-66.7120595238448,32.08702905916289,51956.44751190474,-0.0005663274252758678,-0.0012967072527935314,52050.43279761902,51681.12962384475,51875.90876888507,52034.69165537116,52060.69602902979,51971.12030684553,-1.2252976730596856,10.743709398821567,133.7525240243577,10.336547299586528,-5.614913656645513,-17.800650154793402,52153.18621427841,51790.55439941265,42.78622728022589,24.11045906754606,True,False,52569.395,51669.395,52169.395,52219.395,,False,,,2024-02-21 09:03:49,fail,False,-74.67,2706.3099999999918,,0,1,8,2
2024-02-21 10:30:00,51780.648,51780.648,51612.027,51674.539,1212,36422,0,2024-02-21 10:00:00,2024-02-21 10:00:00,-115.87145238096855,-35.57654254922818,51690.46433333332,-0.001825595219155076,-0.0011131881736017965,51744.61903571429,51037.921466730106,51740.479209773424,51745.89915159368,51848.34438345208,51645.07745889233,-50.14156154342345,-39.64275151773829,163.75679085430843,-11.069725490167912,4.763676642549399,-28.112840729205345,51866.14912654565,51422.50579123901,32.556569486542166,25.99818466088914,False,True,51174.539,51574.539,51574.539,51524.539,2024-02-21 11:30:00,True,2024-02-21 11:30:00,2024-02-21 11:55:16,2024-02-22 01:01:33,success,True,93.3,2799.609999999992,,1,0,8,2
2024-02-21 11:30:00,51354.586,51451.738,51234.84,51267.34,2138,36422,0,2024-02-21 11:00:00,2024-02-21 11:00:00,-54.154702380968956,-50.91398709621717,51462.231773809544,-0.0029124754149879605,-0.0020443631377510514,51690.46433333332,50434.67428744584,51305.96209093797,51593.37269418028,51742.435225784175,51475.67599931203,-71.98772201487736,-52.83976803765762,209.25399742874797,-58.98202442377806,-60.51386859302875,-37.03640522882051,51758.16889584084,51191.683102783216,10.032880141516157,20.885765022383193,False,True,50767.34,51167.34,51167.34,51117.34,2024-02-21 12:00:00,True,2024-02-21 12:00:00,2024-02-21 14:07:31,2024-02-21 12:00:57,even,True,18.66,2818.269999999992,,2,0,8,2
2024-02-21 13:15:00,51218.938,51263.438,51056.84,51078.84,1488,36422,0,2024-02-21 13:00:00,2024-02-21 13:00:00,-112.41065476190124,-138.81758722920495,51174.19141666663,-0.0031961279877090612,-0.002044449838625174,51349.82111904764,50059.3615833144,51097.26714078319,51311.38324218116,51509.87933185153,51137.99193223252,-105.3767921963954,-89.728677171656,286.67948637842915,-47.26219539052545,-28.634285861626267,-16.705240798117302,51525.0092388434,50749.474625621646,32.71738895493335,37.878297729264915,False,True,50578.84,51478.84,50978.84,50928.84,,False,2024-02-21 20:30:00,2024-02-21 14:07:35,2024-02-22 00:57:11,success,True,93.3,2911.569999999992,,3,0,8,2
2024-02-21 15:00:00,51314.18,51449.738,51276.516,51339.137,1709,36422,0,2024-02-21 15:00:00,2024-02-21 15:00:00,-5.393273809509992,-191.73383703731088,51146.103107142844,-0.0028537052443709733,-0.0014080618022225006,51168.79814285712,49874.244200809546,51171.699767527716,51256.31319070348,51383.83779884618,51150.63626006195,-88.4788522230956,-99.08370208221893,252.3884754610238,51.5866948744806,49.993275885841285,41.025418988545425,51492.86070193433,50809.91181818956,83.90422114739789,73.16334821463482,True,False,51839.137,50939.137,51439.137,51489.137,,False,2024-02-22 01:00:00,2024-02-22 01:46:34,2024-02-21 15:34:10,fail,False,-74.67,2836.899999999992,,0,1,8,2
2024-02-21 15:15:00,51346.238,51348.039,51042.84,51113.34,1914,36422,0,2024-02-21 15:00:00,2024-02-21 15:00:00,-5.393273809509992,-191.73383703731088,51146.103107142844,-0.0028537052443709733,-0.0014080618022225006,51168.79814285712,49874.244200809546,51171.699767527716,51234.31731521063,51363.800924857576,51165.819259029915,-88.5965258368451,-96.98626683314419,250.7891558272124,15.18299896796816,51.5866948744806,49.993275885841285,51505.88461939665,50827.25389866318,78.01726479622043,78.68148325321602,False,True,50613.34,51013.34,51013.34,50963.34,2024-02-21 16:30:00,True,2024-02-21 16:30:00,,2024-02-21 16:31:02,even,True,18.66,2855.5599999999918,,1,0,8,2
2024-02-21 16:00:00,51199.277,51223.137,51099.703,51113.566,2061,36422,0,2024-02-21 16:00:00,2024-02-21 16:00:00,-22.695035714277765,-204.01011276054487,51066.86394047618,-0.0028536772966181417,-0.0014080236358649362,51146.103107142844,49732.54456870529,51100.02460088559,51201.5807357967,51320.221065330465,51194.558069487444,-83.08886527132563,-90.86074067469234,224.24121451323435,-5.323495356060448,16.742186102521373,17.3201197110684,51497.28370908031,50890.33242989458,66.3993800340591,68.14938831513355,False,True,50613.566,51013.566,51013.566,50963.566,2024-02-21 16:30:00,True,2024-02-21 16:30:00,,2024-02-21 16:31:02,even,True,18.66,2874.2199999999916,,2,0,8,2
2024-02-21 16:15:00,51113.492,51122.238,50888.859,50929.539,2606,36422,0,2024-02-21 16:00:00,2024-02-21 16:00:00,-22.695035714277765,-204.01011276054487,51066.86394047618,-0.0028536772966181417,-0.0014080236358649362,51146.103107142844,49732.54456870529,51100.02460088559,51159.72816105874,51291.281653083766,51141.60304471964,-87.12003024134174,-90.11259858802222,222.82758317287428,-52.9550247678053,-5.323495356060448,16.742186102521373,51442.42028200302,50839.28580743626,58.196468899496296,63.662229900006416,False,True,50429.539,51329.539,50829.539,50779.539,,False,,,2024-02-21 17:36:46,fail,False,-74.67,2799.5499999999915,,0,1,8,2
2024-02-21 18:00:00,51170.738,51253.637,51024.414,51249.137,1440,36422,0,2024-02-21 18:00:00,2024-02-21 18:00:00,14.673928571435681,-232.65085434214416,51197.58060714286,0.0005431089902846349,-0.0007556228874848405,51081.537869047614,50783.314986741934,51289.583355156945,51146.54532408155,51222.88566571713,51118.571470932235,-64.25380046376813,-78.40135795799017,128.22874296919522,7.385079119369038,3.028987616096856,7.396575851380476,51293.18027394065,50945.46266792382,61.55265817869823,61.35087237764973,True,False,51749.137,50849.137,51349.137,51399.137,,False,2024-02-22 01:00:00,2024-02-22 01:17:28,2024-02-21 20:28:11,fail,False,-74.67,2724.8799999999915,,0,2,8,2
2024-02-21 19:00:00,51352.348,51435.738,51291.938,51317.84,1639,36422,0,2024-02-21 19:00:00,2024-02-21 19:00:00,116.04273809524602,-216.2834715622521,51111.71279761901,0.0012699540559290654,-6.553978433839833e-05,51197.58060714286,51138.26010477996,51422.76739388156,51211.91533895444,51236.34234272619,51202.49849707606,-39.788232867373154,-60.79299022649207,133.95656921261863,45.13463295497786,41.35025834193948,19.790109391105943,51384.839865513095,51021.65712863903,86.41273697308422,77.85560342655064,True,False,51817.84,50917.84,51417.84,51467.84,,False,2024-02-22 01:00:00,2024-02-22 01:46:32,2024-02-21 19:45:23,fail,False,-74.67,2650.2099999999914,,0,3,8,2
2024-02-21 20:00:00,50938.34,51090.938,50863.738,51083.84,1899,36422,0,2024-02-21 20:00:00,2024-02-21 20:00:00,-85.86780952385016,-234.02153381092648,51031.71423809521,0.0008074152289305609,-6.556551128396228e-05,51111.71279761901,50970.72786422259,51419.41180788447,51128.32044829073,51185.31133713322,51153.19539903682,-45.54415555379819,-50.60891124971599,136.56368012170665,-7.610324389424932,-40.59415720672405,-22.571673890612146,51337.55636720113,50967.33443087251,31.911702833172185,44.27695336144894,False,True,50583.84,50983.84,50983.84,50933.84,2024-02-21 20:30:00,True,2024-02-21 20:30:00,,2024-02-21 20:45:44,even,True,18.66,2668.8699999999913,,1,0,8,2
2024-02-21 21:00:00,50850.203,50989.539,50644.84,50924.137,1955,36422,0,2024-02-21 21:00:00,2024-02-21 21:00:00,-79.99855952380312,-252.29065342100512,51004.392928571455,0.00021955561122592832,-6.563493964638719e-05,51031.71423809521,50687.94976796358,51416.02324517027,51013.794461588346,51107.48045730319,50982.148375645025,-57.870127172347566,-53.54721203132876,155.45498725175543,-31.704390436898393,-62.07724148604757,-28.926820433378452,51192.012608434896,50770.784142855155,21.052899892139887,17.676635561353123,False,True,50424.137,51324.137,50824.137,50774.137,,False,2024-02-23 18:15:00,,2024-02-21 23:30:04,fail,False,-74.67,2594.199999999991,,0,1,8,2
2024-02-22 03:00:00,51545.301,51628.539,51447.637,51603.84,1182,36422,0,2024-02-22 03:00:00,2024-02-22 03:00:00,123.36609523809602,-87.2659122706682,51537.12086904763,0.001678534093373146,0.0033045029131895626,51584.60426190478,51488.987194044465,52982.912836055824,51562.36016905382,51425.10193019328,51752.645965600255,65.96125371788366,52.469518943069644,294.5373551277322,-7.99320674235787,-6.927308909558633,5.7825786033208715,52150.2713950227,51353.52053617781,51.94235998115065,60.562058295633484,False,True,51103.84,51503.84,51503.84,51453.84,2024-02-22 03:45:00,True,2024-02-22 03:45:00,2024-02-22 15:42:51,2024-02-22 04:44:13,even,True,18.66,2612.859999999991,,1,0,8,2
2024-02-22 05:00:00,51433.238,51481.738,51383.844,51481.738,680,36422,0,2024-02-22 05:00:00,2024-02-22 05:00:00,-17.693821428576484,-76.74218744399695,51551.075928571416,0.0011576124576763768,0.0003883670001394292,51519.42704761905,51505.86080742688,52126.868174678595,51467.60971218786,51427.20642365113,51413.58119917446,33.10057639097795,41.88468998610977,183.12872264152966,-26.089725146179262,-38.020091159247386,-34.05076504986209,51660.80497474053,51164.857423608395,37.75535225568999,36.03155481608339,False,True,50981.738,51881.738,51381.738,51331.738,,False,2024-02-22 15:30:00,2024-02-22 15:49:05,2024-02-22 09:20:13,fail,False,-74.67,2538.189999999991,,0,1,8,2
2024-02-22 07:00:00,51453.941,51527.637,51435.863,51492.637,530,36422,0,2024-02-22 07:00:00,2024-02-22 07:00:00,-63.141666666684614,-44.50219233245298,51478.67557142859,0.0004752376711658515,-0.0008581640344016272,51487.93426190473,51349.10949992525,51530.562530987496,51517.71775134936,51480.37002738988,51530.49997144824,29.5957306024211,35.04544046767483,131.66198783414399,3.3867997936104075,2.4077598899166333,25.69170622630918,51709.74365502434,51352.756287872144,65.00183504937903,73.09576807727929,False,True,50992.637,51892.637,51392.637,51342.637,,False,2024-02-22 15:30:00,2024-02-22 15:48:38,2024-02-22 09:20:32,fail,False,-74.67,2463.519999999991,,0,2,8,2
2024-02-22 08:00:00,51540.539,51607.039,51540.539,51607.039,458,36422,0,2024-02-22 08:00:00,2024-02-22 08:00:00,-9.258690476141055,-30.459852905376465,51562.11302380952,0.0010232846348521068,-0.0003905534888178929,51478.67557142859,51623.3496039516,51748.273243418495,51553.88609185624,51510.26121577592,51610.807111455135,30.577218426507898,32.584170303362214,109.31663005268263,9.40014757480094,13.827422084665159,26.528373581029882,51759.88456202626,51463.22966088401,66.33913248291894,71.17022980783163,True,False,52107.039,51707.039,51707.039,51757.039,2024-02-22 09:00:00,True,2024-02-22 09:00:00,2024-02-22 22:31:44,2024-02-22 09:05:26,even,True,18.66,2482.1799999999907,,1,0,8,2
2024-02-22 09:15:00,51740.086,51893.539,51740.086,51859.84,1554,36422,0,2024-02-22 09:00:00,2024-02-22 09:00:00,83.43745238093106,0.05841135123046115,51700.29902380952,0.0013076771219178336,0.00010186388254256463,51562.11302380952,51821.33366459453,51950.76600435949,51675.66891977371,51590.41320889749,51727.574442724435,46.16075963196636,37.78076653532885,137.7714746496372,36.57430615755584,23.209607843105914,32.85608531132311,51915.06593350144,51541.58295194743,88.81613116288196,89.06053990227899,True,False,52359.84,51459.84,51959.84,52009.84,,False,,,2024-02-22 14:40:35,fail,False,-74.67,2407.5099999999907,,0,1,8,2
2024-02-22 11:00:00,51895.238,51898.238,51794.988,51800.637,910,36422,0,2024-02-22 11:00:00,2024-02-22 11:00:00,112.66796428569796,55.34927558214986,51884.0583452381,0.0013749693243459969,0.0012355101539943709,51812.96698809522,51988.06535327164,52308.105886112055,51781.33544872915,51690.15873544595,51886.70440729278,53.34725567483838,49.877960936739655,138.86420950446873,3.334037839755183,30.740666322664765,23.864695906362613,52075.67109012381,51699.23772446175,75.64304048895464,73.35406706689905,False,True,51300.637,51700.637,51700.637,51650.637,2024-02-22 13:30:00,True,2024-02-22 13:30:00,2024-02-22 15:15:48,2024-02-22 14:07:28,even,True,18.66,2426.1699999999905,,1,0,8,2
2024-02-22 12:00:00,51957.949,51960.738,51877.34,51930.438,1378,36422,0,2024-02-22 12:00:00,2024-02-22 12:00:00,71.09135714288277,80.67814749920217,51853.52639285714,0.0007570501708276441,0.0012387682767837458,51884.0583452381,51743.47866079555,52373.99057592772,51840.82698556925,51745.32233059092,51921.90234158931,56.2659946115964,52.57321880930973,147.01798646667123,12.17873065022286,26.608692810383218,7.172596491313016,52121.87662331932,51723.4280598593,76.12021928117746,73.55282239389066,False,True,51430.438,51830.438,51830.438,51780.438,2024-02-22 12:45:00,True,2024-02-22 12:45:00,2024-02-22 15:12:12,2024-02-22 22:27:57,success,True,93.3,2519.4699999999907,,2,0,8,2
2024-02-22 13:00:00,51708.438,51714.539,51590.176,51673.238,1394,36422,0,2024-02-22 13:00:00,2024-02-22 13:00:00,-30.531952380966686,79.14989447125845,51808.6665595238,0.0004937567847781042,0.0011983155535592322,51853.52639285714,51634.91218468947,52426.18603997314,51793.0493559651,51746.73379170045,51812.24947850018,38.910380758890824,48.765295761467826,126.1517481031256,-35.484334365326504,-39.76582800139295,-31.40201272784907,51982.554338439404,51640.44461856096,19.79095058028686,33.99759754739847,False,True,51173.238,51573.238,51573.238,51523.238,2024-02-22 14:45:00,True,2024-02-22 14:45:00,2024-02-22 15:20:36,2024-02-22 17:32:40,success,True,93.3,2612.769999999991,,3,0,8,2
2024-02-22 17:00:00,51396.34,51505.938,51322.723,51368.039,2040,36422,0,2024-02-22 17:00:00,2024-02-22 17:00:00,-89.25553571427008,0.9031942319779773,51419.64217857141,-0.0028578843882037745,-0.001191044541710749,51401.69361904765,50105.270675814994,51451.879376944366,51363.29388825925,51478.71587567532,51208.78063845889,-51.73930932168878,-37.15971732601959,263.47528638400763,7.23962194698106,16.873394908827322,-7.665467492210155,51565.9722750773,50853.08900184048,50.183659444704915,41.49450435013001,True,False,51868.039,51468.039,51468.039,51518.039,2024-02-22 17:45:00,True,2024-02-22 17:45:00,2024-02-22 22:28:37,2024-02-22 18:27:08,even,True,18.66,2631.4299999999907,,4,0,8,2
2024-02-22 18:00:00,51606.461,51765.637,51583.34,51713.137,1910,36422,0,2024-02-22 18:00:00,2024-02-22 18:00:00,17.948559523763834,6.685479312509415,51419.35480952383,-0.0019721955707305474,-0.0008080027553091097,51419.64217857141,50265.91346155816,51604.66724159061,51474.995293722335,51505.90740115586,51396.18644857244,-25.559368953901867,-36.48832141272956,232.10491363744242,69.16633230134903,55.89244582046376,50.62801513585873,51711.02808198299,51082.844815161894,87.34547336126779,74.47734788024509,True,False,52213.137,51813.137,51813.137,51863.137,2024-02-22 22:30:00,True,2024-02-22 22:30:00,,2024-02-22 22:48:36,even,True,18.66,2650.0899999999906,,5,0,8,2
2024-02-22 22:00:00,51524.832,51634.84,51478.84,51634.84,845,36422,0,2024-02-22 22:00:00,2024-02-22 22:00:00,12.772500000013679,19.710917826741934,51791.07146428568,0.0014756795702738205,0.0014981501702378095,51626.69610714286,51772.06049699196,52412.572294568505,51593.17103015251,51572.8043796309,51617.73375060199,7.283267010163399,4.021706639133145,156.27606448510167,5.238576883326459,-30.33245442032785,-34.916252493989305,51830.206437656874,51406.76106354711,39.22522550963953,42.30957728733417,False,True,51134.84,52034.84,51534.84,51484.84,,False,2024-02-23 00:30:00,2024-02-23 04:55:07,2024-02-22 22:31:40,fail,False,-74.67,2575.4199999999905,,0,1,8,2
2024-02-22 22:15:00,51631.082,51955.438,51630.508,51937.539,1445,36422,0,2024-02-22 22:00:00,2024-02-22 22:00:00,12.772500000013679,19.710917826741934,51791.07146428568,0.0014756795702738205,0.0014981501702378095,51626.69610714286,51772.06049699196,52412.572294568505,51646.15071782136,51599.8217589175,51681.75370553841,17.055586561909877,6.628482623688491,164.1506404286709,64.0199549364188,5.238576883326459,-30.33245442032785,51904.85707011711,51460.150340959706,62.24747887002393,46.65769121059932,True,False,52437.539,51537.539,52037.539,52087.539,,False,,,2024-02-23 00:10:10,fail,False,-74.67,2500.7499999999905,,0,2,8,2
2024-02-23 00:00:00,51665.738,51717.738,51509.93,51590.34,1334,56422,0,2024-02-23 00:00:00,2024-02-23 00:00:00,-58.019690476161486,42.84202076744987,51639.1149166667,-0.0003479111513347332,0.0015467781212532216,51733.051773809515,51107.16156992356,52584.69898850461,51680.40128428015,51649.49905254583,51716.4321011352,19.437450676203298,22.06468531426574,139.88300358435183,-19.730074991406582,-30.032621259015286,-31.076619539031526,51905.274155974075,51526.090046296325,19.996550715648286,27.395473437653234,False,True,51090.34,51490.34,51490.34,51440.34,2024-02-23 00:30:00,True,2024-02-23 00:30:00,2024-02-23 04:55:45,2024-02-23 00:39:32,even,True,18.66,2519.4099999999903,,1,0,8,2
2024-02-23 04:45:00,51417.84,51436.438,51042.438,51106.34,1826,36422,0,2024-02-23 04:00:00,2024-02-23 04:00:00,-76.97298809525819,-26.735543322152807,51263.79558333336,-0.0007640533824324492,-0.001767279402535866,51384.71059523808,50869.888661635014,51211.63145782022,51354.5047785654,51422.74272868443,51343.39027519782,-34.90897486996255,-27.822944673411993,189.26831870120043,-65.37268524252431,25.688740970101207,-2.658723082196957,51598.902505444436,51086.3780449512,28.92354740602735,34.54446365137337,False,True,50606.34,51006.34,51006.34,50956.34,2024-02-23 10:00:00,True,2024-02-23 10:00:00,,2024-02-23 10:04:38,even,True,18.66,2538.06999999999,,2,0,8,2
2024-02-23 06:00:00,51108.82,51115.039,51000.738,51096.539,754,36422,0,2024-02-23 06:00:00,2024-02-23 06:00:00,-110.73919047619711,-79.68099726573564,51174.37409523808,-0.0007695039975971254,-0.0018947242760915908,51153.056392857165,50789.52111269131,50961.13146015589,51203.77974145684,51315.096343892736,51126.18185414516,-56.23072000082175,-44.152339346923675,150.9740245541828,-38.93332094940706,-35.00987581701338,-40.87354867560498,51329.996787293305,50920.86692099701,21.696807592752435,19.06421244367789,True,False,51596.539,51196.539,51196.539,51246.539,2024-02-23 08:15:00,True,2024-02-23 08:15:00,2024-02-26 00:00:03,2024-02-23 09:23:46,even,True,18.66,2556.72999999999,,3,0,8,2
2024-02-23 07:00:00,51228.438,51228.539,51158.84,51195.238,652,36422,0,2024-02-23 07:00:00,2024-02-23 07:00:00,21.31770238091849,-87.20272779354855,51186.77957142857,-0.0007732958972534328,-0.001034074150666584,51174.37409523808,50748.75795765076,51141.01605334385,51212.99038390357,51291.08764386094,51112.565475060226,-47.37555738235824,-47.310487902704075,135.69263861725102,0.07311661510175327,-0.7002435500617139,-5.536484692100203,51297.25053719352,50929.380412926934,43.47454106813458,41.612499213297816,True,False,51695.238,50795.238,51295.238,51345.238,,False,2024-02-26 00:15:00,2024-02-26 00:00:03,2024-02-23 16:46:31,fail,False,-74.67,2482.05999999999,,0,1,8,2
2024-02-23 08:00:00,51242.223,51307.637,51241.84,51279.039,845,36422,0,2024-02-23 08:00:00,2024-02-23 08:00:00,12.405476190484478,-90.71386450003047,51222.54514285714,-0.0007168488434564653,-0.0008918735073328896,51186.77957142857,50729.04999901693,51152.870935652056,51222.84048719344,51274.912825520005,51183.05092500864,-38.138463165618305,-44.09565494475666,136.87574814572963,34.96260440318292,22.085996904039348,2.780744754054467,51369.33318500537,50998.26866501191,55.1505899772651,50.41519152150081,True,False,51779.039,50879.039,51379.039,51429.039,,False,2024-02-26 00:15:00,2024-02-26 00:00:10,2024-02-23 10:37:14,fail,False,-74.67,2407.38999999999,,0,2,8,2
2024-02-23 09:00:00,51310.32,51311.438,51264.664,51267.637,916,36422,0,2024-02-23 09:00:00,2024-02-23 09:00:00,35.765571428572,-87.26980505923711,51119.290940476174,-0.00043580567786175874,-0.0008006901982445655,51222.54514285714,50804.71441427353,51153.187816028534,51244.883108679634,51272.60097717479,51286.76444100449,-27.236989206539874,-36.27571412297616,122.50000132211301,33.44496319231257,30.491781561737298,27.283613347077335,51453.63944278934,51121.38943921964,83.61322121587183,78.05888130047833,True,False,51767.637,50867.637,51367.637,51417.637,,False,2024-02-26 00:15:00,2024-02-26 00:00:03,2024-02-23 10:37:15,fail,False,-74.67,2332.71999999999,,0,3,8,2
2024-02-23 10:15:00,51182.238,51186.426,51046.539,51068.039,1251,36422,0,2024-02-23 10:00:00,2024-02-23 10:00:00,-103.25420238096558,-113.6033105679162,51077.24903571429,-0.0005260304838979875,-0.000800684800603046,51119.290940476174,50742.12641219458,51112.34364584896,51151.71342495539,51211.30618102624,51137.772313725516,-37.13838209666574,-35.42397941019738,106.08534428774979,-29.98062951493921,-7.830065359492437,-60.22610560710018,51280.98752851398,50993.05709893705,39.186182666531806,30.457319422407124,False,True,50568.039,50968.039,50968.039,50918.039,2024-02-23 17:30:00,True,2024-02-23 17:30:00,,2024-02-23 17:30:45,even,True,18.66,2351.3799999999896,,1,0,8,2
2024-02-26 04:00:00,51491.438,51561.34,51467.84,51558.84,827,36422,0,2024-02-26 04:00:00,2024-02-26 04:00:00,26.40591666666296,54.4430150066255,51605.2035714286,0.0017681132825168554,0.0010258044346926165,51619.92188095238,51789.73584450311,52297.406169139584,51586.411679955054,51494.85498491329,51626.0056515308,64.2033549296757,73.42233937588425,321.2583246023902,-64.43101547987317,-73.75263433090004,-49.66884760923131,52059.70438974403,51190.806913317574,12.667408823767916,15.564174965554825,False,True,51058.84,51458.84,51458.84,51408.84,2024-02-26 09:45:00,True,2024-02-26 09:45:00,2024-02-26 11:30:07,2024-02-26 15:28:17,success,True,93.3,2444.67999999999,,2,0,9,2
2024-02-26 05:00:00,51441.738,51495.461,51412.84,51464.84,735,36422,0,2024-02-26 05:00:00,2024-02-26 05:00:00,-14.718309523777862,56.42942943408707,51616.53803571428,0.0013917432755996262,-0.00036455761085329525,51605.2035714286,51689.407037808196,51710.81230290237,51528.89898162606,51487.991728755886,51468.00545442036,42.48346104595112,58.83382394236686,261.46786029699064,-12.06928723771125,-26.39302683182177,-23.688191950379405,51820.9870658213,51113.52384301942,11.155861717915514,11.333499724470878,False,True,50964.84,51364.84,51364.84,51314.84,2024-02-26 10:00:00,True,2024-02-26 10:00:00,2024-02-26 11:40:03,2024-02-26 10:05:10,even,True,18.66,2463.3399999999897,,3,0,9,2
2024-02-26 07:00:00,51554.938,51581.738,51542.836,51544.859,1236,36422,0,2024-02-26 07:00:00,2024-02-26 07:00:00,-27.80363095238863,74.86857412008976,51532.54834523811,-0.0008602034626908563,-0.0008283632241586503,51588.73440476189,51135.95760015582,51449.212569742245,51535.625818398825,51510.734598869465,51511.44680185757,27.3254292442507,35.8873297131419,105.29389505866037,17.735690058492764,15.556600275180244,3.9030251117656007,51655.09356018676,51369.30004352838,65.60541710461678,52.72491537576308,False,True,51044.859,51444.859,51444.859,51394.859,2024-02-26 09:45:00,True,2024-02-26 09:45:00,2024-02-26 11:33:50,2024-02-26 15:26:47,success,True,93.3,2556.63999999999,,4,0,9,2
2024-02-26 08:00:00,51586.34,51626.738,51558.078,51558.082,965,36422,0,2024-02-26 08:00:00,2024-02-26 08:00:00,-56.186059523781296,81.5591116973228,51530.53451190477,-0.0005009008997951804,-0.0006495581044290926,51532.54834523811,51236.747153826946,51497.23636142799,51545.0392221973,51521.78850699398,51555.965493291995,23.208742926952254,28.73707065348279,78.31596383548369,10.137358445063,14.840687306517793,15.705002064009022,51663.1920444699,51450.23894211409,80.5148751687828,70.00341217787324,True,False,52058.082,51158.082,51658.082,51708.082,,False,2024-02-26 17:15:00,2024-02-26 17:15:36,2024-02-26 11:18:52,fail,False,-74.67,2481.96999999999,,0,1,9,2
2024-02-26 14:00:00,51108.637,51150.738,51032.84,51055.352,1088,36422,0,2024-02-26 14:00:00,2024-02-26 14:00:00,-59.720511904757586,-23.702948459344043,51125.80627380954,-0.002009580430540296,-0.0011984704615181474,51111.185250000024,50224.51317676194,51021.20024171039,51160.95275162756,51248.00944236778,51092.369901960745,-46.728688176182914,-41.38613136837048,176.60248933869966,-13.313133126961475,-0.47706501549691893,-1.3087093223221018,51330.78326256799,50852.4565413535,37.65047684868863,44.758708103836256,True,False,51555.352,51155.352,51155.352,51205.352,2024-02-26 15:00:00,True,2024-02-26 15:00:00,2024-02-26 16:43:30,,success,True,93.3,2575.26999999999,,1,0,9,2
2024-02-26 15:00:00,51259.84,51412.438,51218.742,51399.637,1414,36422,0,2024-02-26 15:00:00,2024-02-26 15:00:00,14.621023809515464,-24.567320436864975,51157.469035714304,-0.0005388096576499886,-0.00046117431602649107,51125.80627380954,50704.78943350005,51368.58721739836,51211.898521220515,51250.08461958507,51204.49389680083,-30.789164363355667,-39.51661732635375,136.45199168181225,56.798442380473716,37.30187444098556,15.711839353294636,51390.20408557128,51020.28370803038,87.5388732748989,70.6142612205143,True,False,51899.637,51499.637,51499.637,51549.637,2024-02-26 17:00:00,True,2024-02-26 17:00:00,2024-02-26 17:08:56,,success,True,93.3,2668.56999999999,,2,0,9,2
2024-02-27 00:00:00,54655.039,54811.738,54626.438,54782.84,1526,56422,0,2024-02-27 00:00:00,2024-02-27 00:00:00,193.2566666666753,783.7869915127958,54618.64239285717,0.007574737093720192,0.005965357156215828,54523.47858333333,56097.53864089201,56935.68276412605,54419.89118762879,53869.03079530835,54811.999393876846,344.33466527237033,345.2301131541254,556.3200021171644,52.36568111451197,16.699251806014217,54.859602339187404,55564.531396735016,54060.967391018676,80.7499255346866,78.07673961088588,False,True,54282.84,54682.84,54682.84,54632.84,2024-02-27 00:30:00,True,2024-02-27 00:30:00,,2024-02-27 00:51:36,even,True,18.66,2687.22999999999,,3,0,9,2
2024-02-27 01:00:00,54671.84,54676.84,54548.84,54561.059,1166,56422,0,2024-02-27 01:00:00,2024-02-27 01:00:00,95.1638095238377,843.1705216671253,54640.23729761904,0.0042872436789728515,0.004660909040760536,54618.64239285717,55286.44486212499,56761.518020731775,54496.29570785593,54056.02455985015,54727.09204953562,303.2900501847689,327.885801402432,518.783946807829,-51.69653113178356,-5.528015135816531,-26.745352941201418,55427.450377726185,54025.23372134505,52.8006062656043,63.441837073190186,False,True,54061.059,54961.059,54461.059,54411.059,,False,,,2024-02-27 03:43:27,fail,False,-74.67,2612.55999999999,,0,1,9,2
2024-02-27 03:00:00,54583.438,54748.938,54529.688,54709.039,1367,36422,0,2024-02-27 03:00:00,2024-02-27 03:00:00,34.102630952394975,880.041709551726,55074.61725,0.0033514443620601786,0.0032738586717296052,54674.33992857143,55248.307508521764,56593.46954693517,54563.81172895112,54296.48514197263,54593.92851083594,216.7290408353074,254.24400878426482,173.97160653389187,27.860132782938308,-10.84499208809575,-12.687739938031882,54830.290179656695,54359.066842015185,37.08285987157047,37.80539523177877,False,True,54209.039,55109.039,54609.039,54559.039,,False,,,2024-02-27 03:43:39,fail,False,-74.67,2537.88999999999,,0,2,9,2
2024-02-27 03:45:00,55186.539,55870.238,55091.438,55838.91,4015,36422,0,2024-02-27 03:00:00,2024-02-27 03:00:00,34.102630952394975,880.041709551726,55074.61725,0.0033514443620601786,0.0032738586717296052,54674.33992857143,55248.307508521764,56593.46954693517,54862.770406569834,54501.28727954694,54945.186298933564,240.6746635505915,240.26314040948293,289.63479142868283,222.9881348468989,103.48329170966463,24.786361541060614,55337.69326736229,54554.17933050484,86.37218951828594,74.63690692232137,True,False,56338.91,55438.91,55938.91,55988.91,,False,2024-02-27 04:15:00,2024-02-27 04:06:50,,success,True,93.3,2631.18999999999,,1,0,9,2
2024-02-27 09:00:00,56376.227,56400.738,56102.641,56209.637,1351,36422,0,2024-02-27 09:00:00,2024-02-27 09:00:00,194.2765238094944,1174.7620691776247,56238.59483333326,0.003935943402540925,-0.003095137229838947,56270.504940476196,56703.14223544064,56021.309732994065,56172.85371400145,55861.421755162766,56146.30410388718,230.47664710794197,254.8593216068888,511.0644102184347,21.074187134508975,59.127048159672995,78.13710113511479,56837.74105768207,55456.367150092294,74.88775562687657,74.03192579715257,False,True,55709.637,56109.637,56109.637,56059.637,2024-02-27 09:30:00,True,2024-02-27 09:30:00,,2024-02-27 09:46:07,even,True,18.66,2649.84999999999,,2,0,9,2
2024-02-27 12:00:00,56641.867,56647.738,56491.559,56647.738,2019,36422,0,2024-02-27 12:00:00,2024-02-27 12:00:00,151.64707142851694,1150.6321951264763,56494.19494047619,0.0016748618349119978,0.0005447463023504409,56341.00305952379,56485.02903307329,56979.65816647597,56428.94000847242,56193.13113372351,56515.75876952186,169.056978119399,178.42001357547073,254.3767152981973,49.49766597865528,34.806816305477696,62.825323357428715,56860.667335174425,56172.3502038693,87.57896991112553,87.72512901590892,True,False,57147.738,56747.738,56747.738,56797.738,2024-02-27 14:30:00,True,2024-02-27 14:30:00,2024-02-27 14:32:14,2024-02-27 14:59:06,success,True,93.3,2743.14999999999,,3,0,9,2
2024-02-27 14:30:00,56959.34,57467.738,56872.152,57431.438,4203,36422,0,2024-02-27 14:00:00,2024-02-27 14:00:00,58.085440476184885,1111.1925416409576,56655.9265,0.0022736836217516323,0.0028947134951301376,56552.280380952376,56978.9907409383,58130.112788482846,56718.084900403825,56479.82917293837,56831.62445545238,153.1476196147487,146.7801311702668,296.9302422463051,150.43103405572765,50.882617819079314,-6.491848985191609,57233.98028248489,56430.76862841987,82.19646832191246,67.17376335187278,True,False,57931.438,57031.438,57531.438,57581.438,,False,2024-02-28 09:45:00,2024-02-28 09:43:02,2024-02-27 14:57:25,fail,False,-74.67,2668.47999999999,,0,1,9,2
2024-02-27 15:00:00,56823.938,57067.438,56634.039,56984.176,3448,36422,0,2024-02-27 15:00:00,2024-02-27 15:00:00,103.64611904762569,1100.696957896529,56849.17869047616,0.002273731914426059,0.0028947883457960044,56655.9265,57109.06682187875,58297.91394880942,56772.80168608794,56540.789625633035,56906.77425490196,150.8020705163799,148.0852668343344,317.9629939062594,51.378924664670194,23.77087478491012,150.43103405572765,57337.52429667541,56477.52421312851,65.62826424334766,74.06845838324318,True,False,57484.176,57084.176,57084.176,57134.176,2024-02-27 16:00:00,True,2024-02-27 16:00:00,2024-02-27 21:52:31,2024-02-27 16:02:30,even,True,18.66,2687.13999999999,,1,0,9,2
2024-02-27 15:45:00,56932.539,57193.078,56919.664,57142.738,2246,36422,0,2024-02-27 15:00:00,2024-02-27 15:00:00,103.64611904762569,1100.696957896529,56849.17869047616,0.002273731914426059,0.0028947883457960044,56655.9265,57109.06682187875,58297.91394880942,56852.45534009242,56628.11336963452,56969.68048331613,147.00861094483844,146.73286092258792,298.11383074268434,58.30698486408801,11.944934640603606,-7.34569109052245,57373.634154818756,56567.2268118135,54.489808727492864,50.3032344946979,True,False,57642.738,56742.738,57242.738,57292.738,,False,2024-02-27 21:45:00,2024-02-27 21:54:24,2024-02-27 16:23:24,fail,False,-74.67,2612.46999999999,,0,1,9,2
2024-02-27 17:00:00,56991.738,57141.738,56838.211,56991.539,3207,36422,0,2024-02-27 17:00:00,2024-02-27 17:00:00,119.50097619050212,1084.374124805734,56931.0374642857,0.0013863338689167144,0.002853080559267699,56968.67966666666,56914.36763268776,58619.73823994131,56891.32762212383,56718.747790140755,57037.30566322667,124.4222813656379,134.8003362823896,254.84475840158393,14.443241830063926,30.09281114548503,9.681960440335388,57382.84608706881,56693.26523938453,54.36537472014936,49.94856451373837,False,True,56491.539,56891.539,56891.539,56841.539,2024-02-27 18:00:00,True,2024-02-27 18:00:00,2024-02-27 18:09:31,2024-02-27 18:02:32,even,True,18.66,2631.1299999999896,,1,0,9,2
2024-02-27 18:00:00,56760.34,57001.137,56212.695,56496.539,3816,36422,0,2024-02-27 18:00:00,2024-02-27 18:00:00,-37.64220238096459,1036.835021186802,56983.99207142855,2.0548666099731694e-05,0.0008903772141301504,56931.0374642857,56217.24267857017,57876.19199904918,56854.17773150501,56751.532296713514,56904.038178190516,95.33515798279404,121.3926233947963,253.1932811887994,-119.30103508778848,-53.92267182667274,-15.295949776351335,57245.849107795395,56560.72724858564,26.88696109065168,43.679274900760085,False,True,55996.539,56896.539,56396.539,56346.539,,False,,,2024-02-27 18:21:14,fail,False,-74.67,2556.4599999999896,,0,1,9,2
2024-02-28 03:00:00,57026.07,57129.34,56898.539,56917.934,1198,36422,0,2024-02-28 03:00:00,2024-02-28 03:00:00,21.18757142855611,679.6392066644112,56886.78729761905,-0.000531438147019593,-0.001541821988529849,56983.16789285713,56358.90667535027,56781.669799980875,56978.52534572779,56962.24412057464,57026.58133608535,16.15599095863581,18.953631982267886,163.26415316100753,-4.830574131374306,39.49032851734228,36.89801960785553,57246.98794285271,56804.67472931799,72.28467680678752,75.70609292435185,True,False,57417.934,57017.934,57017.934,57067.934,2024-02-28 06:30:00,True,2024-02-28 06:30:00,2024-02-28 09:20:58,,success,True,93.3,2649.7599999999898,,1,0,9,2
2024-02-28 05:00:00,56951.84,56973.438,56896.313,56909.039,579,36422,0,2024-02-28 05:00:00,2024-02-28 05:00:00,5.303071428541443,585.3716717665593,56940.034047619025,0.0004078613635573303,-0.000937280179547513,56892.09036904759,56826.97881959758,56811.032155596535,56923.638809491036,56933.017790310085,56894.99049054011,1.0629471476349863,5.440105423659069,106.78412205542315,-9.666773649747483,-4.442881320981542,-18.264003095966473,57039.149055314934,56749.33192576529,53.58837008493199,51.82328157541471,True,False,57409.039,57009.039,57009.039,57059.039,2024-02-28 06:30:00,True,2024-02-28 06:30:00,2024-02-28 09:20:53,,success,True,93.3,2743.05999999999,,2,0,9,2
2024-02-28 06:00:00,56944.156,57062.84,56913.941,57006.438,582,36422,0,2024-02-28 06:00:00,2024-02-28 06:00:00,47.94367857143516,548.0933964074648,57055.62789285715,0.0004038941947137957,0.0005831474526283985,56940.034047619025,56848.27593817292,57435.827547793924,56943.88839024398,56940.96335726426,56918.221790849704,3.7846094947090023,3.6437357047065477,85.71187096739028,17.86338149295625,9.546182318495994,1.5051633987968671,57035.43281665568,56802.51076504373,61.043432325388956,56.782606591681514,True,False,57506.438,57106.438,57106.438,57156.438,2024-02-28 07:00:00,True,2024-02-28 07:00:00,2024-02-28 09:31:18,2024-02-28 07:42:50,even,True,18.66,2761.71999999999,,3,0,9,2
2024-02-28 08:15:00,57072.637,57214.738,57065.438,57150.438,926,36422,0,2024-02-28 08:00:00,2024-02-28 08:00:00,9.84854761902534,508.98296805875,57119.30535714287,0.0008683774791387629,0.0005870413211217505,57065.47644047617,57104.80735523784,57504.700176037804,57092.08682361618,57039.354282390355,57173.61841795666,27.04647633766581,21.648892026456508,121.40458000818793,4.266114895071951,-5.802696594408189,17.146434468551888,57339.01460096772,57009.722234945606,55.276509271286294,58.60916629424514,True,False,57650.438,57250.438,57250.438,57300.438,2024-02-28 09:30:00,True,2024-02-28 09:30:00,2024-02-28 09:35:27,,success,True,93.3,2855.01999999999,,4,0,9,2
2024-02-28 09:30:00,57466.145,58019.938,57441.938,57874.34,2856,36422,0,2024-02-28 09:00:00,2024-02-28 09:00:00,53.82891666669457,490.8106876597667,57535.68000000004,0.0016921641494431097,0.0032283774737783804,57119.30535714287,57546.365710648104,59189.68646436818,57296.59416834201,57161.34034880484,57400.79310354316,60.23225283604552,35.492787980267124,229.65143848020853,122.5654262125754,57.89276229788811,27.823321981501067,57712.32254549144,57090.76366159488,92.93990276533783,87.13108995175419,True,False,58374.34,57474.34,57974.34,58024.34,,False,2024-02-28 10:00:00,2024-02-28 09:54:14,,success,True,93.3,2948.31999999999,,5,0,9,2
2024-02-28 16:45:00,60392.84,61261.539,60306.32,61023.84,3329,36422,0,2024-02-28 16:00:00,2024-02-28 16:00:00,407.9270357141868,997.7448649369835,60263.339440476215,0.005941048723510511,0.005136014916163085,59876.51777380947,61022.76284310911,62688.375614904195,60140.73383501282,59550.09652639282,60535.44806019956,341.8768299227959,311.6921578905941,574.6323510822831,210.527065015478,107.92124905408127,103.99227278979379,61312.70173416064,59759.69438623848,76.49901512582257,73.64956226725347,True,False,61523.84,60623.84,61123.84,61173.84,,False,2024-02-28 17:15:00,2024-02-28 18:27:28,2024-02-28 17:06:59,fail,False,-74.67,2873.64999999999,,0,1,9,2
2024-02-28 18:45:00,61723.039,62634.852,61642.637,62513.215,4621,36422,0,2024-02-28 18:00:00,2024-02-28 18:00:00,299.30880952378357,1179.1799531881115,61383.70667857141,0.0070701287988871354,0.007317398330606253,60562.64825,62359.87913358911,64516.05708321468,61171.35039241082,60424.013084300226,61746.9652624699,423.4155749350102,376.05290061628347,950.211994410559,255.47097007223783,136.90012693498284,105.55625937391596,63031.25145492415,60464.17907001565,93.90068977917535,89.86802610466596,True,False,63013.215,62113.215,62613.215,62663.215,,False,2024-02-28 19:15:00,2024-02-28 19:05:59,2024-02-28 19:25:55,success,True,93.3,2966.9499999999903,,1,0,9,2
2024-02-28 20:30:00,60314.238,60831.738,60131.855,60670.84,5567,36422,0,2024-02-28 20:00:00,2024-02-28 20:00:00,268.3902857143403,1372.5158863272736,61691.32227380952,0.0053049487400708886,0.012718825344721376,61652.09696428575,60564.71692337971,68527.51029677512,61198.64576893128,60816.0677026336,61565.963203302395,313.2881829023536,387.4053533905235,966.3137699730976,-187.8878596490904,-253.8055290677803,-174.0282287581722,62870.486792766074,60259.93961383872,30.508102860344426,36.15515703216273,True,False,61170.84,60270.84,60770.84,60820.84,,False,2024-02-28 21:00:00,2024-02-28 20:57:16,2024-02-28 22:08:20,success,True,93.3,3060.2499999999905,,2,0,9,2
2024-02-29 01:00:00,61295.438,62133.938,61271.738,62132.137,2290,56422,0,2024-02-29 01:00:00,2024-02-29 01:00:00,30.941476190491812,1132.1171283735312,61258.47752380953,0.00349541624646072,-0.004175341553913771,60855.685357142844,61084.88263506588,61641.180393206174,61115.73532559053,60926.59228068941,61080.951115239135,120.49230391519814,101.52207840894619,816.2918413447495,238.36727657383744,62.99311489507818,115.08426694188529,62184.445101054545,59978.957129423725,92.2286593937999,88.41366381152129,True,False,62632.137,62232.137,62232.137,62282.137,2024-02-29 01:30:00,True,2024-02-29 01:30:00,2024-02-29 01:41:10,2024-02-29 01:30:49,even,True,18.66,3078.9099999999903,,3,0,9,2
2024-02-29 03:15:00,61173.34,61486.539,61086.762,61269.137,2249,36422,0,2024-02-29 03:00:00,2024-02-29 03:00:00,189.00917857144668,1160.1343414587755,61558.145809523805,0.002889096327867123,0.00345012954878489,61447.48670238098,61214.38113999707,64009.37057075991,61518.813511611275,61328.92220823424,61955.660532507776,140.8026628274456,161.24354022520862,727.1770027479453,-100.85677502575709,-136.37934124530148,-72.04547746819298,62937.3494862175,60972.47157879805,37.71341445983942,47.171285227786335,True,False,61769.137,61369.137,61369.137,61419.137,2024-02-29 03:45:00,True,2024-02-29 03:45:00,2024-02-29 04:51:12,2024-02-29 03:54:52,even,True,18.66,3097.56999999999,,4,0,9,2
2024-02-29 05:00:00,61810.719,61810.719,61552.758,61668.539,2003,36422,0,2024-02-29 05:00:00,2024-02-29 05:00:00,183.4613452380654,1097.1107327787176,61801.72626190477,0.003779095751401873,0.0005644200121274597,61741.60715476187,62120.459140894025,62976.5852984437,61558.150379274965,61424.19003142611,61424.88002545581,106.4297103544086,121.66999537256237,590.2159734866067,-38.07579153757979,4.066134846820205,-59.25612349498988,62221.67158966273,60626.58846124889,37.34939508701985,30.20290564314108,False,True,61168.539,61568.539,61568.539,61518.539,2024-02-29 05:30:00,True,2024-02-29 05:30:00,2024-02-29 19:40:20,2024-02-29 05:50:14,even,True,18.66,3116.22999999999,,5,0,9,2
2024-02-29 06:45:00,62201.84,62773.438,62201.84,62513.738,3574,36422,0,2024-02-29 06:00:00,2024-02-29 06:00:00,60.11910714289843,1054.3479654367184,62044.38219047619,0.0037197187516853783,0.00025862618131316107,61801.72626190477,62315.6479024032,62838.59997810011,61807.310773799094,61603.2426786743,61912.570477468216,120.05542432731454,103.74962044428301,406.3107693005351,191.14303783972719,145.68089611284086,118.44194152044656,62462.59001602394,61364.05093891249,87.25148629440169,80.19023560341653,True,False,63013.738,62113.738,62613.738,62663.738,,False,2024-02-29 08:15:00,2024-02-29 08:07:21,2024-02-29 07:12:37,fail,False,-74.67,3041.55999999999,,0,1,9,2
2024-02-29 10:00:00,62743.34,63141.738,62695.891,63128.637,2254,36422,0,2024-02-29 10:00:00,2024-02-29 10:00:00,258.3786190475512,1118.8931627512866,62889.554392857106,0.003951792849569448,0.006761283717849045,62755.7295238095,63371.02981013337,66407.94080467272,62782.27122322461,62403.938919138716,63215.517478844136,221.45594569095556,209.12402147151778,687.5199240501964,30.282150326798728,-28.747357069136342,12.825612315078615,64145.169376311904,62287.36558137637,57.59908883046171,57.51129658176264,True,False,63628.637,62728.637,63228.637,63278.637,,False,2024-02-29 16:30:00,,2024-02-29 10:25:09,fail,False,-74.67,2966.88999999999,,0,2,9,2
2024-02-29 11:00:00,62850.871,63039.215,62735.188,62813.84,2624,36422,0,2024-02-29 11:00:00,2024-02-29 11:00:00,133.824869047603,1107.9560332593974,62906.60746428571,0.003075385879837849,0.004605148524528913,62889.554392857106,63101.54026812443,65848.50856510636,62774.60869049514,62497.60291354744,62966.56979119363,186.98463031789288,200.68381910650317,612.8720583087512,-38.37712074306182,-51.797087031292904,-66.66832679742947,63793.94706991044,62137.69251247682,46.455722211302856,47.72823531096363,False,True,62313.84,62713.84,62713.84,62663.84,2024-02-29 11:30:00,True,2024-02-29 11:30:00,2024-02-29 12:16:09,2024-02-29 11:50:44,even,True,18.66,2985.5499999999897,,1,0,9,2
2024-02-29 12:00:00,62748.27,62781.738,62376.984,62442.371,2213,36422,0,2024-02-29 12:00:00,2024-02-29 12:00:00,17.053071428606927,1078.2410396887353,62901.240142857176,0.002246131632589724,0.0005439510242437279,62906.60746428571,62718.685066925675,64024.22767427884,62683.782476717875,62522.1289031905,62609.616091847296,138.83962759117276,172.78515965109287,454.08217957796546,-131.3630598554737,-63.855601995266625,-79.71477261772088,63222.627034277546,61995.105149417046,21.54655810306105,22.591666359349706,False,True,61942.371,62842.371,62342.371,62292.371,,False,2024-02-29 15:30:00,2024-02-29 18:40:12,2024-02-29 12:55:31,fail,False,-74.67,2910.8799999999896,,0,1,9,2
2024-02-29 12:45:00,62596.539,62856.738,62575.871,62768.176,1926,36422,0,2024-02-29 12:00:00,2024-02-29 12:00:00,17.053071428606927,1078.2410396887353,62901.240142857176,0.002246131632589724,0.0005439510242437279,62906.60746428571,62718.685066925675,64024.22767427884,62665.037244657025,62543.979691629924,62536.90110870308,114.73206279404985,146.434105474283,336.44827359421583,25.915120055047737,-8.77908152735472,-89.8510216719078,62992.606278055275,62082.69593935089,44.76607867844766,32.2309241760939,True,False,63268.176,62868.176,62868.176,62918.176,2024-02-29 13:15:00,True,2024-02-29 13:15:00,2024-02-29 13:35:12,2024-02-29 13:15:48,even,True,18.66,2929.5399999999895,,1,0,9,2
2024-02-29 22:00:00,61660.398,62047.637,61578.195,62001.137,2679,36422,0,2024-02-29 22:00:00,2024-02-29 22:00:00,-125.59246428560436,359.6115575214426,61455.517702380974,-0.005298541780506909,-0.0033553161866230322,61445.504809523874,58367.35198596442,61474.95445661943,61526.17523104802,61833.48785047898,61070.30969969037,-172.20112260289898,-168.05994284972402,838.6230623884944,182.9141283109493,113.80655039556586,-10.770964912255295,62203.95083391484,59938.1685654659,59.66545728846086,45.04609987510898,True,False,62501.137,62101.137,62101.137,62151.137,2024-02-29 22:30:00,True,2024-02-29 22:30:00,2024-03-01 14:40:38,2024-02-29 22:33:48,even,True,18.66,2948.1999999999894,,2,0,9,2
2024-03-01 01:00:00,61248.41,61417.34,61199.137,61274.938,1454,56422,0,2024-03-01 01:00:00,2024-03-01 01:00:00,-38.97297619051824,170.77313315973151,61291.53345238093,0.0008727502827564434,-0.002478160961515002,61278.04994047617,60911.729900785016,61237.47122230277,61263.81732689944,61501.12835034141,61223.57283900932,-149.57492914801696,-150.41783078419508,424.1648501854236,-55.528127622936154,-35.81162813898118,-113.38186756102368,61796.195386759646,60649.450291258996,28.348911828196673,26.450194723466428,True,False,61774.938,61374.938,61374.938,61424.938,2024-03-01 01:30:00,True,2024-03-01 01:30:00,2024-03-01 02:29:19,2024-03-01 01:34:05,even,True,18.66,2966.859999999989,,3,0,9,3
2024-03-01 06:00:00,61161.883,61259.539,61116.84,61235.738,906,36422,0,2024-03-01 06:00:00,2024-03-01 06:00:00,-40.4467738095409,-30.84126435543294,61328.09867857143,0.0006459609904317505,-0.0009492238561033622,61154.31382142856,61024.78911080445,61364.67131592757,61156.21028342232,61271.47492166759,61026.47383453735,-79.8886142948395,-84.1752320231351,254.82697697750643,8.349566907469125,-3.1148410732203047,-45.089847609189746,61371.990253456985,60682.45741561771,35.077220494622445,23.489382783727535,True,False,61735.738,61335.738,61335.738,61385.738,2024-03-01 06:30:00,True,2024-03-01 06:30:00,2024-03-01 08:19:01,2024-03-01 06:42:15,even,True,18.66,2985.519999999989,,4,0,9,3
2024-03-01 07:00:00,61594.84,61616.238,61471.438,61552.34,1624,36422,0,2024-03-01 07:00:00,2024-03-01 07:00:00,173.78485714286944,-19.296796613838524,61347.770761904816,0.000436001163890452,-0.0006386884467778491,61328.09867857143,60987.176960281446,61457.31972407471,61319.84801903246,61327.91023032924,61257.64167939454,-36.27979823972419,-64.19497957762604,238.58322992085954,87.70100412801548,105.24968799443741,16.997116959028062,61581.2290397877,60935.55431900138,85.83681306077669,75.54489948257542,True,False,62052.34,61652.34,61652.34,61702.34,2024-03-01 08:30:00,True,2024-03-01 08:30:00,2024-03-01 10:35:24,2024-03-01 08:32:59,even,True,18.66,3004.179999999989,,5,0,9,3
2024-03-01 12:45:00,62020.539,62073.738,61903.637,62036.84,1788,36422,0,2024-03-01 12:00:00,2024-03-01 12:00:00,225.85873809512123,69.49862891395605,61990.763428571445,0.0017678695355993902,0.002808430792421566,61900.06305952376,62025.28920334789,63361.15981514032,61996.25234530805,61820.09914181915,62190.904477812095,90.78697613417171,77.50831148418753,288.3290692240728,17.53216305461683,6.406879600952379,31.362936016579624,62581.648721264595,61801.660234359595,76.38259821794304,78.40393066851813,True,False,62536.84,61636.84,62136.84,62186.84,,False,2024-03-01 14:45:00,2024-03-01 14:41:04,2024-03-01 16:40:27,success,True,93.3,3097.479999999989,,6,0,9,3
2024-03-01 14:00:00,61906.422,62140.637,61900.238,62058.637,1181,36422,0,2024-03-01 14:00:00,2024-03-01 14:00:00,6.295869047600718,102.7511086925806,62141.704345238104,0.002000068839290586,0.0015348565470953736,61997.059297619046,62361.191831129894,63069.61956640294,62007.69514515547,61883.836313028,62118.11158341934,77.54805179042887,80.99747095556077,258.54075747191604,-30.940288957659504,-47.36126694185077,-0.42075541793747107,62467.14160600643,61767.58156083225,42.45850979462329,53.637556021729544,True,False,62558.637,61658.637,62158.637,62208.637,,False,2024-03-01 14:45:00,2024-03-01 14:41:14,2024-03-01 16:40:27,success,True,93.3,3190.7799999999893,,7,0,9,3
2024-03-01 14:30:00,62172.766,62624.984,62150.207,62534.438,2627,36422,0,2024-03-01 14:00:00,2024-03-01 14:00:00,6.295869047600718,102.7511086925806,62141.704345238104,0.002000068839290586,0.0015348565470953736,61997.059297619046,62361.191831129894,63069.61956640294,62110.98529327699,61952.248556436905,62148.209245614016,90.36345444023755,82.59226357419882,278.2252787748374,47.0462070863432,-16.948544891667552,-30.940288957659504,62525.313371960045,61772.60511926799,73.66971708739042,54.93270563854145,True,False,63034.438,62134.438,62634.438,62684.438,,False,2024-03-01 23:00:00,2024-03-01 22:57:28,2024-03-01 16:34:04,fail,False,-74.67,3116.109999999989,,0,1,9,3
2024-03-01 15:00:00,62273.238,62438.34,62230.938,62394.738,2140,36422,0,2024-03-01 15:00:00,2024-03-01 15:00:00,144.64504761905846,137.1085862041,62286.42541666663,0.002164461281514559,0.00139339029378472,62141.704345238104,62579.62591946892,63085.873370001565,62175.76120997939,62007.0412891263,62220.81017096664,95.72752911483985,86.67739749554067,276.0469549196762,58.33964396284864,14.261281389772194,47.0462070863432,62594.9735601082,61848.146781825075,70.86480081963873,73.07222629330455,True,False,62894.738,62494.738,62494.738,62544.738,2024-03-01 15:30:00,True,2024-03-01 15:30:00,2024-03-01 22:55:47,2024-03-01 15:34:41,even,True,18.66,3134.769999999989,,1,0,9,3
2024-03-01 15:15:00,62388.039,62731.738,62350.414,62587.34,2074,36422,0,2024-03-01 15:00:00,2024-03-01 15:00:00,144.64504761905846,137.1085862041,62286.42541666663,0.002164461281514559,0.00139339029378472,62141.704345238104,62579.62591946892,63085.873370001565,62239.081023828716,62050.02637882064,62290.633344341164,104.01922506282426,90.14576300899739,293.7629934773882,69.82317337452696,58.33964396284864,14.261281389772194,62688.71338553564,61894.05330314669,69.29401965138811,71.6136604813038,True,False,63087.34,62187.34,62687.34,62737.34,,False,2024-03-01 23:00:00,2024-03-01 22:57:54,2024-03-01 16:33:44,fail,False,-74.67,3060.099999999989,,0,1,9,3
2024-03-01 16:00:00,62481.41,62521.438,62336.84,62389.691,1685,36422,0,2024-03-01 16:00:00,2024-03-01 16:00:00,144.72107142852474,179.9105006509708,62230.621107142884,0.0005370280833750782,0.0013970334440961873,62286.42541666663,61699.17071935354,63175.2820178921,62329.82761252436,62137.48516217408,62445.2515875473,109.61516298820789,99.9184703016663,237.44982552583645,25.493299621608458,56.441428276579245,72.68351530794462,62767.308852007176,62124.69432308742,71.09305838818226,75.82190944024255,False,True,61889.691,62789.691,62289.691,62239.691,,False,2024-03-01 16:45:00,2024-03-01 16:37:00,2024-03-01 22:54:35,success,True,93.3,3153.399999999989,,1,0,9,3
2024-03-04 00:00:00,62870.039,63056.039,62819.762,63053.438,1081,53215,0,2024-03-04 00:00:00,2024-03-04 00:00:00,222.33019047611742,229.2364679965831,62791.694630952305,0.003456711279480139,0.0030595690700783674,62557.81732142854,63422.65690095544,64356.22164047347,62611.03960414212,62386.87907198753,62821.45575816987,109.1526499267784,81.38816517618434,462.3123743397129,92.52499346396507,-8.047001032005937,12.235955280404596,63447.07746352848,62197.33405281125,65.94993055486673,63.416502571537364,True,False,63553.438,63153.438,63153.438,63203.438,2024-03-04 00:30:00,True,2024-03-04 00:30:00,2024-03-04 02:27:09,2024-03-04 00:30:14,even,True,18.66,3172.059999999989,,2,0,10,3
2024-03-04 02:00:00,63160.34,63346.34,63069.738,63346.34,1830,36422,0,2024-03-04 02:00:00,2024-03-04 02:00:00,184.30951190483756,317.0924446449062,63193.273952380936,0.0019201693083200871,0.004840603788809956,62976.00414285714,62787.01763136279,65692.39764059409,62963.987593194586,62703.13567922393,63180.80792982454,142.6616240584408,125.02021646839447,372.4934279259311,67.72134296521108,24.85998211218248,7.048925696624792,63685.17405752455,62677.94180212454,83.45915980542101,73.91832760818495,False,True,62846.34,63746.34,63246.34,63196.34,,False,2024-03-05 21:45:00,2024-03-04 02:49:38,2024-03-04 02:28:23,fail,False,-74.67,3097.389999999989,,0,1,10,3
2024-03-04 09:00:00,63719.969,63738.938,63525.84,63623.438,1048,36422,0,2024-03-04 09:00:00,2024-03-04 09:00:00,20.93572619050974,505.8633985003835,63769.23471428575,0.0027806649604427535,-0.00010996000030985437,63632.42590476194,64247.52904658306,64331.52628449902,63580.71149941252,63495.58412011172,63542.37946646024,79.76357003058365,97.76932509588462,145.6592380244102,31.229656002717093,24.112269349840062,-24.8739525283454,63740.51943779319,63345.73949512729,70.1610195347185,65.03801970832272,True,False,64123.438,63723.438,63723.438,63773.438,2024-03-04 09:30:00,True,2024-03-04 09:30:00,2024-03-04 09:42:50,2024-03-05 19:10:08,success,True,93.3,3190.689999999989,,1,0,10,3
2024-03-04 10:00:00,64102.34,64969.738,64061.84,64855.84,4232,36422,0,2024-03-04 10:00:00,2024-03-04 10:00:00,136.8088095238054,538.2443847635877,64305.24580952386,0.002650234563552934,0.0038644788465125547,63769.23471428575,64384.76854890991,66711.66334946276,63930.38501428167,63698.80022638193,64033.616446508466,127.9358155165246,102.08512420616913,313.9500553660352,224.02225937399635,104.06557963538944,112.35012349489989,64458.949021252614,63609.78387176432,90.04107118805616,89.45644036060763,True,False,65355.84,64455.84,64955.84,65005.84,,False,2024-03-04 10:45:00,2024-03-04 10:42:09,2024-03-05 19:07:48,success,True,93.3,3283.9899999999893,,2,0,10,3
2024-03-04 16:00:00,65152.457,65323.84,64548.043,65269.34,4400,36422,0,2024-03-04 16:00:00,2024-03-04 16:00:00,-30.37133333318343,826.432646481022,65622.20673809528,0.002279085417837151,0.0020085438391783065,65359.245321428636,65150.33519657117,67011.22939963896,65220.244190843856,64976.44275450147,65270.24389714482,176.10909684185026,193.55754116171002,189.97013645581734,28.27472927416966,-2.1271135190618224,84.026692122432,65528.203581360176,65013.784212929466,63.65182586878618,71.55828608692217,False,True,64769.34,65669.34,65169.34,65119.34,,False,2024-03-05 19:15:00,2024-03-05 18:12:44,2024-03-04 16:35:13,fail,False,-74.67,3209.3199999999892,,0,1,10,3
2024-03-04 23:00:00,67467.641,67673.438,67009.242,67193.938,3631,36421,0,2024-03-04 23:00:00,2024-03-04 23:00:00,212.93552380955953,1174.9560834811273,67328.16846428569,0.004873049549188786,0.002165920740244434,67315.14673809524,68138.73316353912,68816.34296003908,67142.98118238806,66748.65701030822,67314.28102820771,255.38123787331278,257.8744959030052,440.14597131896284,-3.100095287314616,59.3962734779052,121.67801582383981,67908.47808948832,66718.58396692711,73.667641349698,78.95719303929556,False,True,66693.938,67093.938,67093.938,67043.938,2024-03-04 23:30:00,True,2024-03-04 23:30:00,2024-03-05 07:02:28,2024-03-04 23:33:16,even,True,18.66,3227.979999999989,,1,0,10,3
2024-03-05 00:00:00,67419.906,67840.734,67405.438,67605.234,2769,56421,0,2024-03-05 00:00:00,2024-03-05 00:00:00,13.021726190447225,1173.5838395257742,67590.79509523815,0.002988604680408185,0.0011642232348004068,67328.16846428569,67775.78371524138,68338.57306474532,67214.12695596596,66885.72928198172,67459.52989404877,226.9919163196173,240.85024836800244,413.17796328004243,130.6758159614401,74.9484382525261,-22.37059167532425,68018.82014447683,66901.7396436207,68.68601868628086,60.59112309653229,False,True,67105.234,67505.234,67505.234,67455.234,2024-03-05 00:30:00,True,2024-03-05 00:30:00,2024-03-05 06:52:11,2024-03-05 00:39:32,even,True,18.66,3246.639999999989,,2,0,10,3
2024-03-05 00:30:00,67395.539,67900.039,67277.938,67818.641,2436,56421,0,2024-03-05 00:00:00,2024-03-05 00:00:00,13.021726190447225,1173.5838395257742,67590.79509523815,0.002988604680408185,0.0011642232348004068,67328.16846428569,67775.78371524138,68338.57306474532,67330.62290930108,66989.73596054675,67613.93984210526,228.704613624388,235.42372127492754,428.6731109594452,105.35946267627878,49.050485380212194,130.6758159614401,68194.14854190052,67035.23114231,82.75023803509714,74.94735849898863,True,False,68318.641,67418.641,67918.641,67968.641,,False,2024-03-05 01:15:00,2024-03-05 01:07:24,2024-03-05 06:50:04,success,True,93.3,3339.939999999989,,3,0,10,3
2024-03-05 01:45:00,67832.734,68371.133,67694.336,68278.234,3139,36421,0,2024-03-05 01:00:00,2024-03-05 01:00:00,262.62663095246535,1213.345895235674,67892.6625357143,0.003289194314401032,0.0023370807247481895,67590.79509523815,68145.37294953673,69237.07449336459,67763.48890857583,67342.30756077464,67985.43965015475,259.2534618227219,247.73942860221467,558.0118731547329,110.44509700719209,-10.400919160674675,54.84921568632126,68740.25567891363,67232.12362139586,69.5369668275663,75.79422156227331,True,False,68778.234,67878.234,68378.234,68428.234,,False,2024-03-05 03:15:00,2024-03-05 03:53:09,2024-03-05 02:34:26,fail,False,-74.67,3265.269999999989,,0,1,10,3
2024-03-05 03:00:00,68096.141,68620.336,68041.742,68431.734,2949,36421,0,2024-03-05 03:00:00,2024-03-05 03:00:00,150.53297619050136,1259.6666119256552,68312.6365714286,0.004210622003188786,0.0035512135783575273,68043.1955119048,69112.64581599337,70083.0758230786,68031.60573488065,67625.78438622034,68371.88886068107,257.2303427611914,254.84504345555143,513.4915169089815,107.28879428964865,38.27184520116134,83.49986652909138,69066.60240850819,67678.67531285394,80.12103738547732,77.95471199971324,True,False,68931.734,68531.734,68531.734,68581.734,2024-03-05 04:00:00,True,2024-03-05 04:00:00,2024-03-05 17:01:34,2024-03-05 04:01:03,even,True,18.66,3283.929999999989,,1,0,10,3
2024-03-05 04:00:00,68585.141,68620.938,68101.836,68190.039,3083,36421,0,2024-03-05 04:00:00,2024-03-05 04:00:00,269.44105952378595,1287.600669547377,68319.03553571431,0.003055946460790698,0.0031247568114721623,68312.6365714286,68643.12656715297,70118.01679265787,68203.35296468568,67828.7342067912,68485.75858685926,247.09334798683994,254.43034304949853,483.9412936566309,-50.163854489146615,39.431803233514074,27.609590643332922,69139.07933329571,67830.9378404228,72.51480532622769,80.89051640876806,False,True,67690.039,68590.039,68090.039,68040.039,,False,2024-03-05 05:15:00,2024-03-05 05:12:41,2024-03-05 16:45:54,success,True,93.3,3377.229999999989,,2,0,10,3
2024-03-05 05:00:00,68207.039,68207.039,67596.656,67717.234,2984,36421,0,2024-03-05 05:00:00,2024-03-05 05:00:00,6.398964285719558,1264.0294876892149,68340.63744047619,0.0020088384464762707,0.0016810908638092642,68319.03553571431,68159.21664138364,69515.55867434952,68145.4682550318,67902.41085684358,68245.7097230822,195.25488610900356,232.5706044297941,462.74506347769443,-128.04314172685554,-64.18642002067645,-24.839648778826813,68870.41555877708,67619.50388738731,40.714767183916656,52.665684069430654,False,True,67217.234,68117.234,67617.234,67567.234,,False,2024-03-05 07:00:00,2024-03-05 06:52:10,2024-03-05 05:25:34,fail,False,-74.67,3302.559999999989,,0,1,10,3
2024-03-05 05:30:00,68045.406,68273.641,68037.836,68247.094,2751,36421,0,2024-03-05 05:00:00,2024-03-05 05:00:00,6.398964285719558,1264.0294876892149,68340.63744047619,0.0020088384464762707,0.0016810908638092642,68319.03553571431,68159.21664138364,69515.55867434952,68148.9008926559,67938.18458371364,68221.09792225661,176.87675980730273,213.48361003502046,383.38068485169066,25.67904265568359,-50.29084348127071,-128.04314172685554,68740.1618468064,67703.53399770682,33.869625749991485,36.165798607192094,True,False,68747.094,67847.094,68347.094,68397.094,,False,2024-03-05 16:45:00,2024-03-05 16:51:40,2024-03-05 06:19:45,fail,False,-74.67,3227.889999999989,,0,2,10,3
2024-03-05 12:00:00,66495.445,66816.836,66495.047,66798.539,2550,36421,0,2024-03-05 12:00:00,2024-03-05 12:00:00,-174.19203571423714,569.4621364171035,66616.45140476192,0.0026996108702542322,-0.0029714739718316794,66593.96421428572,66622.20144545118,66438.74768441636,66751.6644341599,66991.72163901544,66547.64969005848,-129.1177153615281,-117.97182996034243,472.0444895665727,-34.35328895765997,-58.93038974892988,-97.34678534563864,67184.90975097335,65908.8896291436,51.01882779726744,52.58084329785677,True,False,67298.539,66898.539,66898.539,66948.539,2024-03-05 12:30:00,True,2024-03-05 12:30:00,2024-03-05 14:53:05,2024-03-05 12:59:32,even,True,18.66,3246.549999999989,,1,0,10,3
2024-03-05 14:00:00,66730.836,67114.438,66650.555,67109.039,2299,36421,0,2024-03-05 14:00:00,2024-03-05 14:00:00,46.64400000002934,446.0917777213763,66904.69872619049,0.0029527992145625807,-0.00034518475853855977,66663.09540476195,67171.94149919038,67312.31900744584,66845.573587,66942.33088557539,66930.11486308902,-77.41483119012264,-95.21795962231343,306.73924746358716,59.83933333319146,18.20837770907383,10.645016855880385,67345.71284716486,66516.01687901319,60.12009215713575,60.60644066726811,True,False,67609.039,67209.039,67209.039,67259.039,2024-03-05 15:00:00,True,2024-03-05 15:00:00,2024-03-05 15:04:16,2024-03-05 17:05:08,success,True,93.3,3339.849999999989,,2,0,10,3
2024-03-05 15:00:00,67378.148,67906.539,67364.734,67901.641,3707,36421,0,2024-03-05 15:00:00,2024-03-05 15:00:00,241.60332142854168,442.3260510844266,67246.01938095239,0.003925280208637917,0.0011924718785065336,66904.69872619049,67972.10849747025,68450.23508081405,67127.82098138255,67061.26930888637,67235.60956621949,-10.69075918100134,-61.899658532391996,349.3518517193161,182.03491744067287,83.1945583075576,43.52043653243163,67708.73456604056,66763.98456639842,96.2376992857911,89.86387708093748,True,False,68401.641,67501.641,68001.641,68051.641,,False,2024-03-05 16:45:00,2024-03-05 16:44:04,2024-03-05 16:11:37,fail,False,-74.67,3265.179999999989,,0,1,10,3
2024-03-05 16:30:00,67649.836,68502.336,67323.648,68456.938,4246,36421,0,2024-03-05 16:00:00,2024-03-05 16:00:00,341.32065476190473,470.6081849035254,67897.47189285711,0.004036907437915927,0.003098236048607507,67246.01938095239,68316.86281866585,69787.90801803558,67612.57754783276,67360.27137932119,67907.97757791537,87.56071995466482,25.339164556869093,516.2224082997147,191.62362607500108,28.57147402818373,27.294908840674907,68606.37782911999,67211.07732671076,77.43151898075837,75.77080131707106,True,False,68956.938,68556.938,68556.938,68606.938,2024-03-05 17:00:00,True,2024-03-05 17:00:00,2024-03-05 17:02:39,2024-03-05 17:05:01,success,True,93.3,3358.479999999989,,1,0,10,3
2024-03-05 18:00:00,66826.336,67066.898,64581.84,65444.941,7833,36421,0,2024-03-05 18:00:00,2024-03-05 18:00:00,-246.51736904760764,472.3050671862293,67066.12035714286,-0.0033884491287756954,0.005784764548929182,67650.9545238095,63696.07816723496,71404.86958060578,67204.76471637476,67274.36435232034,67378.59077949775,0.660548201893107,59.094184304924035,702.6828572373357,-470.55961197119905,-183.81908943918825,-176.41303130380402,68327.21263676816,66428.46892222734,15.379182206574912,22.320569669607448,False,True,64944.941,65844.94099999999,65344.941,65294.941,,False,2024-03-05 18:45:00,2024-03-05 18:15:31,2024-03-05 18:24:58,success,True,93.3,3451.7799999999893,,2,0,10,3
2024-03-05 23:00:00,61938.438,63346.137,61911.84,63036.238,6920,36422,0,2024-03-05 23:00:00,2024-03-05 23:00:00,-1134.8609166666574,-724.4645332100044,62424.556285714294,-0.024614742064999865,-0.013317227615047403,62705.72054761907,50939.25724226098,60625.649967534475,63136.74246411898,64247.503844435174,62185.29410319918,-596.0079952716769,-518.6885082683988,1784.1571888861934,-29.46275128997513,-232.7493023736024,-295.0802191262701,64593.90630819554,59775.18189820282,49.465533400109756,50.60306726650446,True,False,63536.238,62636.238,63136.238,63186.238,,False,2024-03-05 23:30:00,2024-03-05 23:17:24,2024-03-06 00:22:59,success,True,93.3,3545.0799999999895,,3,0,10,3
2024-03-06 01:00:00,63411.039,63701.281,63240.551,63689.617,3315,56422,0,2024-03-06 01:00:00,2024-03-06 01:00:00,149.82284523813723,-863.4785597019509,62871.79384523809,0.0018539629991837353,-0.005851961913703697,62574.37913095243,59984.0823604218,62859.04293845026,63337.13202288304,63867.56021012122,63267.17363295496,-397.9911828482145,-463.3527605140473,1034.1049736093894,240.57874681809335,176.53879291364865,112.88404987958347,64664.715347327634,61871.13191858229,86.96001250564962,82.02084903450607,True,False,64189.617,63789.617,63789.617,63839.617,2024-03-06 01:45:00,True,2024-03-06 01:45:00,2024-03-06 01:45:42,2024-03-06 01:55:43,success,True,93.3,3638.3799999999896,,4,0,10,3
2024-03-06 02:00:00,63739.137,63874.84,63535.488,63667.523,3712,36422,0,2024-03-06 02:00:00,2024-03-06 02:00:00,297.41471428566,-868.871046932938,63088.5357857143,0.011663123817693565,-0.0037882782529913457,62871.79384523809,65679.19548906287,63185.652918341955,63566.40583813699,63854.08426588577,63908.044323701404,-283.90078898417414,-374.66550847970376,852.5541314783636,38.32123804609728,139.67548194016854,237.9120567595237,65060.492401197196,62757.09624620561,82.74368218199226,89.17231431597092,True,False,64167.523,63767.523,63767.523,63817.523,2024-03-06 02:30:00,True,2024-03-06 02:30:00,2024-03-06 02:34:41,2024-03-06 02:44:29,success,True,93.3,3731.67999999999,,5,0,10,3
2024-03-06 05:00:00,62834.84,63099.738,62814.938,62830.34,2047,36422,0,2024-03-06 05:00:00,2024-03-06 05:00:00,64.18271428573644,-948.3863143721974,63322.75507142854,0.003658198051346681,-0.0009485475896242416,63396.909749999984,63752.628652295156,63885.508863898445,63256.38708064554,63510.47048137787,63107.01505228754,-195.23478949175478,-211.16782997108265,359.4327782567773,-169.93812555908517,-156.53250257992477,-36.45517199860478,63592.24930293419,62620.28080164089,11.479472607295465,18.91136844428939,False,True,62330.34,63230.34,62730.34,62680.34,,False,,,2024-03-06 05:22:34,fail,False,-74.67,3657.0099999999898,,0,1,10,3
2024-03-06 06:00:00,63308.438,63578.238,63291.262,63527.34,2002,36422,0,2024-03-06 06:00:00,2024-03-06 06:00:00,-74.1546785714454,-928.0088766559711,63646.34438095242,0.002415201978295262,0.0008213158441435551,63322.75507142854,63587.23287905681,64857.335200730384,63292.65377653903,63459.89273659397,63107.766622291005,-152.92529191687208,-186.180701811638,332.93011558098823,84.82126728592266,5.195792913560581,-44.8004334364814,63558.72227832534,62658.31096625667,43.14923173229795,31.46860966289969,False,True,63027.34,63927.34,63427.34,63377.34,,False,,,2024-03-06 06:49:52,fail,False,-74.67,3582.3399999999897,,0,2,10,3
2024-03-06 11:00:00,66993.805,67324.539,66956.891,67123.492,3444,36421,0,2024-03-06 11:00:00,2024-03-06 11:00:00,664.5012261903903,-1.1306710850694799,66773.57063095237,0.008702985364265167,0.008685410520644463,66640.12194047615,68507.68552271713,71328.73182323648,66583.79551440812,65769.63990564461,67160.44553525971,419.76173276004556,352.98921432259965,1505.6598638256223,-34.64535397311556,-25.86854248374584,50.79792122465733,69193.08635142431,65126.304719095126,71.75115281729852,78.78830847374508,False,True,66623.492,67523.492,67023.492,66973.492,,False,2024-03-06 11:45:00,2024-03-06 11:39:33,2024-03-06 14:01:45,success,True,93.3,3675.63999999999,,1,0,10,3
2024-03-06 12:00:00,66171.945,66635.141,66165.578,66428.539,3273,36421,0,2024-03-06 12:00:00,2024-03-06 12:00:00,133.44869047621614,75.04840803433035,66860.84417857142,0.007424817771280533,0.006153347135387439,66773.57063095237,68211.13097513636,70304.8112552068,66573.34117700534,65986.67726429919,66918.3924103887,361.7122012278851,373.38870270075324,1125.7318587964517,-65.77211730308773,-131.81116752664093,-31.03551049195812,68438.13041976391,65397.15440101349,42.81505312657881,54.077718702403764,False,True,65928.539,66828.539,66328.539,66278.539,,False,2024-03-06 14:45:00,2024-03-06 14:45:01,2024-03-06 13:18:22,fail,False,-74.67,3600.96999999999,,0,1,10,3
2024-03-06 14:00:00,67365.734,67669.805,67057.625,67197.141,3460,36421,0,2024-03-06 14:00:00,2024-03-06 14:00:00,143.83211904767086,306.61310487367155,66633.80794047615,0.0007565174230788436,0.0012592451268836863,67004.6762976191,64816.472109073606,68407.34424542765,66899.00261581507,66434.79255325743,66885.20708840727,309.84719317927375,324.56196306140276,489.2390984098228,0.7742696938075824,46.71316649465007,25.09437633304333,67547.17987126054,66224.73430555401,70.48143670568824,64.2931591600082,False,True,66697.141,67097.141,67097.141,67047.141,2024-03-06 14:30:00,True,2024-03-06 14:30:00,2024-03-06 14:39:35,2024-03-06 16:31:22,success,True,93.3,3694.26999999999,,1,0,10,3
2024-03-06 19:00:00,67139.641,67179.938,66791.438,67051.039,4923,36421,0,2024-03-06 19:00:00,2024-03-06 19:00:00,282.11494047616725,378.05520632381376,66813.14178571431,0.003538272115645588,-0.0008008044335400997,66579.20513095235,66732.5698356595,67177.47601195285,66706.06197737396,66548.70538872361,66866.4888008256,106.15042108013586,100.03443460586996,460.21731834484126,83.40459201924386,191.86315376682614,109.41286480902636,67489.28218059114,66245.19542106005,83.17235474551075,80.82393036773333,True,False,67551.039,67151.039,67151.039,67201.039,2024-03-06 20:00:00,True,2024-03-06 20:00:00,2024-03-07 16:33:23,2024-03-06 20:07:45,even,True,18.66,3712.92999999999,,2,0,10,3
2024-03-06 23:00:00,66909.586,66915.234,66617.008,66677.641,2903,36422,0,2024-03-06 23:00:00,2024-03-06 23:00:00,-11.01782142848242,454.354892622272,66952.00580952382,0.0025107728730389563,0.0009228870263803563,67072.68739285716,66982.87419108271,67974.2047224348,66915.34989468806,66844.19409210855,66899.35926969384,71.4182552495331,94.12078882158214,305.46885650639194,-92.98967251465365,-23.28486790500756,-35.88021740630211,67311.74222597748,66485.47631341021,21.73441752111013,31.71897674954721,False,True,66177.641,66577.641,66577.641,66527.641,2024-03-06 23:30:00,True,2024-03-06 23:30:00,2024-03-07 00:22:31,2024-03-06 23:54:46,even,True,18.66,3731.5899999999897,,3,0,10,3
2024-03-07 00:00:00,66446.938,66446.938,66217.516,66312.234,1797,56421,0,2024-03-07 00:00:00,2024-03-07 00:00:00,-120.6815833333385,419.0448902378703,66542.89885714292,0.0013024664719919394,-0.0009147706812791659,66952.00580952382,66255.96686372592,67030.73378218859,66687.64866671784,66740.66383422412,66537.97871792223,15.064811433519935,57.311605789742366,260.37431370370007,-114.45101719985541,-73.22453525970923,-91.47381320956629,66889.48404142223,66184.97339442224,13.932584159278433,11.89350794632604,False,True,65812.234,66212.234,66212.234,66162.234,2024-03-07 00:45:00,True,2024-03-07 00:45:00,2024-03-07 01:03:06,2024-03-07 00:49:36,even,True,18.66,3750.2499999999895,,4,0,10,3
2024-03-07 01:00:00,65944.438,66171.734,65722.688,66155.586,3085,56421,0,2024-03-07 01:00:00,2024-03-07 01:00:00,-409.1069523808983,336.05375001944776,66273.71535714285,-0.0011569519502478884,-0.0016441060094759068,66542.89885714292,65412.796137014564,66623.67455093475,66429.45795537328,66589.35876243985,66191.46858823532,-40.87365540138853,9.814622825686682,374.56122720372525,-81.91293257648067,-119.1836460268969,-116.47098108011414,66697.12624496035,65684.31093151029,9.50839661782795,10.619309433551058,False,True,65655.586,66055.586,66055.586,66005.586,2024-03-07 02:30:00,True,2024-03-07 02:30:00,2024-03-07 03:10:01,2024-03-07 02:31:20,even,True,18.66,3768.9099999999894,,5,0,10,3
2024-03-07 03:00:00,66237.336,66293.539,65590.125,65830.914,3386,36421,0,2024-03-07 03:00:00,2024-03-07 03:00:00,-114.00208333335468,243.76623480908165,66205.9136785714,-0.002746570548004095,-0.002766137202447584,66159.7132738095,64632.30326534582,65729.73179882341,66160.0733025757,66351.43643746727,65940.8967100103,-85.90427154451027,-61.32866573180473,415.8173373157463,-39.32557550739148,29.842091503247502,25.0550687994255,66502.25011538656,65378.04330463405,41.93791362270274,36.73320766887894,True,False,66330.914,65930.914,65930.914,65980.914,2024-03-07 03:30:00,True,2024-03-07 03:30:00,2024-03-07 03:58:58,2024-03-07 03:37:44,even,True,18.66,3787.5699999999892,,6,0,10,3
2024-03-07 04:00:00,66456.438,66520.734,66227.242,66379.539,3376,36421,0,2024-03-07 04:00:00,2024-03-07 04:00:00,46.20040476191207,229.75116065127077,66173.20177380953,-0.0026836374893568324,-0.0022054061466782026,66205.9136785714,64482.971295257455,65920.52859029893,66219.20384836005,66329.76836555639,66126.92582249745,-65.4947900709376,-69.38528724078058,357.3336548100227,59.82187994499691,78.89947884417779,5.094040935655357,66610.82625649098,65644.52538850391,75.082513652426,62.51750588113091,True,False,66879.539,65979.539,66479.539,66529.539,,False,2024-03-07 10:15:00,2024-03-07 10:11:37,2024-03-07 04:27:19,fail,False,-74.67,3712.899999999989,,0,1,10,3
2024-03-07 06:00:00,65896.734,66053.539,65696.297,66000.039,2812,36421,0,2024-03-07 06:00:00,2024-03-07 06:00:00,-111.60633333335863,139.90078625538445,66017.47782142859,-0.0010144542999601762,-0.0011844661131158794,66061.59544047617,65119.87693111028,66041.16533997512,66109.58243058952,66217.40217984251,66107.95001135195,-65.21507087242207,-63.346880868832045,184.88204755448558,-34.79240626076353,-50.002624010972795,-43.76552287583763,66357.5407755505,65856.85924715339,37.43208300514357,49.90897836195961,True,False,66500.039,66100.039,66100.039,66150.039,2024-03-07 06:30:00,True,2024-03-07 06:30:00,2024-03-07 09:56:24,2024-03-07 06:42:35,even,True,18.66,3731.559999999989,,1,0,10,3
2024-03-07 15:00:00,66763.703,66845.641,66625.078,66679.438,2210,36421,0,2024-03-07 15:00:00,2024-03-07 15:00:00,34.82735714285809,199.09680570730416,66975.25221428573,0.0020342932512991607,0.001199005232089627,66934.95190476191,67184.66938569401,67826.46630395392,66815.52495506822,66706.54650274245,66861.44651221186,74.45803246878495,84.18660554296807,262.59845389101,-34.03974165812542,-22.26055624350556,-22.238597523304634,67215.95442496472,66505.438599459,27.198079993700773,36.90443679569163,False,True,66179.438,67079.438,66579.438,66529.438,,False,2024-03-08 18:15:00,2024-03-08 18:11:42,2024-03-07 16:02:24,fail,False,-74.67,3656.889999999989,,0,1,10,3
2024-03-07 16:00:00,66959.836,67190.234,66958.813,67091.336,2289,36421,0,2024-03-07 16:00:00,2024-03-07 16:00:00,40.30030952382367,217.0250611075753,66994.31094047627,0.001631843709222702,0.0021891381494373724,66975.25221428573,67021.14476964856,68592.63421853773,66898.87061150357,66779.10907383844,66917.16612762303,76.89837786296266,78.69351781502095,110.01774139906472,40.6667512900749,4.590041279690922,8.505580323224422,67067.19007851176,66768.6421767343,57.84748858222779,49.71777799100237,False,True,66591.336,67491.336,66991.336,66941.336,,False,2024-03-08 02:00:00,2024-03-07 16:46:43,2024-03-07 16:33:08,fail,False,-74.67,3582.219999999989,,0,2,10,3
2024-03-07 21:00:00,67644.313,67906.734,67624.477,67732.336,2211,36421,0,2024-03-07 21:00:00,2024-03-07 21:00:00,150.9484999999986,362.32684043061454,67600.11989285711,0.002034114951838916,0.00039289041380162904,67525.75255952383,67819.00050386679,68219.89674540999,67581.11926600666,67366.30172256837,67805.72700825601,128.047406867292,122.35434863624343,347.1919872545375,40.51634090131847,37.9468249053607,24.102358101212303,68275.93619104964,67337.01782546239,66.15661861666253,66.77022227294931,False,True,67232.336,67632.336,67632.336,67582.336,2024-03-07 21:30:00,True,2024-03-07 21:30:00,2024-03-07 23:06:52,2024-03-07 22:01:35,even,True,18.66,3600.8799999999887,,1,0,10,3
2024-03-07 23:00:00,67571.734,67598.336,67054.242,67205.836,2877,36421,0,2024-03-07 23:00:00,2024-03-07 23:00:00,18.11034523813578,376.3681479353836,67497.78416666671,0.0010302056230141463,0.0003926970802084474,67618.23023809525,67339.5620253724,68273.2548042309,67565.78698488328,67459.56287168732,67563.476372893,87.25357828241249,106.43851022683354,282.7692117359889,-120.46233642926381,-37.84991159274068,6.341038871672936,67945.21480873658,67180.23793704942,44.30040565659673,59.20416097829588,False,True,66705.836,67105.836,67105.836,67055.836,2024-03-08 01:45:00,True,2024-03-08 01:45:00,2024-03-08 18:03:39,2024-03-08 02:54:01,even,True,18.66,3619.5399999999886,,2,0,10,3
2024-03-08 03:00:00,67112.641,67305.336,67018.852,67044.945,2452,36421,0,2024-03-08 03:00:00,2024-03-08 03:00:00,-86.56702380950446,240.57216578326188,66983.65135714285,-0.0015490580053231066,-0.0019276835241182012,67057.93264285718,66207.80483714331,66772.65816375411,67070.95634932347,67185.59396068592,66920.91805194356,-40.9079859797057,-18.763989440410388,301.2973938143395,31.522654282744043,36.00896972825285,-42.88941107671417,67329.16953359293,66514.1665702942,30.77592229631482,22.17683530332744,True,False,67544.945,67144.945,67144.945,67194.945,2024-03-08 05:30:00,True,2024-03-08 05:30:00,2024-03-08 08:59:10,2024-03-08 05:37:54,even,True,18.66,3638.1999999999884,,3,0,10,3
2024-03-08 05:00:00,67164.117,67233.641,67035.742,67168.039,1512,36421,0,2024-03-08 05:00:00,2024-03-08 05:00:00,28.24130952381529,198.27385571798368,67065.03735714282,-0.0008148514477907667,-0.0013432121254063093,67011.89266666667,66397.05968662217,66949.29682131996,67064.97774982927,67124.02794218794,67037.06810388713,-34.47151566168759,-37.040520207183896,161.73073974180704,33.713314069464104,58.62846990022808,24.936640178930247,67256.90460253856,66818.73160523569,62.704919078981085,50.75307176528613,True,False,67668.039,67268.039,67268.039,67318.039,2024-03-08 09:00:00,True,2024-03-08 09:00:00,2024-03-08 09:00:35,2024-03-08 09:55:49,success,True,93.3,3731.4999999999886,,4,0,10,3
2024-03-08 06:00:00,67201.734,67290.234,67141.031,67286.836,1267,36421,0,2024-03-08 06:00:00,2024-03-08 06:00:00,53.14469047615421,189.71559639000043,67112.72460714285,0.0002386154703071181,-0.0006437417470051046,67065.03735714282,66912.42471681316,67116.30380619675,67147.44146385808,67152.82922082258,67214.74596732027,-14.118700875013019,-27.05343989320585,156.74834909305915,46.74314000684535,37.19477984182595,39.30074475404399,67427.8562385959,67003.13569604464,80.48473312969405,79.488696398308,True,False,67786.836,66886.836,67386.836,67436.836,,False,2024-03-08 09:00:00,2024-03-08 13:59:26,2024-03-08 07:37:22,fail,False,-74.67,3656.8299999999886,,0,1,10,3
2024-03-08 13:00:00,67382.336,67562.141,67327.281,67551.336,1526,36421,0,2024-03-08 13:00:00,2024-03-08 13:00:00,44.34197619052429,152.18995366353192,67492.60221428571,0.0010458717885211573,0.0005558772757243686,67313.96226190477,67509.9321045549,68004.69858715171,67334.26587924258,67272.8782600077,67308.06430340557,28.574365517823026,19.514741446797498,203.9698246995032,36.12372377018619,-14.333507739851484,-3.065398004866438,67584.9235667499,67032.70504006124,69.75473456577312,52.45459375635645,True,False,68051.336,67651.336,67651.336,67701.336,2024-03-08 14:00:00,True,2024-03-08 14:00:00,2024-03-08 16:11:30,2024-03-08 14:05:00,even,True,18.66,3675.4899999999884,,1,0,10,3
2024-03-08 13:30:00,67395.336,67594.734,67317.039,67581.734,1535,36421,0,2024-03-08 13:00:00,2024-03-08 13:00:00,44.34197619052429,152.18995366353192,67492.60221428571,0.0010458717885211573,0.0005558772757243686,67313.96226190477,67509.9321045549,68004.69858715171,67380.28785436894,67304.15548491743,67401.65395940833,35.56726616094238,24.33570656807051,199.87723607399283,57.456480908134836,36.133175094626495,36.12372377018619,67672.98822810822,67131.81969070843,87.01737001552101,76.31508393977862,True,False,68081.734,67681.734,67681.734,67731.734,2024-03-08 14:00:00,True,2024-03-08 14:00:00,2024-03-08 16:11:46,2024-03-08 14:04:41,even,True,18.66,3694.1499999999883,,2,0,10,3
2024-03-08 15:00:00,67497.172,67736.734,67496.133,67586.938,1802,36421,0,2024-03-08 15:00:00,2024-03-08 15:00:00,28.48221428573015,186.9676422122866,67609.03769047624,0.0009905649386624247,0.0005698601038344945,67521.08442857144,67609.72713909695,68091.0001483675,67500.13335952132,67405.1033858105,67601.3936535947,50.15093674356467,42.764434067036454,161.5385025910762,24.479018919708324,-8.9561695906159,14.451530099846423,67820.97063209265,67383.31667509675,55.79695501810014,56.41558576208561,True,False,68086.938,67686.938,67686.938,67736.938,2024-03-08 16:00:00,True,2024-03-08 16:00:00,2024-03-08 16:11:46,2024-03-08 16:00:41,even,True,18.66,3712.809999999988,,3,0,10,3
2024-03-08 15:30:00,67469.141,67708.836,67397.188,67708.836,3506,36421,0,2024-03-08 15:00:00,2024-03-08 15:00:00,28.48221428573015,186.9676422122866,67609.03769047624,0.0009905649386624247,0.0005698601038344945,67521.08442857144,67609.72713909695,68091.0001483675,67527.39945859219,67431.56880676482,67640.29414860686,51.893502098319004,45.33993002491868,173.39786117908443,47.705346061251475,-8.804851049091667,24.479018919708324,67875.88126119862,67406.2070360151,62.68906827572687,57.14484614244045,True,False,68208.836,67808.836,67808.836,67858.836,2024-03-08 16:30:00,True,2024-03-08 16:30:00,2024-03-08 16:31:26,2024-03-08 17:32:40,success,True,93.3,3806.1099999999883,,4,0,10,3
2024-03-11 00:00:00,69144.836,69149.641,68869.836,68955.438,2282,36421,0,2024-03-11 00:00:00,2024-03-11 00:00:00,-150.30863095237873,421.6476541782613,68660.34277380949,0.0050551795208777965,-0.002339194365404898,68629.42959523808,69574.75717556855,68481.97778777071,68716.80033922633,68520.52903942973,68857.71323976609,135.45732981472975,149.33748018929043,679.5467604742475,16.036258341977373,-146.1813728930283,-73.12531338156259,69776.60136640632,67940.32511312586,35.0505793882871,38.41891724507439,False,True,68455.438,68855.438,68855.438,68805.438,2024-03-11 00:30:00,True,2024-03-11 00:30:00,2024-03-11 00:55:33,2024-03-11 00:31:01,even,True,18.66,3824.769999999988,,5,0,11,3
2024-03-11 02:00:00,68990.938,68995.539,68837.938,68885.523,1913,36421,0,2024-03-11 02:00:00,2024-03-11 02:00:00,97.05704761909146,440.15805358877697,68517.87411904757,-0.001527109857196767,-0.00010507580388251659,68757.39982142858,66562.52506702839,69369.36270979741,68771.06141702755,68634.16427615935,68696.96788200896,101.87386904508458,112.62607996962593,246.95221047028755,1.2999528724176344,10.050995184006752,2.796118679107167,69031.85336614386,68363.58239787407,66.25851352386188,59.789310229398744,False,True,68385.523,68785.523,68785.523,68735.523,2024-03-11 02:30:00,True,2024-03-11 02:30:00,2024-03-11 02:42:43,2024-03-11 06:06:31,success,True,93.3,3918.0699999999883,,6,0,11,3
2024-03-11 06:00:00,68635.719,68862.141,68578.938,68630.438,2321,36421,0,2024-03-11 06:00:00,2024-03-11 06:00:00,79.45865476194012,340.21590538925375,68524.87332142855,0.0021323643722192696,-0.0006961073362234354,68419.31183333334,68153.8501496889,68663.31380968395,68508.88935378104,68493.86569044272,68461.79598314411,14.391869667801075,12.515505498548334,283.24365583376874,63.773319917498156,62.108718610194046,28.21353697964514,68845.6749185197,68079.41704776853,87.28614663871018,83.2577718692966,True,False,69130.438,68230.438,68730.438,68780.438,,False,2024-03-11 09:00:00,2024-03-11 08:55:22,,success,True,93.3,4011.3699999999885,,7,0,11,3
2024-03-11 08:00:00,68585.734,68620.734,68483.094,68516.836,1746,36421,0,2024-03-11 08:00:00,2024-03-11 08:00:00,0.6337142857228173,322.129182333505,68803.81589285712,0.0036955796630181743,0.0007139498874940439,68525.50703571427,69538.0265159616,69586.95770070181,68592.73605500934,68557.36423931563,68665.36191056068,23.271745706020738,23.03433352829316,240.01092977004967,-64.5009735122294,-26.047445476433495,3.97507017548196,68989.37666575024,68339.84715537111,51.05625865177266,61.99357224407652,False,True,68016.836,68916.836,68416.836,68366.836,,False,,,2024-03-11 08:51:13,fail,False,-74.67,3936.6999999999884,,0,1,11,3
2024-03-11 09:00:00,69375.039,70817.547,69329.258,70759.813,6056,36421,0,2024-03-11 09:00:00,2024-03-11 09:00:00,278.3088571428525,373.2495762960607,69712.24565476194,0.0036926715956888106,0.005121773977966322,68803.81589285712,69797.04668915605,73060.14940025403,69056.72290141773,68798.09144051865,69210.48978500172,105.29088352220424,44.648840529548934,521.7640221397759,372.682804609547,136.12675885800854,30.472158582677366,69916.37121489042,68506.10835511301,91.0749889580017,78.62213049875315,True,False,71259.813,70359.813,70859.813,70909.813,,False,2024-03-11 10:00:00,2024-03-11 09:36:41,2024-03-11 09:16:12,fail,False,-74.67,3862.0299999999884,,0,2,11,3
2024-03-11 14:00:00,71535.719,71845.641,71416.336,71699.125,3176,36421,0,2024-03-11 14:00:00,2024-03-11 14:00:00,250.47694047604455,984.8799923177867,72021.32338095237,0.006991111092054591,0.004853986868992049,71784.16689285706,73532.71647411631,74775.11489860564,71600.25926332548,71026.82962528599,71814.6213078775,370.47314192025806,386.8875245229274,1061.473287822023,-41.85641692475474,-75.02643137246196,61.24590402476315,73247.61024643724,70380.13236931777,55.62378589550489,65.1047295271381,False,True,71199.125,72099.125,71599.125,71549.125,,False,2024-03-12 18:15:00,2024-03-12 17:00:38,2024-03-11 14:33:06,fail,False,-74.67,3787.3599999999883,,0,3,11,3
2024-03-11 15:00:00,72040.938,72075.438,71861.953,71998.734,2517,36421,0,2024-03-11 15:00:00,2024-03-11 15:00:00,237.1564880953083,1054.8071017165494,71898.12652380954,0.005933257792981116,0.002702912745142049,72021.32338095237,73178.10198308885,73669.75710853397,71807.18410617094,71291.52696154671,71967.18916959067,347.2946726352384,368.86872960154017,383.7612966210808,14.26998417613504,54.44830478158838,51.811700378370006,72486.76692002913,71449.1114191522,72.21004172173976,69.65229454317038,False,True,71498.734,72398.734,71898.734,71848.734,,False,2024-03-11 16:00:00,2024-03-11 15:52:13,2024-03-11 15:24:09,fail,False,-74.67,3712.6899999999882,,0,4,11,3
2024-03-11 16:00:00,71566.641,72370.93,71543.313,72324.641,3726,36421,0,2024-03-11 16:00:00,2024-03-11 16:00:00,-123.19685714282969,1060.2182318527193,71928.49367857142,0.004491836932211938,0.001985130649067301,71898.12652380954,72899.15339125045,73355.22540677767,71911.00540465841,71484.40995596911,72026.13517922259,307.36489986594825,339.66151384559674,270.6573912496282,70.71741658063547,-60.01548400406318,-4.8620925353170605,72393.02265740959,71660.7477010356,54.265105220259706,58.548980111163836,False,True,71824.641,72224.641,72224.641,72174.641,2024-03-11 16:30:00,True,2024-03-11 16:30:00,2024-03-11 16:39:45,2024-03-11 16:30:13,even,True,18.66,3731.349999999988,,1,0,11,3
2024-03-11 17:00:00,72224.93,72580.984,72071.836,72508.039,3481,36421,0,2024-03-11 17:00:00,2024-03-11 17:00:00,30.367154761886923,1104.7850804568006,71989.58254761901,0.0006653746589990552,0.0014306639701138681,71928.49367857142,71681.2139900427,73167.69758227665,72075.20038190552,71682.65775772747,72230.65060268316,283.12888845513226,308.41894411818555,271.45085354577685,88.19141038869566,53.05836635705782,7.262585139324074,72598.60925496997,71864.19195039636,77.12544847317012,73.55839702367044,False,True,72008.039,72408.039,72408.039,72358.039,2024-03-11 18:00:00,True,2024-03-11 18:00:00,2024-03-11 18:02:24,2024-03-11 18:15:11,success,True,93.3,3824.6499999999883,,2,0,11,3
2024-03-11 21:00:00,72533.117,72863.734,72484.602,72699.836,2222,36421,0,2024-03-11 21:00:00,2024-03-11 21:00:00,112.14916666671343,1155.1292862678238,72372.20739285715,0.0009188410329744697,0.0007338660037966469,72491.58964285717,72058.46087410851,73168.72969931811,72454.2179438057,72232.06704391168,72513.1042604059,176.80870534949645,201.13184113634918,261.01681778813776,20.450706914329203,12.030274509859737,-7.1799184726551175,72866.9769644199,72160.73155639191,73.37381245516104,69.26082921301672,False,True,72199.836,72599.836,72599.836,72549.836,2024-03-11 21:30:00,True,2024-03-11 21:30:00,2024-03-11 21:36:37,2024-03-11 23:57:19,success,True,93.3,3917.9499999999884,,3,0,11,3
2024-03-12 09:00:00,72312.836,72402.234,72094.117,72210.516,2981,36421,0,2024-03-12 09:00:00,2024-03-12 09:00:00,116.86897619046795,568.7603106963797,72078.38386904763,-0.0003323762920470999,-0.0003389745683661067,72054.78864285714,71164.89082505196,72301.46827222739,71979.48885116154,72035.43536704527,71942.936119711,-37.80031283435528,-45.23074216896049,275.07239834448325,84.12000687992258,110.3544066047034,-14.326697626456735,72315.78385747605,71571.58838194594,75.14474665181412,56.53855006127088,True,False,72710.516,71810.516,72310.516,72360.516,,False,2024-03-13 08:15:00,2024-03-12 16:05:17,2024-03-12 10:13:16,fail,False,-74.67,3843.2799999999884,,0,1,11,3
2024-03-13 00:00:00,70859.383,71241.945,70689.438,71092.734,2743,56421,0,2024-03-13 00:00:00,2024-03-13 00:00:00,-54.02036904767738,-78.36209867353318,71099.29234523805,0.006050162988572081,-0.0014670568001980489,71045.8526904762,72494.51686069043,70959.012933684,71046.79880416086,71148.92936556395,71040.61650705193,-79.17719375975139,-89.5762352181399,535.6995272192277,-80.52756381148356,-180.2337764018448,-66.87003818368248,71763.8108687979,70315.92214530597,38.89845993690583,37.69140871912697,True,False,71592.734,71192.734,71192.734,71242.734,2024-03-13 00:45:00,True,2024-03-13 00:45:00,2024-03-13 01:34:01,2024-03-13 00:47:38,even,True,18.66,3861.9399999999882,,1,0,11,3
2024-03-13 01:00:00,71202.641,71270.234,71067.773,71192.836,1850,36421,0,2024-03-13 01:00:00,2024-03-13 01:00:00,53.43965476185258,-90.05096809854149,71284.75033333339,0.00593118013661711,-0.0005923006699800905,71099.29234523805,72848.58916454067,71417.29694604881,71107.98579068377,71153.62965691283,70993.10585070516,-53.294143100618385,-73.35757136907984,515.779878684764,5.565406604742748,-16.54172755422769,-6.032825937421876,71690.9086869296,70296.80301448073,60.77679646714756,53.317293257862275,True,False,71692.836,71292.836,71292.836,71342.836,2024-03-13 01:30:00,True,2024-03-13 01:30:00,2024-03-13 02:08:21,2024-03-14 16:51:07,success,True,93.3,3955.2399999999884,,2,0,11,3
2024-03-13 02:00:00,71483.516,71784.766,71407.109,71482.172,2297,36421,0,2024-03-13 02:00:00,2024-03-13 02:00:00,185.4579880953388,-75.55733624521235,71304.70169047623,0.00569001713847545,0.00020496038631335372,71284.75033333339,73086.54989622872,71845.62103587051,71288.38140756282,71239.6380798312,71339.69535259715,-8.729232851066627,-42.16955325581415,251.97465402357028,90.1868668730167,84.08646233235777,85.43845648434944,71681.36113552896,70999.52956966533,82.74558901187308,84.72246992048048,True,False,71982.172,71582.172,71582.172,71632.172,2024-03-13 03:30:00,True,2024-03-13 03:30:00,2024-03-13 03:30:20,2024-03-14 15:54:31,success,True,93.3,4048.5399999999886,,3,0,11,3
2024-03-13 03:00:00,71451.789,71576.438,71427.641,71434.641,1889,36421,0,2024-03-13 03:00:00,2024-03-13 03:00:00,19.951357142839697,-65.35200831176189,71555.67996428566,0.0012669052328312057,0.001084119857918885,71304.70169047623,71335.76122124775,72506.20228114465,71375.57912818623,71300.32753342339,71540.82835534913,13.65403296853765,-12.343869438067106,238.6527415956914,29.77684382525331,27.4771093911113,74.7657739938586,71864.50955650331,71218.64715419496,74.39248800599232,74.6057335714071,False,True,70934.641,71834.641,71334.641,71284.641,,False,2024-03-14 17:30:00,2024-03-14 17:28:14,2024-03-13 03:29:58,fail,False,-74.67,3973.8699999999885,,0,1,11,3
2024-03-13 05:00:00,72017.336,72167.734,71931.836,72067.039,1415,36421,0,2024-03-13 05:00:00,2024-03-13 05:00:00,229.3268095239473,33.03053711701068,72001.66253571429,0.0034334407147332806,0.0021936181281381564,71785.00677380961,72953.85253959267,73163.6227936351,71829.51029129112,71614.03245568868,72055.51422428622,94.18907164304983,61.76518357164686,403.59263384589116,52.171070519441855,31.947545579605503,40.53751393198036,72601.86427997817,71510.66416859427,81.10989299725456,79.72554964254154,True,False,72567.039,72167.039,72167.039,72217.039,2024-03-13 06:45:00,True,2024-03-13 06:45:00,2024-03-13 08:26:56,2024-03-13 07:06:17,even,True,18.66,3992.5299999999884,,1,0,11,3
2024-03-13 06:00:00,72117.539,72181.734,71971.836,72142.539,1042,36421,0,2024-03-13 06:00:00,2024-03-13 06:00:00,216.65576190467982,72.78530804651382,72181.46692857142,0.002997960748359706,0.0027502839765103267,72001.66253571429,72880.96491271039,73618.98094628344,71969.25482597924,71746.6717586287,72190.14890058478,109.86678252635465,87.90827275934372,371.7493327538387,31.69791262470244,41.697926384586026,20.942880976974266,72693.51049980246,71688.2873013671,81.53138407007454,81.39142930359674,False,True,71642.539,72542.539,72042.539,71992.539,,False,2024-03-14 16:00:00,2024-03-14 15:52:16,2024-03-13 08:26:50,fail,False,-74.67,3917.8599999999883,,0,1,11,3
2024-03-13 07:00:00,72275.938,72275.938,72132.938,72134.539,1591,36421,0,2024-03-13 07:00:00,2024-03-13 07:00:00,179.80439285712782,115.62696267168212,72239.11323809526,0.0026903667130160087,0.0015862481543450582,72181.46692857142,72848.9111955327,73121.43916087788,72079.34789724316,71865.50999694856,72261.88395149638,116.14092889451422,104.20291416074042,323.62078736308337,-5.644057447541854,22.796131750932545,33.91497282424825,72698.77201443654,71823.49588855621,86.1801793573765,88.60953308571915,False,True,71634.539,72534.539,72034.539,71984.539,,False,2024-03-14 16:00:00,2024-03-14 15:52:16,2024-03-13 08:26:46,fail,False,-74.67,3843.1899999999882,,0,2,11,3
2024-03-13 08:00:00,72209.234,72360.641,72161.836,72360.641,1638,36421,0,2024-03-13 08:00:00,2024-03-13 08:00:00,57.64630952384323,142.66515974071808,72451.29569047618,0.002181215965817557,0.001773667657216873,72239.11323809526,72823.83772744577,73364.72617679532,72161.38949965118,71964.94289905,72256.51724871,114.85023888353317,109.91914974225485,281.39744647782396,31.393303061529878,3.8604513244354166,-22.78443515651452,72637.90380145508,71876.63069596494,86.73203475483852,77.69333281009175,False,True,71860.641,72760.641,72260.641,72210.641,,False,2024-03-14 15:45:00,2024-03-13 15:57:16,2024-03-13 08:36:25,fail,False,-74.67,3768.519999999988,,0,3,11,3
2024-03-13 09:00:00,72770.445,73176.039,72683.195,73115.836,3092,36421,0,2024-03-13 09:00:00,2024-03-13 09:00:00,212.18245238091913,206.94222969803377,72665.67442857145,0.002063007654328502,0.002526092093883993,72451.29569047618,72939.20625320444,74061.42934429241,72465.69814685735,72176.08922988143,72619.81417956656,153.29288278981403,125.83805275063538,322.9524272853728,140.59592707258707,87.61262263500248,76.99337117302639,73057.29995640181,72183.8284027313,88.35744958505927,86.36257175684663,True,False,73615.836,73215.836,73215.836,73265.836,2024-03-13 10:15:00,True,2024-03-13 10:15:00,2024-03-13 10:27:19,2024-03-13 10:15:21,even,True,18.66,3787.179999999988,,1,0,11,3
2024-03-13 10:00:00,72945.836,73425.734,72912.695,73289.734,2871,36421,0,2024-03-13 10:00:00,2024-03-13 10:00:00,214.37873809527082,268.1370254800131,72976.04509523814,0.002063076959150092,0.003052254395431795,72665.67442857145,73090.34246710148,74689.15806678613,72759.13937397634,72409.60113402324,73021.27315686272,186.06771696635406,155.13049014074062,404.1042257718877,126.21838734085031,74.93451221192663,92.87232817334007,73568.31386165477,72475.73245207068,79.43811484413676,79.27989398146683,True,False,73789.734,73389.734,73389.734,73439.734,2024-03-13 10:30:00,True,2024-03-13 10:30:00,2024-03-14 09:05:37,2024-03-13 10:37:53,even,True,18.66,3805.839999999988,,2,0,11,3
2024-03-13 13:00:00,73314.539,73538.039,73303.789,73530.031,1307,36421,0,2024-03-13 13:00:00,2024-03-13 13:00:00,132.4766547619074,448.59547915104486,73350.75310714287,0.002595837682649514,0.0035184913988276947,73342.77255952382,73905.85715535305,75629.24144583066,73329.62574970748,73030.17301282841,73519.58808943928,198.27413211431121,209.56278601260107,518.174651068,-8.870283797718002,-49.7270639835624,-63.72992432054889,74219.12386838108,72818.55231049747,60.13838830306151,58.261333232670886,False,True,73030.031,73430.031,73430.031,73380.031,2024-03-13 13:30:00,True,2024-03-13 13:30:00,2024-03-13 14:29:37,2024-03-13 22:13:50,success,True,93.3,3899.139999999988,,3,0,11,3
2024-03-13 14:00:00,73131.641,73253.539,73131.641,73234.438,999,36421,0,2024-03-13 14:00:00,2024-03-13 14:00:00,7.980547619052231,456.1784370593814,73229.46567857139,0.000947190099405934,0.0011138113953572247,73350.75310714287,72800.95047926743,74412.61603905745,73282.16860136084,73084.67978833793,73305.44971998621,156.42060373495042,186.016130449947,353.8256116912823,-58.31048916411237,-73.75164430690347,-30.16205022354552,73783.11429576944,72826.28514420298,16.317193383003907,30.19596845087327,False,True,72734.438,73134.438,73134.438,73084.438,2024-03-13 14:30:00,True,2024-03-13 14:30:00,2024-03-13 14:35:16,2024-03-13 17:16:57,success,True,93.3,3992.4399999999882,,4,0,11,3
2024-03-13 14:45:00,72791.703,73096.141,72723.711,72857.641,2808,36421,0,2024-03-13 14:00:00,2024-03-13 14:00:00,7.980547619052231,456.1784370593814,73229.46567857139,0.000947190099405934,0.0011138113953572247,73350.75310714287,72800.95047926743,74412.61603905745,73128.50437797508,73046.19256062493,73015.48665290682,105.72939085513644,154.11541525289897,262.69319485545583,-72.81506811143481,-118.76017371861963,-98.38782524933049,73370.12246596169,72659.35083985196,22.093024240800418,17.26058487967009,True,False,73357.641,72457.641,72957.641,73007.641,,False,2024-03-13 19:00:00,2024-03-13 21:59:41,2024-03-13 15:38:01,fail,False,-74.67,3917.769999999988,,0,1,11,3
2024-03-13 19:00:00,73035.484,73237.734,72886.539,72990.141,2952,36421,0,2024-03-13 19:00:00,2024-03-13 19:00:00,115.94361904758262,307.6027196658979,72689.47002380951,-4.1378601668931375e-05,-0.0006836511336868979,72618.51995238093,71628.79484804066,73026.95108225048,72789.55857539817,72810.25049173151,72763.03976504986,-4.944773762399564,-7.074752209966312,308.5976434122902,65.36991847259924,98.31644547653559,63.43491021664522,73181.14658365646,72346.43294644327,84.177860685102,77.44922758739494,True,False,73490.141,73090.141,73090.141,73140.141,2024-03-13 21:00:00,True,2024-03-13 21:00:00,2024-03-14 06:10:29,2024-03-13 21:08:54,even,True,18.66,3936.429999999988,,1,0,11,3
2024-03-13 23:00:00,73117.734,73260.336,73075.836,73203.234,1447,56421,0,2024-03-13 23:00:00,2024-03-13 23:00:00,102.87992857140489,334.18214253828046,73277.83402380953,0.0018209948807260676,0.0008317177872443459,73231.47734523809,73515.6980700245,73781.04566536956,73103.94721321839,73015.07024759619,73187.84703543171,45.52253698007553,36.605183141493356,233.99162974124556,9.010125558968866,-4.53567079459026,-47.126657034808886,73505.23573558239,72871.95833528103,52.91945914645893,57.78493364572847,False,True,72703.234,73103.234,73103.234,73053.234,2024-03-14 00:45:00,True,2024-03-14 00:45:00,2024-03-14 03:01:19,2024-03-14 01:08:29,even,True,18.66,3955.089999999988,,2,0,11,3
2024-03-14 00:00:00,73267.141,73303.836,73084.875,73162.039,2267,56421,0,2024-03-14 00:00:00,2024-03-14 00:00:00,46.35667857143562,337.87820348821697,73192.9298095238,0.0009775991445541542,0.0006762671652069317,73277.83402380953,73117.97351492189,73760.43226557648,73138.33536062218,73056.29066244657,73212.68269315442,46.00719993002713,41.65803474738234,216.32113239031463,-2.998446852507186,15.164712074372801,16.238833849318326,73504.71622188135,72919.1491644275,62.91754560148765,59.450359068915155,False,True,72662.039,73062.039,73062.039,73012.039,2024-03-14 00:45:00,True,2024-03-14 00:45:00,2024-03-14 03:04:50,2024-03-14 01:08:23,even,True,18.66,3973.7499999999877,,3,0,11,3
2024-03-14 02:00:00,73113.641,73113.641,72968.844,73026.336,874,36421,0,2024-03-14 02:00:00,2024-03-14 02:00:00,-42.54765476187458,302.39103518203774,73059.80085714285,0.00015826908780801994,-0.00035182486449589895,73150.38215476193,72842.59527093955,73234.11997227668,73072.95609565762,73051.60148315542,73016.15175816994,21.902301239591907,29.384546119579003,143.70219264105015,-40.44348641204124,-24.60009700730734,-0.3964385964354733,73210.14971823536,72820.65379810453,36.60415667723965,35.7800312674925,False,True,72526.336,72926.336,72926.336,72876.336,2024-03-14 03:15:00,True,2024-03-14 03:15:00,2024-03-14 03:37:33,2024-03-14 03:54:49,success,True,93.3,4067.049999999988,,4,0,11,3
2024-03-14 18:15:00,70549.039,70759.539,70205.836,70362.906,4737,36421,0,2024-03-14 18:00:00,2024-03-14 18:00:00,-577.5026428571146,-210.27245310813305,71405.75308333331,-0.006606892156238341,-0.004737461443360016,71657.79120238098,67996.88994398765,70509.6645858035,71369.90677607154,71990.46645624592,70796.4185503956,-294.87404813493777,-209.62542577726055,856.6651132474884,-234.98405056765478,-245.70856828329852,-203.49873581025167,71952.9164532797,69638.42064751149,10.532440089403325,13.535235807899253,False,True,69862.906,70762.906,70262.906,70212.906,,False,2024-03-14 21:00:00,2024-03-14 20:51:43,2024-03-14 18:35:56,fail,False,-74.67,3992.379999999988,,0,1,11,3
2024-03-14 21:30:00,69651.305,69681.734,68591.836,69035.031,7476,36421,0,2024-03-14 21:00:00,2024-03-14 21:00:00,-466.1117976190144,-486.6541104678472,70172.5290238095,-0.0062485982071017,-0.005023222522004634,70701.05159523814,66841.87541668159,69336.91380668538,70309.88376666709,70967.99218834852,70042.37088269698,-359.5391509716719,-307.0750668600346,812.4163643225492,-213.30543756445695,-151.78978224970342,-91.21374028212449,71139.13297453242,68944.10879086154,21.39103120431378,27.80252904190458,False,True,68535.031,69435.031,68935.031,68885.031,,False,2024-03-15 05:30:00,2024-03-15 04:52:39,2024-03-14 21:45:58,fail,False,-74.67,3917.7099999999878,,0,2,11,3
2024-03-14 22:00:00,69482.039,70259.539,69358.945,70162.734,5266,36421,0,2024-03-14 22:00:00,2024-03-14 22:00:00,-528.5225714286353,-636.1564073491463,70276.74701190474,-0.006249200217576354,-0.003343252680648578,70172.5290238095,66420.68774745516,70273.68328082123,70179.04832998058,70806.19952499017,69843.11625662191,-358.7550444959925,-327.6369109434248,810.0382448992304,-14.50704850362672,-184.74757757144107,-213.30543756445695,70936.66788723588,68748.06462600795,33.05620050100649,24.858780505447086,True,False,70662.734,69762.734,70262.734,70312.734,,False,2024-03-14 22:30:00,2024-03-14 22:28:48,2024-03-15 04:39:56,success,True,93.3,4011.009999999988,,1,0,11,3
2024-03-14 23:00:00,70774.148,71041.734,70327.836,71039.617,3273,56421,0,2024-03-14 23:00:00,2024-03-14 23:00:00,104.2179880952317,-642.0228176424716,70488.14188095239,-0.006154138391578653,-0.0028726485285764294,70276.74701190474,66039.84991358749,70310.50308343889,70507.9530799778,70815.2043368338,70171.33377433778,-245.78106700735225,-300.45342031820763,630.4915064050293,129.38432714136434,47.14374269000837,93.33990540084778,71023.99730798457,69320.17024069099,86.08341061819681,77.67241850232134,True,False,71539.617,71139.617,71139.617,71189.617,2024-03-15 00:15:00,True,2024-03-15 00:15:00,2024-03-15 00:19:56,2024-03-15 04:23:47,success,True,93.3,4104.309999999988,,2,0,11,3
2024-03-15 00:00:00,71135.539,71469.836,71113.461,71250.828,3726,56421,0,2024-03-15 00:00:00,2024-03-15 00:00:00,211.39486904765363,-611.1511012894625,70865.99439285714,-0.0016263074841008963,-0.0008420187928468298,70488.14188095239,67796.43345886527,71455.27964959276,70785.61959160937,70880.36375048915,70825.58183006533,-148.48555698832206,-229.49350404128245,583.3663847852534,187.16642242859234,160.47608599928208,174.65501238399884,71614.62644952543,70038.03721060524,92.81213775345181,90.145477023674,True,False,71750.828,71350.828,71350.828,71400.828,2024-03-15 00:30:00,True,2024-03-15 00:30:00,2024-03-15 01:14:54,2024-03-15 00:31:36,even,True,18.66,4122.9699999999875,,3,0,11,3
2024-03-15 01:00:00,71570.75,71763.891,71431.836,71744.336,2479,36421,0,2024-03-15 01:00:00,2024-03-15 01:00:00,377.8525119047554,-545.334456268858,71086.93309523808,0.004597081235975325,0.00049106153757748,70865.99439285714,71219.07306733757,71910.69075809869,71180.76148947001,71067.9698606446,71660.61929755766,-40.898625817819266,-136.60012128683604,673.778801041156,200.12691606464796,196.31033814938564,183.79640454069886,72571.72067896322,70751.0179161521,95.43374716615155,94.27128221756948,True,False,72244.336,71344.336,71844.336,71894.336,,False,2024-03-15 02:30:00,2024-03-15 02:31:42,2024-03-15 02:16:06,fail,False,-74.67,4048.2999999999874,,0,1,11,3
2024-03-15 04:00:00,71681.734,71816.734,71536.836,71555.641,1918,36421,0,2024-03-15 04:00:00,2024-03-15 04:00:00,263.85634523807676,-365.6487980391539,70993.73346428573,-0.00164000000916015,0.00424772824429242,71783.22378571425,67352.3073956171,74410.23510184865,71712.1309641763,71504.25673463987,71926.85890643277,84.70240084563557,57.97282397558967,505.657364666868,-72.72553697966214,-56.18702098380891,31.933824905368965,72609.49634873304,71242.7214641325,36.914674164761216,50.27794345750721,False,True,71055.641,71955.641,71455.641,71405.641,,False,2024-03-15 04:30:00,2024-03-15 04:25:29,,success,True,93.3,4141.599999999988,,1,0,11,3
2024-03-15 09:00:00,68691.641,68780.039,68318.836,68434.539,2732,36421,0,2024-03-15 09:00:00,2024-03-15 09:00:00,-143.71548809528758,-1079.7524490645883,67790.43416666669,-0.005021357719858043,-0.0083159755798078,67855.39184523807,63976.04491840973,66560.21401519807,68320.29636496474,68912.05663580031,68005.91539869276,-387.28007425091346,-418.7694709000564,1640.6431825537993,188.9381689026195,298.1567757137236,318.21300928795245,70222.28369514039,65791.04710224512,78.61618643064607,70.1249225714615,True,False,68934.539,68534.539,68534.539,68584.539,2024-03-15 09:45:00,True,2024-03-15 09:45:00,2024-03-15 20:42:13,2024-03-15 09:54:27,even,True,18.66,4160.2599999999875,,2,0,11,3
2024-03-15 11:00:00,67099.234,67381.836,65561.836,66163.695,7432,36421,0,2024-03-15 11:00:00,2024-03-15 11:00:00,-274.961119047628,-1195.1091554068407,67741.79524999995,-0.0027241033733321567,-0.007488228740335514,67515.47304761906,64835.29526649693,66074.1477359807,67727.09447961787,68342.37786724893,67748.55881561746,-374.65318956106785,-352.24411133981357,671.9799546015322,-423.81814379086427,-158.94531131751137,-55.888862401014194,68655.73175432954,66839.88587690539,14.980033278366903,26.198607085414633,False,True,65663.695,66563.695,66063.695,66013.695,,False,2024-03-19 04:00:00,2024-03-19 04:04:38,2024-03-15 11:16:50,fail,False,-74.67,4085.5899999999874,,0,1,11,3
2024-03-15 12:00:00,67836.563,68137.938,67343.836,67491.539,4574,36421,0,2024-03-15 12:00:00,2024-03-15 12:00:00,226.32220238089212,-1204.1958796926774,67635.38267857143,-0.0027240406931220264,-0.0020425992096967426,67741.79524999995,64654.43523569421,67895.60796163567,67625.06460320317,68119.77023831077,67367.49870313036,-334.5799129935913,-352.08073992250803,640.8349285152174,-117.58565187478962,-12.634078087372473,-46.15364981078892,68232.6258566259,66500.87154963482,62.27389839492677,53.685502119833615,True,False,67991.539,67091.539,67591.539,67641.539,,False,2024-03-15 12:30:00,2024-03-15 12:22:46,2024-03-15 13:08:18,success,True,93.3,4178.889999999988,,1,0,11,3
2024-03-15 15:00:00,67940.461,68404.539,67816.375,67981.734,4344,36421,0,2024-03-15 15:00:00,2024-03-15 15:00:00,16.869095238071168,-1170.6392391578265,67871.55282142854,0.001786826826666633,-0.0005115768680325714,67706.71026190474,66519.86594677942,68535.88528266324,67694.22116484026,67834.98030835002,67852.86296284832,-166.90973356040195,-231.3159913602567,558.8677127392489,111.73330065356276,121.71668799457257,119.68075851387403,68608.83437504631,67098.39155065033,79.47752487841271,81.84803465725594,True,False,68481.734,67581.734,68081.734,68131.734,,False,2024-03-15 16:00:00,2024-03-15 15:51:35,2024-03-15 15:30:40,fail,False,-74.67,4104.2199999999875,,0,1,11,3
2024-03-15 17:00:00,68647.141,68758.734,68316.797,68609.734,4142,36421,0,2024-03-15 17:00:00,2024-03-15 17:00:00,336.0627619048173,-982.5001625874429,68358.16940476187,0.00639627431881323,0.0002335470634709328,68207.61558333336,69950.11785247161,68824.56080337222,68141.97376572764,68029.99449751907,68440.00857894735,-21.733968117347104,-95.10722844227891,536.5558388104856,130.6872607499099,162.12425902989344,50.4798895768763,69165.85896134151,67715.6581965532,85.18399442754294,76.79887557043169,True,False,69109.734,68209.734,68709.734,68759.734,,False,2024-03-15 20:45:00,2024-03-15 20:42:46,2024-03-15 17:35:18,fail,False,-74.67,4029.5499999999874,,0,2,11,3
2024-03-15 18:00:00,68168.023,68298.539,67548.258,67692.734,4580,36421,0,2024-03-15 18:00:00,2024-03-15 18:00:00,150.5538214285043,-932.8528633276437,68252.07720238094,0.004265483065113267,0.0017508410671375583,68358.16940476187,68746.68236740943,69544.97442609191,68134.30872665587,68063.17139736562,68337.81429549363,-8.32442690289463,-40.6260662346382,432.6231355344026,-120.39055830749567,-69.14666632279113,32.86148606817005,68921.85552846508,67752.27306252219,49.9345281661509,66.12857902474163,False,True,67192.734,68092.734,67592.734,67542.734,,False,2024-03-18 02:45:00,2024-03-18 03:01:38,2024-03-15 18:27:50,fail,False,-74.67,3954.8799999999874,,0,3,11,3
2024-03-15 19:00:00,67920.836,68047.734,67640.938,68033.672,3531,36421,0,2024-03-15 19:00:00,2024-03-15 19:00:00,-106.0922023809253,-901.8223141830385,68305.47821428571,0.002131832523026572,0.0006182596282677192,68252.07720238094,68238.53737482306,69027.93762244104,68110.30209218754,68070.3844636525,68191.85265359477,-4.884651955057052,-19.055661752617162,406.6117891881531,-62.14948331614141,-62.87222394217679,13.725471964251483,68740.77856899878,67641.42673819077,50.04168947910052,49.09966797343791,False,True,67533.672,68433.672,67933.672,67883.672,,False,2024-03-15 22:45:00,2024-03-15 22:49:12,2024-03-15 20:03:10,fail,False,-74.67,3880.2099999999873,,0,4,11,3
2024-03-18 04:00:00,67668.438,67814.734,67583.305,67804.641,2652,36421,0,2024-03-18 04:00:00,2024-03-18 04:00:00,-319.0174285713729,-583.2541939616349,67573.5402380953,-0.0022156880805908317,-0.005897581051665703,67790.55420238097,66043.78983180893,66584.79848856828,67790.43808094517,68037.56885045984,67507.0124860681,-108.7431200962601,-72.89186236368295,788.0853584644203,-61.1452115583088,-31.105253526038723,-117.38200963185227,68570.92771999506,66441.59725214113,40.905027487819495,34.735250089007586,True,False,68304.641,67904.641,67904.641,67954.641,2024-03-18 05:15:00,True,2024-03-18 05:15:00,2024-03-18 06:37:11,2024-03-18 05:32:42,even,True,18.66,3898.869999999987,,1,0,12,3
2024-03-18 05:00:00,67794.68,68075.438,67771.352,68035.859,3098,36421,0,2024-03-18 05:00:00,2024-03-18 05:00:00,-217.0139642856666,-573.9964192718326,67742.17802380958,-0.0022203068343070085,-0.005113577825983099,67573.5402380953,65894.35845524464,66773.56283449623,67789.67105406387,67966.4686935236,67551.5800354317,-97.19400731560017,-93.03114862626535,409.0736508955582,114.17591778463975,30.69288372893061,0.7841950465372065,68105.32946414071,66999.3306067227,54.31780449744277,47.70695110486637,True,False,68535.859,68135.859,68135.859,68185.859,2024-03-18 06:45:00,True,2024-03-18 06:45:00,2024-03-18 06:46:18,2024-03-18 10:05:59,success,True,93.3,3992.1699999999873,,2,0,12,3
2024-03-18 06:00:00,68010.609,68028.539,67741.734,67770.141,2858,36421,0,2024-03-18 06:00:00,2024-03-18 06:00:00,168.63778571427974,-542.9961066884134,67993.74551190478,-0.0014421994009412634,-0.0008111071081372298,67742.17802380958,66113.72130176774,68379.2904028162,67855.64893556069,67957.4361387504,67808.29953904371,-71.42011659871787,-83.19158646733175,396.2632629695595,41.066070863438654,77.39768799451122,75.79982731339987,68344.75494405262,67273.3441340348,79.05014762456527,77.32554163706493,True,False,68270.141,67870.141,67870.141,67920.141,2024-03-18 06:30:00,True,2024-03-18 06:30:00,2024-03-18 06:36:59,2024-03-18 10:22:06,success,True,93.3,4085.4699999999875,,3,0,12,3
2024-03-18 07:00:00,68403.836,68567.039,68255.602,68463.734,2617,36421,0,2024-03-18 07:00:00,2024-03-18 07:00:00,251.56748809519922,-481.53241897560656,68236.6420714286,0.0013288785061889381,0.00013327082425092923,67993.74551190478,67522.09560134515,69043.3842046996,68100.082939587,68059.98565211073,68301.32284898519,-14.12040149178938,-53.60731798791492,352.65904352554793,100.25686171311827,136.72546646025148,141.14746955625014,68778.91255774468,67825.2331402257,88.75150589204974,87.00732342665687,True,False,68963.734,68563.734,68563.734,68613.734,2024-03-18 07:30:00,True,2024-03-18 07:30:00,2024-03-18 07:35:25,2024-03-18 08:05:40,success,True,93.3,4178.769999999988,,4,0,12,3
2024-03-18 09:00:00,68512.039,68512.039,68304.992,68487.141,2013,36421,0,2024-03-18 09:00:00,2024-03-18 09:00:00,169.1549642857135,-351.65983376989607,68496.4963928572,0.0033253396111267704,0.0015831607279163929,68405.79703571432,69084.69954056664,69678.77825691435,68468.18450811374,68317.01411941196,68725.14887168905,59.95100997008558,33.652096537352925,460.1338650214816,-17.47262882688665,-16.397944616459426,55.51456725146272,69346.32958946805,68102.46815391004,64.37560710138627,66.15901267825262,False,True,67987.141,68387.141,68387.141,68337.141,2024-03-18 09:30:00,True,2024-03-18 09:30:00,2024-03-18 10:15:09,2024-03-18 13:25:22,success,True,93.3,4272.069999999988,,5,0,12,3
2024-03-18 10:00:00,68244.641,68257.938,67991.836,67991.836,2428,36421,0,2024-03-18 10:00:00,2024-03-18 10:00:00,90.69935714287567,-329.85314790337,68381.9033809524,0.0011407220751926115,0.0018790692384277568,68496.4963928572,67649.53888379585,69936.82214338476,68313.90097963282,68275.40000596736,68429.95181424145,26.67686921916902,36.4001166727488,369.4009281441221,-107.93574303408968,-59.28350464401592,-61.98008840720286,68928.64306723601,67929.76056124688,19.40748315302568,32.24005047989174,False,True,67491.836,68391.836,67891.836,67841.836,,False,2024-03-18 10:30:00,2024-03-18 10:25:50,2024-03-18 13:25:22,success,True,93.3,4365.369999999988,,6,0,12,3
2024-03-18 13:00:00,68163.328,68253.734,68053.453,68174.109,2258,36421,0,2024-03-18 13:00:00,2024-03-18 13:00:00,-70.29103571437008,-307.121027669069,68118.31201190477,-0.0013837020062644893,-0.0011583907939206259,68139.94041666665,66671.70400447177,68200.52481116817,68054.076269666,68099.97356901802,67926.70422050222,-23.591368606619653,-21.66966573506682,345.1194310827699,68.1628568971646,47.782085999278934,28.031957688377588,68394.11545246396,67460.79298854047,74.53245310495791,61.257589271563,True,False,68674.109,68274.109,68274.109,68324.109,2024-03-18 13:30:00,True,2024-03-18 13:30:00,,2024-03-18 13:52:05,even,True,18.66,4384.029999999988,,7,0,12,3
2024-03-18 14:00:00,68287.375,68528.836,68195.039,68239.141,3055,36421,0,2024-03-18 14:00:00,2024-03-18 14:00:00,-21.628404761882848,-276.68860870887875,68235.73266666665,0.0001346896954047088,-0.0007490496121215181,68118.31201190477,67406.30058493781,68432.68814731805,68185.79628641084,68161.42849131637,68245.40833539731,3.356907962297555,-9.700749619990361,283.65778047639895,45.90073099415167,61.417594083279255,102.00788854483108,68629.84633904045,67862.47033175417,77.60795924906917,84.68687896554566,True,False,68739.141,68339.141,68339.141,68389.141,2024-03-18 14:30:00,True,2024-03-18 14:30:00,,2024-03-18 14:32:28,even,True,18.66,4402.689999999988,,8,0,12,3
2024-03-18 23:00:00,67380.57,67655.734,67357.813,67543.688,1956,56421,0,2024-03-18 23:00:00,2024-03-18 23:00:00,160.85307142860256,-414.35625861510925,67346.62360714281,0.0014951182322444348,-0.0005364501253243804,67173.14872619054,67400.90767766349,67789.0354752878,67283.49243499315,67358.07526408315,67280.92433677326,-70.1944421928929,-92.28836577867408,248.83771486497443,104.98917819048802,78.97173718608974,28.86545304438914,67618.35525184097,66944.99342170554,74.91694406778868,67.96724279091279,True,False,68043.688,67643.688,67643.688,67693.688,2024-03-19 01:00:00,True,2024-03-19 01:00:00,2024-03-19 02:16:36,2024-03-19 01:01:07,even,True,18.66,4421.349999999988,,9,0,12,3
2024-03-19 08:00:00,65247.637,65475.039,65061.738,65433.227,3495,36422,0,2024-03-19 08:00:00,2024-03-19 08:00:00,-326.6350119047129,-690.798479772071,65123.52163095239,-0.007011988364687161,-0.0066984068278976225,65392.48178571432,61733.949861803136,63705.224010246064,65417.01359225744,65909.83356408616,65083.36039250089,-283.40336760490027,-266.27905849328096,862.0834079268133,15.859476092242403,-12.175439972554159,-72.82331062940648,66248.67299320208,63919.54779179969,31.245465409043305,18.465914099712855,True,False,65933.227,65033.227,65533.227,65583.227,,False,2024-03-20 21:15:00,2024-03-20 21:49:45,2024-03-19 08:21:32,fail,False,-74.67,4346.679999999988,,0,1,12,3
2024-03-19 10:00:00,64723.84,64731.738,64352.348,64420.539,3222,36422,0,2024-03-19 10:00:00,2024-03-19 10:00:00,-194.02226190477086,-818.6123904392298,64430.44036904764,-0.005404259222663951,-0.005237343653660533,64929.49936904762,61777.30916969468,63423.123330017814,64757.83650608448,65284.62191437472,64382.555011351935,-316.09686590285855,-303.9719261917683,609.0670779208184,-97.66005056760332,-25.08487891301047,-136.74187203292968,65204.79556654504,63558.81445615883,39.77178273063022,33.63687876376118,True,False,64920.539,64020.539,64520.539,64570.539,,False,2024-03-19 18:45:00,2024-03-19 18:44:10,2024-03-19 10:19:30,fail,False,-74.67,4272.0099999999875,,0,2,12,3
2024-03-19 11:00:00,63510.227,63883.84,63031.84,63833.141,6079,36422,0,2024-03-19 11:00:00,2024-03-19 11:00:00,-499.0589999999793,-954.5692940096778,64188.23751190475,-0.00540411360029639,-0.004348797478887457,64430.44036904764,61444.99221857581,63492.473193484904,64240.07562877991,64863.02495113969,63828.840275885785,-361.6747841008546,-333.0472194329095,700.1463609901505,-83.57793945648154,-158.8678624011518,-160.76171001028706,64774.03786322249,62882.14268854908,19.011923489449515,15.965135544133247,True,False,64333.141,63933.141,63933.141,63983.141,2024-03-19 12:00:00,True,2024-03-19 12:00:00,2024-03-19 18:07:48,2024-03-19 12:05:50,even,True,18.66,4290.669999999987,,1,0,12,3
2024-03-19 13:00:00,63282.41,63347.738,62662.859,62713.273,4855,36422,0,2024-03-19 13:00:00,2024-03-19 13:00:00,-432.0482380951653,-1090.7494422506861,63427.310488095245,-0.006526286345513,-0.004993068488301422,63756.189273809585,60308.542808708895,62579.32726840375,63541.524137226384,64172.120742406274,63130.572832473306,-379.49169586794596,-360.27987944885757,754.0341533183363,-151.96927106987278,-52.07355314756569,-69.36804127959476,64148.51893945306,62111.12672549355,12.679143530502587,13.587567716961575,False,True,62213.273,63113.273,62613.273,62563.273,,False,2024-03-20 01:15:00,2024-03-20 01:04:13,2024-03-19 13:44:31,fail,False,-74.67,4215.999999999987,,0,1,12,3
2024-03-19 13:15:00,62723.039,62917.945,62526.465,62574.438,4857,36422,0,2024-03-19 13:00:00,2024-03-19 13:00:00,-432.0482380951653,-1090.7494422506861,63427.310488095245,-0.006526286345513,-0.004993068488301422,63756.189273809585,60308.542808708895,62579.32726840375,63392.74165457617,64053.7738725984,62999.23780839357,-392.46395190530893,-366.7166939401479,791.7021882350493,-131.3350240797372,-151.96927106987278,-52.07355314756569,64068.03576251089,61928.93985427625,10.453146749188372,12.05390044332877,False,True,62074.438,62974.438,62474.438,62424.438,,False,2024-03-20 01:15:00,2024-03-20 01:09:51,2024-03-19 13:33:30,fail,False,-74.67,4141.329999999987,,0,2,12,3
2024-03-19 14:00:00,63111.762,63680.738,63024.387,63343.84,5010,36422,0,2024-03-19 14:00:00,2024-03-19 14:00:00,-328.87878571433976,-1164.1875574197038,63365.78546428567,-0.004005235148151744,-0.0042327235881730405,63427.310488095245,61141.65562061861,62743.986354074535,63311.879458461946,63873.35526999695,62903.13532335736,-362.34791474964004,-370.3771899637919,757.3062383457476,16.41639697280334,-20.545891296918853,-91.97299071209272,63926.99874512412,61880.771901590604,36.574198978467734,22.877445926812864,True,False,63843.84,63443.84,63443.84,63493.84,2024-03-19 14:45:00,True,2024-03-19 14:45:00,2024-03-19 15:26:12,2024-03-19 15:04:09,even,True,18.66,4159.989999999987,,1,0,12,3
2024-03-19 15:00:00,63648.738,63748.738,63331.84,63369.84,4052,36422,0,2024-03-19 15:00:00,2024-03-19 15:00:00,-61.52502380957594,-1166.194199704034,63368.099666666676,-0.003286538508748632,-0.003499811328982324,63365.78546428567,61295.05087690063,62987.973341113226,63405.49744887579,63774.87028218101,63208.73001100795,-285.9719825153734,-333.8637286861281,537.0516482373405,21.793301341560436,79.07196594440757,157.65800687989395,63935.24973612836,62483.710285887544,62.89440828929722,58.47520369215808,True,False,63869.84,62969.84,63469.84,63519.84,,False,2024-03-19 15:30:00,2024-03-19 15:26:17,2024-03-19 16:09:51,success,True,93.3,4253.289999999987,,2,0,12,3
2024-03-19 18:00:00,64060.188,64653.137,63983.867,64334.48,4386,36422,0,2024-03-19 18:00:00,2024-03-19 18:00:00,308.0541547619141,-1116.882931046508,63987.28027380953,-0.0005227629421864345,0.0018195923463594768,63507.85363095237,62231.37251072028,65547.52596812902,63511.32058842765,63562.98902517511,63497.990282077684,-125.32097192345827,-206.22705505349236,466.1846850485756,170.21872721012187,99.93435810115625,110.21087753698521,64128.83960689326,62868.640957262105,91.56058000577195,73.80432248077689,True,False,64834.48,63934.48,64434.48,64484.48,,False,2024-03-19 18:45:00,2024-03-19 18:43:16,2024-03-19 22:04:57,success,True,93.3,4346.589999999987,,3,0,12,3
2024-03-19 22:00:00,64416.84,64520.938,63695.91,63807.539,4017,36422,0,2024-03-19 22:00:00,2024-03-19 22:00:00,15.82667857130582,-705.5658632451523,64495.99954761901,0.0029626881597781263,0.00441262959841473,64693.3838928571,64317.67192633198,67868.74587340666,64526.849745143576,64369.574923276276,64642.57873890601,89.99514605329023,100.64213750083891,881.9942505158218,-241.64870897834044,-192.4949625043737,-125.15547024420812,65833.27097710237,63450.386500709654,17.71648175074794,31.554641650927408,False,True,63307.539,64207.539,63707.539,63657.539,,False,2024-03-20 00:15:00,2024-03-20 00:16:12,2024-03-19 22:36:17,fail,False,-74.67,4271.919999999987,,0,1,12,3
2024-03-19 23:00:00,63782.203,63969.938,63695.727,63906.34,3112,56422,0,2024-03-19 23:00:00,2024-03-19 23:00:00,-197.38434523808974,-705.964342634572,64343.448392857135,0.0025642279943902625,-0.0005576610259806322,64495.99954761901,64224.849190123074,65487.405780179775,64185.508307434866,64224.469126760625,63893.55353594765,14.147463948349468,60.596374503860595,680.8751500408072,-115.73101754394156,-198.96330890955142,-197.0751093910294,64812.734988502736,62972.87208339256,14.106642144527967,11.153678079618805,False,True,63406.34,63806.34,63806.34,63756.34,2024-03-20 00:15:00,True,2024-03-20 00:15:00,2024-03-20 00:15:41,2024-03-20 13:28:38,success,True,93.3,4365.2199999999875,,1,0,12,3
2024-03-20 00:00:00,63967.887,64058.637,63506.934,63518.84,4576,56422,0,2024-03-20 00:00:00,2024-03-20 00:00:00,-152.55115476187348,-683.5536203028023,63636.92085714287,-0.0002998511725679948,-0.0034504283714561915,64343.448392857135,62406.67989470059,63755.86941744864,63991.00354676496,64111.23936548153,63678.04090746478,-29.19431239239202,16.310177393096538,571.0892048844563,-99.39922119020048,15.310680770635372,-21.594438940563123,64449.0113340588,62905.57048087077,14.926043490682963,17.46646362225229,False,True,63018.84,63418.84,63418.84,63368.84,2024-03-20 00:30:00,True,2024-03-20 00:30:00,2024-03-20 00:31:05,2024-03-20 02:58:45,success,True,93.3,4458.519999999988,,2,0,12,3
2024-03-20 01:45:00,62071.738,62281.738,61830.34,61955.84,4038,36422,0,2024-03-20 01:00:00,2024-03-20 01:00:00,-706.5275357142673,-762.0348421761737,62874.70744047616,-0.005493548544610682,-0.006546183081385044,63636.92085714287,60222.65093496373,61976.31670434903,62741.73538559067,63332.72685710308,62127.80284726523,-251.7767334134187,-144.73143582152383,1024.4951795929203,-155.40144547646923,-184.1618555211462,-309.64486790506635,63510.871339715675,60743.234354814784,12.25859426348125,8.344702129187713,False,True,61455.84,62355.84,61855.84,61805.84,,False,2024-03-20 06:45:00,2024-03-20 06:34:13,2024-03-20 02:18:18,fail,False,-74.67,4383.849999999988,,0,1,12,3
2024-03-20 03:00:00,63262.086,63286.039,62510.738,62737.039,4351,36422,0,2024-03-20 03:00:00,2024-03-20 03:00:00,-68.89492857144796,-842.61733254305,62541.700083333315,-0.008333742569333401,-0.005296017784728921,62805.81251190471,58550.48411616398,61941.30080005198,62791.69733869683,63164.54752668933,62267.85558617129,-210.18851293885382,-201.9682037690754,933.6206408978221,25.649741658075072,111.39960577910824,41.59818403860845,63529.74345138335,61007.46772095923,55.20318769339519,51.045178278788434,True,False,63237.039,62337.039,62837.039,62887.039,,False,2024-03-20 04:30:00,2024-03-20 05:21:10,2024-03-20 03:19:23,fail,False,-74.67,4309.179999999988,,0,2,12,3
2024-03-20 05:00:00,62911.738,63166.238,62783.84,62882.738,3656,36422,0,2024-03-20 05:00:00,2024-03-20 05:00:00,28.94003571432404,-856.8713853992886,62312.97180952378,-0.002725945490218493,-0.002264133022898208,62570.64011904764,60236.61835950177,62925.01535718513,62774.592780727784,62962.34373421089,62913.25528001375,-149.83738381106377,-183.53253152395396,652.5144989518493,86.41699931198673,115.74188751287875,146.73142896458012,63795.64985359875,62032.36070642875,69.30649737491852,71.72329515799068,True,False,63382.738,62482.738,62982.738,63032.738,,False,2024-03-20 05:30:00,2024-03-20 05:24:50,2024-03-20 05:48:21,success,True,93.3,4402.479999999988,,1,0,12,3
2024-03-20 10:00:00,62966.738,63227.539,62735.598,63016.539,3495,36422,0,2024-03-20 10:00:00,2024-03-20 10:00:00,230.063797619041,-892.4537658697081,62299.79327380954,-0.000912990639610162,-0.0005473339859970801,62025.296547619066,60392.19601973131,63191.94907196501,62395.333939694014,62362.58237853819,62546.74320949428,-65.91574439297256,-147.36198040845102,676.9706570340935,263.0178747849495,312.1166288270033,263.92065737866506,63462.1535964903,61632.832822498254,91.59583135581302,89.69844859205512,True,False,63516.539,63116.539,63116.539,63166.539,2024-03-20 12:00:00,True,2024-03-20 12:00:00,2024-03-20 13:25:57,2024-03-20 12:02:14,even,True,18.66,4421.139999999988,,2,0,12,3
2024-03-20 15:00:00,64067.586,64088.84,63531.918,63571.34,3321,36422,0,2024-03-20 15:00:00,2024-03-20 15:00:00,384.8310119047528,-398.68283700627217,63718.05750000004,0.003605945339630166,0.003582377692137908,63646.789964285665,64024.205026838004,65540.39151715508,63595.13083872062,63248.91652608386,63899.48353904364,168.00420696439687,131.33287891579823,475.529537668831,-2.8076219470603974,128.12205435154465,131.34093808057514,64541.448414896564,63256.01866319072,69.4410959700915,77.45384137760833,False,True,63071.34,63971.34,63471.34,63421.34,,False,2024-03-20 18:30:00,2024-03-20 18:25:32,2024-03-20 16:10:41,fail,False,-74.67,4346.4699999999875,,0,1,12,3
2024-03-20 17:00:00,64254.039,64406.262,63945.938,64158.938,3428,36422,0,2024-03-20 17:00:00,2024-03-20 17:00:00,186.69878571427398,-214.15042810062005,63910.5463452381,0.0017351361995513266,0.003316233760838013,63904.75628571431,63762.112374225726,65889.22581670612,63881.226451012226,63563.8928999928,64085.48845407634,177.29870974348887,160.44677964889482,437.0886516292458,19.549902648781426,82.0083804609676,39.02517027858994,64677.05813377582,63495.418774376856,82.15842023650528,79.80513656122525,False,True,63658.938,64058.938,64058.938,64008.938,2024-03-20 17:30:00,True,2024-03-20 17:30:00,2024-03-20 17:33:10,2024-03-20 19:15:25,success,True,93.3,4439.769999999988,,1,0,12,3
2024-03-20 18:00:00,63630.738,63815.039,63318.977,63718.039,4019,36422,0,2024-03-20 18:00:00,2024-03-20 18:00:00,5.7900595237879315,-173.47690622231312,63672.70335714284,-0.001419081521234961,0.0010756120208366064,63910.5463452381,61685.367236783226,64922.40491621769,63792.78031971115,63601.31555042551,63868.199331269345,135.40383630667202,153.6185608187005,373.21664038763294,-49.30594186443341,-33.94636154110776,-106.36420467838616,64372.04179579265,63362.85686674604,40.94887388899364,49.282173316597266,False,True,63218.039,64118.039,63618.039,63568.039,,False,2024-03-20 18:30:00,2024-03-20 18:23:59,2024-03-20 19:15:32,success,True,93.3,4533.069999999988,,2,0,12,3
2024-03-21 02:00:00,67854.805,67924.641,67661.836,67804.836,3815,36421,0,2024-03-21 02:00:00,2024-03-21 02:00:00,481.42714285710827,958.1959972639306,67953.28611904765,0.010082528352243514,0.00634883878027669,67851.30754761907,70312.63763535365,71407.03841719583,67562.61936658893,66764.87620593677,68079.95122841418,500.5954866468819,507.90587192607734,1203.7066543326284,-62.43378465772548,-36.222827657387825,-7.9206735465850215,69704.95521176323,66453.44724506514,77.35917800758011,81.94586217332107,False,True,67304.836,68204.836,67704.836,67654.836,,False,2024-03-21 05:00:00,2024-03-21 05:26:19,2024-03-21 02:43:36,fail,False,-74.67,4458.399999999988,,0,1,12,3
2024-03-21 03:00:00,67676.578,67983.273,67676.539,67885.211,3370,36421,0,2024-03-21 03:00:00,2024-03-21 03:00:00,101.97857142858265,1036.8324374971562,67972.37529761899,0.008183538388922822,0.0026263520779399607,67953.28611904765,69999.0762286999,69459.43227654822,67696.56526039804,67048.72567889954,67909.83381699347,444.77821542958554,481.0993769270281,827.316554154719,16.284050567584927,-64.82120123840286,-19.129480564093683,69028.21116510234,66792.9564688846,56.98526632970322,63.466748887525206,False,True,67385.211,67785.211,67785.211,67735.211,2024-03-21 03:45:00,True,2024-03-21 03:45:00,2024-03-21 05:25:10,2024-03-21 03:46:24,even,True,18.66,4477.059999999988,,1,0,12,3
2024-03-21 04:00:00,67817.141,67946.438,67641.836,67693.328,3211,36421,0,2024-03-21 04:00:00,2024-03-21 04:00:00,19.089178571332013,1097.612560899288,67872.35551190474,0.0051918342988913554,0.0022575310506763283,67972.37529761899,68981.67665942466,69382.41877426111,67739.21471494302,67245.64284232518,67819.41440385276,376.1266186177818,432.8669862313774,388.26683135207867,-32.012815273497836,4.154572411425761,-50.023016511899186,68343.57462617806,67293.75418152746,40.027374321358046,47.82047332390433,False,True,67193.328,68093.328,67593.328,67543.328,,False,2024-03-21 05:30:00,2024-03-21 05:28:38,,success,True,93.3,4570.359999999988,,2,0,12,3
2024-03-21 05:00:00,67553.047,67779.539,67546.641,67546.641,2482,36421,0,2024-03-21 05:00:00,2024-03-21 05:00:00,-100.01978571424843,1111.911454608664,67410.94441666664,0.0015621966292121525,0.00034441234760687123,67872.35551190474,66809.2351796784,68442.95972429265,67694.51835578169,67354.84070101718,67710.6151403509,298.9221867828019,368.98872644304817,156.08042768397488,-61.433334021348855,-49.406738561971,15.753131750854664,67921.32371772427,67498.40656297753,21.805140659785945,30.601755146479736,False,True,67046.641,67446.641,67446.641,67396.641,2024-03-21 05:30:00,True,2024-03-21 05:30:00,2024-03-21 05:44:18,2024-03-21 10:08:56,success,True,93.3,4663.659999999988,,3,0,12,3
2024-03-21 06:00:00,66689.539,66882.039,66526.055,66631.641,4490,36421,0,2024-03-21 06:00:00,2024-03-21 06:00:00,-461.41109523810155,1041.5211353825725,67099.25897619047,-0.0013610785912248626,-0.001994172182940346,67410.94441666664,65922.82700114769,67179.60223241005,67281.92784884981,67226.710236867,67114.90478156177,164.39641039457638,274.0204791144996,367.22145998396815,-178.74574131403642,-176.72318954255024,-132.42028482968453,67610.65375254012,66617.65581058341,10.852983247886646,8.646645994307379,False,True,66131.641,67031.641,66531.641,66481.641,,False,2024-03-21 17:15:00,2024-03-21 07:22:22,2024-03-21 07:58:21,success,True,93.3,4756.959999999988,,4,0,12,3
2024-03-21 09:00:00,66989.984,67115.938,66941.836,67016.141,3278,36421,0,2024-03-21 09:00:00,2024-03-21 09:00:00,-83.29370238094998,900.2867438942048,66890.3057142857,-0.0020471981679703543,-0.0019658593488021715,66906.57740476188,65289.228778026874,66799.23018521829,66983.8281325908,67027.34492848993,66836.89782868935,24.022901268705027,52.48555490805619,480.18449543575565,79.84483935324533,63.08892913654563,47.13451977993827,67486.64689752762,66188.64875985109,66.19609487428555,63.19089621130066,True,False,67516.141,67116.141,67116.141,67166.141,2024-03-21 09:30:00,True,2024-03-21 09:30:00,2024-03-21 10:18:59,2024-03-21 09:44:48,even,True,18.66,4775.619999999988,,5,0,12,3
2024-03-21 10:00:00,67013.539,67481.734,66999.945,67439.438,3419,36421,0,2024-03-21 10:00:00,2024-03-21 10:00:00,-16.271690476176445,857.5218362680607,66998.21248809522,-0.0020472185660579687,-0.0006596631254023556,66890.3057142857,65155.580320396846,67510.28814372548,67102.14559753727,67078.80447321411,67216.72126418988,35.52885999706632,39.74372198732078,387.45918075002857,112.9962979016127,51.28837874099554,91.46152906779025,67741.29115820242,66693.65137017734,82.90559603488516,82.5398111232512,True,False,67939.438,67039.438,67539.438,67589.438,,False,2024-03-21 15:30:00,,2024-03-21 11:11:44,fail,False,-74.67,4700.949999999988,,0,1,12,3
2024-03-21 13:30:00,66903.961,67255.984,66833.977,67214.234,3509,36421,0,2024-03-21 13:00:00,2024-03-21 13:00:00,63.6537857142539,732.853042554023,67061.23035714282,0.0016294773776194332,0.0008861289534770638,67068.4511785714,67209.2473580492,68122.36393854863,67039.15946944607,67056.09293640731,66956.23967320262,2.106055856726016,8.532290771473628,205.66500351366696,16.45031372543599,-43.74807636732294,-1.1691114551649662,67235.38742794607,66678.59191845918,39.701368049469814,33.55081189994653,True,False,67714.234,67314.234,67314.234,67364.234,2024-03-21 15:15:00,True,2024-03-21 15:15:00,2024-03-21 15:27:02,2024-03-21 15:23:23,even,True,18.66,4719.609999999988,,1,0,12,3
2024-03-22 00:00:00,65660.586,65875.438,65604.016,65768.672,3639,56421,0,2024-03-22 00:00:00,2024-03-22 00:00:00,-50.16139285721147,-33.55374664152623,65333.832059523826,-0.0028298013848024758,-0.0035259431752325777,65381.161797618995,63438.0641717158,64930.45020764248,65522.51052371204,65757.32298469951,65485.03738183697,-169.62088453002798,-194.50355118679198,554.1869791212357,123.24686515310896,111.93603095976869,87.28258307527722,66234.68980365063,64736.8849600233,75.09870509373353,62.9354566793048,True,False,66268.672,65368.672000000006,65868.672,65918.672,,False,2024-03-22 05:30:00,2024-03-22 06:54:07,2024-03-22 00:55:36,fail,False,-74.67,4644.939999999988,,0,1,12,3
2024-03-22 02:00:00,65520.438,65853.039,65464.164,65807.641,2853,36421,0,2024-03-22 02:00:00,2024-03-22 02:00:00,32.646321428517695,-114.41046282996831,65597.69748809525,0.0011317941916345088,-0.0022325998426897774,65366.47838095234,65133.908491649716,65405.78182668256,65548.96630142014,65660.94282940666,65585.44448744414,-108.09274472568359,-140.03572304517687,199.60313656879072,54.04940247689228,-8.35735018923151,-17.342685586569132,65856.40872181201,65315.980253076275,66.71388459214604,60.656843224351896,True,False,66307.641,65407.641,65907.641,65957.641,,False,2024-03-22 05:30:00,2024-03-22 06:54:07,2024-03-22 02:36:25,fail,False,-74.66,4570.279999999988,,0,2,12,3
2024-03-22 03:00:00,65825.641,65936.734,65600.266,65898.234,3341,36421,0,2024-03-22 03:00:00,2024-03-22 03:00:00,231.21910714290425,-112.43697950312344,65550.11389285716,0.0021078138815878987,0.00040456091955972794,65597.69748809525,65788.29181936083,66211.1133521998,65676.13913998433,65698.993998075,65756.62744031647,-62.59709302113333,-102.69808414767851,203.57380354961543,49.02889714480261,61.1100337117532,24.911891984884278,66032.95207510845,65481.802805524494,75.15877477422005,75.12621587515696,True,False,66398.234,65498.234,65998.234,66048.234,,False,2024-03-22 07:00:00,2024-03-22 07:52:15,2024-03-22 03:53:09,fail,False,-74.66,4495.619999999988,,0,3,12,3
2024-03-22 04:00:00,65265.844,65374.438,65143.164,65276.539,3379,36422,0,2024-03-22 04:00:00,2024-03-22 04:00:00,-47.58359523808758,-154.26476345499395,65583.73011904763,0.001550951359908941,0.00014504319856197283,65550.11389285716,65557.75486795134,66065.19649277664,65570.11309150625,65640.8515870474,65592.46761506707,-65.98324355775549,-77.04500097358505,196.64409064644474,-82.18546439625788,-104.32326625390851,-9.401347093240474,65857.93713743977,65325.49809269437,24.352194904205103,45.01553590497344,False,True,64776.539,65676.53899999999,65176.539,65126.539,,False,2024-03-22 12:30:00,2024-03-22 12:26:52,2024-03-22 04:58:03,fail,False,-74.66,4420.959999999988,,0,4,12,3
2024-03-22 10:00:00,66205.141,66320.539,66168.172,66320.539,1589,36421,0,2024-03-22 10:00:00,2024-03-22 10:00:00,37.83426190483442,21.433986497868318,66267.49898809525,0.0017478341684649245,0.002133005110201377,66334.1838214286,66302.75452783577,67532.11155418436,66271.62762541887,66126.77893921132,66419.61687134505,78.62153785440023,73.37367708674871,340.84190599409226,-11.09297144813172,-16.532226350318524,-20.790214654276497,66879.75344443707,65957.98029825302,51.45771567551844,53.39657953621225,False,True,65820.539,66220.539,66220.539,66170.539,2024-03-22 10:45:00,True,2024-03-22 10:45:00,2024-03-22 11:33:36,2024-03-25 00:00:03,success,True,93.3,4514.259999999988,,1,0,12,3
2024-03-22 11:00:00,65881.016,66066.336,65880.141,65986.836,2388,36421,0,2024-03-22 11:00:00,2024-03-22 11:00:00,-66.68483333334734,5.6048035791754955,65995.5106547619,0.0004831428246931383,0.0012037164071696976,66267.49898809525,65493.06904517099,67230.67382398825,66144.63558102859,66098.73412694056,66149.04982490544,44.14391599908413,63.33494104495995,231.7445663071237,-77.18447368413035,-99.49889439289109,-82.32855555554852,66461.90498942006,65834.69466039081,11.689105032478421,23.534719783974456,False,True,65486.835999999996,66386.836,65886.836,65836.836,,False,2024-03-22 11:45:00,2024-03-22 11:42:35,2024-03-25 00:00:03,success,True,93.3,4607.559999999989,,2,0,12,3
2024-03-22 13:45:00,64744.039,64796.039,64083.84,64249.84,4055,36422,0,2024-03-22 13:00:00,2024-03-22 13:00:00,-507.66372619047615,-135.05348550755298,64943.54624999996,-0.0037346741275230996,-0.004586811081257561,65487.84692857143,63118.16309972412,64272.093770928775,65036.571031031795,65429.83232901946,64542.09801100789,-165.686287063465,-94.54618945472052,719.9527627282001,-182.60347850018297,-110.96650154804956,-102.71869659440563,65514.03424069096,63568.661781324816,11.57269639124116,13.338386037161404,False,True,63749.84,64649.84,64149.84,64099.84,,False,2024-03-22 15:45:00,2024-03-22 15:36:22,2024-03-22 14:09:23,fail,False,-74.66,4532.899999999989,,0,1,12,3
2024-03-22 17:00:00,62771.738,63587.035,62661.066,63322.969,5271,36422,0,2024-03-22 17:00:00,2024-03-22 17:00:00,-554.0362380951992,-623.587847520801,63329.63069047618,-0.008953572192214508,-0.004390211371515482,63324.09314285714,59521.240612796646,63243.88732491325,63564.67883502477,64234.54048138666,63019.465024767815,-350.7902781800585,-293.61573459075953,934.4662010786383,-63.07327278977755,-200.36777468182845,-173.27457069142838,64280.99439622398,61756.43565331165,16.933297620167387,13.81884918932119,True,False,63822.969,62922.969,63422.969,63472.969,,False,2024-03-22 17:30:00,2024-03-22 17:28:11,2024-03-22 18:50:30,success,True,93.3,4626.199999999989,,1,0,12,3
2024-03-22 20:00:00,63605.938,63924.238,63517.887,63614.137,3653,36422,0,2024-03-22 20:00:00,2024-03-22 20:00:00,99.56945238090702,-695.582388475872,63468.29746428578,-0.0005126331507079625,-0.002156350747513729,63323.08089285714,62339.008355184465,63437.00741626723,63570.28123718342,63845.681071068975,63662.788389748865,-213.22756880857196,-249.32453469825498,520.3452227699535,55.06954764362308,95.39180048161506,100.50064121084142,64366.7544404883,62960.32233900943,58.60218091101586,55.31880076307987,True,False,64114.137,63714.137,63714.137,63764.137,2024-03-22 21:45:00,True,2024-03-22 21:45:00,2024-03-22 21:50:23,2024-03-22 22:06:27,success,True,93.3,4719.499999999989,,2,0,12,3
2024-03-22 21:00:00,63761.039,63854.238,63519.637,63542.539,2758,36422,0,2024-03-22 21:00:00,2024-03-22 21:00:00,145.21657142863842,-681.2332489920591,63648.34209523804,0.001031999220860189,-0.0012233154573861504,63468.29746428578,63184.95586438661,63828.53888397631,63611.05572100426,63795.68110300168,63640.17167664256,-166.35380881922174,-207.73448440106773,376.5113220748451,-51.396571723380475,13.863557275450148,10.257964568350872,64148.4619614436,63130.38139184152,58.07765146631625,57.807997581125,True,False,64042.539,63642.539,63642.539,63692.539,2024-03-22 21:45:00,True,2024-03-22 21:45:00,2024-03-22 21:48:03,2024-03-22 22:07:38,success,True,93.3,4812.799999999989,,3,0,12,3
2024-03-25 04:00:00,66588.656,66716.93,66493.781,66521.539,2514,36421,0,2024-03-25 04:00:00,2024-03-25 04:00:00,354.20342857144715,137.69208151116618,66968.86898809523,0.009428440646533058,0.00921215589423312,66723.78680952382,69029.70285853147,72263.24082170555,66590.13883698556,66012.41031702307,66955.16305297556,347.81588208112225,354.2392732250525,1589.1977051830386,-286.1963842449477,-223.59071138623403,-170.09648950814153,69100.57995497267,64808.24615097846,8.78669573640452,20.734437269164395,False,True,66021.539,66921.539,66421.539,66371.539,,False,,,2024-03-25 05:37:52,fail,False,-74.66,4738.139999999989,,0,1,13,3
2024-03-25 05:00:00,66723.539,66911.438,66596.523,66816.836,2339,36421,0,2024-03-25 05:00:00,2024-03-25 05:00:00,245.08217857140698,234.30586495810712,67271.91953571427,0.008325545981192981,0.004626557097722592,66968.86898809523,68913.04894319824,70272.17232710989,66663.10227773206,66203.6577110406,66569.07745992433,306.95507297007134,333.0224794430203,1279.9753362137733,-5.871844857188989,-27.324614723140257,-39.18028379768657,68297.04416381293,64839.610756035734,32.13425985746775,24.42740147984611,False,True,66316.836,67216.836,66716.836,66666.836,,False,,,2024-03-25 05:56:01,fail,False,-74.66,4663.47999999999,,0,2,13,3
2024-03-25 07:00:00,67520.734,67655.102,67451.836,67453.438,3417,36421,0,2024-03-25 07:00:00,2024-03-25 07:00:00,149.16485714292503,465.55043157834734,67250.9536785715,0.0006437840956052173,0.0001952563978789614,67421.0843928572,66714.41819458225,67815.654665469,67148.3595404749,66702.46435318481,67350.15686377713,293.7469341445685,302.27120520712316,335.76184666776254,82.41587478503061,127.83669384250243,96.78884072926303,67804.9353567786,66896.87837077565,88.51012505222086,85.12099433569624,False,True,66953.438,67353.438,67353.438,67303.438,2024-03-25 08:15:00,True,2024-03-25 08:15:00,2024-03-25 08:37:15,2024-03-25 12:07:17,success,True,93.3,4756.77999999999,,1,0,13,3
2024-03-25 09:00:00,67172.141,67301.734,67118.641,67157.734,2131,36421,0,2024-03-25 09:00:00,2024-03-25 09:00:00,28.117261904772022,559.9864136906399,67224.87077380953,0.0009489315176278016,0.0012165622019708134,67279.07094047627,66986.52432763013,68267.87331738838,67203.86223015415,66953.94840500315,67351.7095204678,208.40739235677756,250.89932763802645,324.96222539447785,-47.27638390097127,-44.366037495667115,-69.50038080493687,67790.40852475035,66911.51051618526,31.25575716381933,37.78193712748908,False,True,66657.734,67057.734,67057.734,67007.734,2024-03-25 10:00:00,True,2024-03-25 10:00:00,,2024-03-25 10:09:13,even,True,18.66,4775.43999999999,,2,0,13,3
2024-03-25 11:00:00,66966.023,67026.734,66785.766,66815.539,2279,36421,0,2024-03-25 11:00:00,2024-03-25 11:00:00,-80.61141666671028,546.1042158683558,67079.65703571426,0.0007735709682791815,-0.0005382830126246575,67144.25935714282,66982.59338377193,67466.39997839005,67049.29427782597,66978.68387404153,66913.20658926725,107.30815075502323,156.28193098757455,222.39334774149452,-63.84744513251644,-48.83088682487141,-24.215597179194447,67213.43760871828,66611.47556981623,23.41412176409349,30.322510383612116,False,True,66315.539,67215.539,66715.539,66665.539,,False,,,2024-03-25 12:06:22,fail,False,-74.66,4700.77999999999,,0,1,13,3
2024-03-25 15:30:00,66956.039,67263.539,66954.563,67210.492,3873,36421,0,2024-03-25 15:00:00,2024-03-25 15:00:00,60.30579761901754,498.50228137466183,67338.23538095239,0.0009106716941859768,0.0013575536831515358,66968.38563095238,67115.54967427813,68457.69864490307,67040.82522479935,67015.51385519034,67037.41015720673,32.23784594537574,39.86988519281721,129.07495381694264,22.77724355008104,-11.299272445830866,2.947965944200405,67213.1613448596,66863.15896955386,45.66324747506811,44.077319696555,True,False,67710.492,66810.492,67310.492,67360.492,,False,2024-03-25 16:00:00,2024-03-25 15:56:33,,success,True,93.3,4794.07999999999,,1,0,13,3
2024-03-25 21:00:00,70889.617,70976.734,70580.953,70637.141,2701,36421,0,2024-03-25 21:00:00,2024-03-25 21:00:00,523.6639880952425,1221.842683141571,70980.40263095242,0.008904403268879658,0.006937337955890119,70676.44911904761,73198.54219742045,74174.843146391,70385.3417447572,69638.82908525025,70872.17872170624,443.7307358695689,428.07131340216904,1192.6978557605805,14.187856209216989,92.56370106634859,34.58676608178939,72483.82082698302,69262.03661642945,87.49570618247054,88.80527765703111,False,True,70137.141,71037.141,70537.141,70487.141,,False,2024-03-25 23:15:00,2024-03-25 23:16:14,2024-03-25 21:56:14,fail,False,-74.66,4719.41999999999,,0,1,13,3
2024-03-25 22:00:00,71001.336,71178.961,70743.445,70795.539,3908,36421,0,2024-03-25 22:00:00,2024-03-25 22:00:00,303.9535119048087,1301.5482331784733,71050.74219047623,0.007961373446705253,0.005535475958527219,70980.40263095242,73081.14444511855,73737.18168876521,70595.80528787473,69949.37788296326,70959.76584382533,414.35739530863066,425.3539582475716,670.2514668386432,6.167560371584841,50.387440660444554,12.187011351968977,71866.1053240575,70054.92636359316,83.57898495150998,83.67273565446173,False,True,70295.539,70695.539,70695.539,70645.539,2024-03-25 23:15:00,True,2024-03-25 23:15:00,2024-03-25 23:15:39,2024-03-26 00:43:51,success,True,93.3,4812.71999999999,,1,0,13,3
2024-03-25 23:00:00,70909.234,70954.039,70396.039,70404.938,2676,56421,0,2024-03-25 23:00:00,2024-03-25 23:00:00,70.33955952381075,1343.2600090401102,70676.73870238099,0.0038867282810400366,0.0025400144827354937,71050.74219047623,70710.74771433132,72352.705348238,70667.13435131032,70163.98872431845,70842.7455703475,359.57294045595336,399.90364298709505,505.4010121853534,-97.80049501193571,-32.90079222570057,-6.325755073979963,71525.03693679773,70158.95420389727,51.94125295775575,63.7351967389633,False,True,69904.938,70804.938,70304.938,70254.938,,False,2024-03-25 23:30:00,2024-03-25 23:18:42,2024-03-26 09:02:17,success,True,93.3,4906.01999999999,,2,0,13,3
2024-03-26 00:00:00,69875.172,70480.68,69871.938,70412.938,3123,56421,0,2024-03-26 00:00:00,2024-03-26 00:00:00,-374.0034880952444,1277.2387962930807,70548.08808333338,0.0010143743972980377,0.0014684183904038158,70676.73870238099,69944.08089742367,71826.42814484941,70389.44449709514,70141.83534003753,70351.47534950123,245.97302364272764,324.6380374587941,397.9267775670927,-45.28777089777577,-137.1490237358521,-105.9794317164924,70888.6764992168,69812.77419978565,35.21611210682732,27.01195531611944,False,True,69912.938,70312.938,70312.938,70262.938,2024-03-26 01:30:00,True,2024-03-26 01:30:00,2024-03-26 01:38:05,2024-03-26 03:18:01,success,True,93.3,4999.319999999991,,3,0,13,3
2024-03-26 04:00:00,70313.734,70313.734,70074.414,70213.336,2442,36421,0,2024-03-26 04:00:00,2024-03-26 04:00:00,-16.471380952381878,1073.513131305328,70169.94813095234,0.0004000580738860596,-0.0013529476450929584,70042.66723809522,69834.13931958933,70206.77246847251,70199.85417012293,70168.66082687727,70139.22484588924,65.94893277772644,93.6377836063447,333.60740330455894,2.116417612734949,0.8254238045192324,42.67250567598967,70591.0948403504,69688.85485142808,54.56936993878812,54.06893620743091,True,False,70713.336,70313.336,70313.336,70363.336,2024-03-26 05:00:00,True,2024-03-26 05:00:00,2024-03-26 09:02:14,2024-03-26 07:36:48,even,True,18.66,5017.9799999999905,,4,0,13,3
2024-03-26 05:00:00,70564.836,70567.836,70325.492,70428.156,2749,36421,0,2024-03-26 05:00:00,2024-03-26 05:00:00,127.28089285711758,1054.1821183160937,70293.90134523808,0.0008830851162849944,-0.0010495513317765864,70169.94813095234,70205.907898613,70349.691451238,70299.76704046672,70229.22780919225,70326.20556415552,68.05067093214893,77.18075582550638,228.53568103922325,77.28582559346978,87.24429205355409,32.053339869424235,70636.22873355847,70017.68239475257,82.11989212997445,75.48033263946321,True,False,70928.156,70528.156,70528.156,70578.156,2024-03-26 06:15:00,True,2024-03-26 06:15:00,2024-03-26 09:02:54,2024-03-26 06:20:27,even,True,18.66,5036.63999999999,,5,0,13,3
2024-03-26 06:00:00,70455.539,70710.641,70438.063,70629.906,2282,36421,0,2024-03-26 06:00:00,2024-03-26 06:00:00,123.95321428573516,1017.8893632012478,70493.77092857142,0.0013581017936250862,-0.0004922526566433243,70293.90134523808,70516.86152485112,70565.09825594009,70420.69603632482,70312.88465532716,70577.2641998624,76.50256430399895,75.2355228481486,230.00259934867134,44.472570347454166,43.53638527695148,91.00696456828155,70889.26770898311,70266.76069074169,85.4573475972882,85.54408136421385,True,False,71129.906,70729.906,70729.906,70779.906,2024-03-26 09:15:00,True,2024-03-26 09:15:00,2024-03-26 09:21:19,2024-03-26 09:54:17,success,True,93.3,5129.9399999999905,,6,0,13,3
2024-03-26 09:00:00,70638.438,70943.578,70633.016,70853.836,3523,36421,0,2024-03-26 09:00:00,2024-03-26 09:00:00,115.64502380952763,905.5918911997869,70572.38888095236,0.0010349836315877337,0.0027166270854966077,70580.45661904762,70573.29731772172,72437.78441000145,70518.44960645771,70435.72898397724,70513.12627278984,57.68498888162139,57.65915098769011,166.57077237172945,50.185188510557055,15.901104575110367,-27.08032989325875,70739.49681549167,70288.25573008801,67.13341686179895,46.93175441353906,True,False,71353.836,70453.836,70953.836,71003.836,,False,2024-03-26 09:30:00,2024-03-26 09:23:55,2024-03-26 09:55:19,success,True,93.3,5223.239999999991,,7,0,13,3
2024-03-26 20:00:00,70107.234,70308.242,70057.891,70254.148,2871,36421,0,2024-03-26 20:00:00,2024-03-26 20:00:00,-84.1807142857142,387.33966633005184,69976.28867857148,-0.0010346892958893882,-0.0020365714965194905,70082.4793928572,68729.56504537631,69865.11496256325,70089.65567263815,70241.69692312586,69978.71485724111,-87.73473619770084,-87.61995639474293,439.9560476263614,76.03389748875634,60.78627106982458,61.49030546956055,70574.1555215367,69384.77419294552,67.96701642678674,59.48193341155936,True,False,70754.148,69854.148,70354.148,70404.148,,False,2024-03-27 02:45:00,2024-03-27 03:13:27,2024-03-26 21:06:11,fail,False,-74.66,5148.579999999991,,0,1,13,3
2024-03-26 23:00:00,69861.141,69951.734,69745.531,69914.234,2324,56421,0,2024-03-26 23:00:00,2024-03-26 23:00:00,23.353761904741987,194.39524323803198,69822.43203571426,0.0002071865454680506,-0.0009438951254579964,69770.95654761905,69472.33434985737,69985.38289772121,69869.66181971756,70006.82182221326,69803.26452975578,-88.00542344116548,-90.88663063961782,237.4083033000903,-28.49805916751211,-7.307596491271397,-8.597802889518789,70123.7657392109,69481.26332030066,43.68853354016668,39.091967713217606,True,False,70414.234,70014.234,70014.234,70064.234,2024-03-26 23:30:00,True,2024-03-26 23:30:00,2024-03-27 02:39:27,2024-03-26 23:53:07,even,True,18.66,5167.239999999991,,1,0,13,3
2024-03-27 01:00:00,70283.578,70349.734,70221.836,70331.734,2867,36421,0,2024-03-27 01:00:00,2024-03-27 01:00:00,153.63367857140838,171.8224750590889,70037.1653690476,0.00028588715385413556,-0.00042655658746817374,69976.06571428567,69539.6892828498,70224.31010012908,70058.23219784774,70052.44738793152,70129.02074406605,-27.209125780660543,-55.36322812490671,217.1560469485822,110.12684348125185,95.13192122458713,55.58834434127493,70423.68140744664,69835.86008068545,91.85247418669117,78.13883262885815,True,False,70831.734,69931.734,70431.734,70481.734,,False,2024-03-27 02:45:00,2024-03-27 15:04:43,2024-03-27 02:10:43,fail,False,-74.66,5092.579999999991,,0,1,13,3
2024-03-27 04:45:00,70419.805,70640.734,70342.836,70628.734,2359,36421,0,2024-03-27 04:00:00,2024-03-27 04:00:00,111.98024999993504,179.5857391805621,70524.39601190477,0.0016930975365376847,0.0017643384983667037,70360.41196428573,70602.2522363263,71510.98312226124,70402.27243629131,70287.95860683637,70521.1701809426,48.79864100331906,31.78142198944984,257.6537045086683,26.407846577261807,-1.8011499827116495,15.826932576470426,70870.5026820293,70173.3376798559,68.9101684875631,59.37915833930325,True,False,71128.734,70228.734,70728.734,70778.734,,False,2024-03-27 15:15:00,2024-03-27 15:07:44,2024-03-27 06:50:45,fail,False,-74.66,5017.919999999991,,0,2,13,3
2024-03-27 06:00:00,70426.938,70533.734,70314.453,70314.641,2129,36421,0,2024-03-27 06:00:00,2024-03-27 06:00:00,-8.100809523806674,194.28244215359155,70441.32383333336,0.0009537085124529391,0.0005709706422966229,70516.29520238096,70348.34968087821,71068.49386527293,70417.0984653391,70336.28427589979,70513.74054695564,44.861813069161144,43.8390891896294,236.72032944715687,-44.50476298590365,-9.560875816998305,1.4960467836353928,70833.3129917093,70192.66810220198,43.14165034578891,57.812824123158414,False,True,69814.641,70214.641,70214.641,70164.641,2024-03-27 09:15:00,True,2024-03-27 09:15:00,2024-03-27 09:29:02,2024-03-27 12:25:23,success,True,93.3,5111.219999999991,,1,0,13,3
2024-03-27 09:00:00,70348.664,70376.039,70073.148,70088.438,2382,36421,0,2024-03-27 09:00:00,2024-03-27 09:00:00,-28.957726190492394,165.8333830368938,70165.37765476189,-0.00040378804905198456,-0.0005046002865823644,70427.94741666663,69555.92891619151,70448.00955551166,70345.42937360864,70345.75789480824,70299.62028964573,13.707199429205502,27.509575849186934,128.30848345993508,-61.8208854488621,-13.393224630199256,-35.76885036115709,70472.83674231663,70124.90383697482,31.245955525442557,41.8808251068133,False,True,69588.438,69988.438,69988.438,69938.438,2024-03-27 09:30:00,True,2024-03-27 09:30:00,2024-03-27 10:57:46,2024-03-27 09:40:31,even,True,18.66,5129.879999999991,,2,0,13,3
2024-03-27 13:00:00,70168.539,70293.039,70059.141,70227.336,2049,36421,0,2024-03-27 13:00:00,2024-03-27 13:00:00,50.15144047618378,39.323381670721574,70051.28369047618,-0.0012919409541205936,-0.0006540973085068602,69967.51847619048,68900.48036102629,70209.71636166419,70069.69791745905,70094.99404041332,70054.88369487446,-26.676077425901894,-40.5277940832044,271.2606536563575,77.65640866872855,70.21837805301766,53.152861713053426,70422.58557731054,69688.68181243837,86.76996467162799,82.9445361072951,True,False,70727.336,69827.336,70327.336,70377.336,,False,2024-03-27 15:15:00,2024-03-27 15:04:17,2024-03-27 15:45:59,success,True,93.3,5223.179999999991,,3,0,13,3
2024-03-27 14:00:00,70267.445,70411.734,70261.391,70269.641,1946,36421,0,2024-03-27 14:00:00,2024-03-27 14:00:00,83.76521428569686,46.71846430421283,70105.69327380955,-0.000729236997761876,-0.0005215489636106808,70051.28369047618,69089.22337004406,70258.3732260406,70157.12606944848,70134.91460235933,70279.47722497421,-4.904200375123764,-23.492479318666383,236.09071866346883,40.06692397662846,45.80852046782093,69.36220330235665,70599.6996951699,69960.75475477852,85.90291453406485,86.28662200125943,True,False,70769.641,69869.641,70369.641,70419.641,,False,2024-03-27 15:15:00,2024-03-27 15:04:35,2024-03-27 15:45:59,success,True,93.3,5316.479999999991,,4,0,13,3
2024-03-27 21:00:00,68513.336,68975.438,68513.336,68965.234,3372,36421,0,2024-03-27 21:00:00,2024-03-27 21:00:00,-331.1426190476923,-281.7424287009926,68651.29003571425,-0.001762360028766051,-0.006785523686854201,68810.27211904756,67488.61137584414,67063.38974076492,68961.26861329649,69286.22054964441,68715.19480804953,-177.55409371726273,-157.8933610298599,803.8062425322964,47.25609459920088,-75.30810629510961,-68.70428070181515,69801.83323546813,67630.05638063094,37.115807816073605,29.14309306881272,True,False,69465.234,68565.234,69065.234,69115.234,,False,2024-03-27 23:15:00,2024-03-28 00:47:32,2024-03-27 21:39:19,fail,False,-74.66,5241.8199999999915,,0,1,13,3
2024-03-27 22:00:00,68689.539,69016.734,68658.102,68986.641,3477,36421,0,2024-03-27 22:00:00,2024-03-27 22:00:00,-158.98208333330695,-324.91092712059617,68661.15195238091,-0.0017624503160604975,-0.0053514288735804615,68651.29003571425,67369.4133710547,67681.53194145055,68877.91830381549,69152.62088051325,68742.53567939455,-167.6105604415352,-167.55340210646767,424.1002473090449,34.194735810073325,-22.65105607151054,-27.002889232942834,69316.57101326177,68170.00034552734,33.00400597538512,33.380414919711974,True,False,69486.641,69086.641,69086.641,69136.641,2024-03-27 23:30:00,True,2024-03-27 23:30:00,2024-03-28 01:51:55,2024-03-27 23:51:07,even,True,18.66,5260.479999999991,,1,0,13,3
2024-03-27 23:00:00,68922.008,69166.039,68915.195,69133.336,2089,56421,0,2024-03-27 23:00:00,2024-03-27 23:00:00,9.861916666661273,-335.9722415277356,68716.3044761905,0.0006192726122959784,-0.0020785217498898037,68661.15195238091,68729.80095954779,68672.25767270727,68954.91587613047,69120.95692941734,68842.16077433781,-127.28061688586604,-151.1901700926843,264.28042325471995,65.39667801857286,14.693695906447829,-2.1188937048136722,69200.43934573169,68485.38220294393,71.35938130823307,63.09998075729184,True,False,69633.336,69233.336,69233.336,69283.336,2024-03-28 00:30:00,True,2024-03-28 00:30:00,2024-03-28 01:55:03,2024-03-28 01:21:17,even,True,18.66,5279.139999999991,,2,0,13,3
2024-03-28 00:00:00,68954.641,69150.938,68935.063,69073.828,3112,56421,0,2024-03-28 00:00:00,2024-03-28 00:00:00,55.15252380959282,-338.7195021996886,69024.35067857143,0.0006191765904793366,-0.0013405481228402091,68716.3044761905,68772.32193393106,69091.77820303058,69023.48482141475,69116.00582294489,69117.87313312691,-91.43931396758126,-120.73554673881155,243.38087527435235,57.426132094915374,33.0737657379068,100.11730099759006,69447.93731474728,68789.30895150654,75.95385190710307,83.16812448520939,True,False,69573.828,69173.828,69173.828,69223.828,2024-03-28 00:30:00,True,2024-03-28 00:30:00,2024-03-28 01:54:19,2024-03-28 01:32:21,even,True,18.66,5297.799999999991,,3,0,13,3
2024-03-28 01:00:00,69463.328,69477.734,69296.742,69364.234,2632,36421,0,2024-03-28 01:00:00,2024-03-28 01:00:00,308.0462023809232,-296.1685582566279,69214.3536666667,0.0016978618729844518,0.00052786497215554,69024.35067857143,69437.21646108493,69836.46871449072,69208.34510550517,69191.90777702858,69373.39963949089,-38.7160484357737,-80.6944121332751,277.5567631351968,50.14214138290845,65.91189370477514,68.36678740975913,69749.60126972341,68998.69800925837,93.99725707066047,93.52496271623279,True,False,69864.234,69464.234,69464.234,69514.234,2024-03-28 02:00:00,True,2024-03-28 02:00:00,2024-03-28 02:19:38,2024-03-28 02:00:09,even,True,18.66,5316.459999999991,,4,0,13,3
2024-03-28 03:00:00,69724.75,69784.734,69582.758,69653.539,2663,36421,0,2024-03-28 03:00:00,2024-03-28 03:00:00,278.5790119047306,-204.20108638389502,69584.5841785714,0.002060350621282599,0.0025964869598016985,69492.93267857144,69931.21560136709,70993.51450337574,69501.05090104256,69369.02000537474,69679.4766928104,34.61331101444375,-3.644823524380876,325.69259109889236,33.98617612654925,58.60519091853348,46.43286308905226,70120.66169079392,69239.7916948269,66.10387855843874,71.78221212098236,False,True,69153.539,69553.539,69553.539,69503.539,2024-03-28 03:30:00,True,2024-03-28 03:30:00,2024-03-28 04:34:17,2024-03-28 03:35:12,even,True,18.66,5335.119999999991,,5,0,13,3
2024-03-28 04:00:00,69487.836,69624.438,69383.391,69606.734,2288,36421,0,2024-03-28 04:00:00,2024-03-28 04:00:00,91.65149999996356,-180.47034002612054,69501.23880952381,0.0009134362788076706,0.0027582232664051225,69584.5841785714,69184.9190162513,71248.50688580106,69513.17663457736,69409.36837521664,69666.174375645,37.590126960436464,19.540764795454606,262.1483497624197,12.993823529439396,-4.9668290333938785,-1.8323240453901235,70021.57464782427,69312.27410346574,47.45721113839145,48.9119316766863,False,True,69106.734,70006.734,69506.734,69456.734,,False,2024-03-28 04:45:00,2024-03-28 04:34:21,2024-03-28 08:13:47,success,True,93.3,5428.419999999991,,6,0,13,3
2024-03-28 12:00:00,70601.742,70734.641,70595.438,70601.539,1789,36421,0,2024-03-28 12:00:00,2024-03-28 12:00:00,191.12290476191265,169.10021055757534,70735.60220238089,0.00260675459390717,0.003136264022566934,70573.43232142858,71137.58985251952,72278.73429500073,70533.04064845064,70262.1742550672,70758.5416006192,156.6709770862799,147.99517129487842,397.7673365031862,-14.494859305152204,2.328399380799965,29.918210870338953,71295.52750489849,70220.0556963399,62.844246429271855,71.85910260734238,False,True,70101.539,70501.539,70501.539,70451.539,2024-03-28 12:30:00,True,2024-03-28 12:30:00,2024-03-29 08:07:00,2024-03-28 12:33:13,even,True,18.66,5447.079999999991,,7,0,13,3
2024-03-28 14:00:00,70689.438,70869.539,70464.617,70548.141,2858,36421,0,2024-03-28 14:00:00,2024-03-28 14:00:00,31.051369047665503,254.14653873382485,70843.98755952386,0.001725737917687927,0.001463937634593294,70766.65357142856,70899.7934608796,71746.64719277513,70631.20516967546,70448.94129891592,70710.7777791538,127.82969413112733,141.0304427103195,212.88576285933004,-35.80394977636752,-4.127584107336588,-22.50140350878064,70998.17355901389,70421.8819992937,39.46007270980652,51.38284394185697,False,True,70048.141,70948.141,70448.141,70398.141,,False,2024-03-29 05:30:00,2024-03-29 09:37:35,2024-03-28 15:03:35,fail,False,-74.66,5372.419999999991,,0,1,13,3
2024-03-28 15:15:00,70785.039,71179.734,70449.734,71069.539,3486,36421,0,2024-03-28 15:00:00,2024-03-28 15:00:00,77.33398809529899,289.47086260111246,70859.97882142864,0.0015981546950879317,0.001485996270778508,70843.98755952386,70920.58175528234,71866.35922807765,70738.13099277767,70560.56506319775,70767.68400859988,120.18561020228663,124.84716670076182,176.60838442232557,66.86715514273965,22.10630202954053,31.969565875508124,71007.60532757003,70529.26268962974,77.2045067344019,61.97992246910502,True,False,71569.539,71169.539,71169.539,71219.539,2024-03-28 16:45:00,True,2024-03-28 16:45:00,2024-03-28 16:51:06,2024-03-28 17:17:27,success,True,93.3,5465.719999999991,,1,0,13,3
2024-03-28 16:00:00,70909.297,71259.539,70717.836,70823.336,4161,36421,0,2024-03-28 16:00:00,2024-03-28 16:00:00,15.991261904782732,315.9374312993896,71123.98029761904,0.000804237666710066,0.0016547250576582648,70859.97882142864,70743.06558551827,72097.9269425662,70802.51590959812,70631.93137989457,70884.30209356722,116.53551827518095,122.25979821960094,172.63813277817096,19.112543171620928,34.71439731682767,62.79114447889151,71118.86357281776,70651.24061431669,51.04716799468582,62.45362781583603,False,True,70323.336,71223.336,70723.336,70673.336,,False,2024-03-28 19:15:00,2024-03-29 05:29:40,2024-03-28 16:31:53,fail,False,-74.66,5391.059999999991,,0,1,13,3
2024-03-28 23:00:00,70691.438,70853.539,70664.836,70827.781,1454,56421,0,2024-03-28 23:00:00,2024-03-28 23:00:00,-97.17278571425413,291.51925579003,70665.4662976191,-0.0011729912860972394,-0.001526131412955721,70715.25533333332,69797.66423807126,70477.01066042599,70772.09095708432,70795.3540087167,70761.21666563468,4.330649459952838,16.44140705980933,205.05101194771277,19.965792913688347,3.0961369108845247,5.246938424475957,71039.5355317641,70484.39779950527,57.70140961004256,50.186667193718215,True,False,71327.781,70927.781,70927.781,70977.781,2024-03-29 01:15:00,True,2024-03-29 01:15:00,,2024-03-29 01:33:39,even,True,18.66,5409.719999999991,,1,0,13,3
2024-03-29 00:00:00,70797.477,70846.836,70563.477,70675.07,2788,56421,0,2024-03-29 00:00:00,2024-03-29 00:00:00,-49.78903571421688,276.2435059213167,70749.47441666666,-9.81866239790176e-05,-0.0012998962048688845,70665.4662976191,70381.87073077493,70547.57287781869,70774.62788147022,70792.55711334835,70748.54794083242,1.6270113948412472,9.487775234224308,101.7391607526289,-28.256338493374642,-1.2369999999500578,-5.832266253943089,70885.89580784847,70609.70007381636,59.6583785665816,66.90863209227314,True,False,71175.07,70775.07,70775.07,70825.07,2024-03-29 00:30:00,True,2024-03-29 00:30:00,2024-04-01 02:11:33,2024-03-29 00:40:12,even,True,18.66,5428.379999999991,,2,0,13,3
2024-03-29 01:00:00,70883.711,71098.781,70811.844,71088.438,1449,36421,0,2024-03-29 01:00:00,2024-03-29 01:00:00,84.0081190475612,268.61904655497347,70814.00672619046,0.00044629805464344854,-0.0004985192147778817,70749.47441666666,70727.05858411187,70966.78981642371,70855.2804279474,70829.3294957666,70890.68541692462,14.639112700984697,8.930697427466225,114.54526254946818,57.74361713102553,34.51815961471584,33.601174062656355,71046.82152136641,70736.04931248284,87.80360917479827,78.48515913460216,True,False,71588.438,70688.438,71188.438,71238.438,,False,2024-04-01 02:45:00,,2024-03-29 02:39:46,fail,False,-74.66,5353.719999999991,,0,1,13,3
2024-03-29 02:15:00,70755.938,70818.039,70714.586,70788.836,2239,36421,0,2024-03-29 02:00:00,2024-03-29 02:00:00,64.53230952379818,254.0880650394247,70809.33257142855,0.0004462955274228876,0.0002932633443318525,70814.00672619046,70758.59878065775,71223.1088128373,70825.89060070444,70822.69519417736,70869.65834502925,6.695277845559758,9.847842051308335,107.9151340536647,-3.367022703794646,-6.07739146889071,-7.411221534173819,71015.3437760017,70722.47291405681,40.40305182655906,43.15184643481363,True,False,71288.836,70388.836,70888.836,70938.836,,False,2024-04-01 00:15:00,2024-04-01 02:33:17,2024-03-29 05:26:38,fail,False,-74.66,5279.059999999991,,0,2,13,3
2024-03-29 02:45:00,70722.18,70792.734,70637.109,70775.438,1970,36421,0,2024-03-29 02:00:00,2024-03-29 02:00:00,64.53230952379818,254.0880650394247,70809.33257142855,0.0004462955274228876,0.0002932633443318525,70814.00672619046,70758.59878065775,71223.1088128373,70804.57905730909,70812.27489487086,70819.95956312353,1.9061564688454382,7.208530329467596,105.76213153153516,-22.464159614683012,-27.234622291041887,-3.367022703794646,70962.7384406911,70675.68068555596,35.984923314671114,36.94206769364828,True,False,71275.438,70375.438,70875.438,70925.438,,False,2024-04-01 00:15:00,2024-04-01 02:33:06,2024-03-29 05:27:09,fail,False,-74.66,5204.399999999991,,0,3,13,3
2024-03-29 09:00:00,70470.414,70551.844,70363.555,70374.344,2067,36421,0,2024-03-29 09:00:00,2024-03-29 09:00:00,-17.54959523814614,63.08935318405565,70168.51033333337,-0.0017379799679144508,-0.0009565677054557724,70381.94370238093,69281.74923209687,70271.3775656393,70426.52579838454,70516.29122428152,70355.13086308904,-52.93328674821532,-52.032004933853386,206.11058844108547,4.542260749833076,20.84277158587065,38.03482903333497,70634.88015748451,70076.88156869357,69.99001011829733,61.895087588278706,True,False,70874.344,69974.344,70474.344,70524.344,,False,2024-03-29 16:15:00,2024-04-01 00:00:11,2024-03-29 09:39:50,fail,False,-74.66,5129.739999999992,,0,4,13,3
2024-03-29 13:00:00,70141.336,70250.438,70087.313,70170.32,2397,36421,0,2024-03-29 13:00:00,2024-03-29 13:00:00,32.30009523805347,-90.52184216238675,70006.54753571429,-0.0013487619083022118,-0.0006837321495075447,69962.1062857143,69020.7321062685,70159.24725401937,70005.52078535208,70120.79070782258,69883.07267973854,-82.16362061571272,-93.7033972216558,252.5684082548626,72.66557825935888,49.04531888542988,-13.294965944252908,70225.5400308826,69542.10532859448,65.11938130246575,49.403793427958625,True,False,70670.32,69770.32,70270.32,70320.32,,False,2024-03-29 15:45:00,2024-03-29 15:42:25,2024-03-29 17:33:06,success,True,93.3,5223.039999999992,,1,0,13,3
2024-03-29 17:00:00,70103.039,70165.438,69891.438,70081.836,2647,36421,0,2024-03-29 17:00:00,2024-03-29 17:00:00,39.62123809523473,-75.20400090204203,69925.38521428574,-0.0014604966764256437,0.0015403536447320177,70249.88730952378,68573.73220360756,71360.29325938378,70252.93587168,70220.21333526589,70325.80737908505,2.5289881802891614,-8.653931600745219,226.60789029280176,-58.62779910553945,-43.70237805294164,24.497606811171863,70631.72803098033,70018.38672718976,40.706322705395564,56.57341850412582,False,True,69581.836,70481.836,69981.836,69931.836,,False,2024-03-29 17:45:00,2024-03-29 17:39:01,2024-04-01 00:00:11,success,True,93.3,5316.339999999992,,2,0,13,3
2024-03-29 21:00:00,69543.891,69547.438,69441.836,69484.414,1059,36421,0,2024-03-29 21:00:00,2024-03-29 21:00:00,-68.43194047617726,-245.0579804431327,69440.292452381,-0.0009316258830642794,-0.00202226223104368,69418.42083333332,68468.11277341675,69250.11664154143,69524.08809376035,69679.81805709748,69366.5916845545,-96.02708690406871,-97.27819944484462,460.7390244867882,62.14701547984441,59.79948606813559,45.17369693843648,69990.08936761167,68744.59400149733,58.68019182827842,50.49971104909307,True,False,69984.414,69584.414,69584.414,69634.414,2024-03-29 22:00:00,True,2024-03-29 22:00:00,2024-04-01 00:00:11,2024-03-29 22:51:19,even,True,18.66,5334.999999999992,,3,0,13,3
2024-04-01 00:00:00,70892.039,71024.438,70839.25,71019.039,1433,56421,0,2024-04-01 00:00:00,2024-04-01 00:00:00,30.838452380892704,-233.08261199890694,69997.5893571428,0.0018584552120855244,0.0009689322341115308,69471.1309047619,70187.24151538969,71312.13970116813,69818.85616368946,69760.39130878967,69943.35283247333,-12.846246963599697,-61.84152336783224,355.6193890318824,269.5087055383192,20.022972136212047,20.966298589715734,70424.93900766637,69463.2666572803,84.57636949665685,82.92000968675603,True,False,71519.039,71119.039,71119.039,71169.039,2024-04-01 02:45:00,True,2024-04-01 02:45:00,,2024-04-01 03:30:06,even,True,18.66,5353.659999999992,,4,0,14,4
2024-04-01 04:00:00,71221.641,71241.641,71065.234,71120.844,1277,36421,0,2024-04-01 04:00:00,2024-04-01 04:00:00,244.726321428534,135.40756607148796,71186.30370238102,0.003706832170513011,0.003521399029190965,71144.36291666662,71943.77800881989,73099.18661987022,71042.08527055559,70716.40996509741,71306.84463226695,179.27929567571846,165.45205103223748,709.7418371991896,-79.80938252498163,-33.08947196416557,-55.65363708292716,72264.99611248585,70347.19315204804,53.184807806054415,56.23729201775484,False,True,70620.844,71020.844,71020.844,70970.844,2024-04-01 04:45:00,True,2024-04-01 04:45:00,2024-04-01 06:29:09,,success,True,93.3,5446.959999999992,,5,0,14,4
2024-04-01 05:00:00,70855.641,70941.039,70832.141,70872.133,1371,36421,0,2024-04-01 05:00:00,2024-04-01 05:00:00,41.94078571439604,158.78652417325065,71172.49214285718,0.0030185278554013565,0.0031040071588893463,71186.30370238102,71706.59619826624,73075.07027292124,70974.47636995219,70767.1460825269,71037.58460268317,141.29081176292675,158.5165200200639,539.9816919497757,-52.908487788110506,-57.537339869348216,-35.953305813483894,71766.55988681538,70307.10931855097,5.2838851075333215,13.923577302417547,False,True,70372.133,70772.133,70772.133,70722.133,2024-04-01 06:30:00,True,2024-04-01 06:30:00,2024-04-01 08:31:56,,success,True,93.3,5540.259999999992,,6,0,14,4
2024-04-01 06:00:00,70911.938,70937.141,70751.836,70751.836,1413,36421,0,2024-04-01 06:00:00,2024-04-01 06:00:00,-13.811559523834148,178.74398110000766,71006.94886904764,0.0021120146976156017,0.0007048229366756213,71172.49214285718,71198.4133886451,71879.43262425633,70915.22690670741,70791.11295122709,70857.31815583071,106.1499445932568,134.44475308570793,154.91299369183426,-58.26511936713359,-36.17748778806708,-35.823840729295625,71066.45069731469,70646.68561434673,9.906799980526793,10.558317853346958,False,True,70251.836,70651.836,70651.836,70601.836,2024-04-01 07:45:00,True,2024-04-01 07:45:00,2024-04-01 08:38:56,,success,True,93.3,5633.559999999992,,7,0,14,4
2024-04-01 07:00:00,70621.586,70708.539,70602.078,70684.539,1198,36421,0,2024-04-01 07:00:00,2024-04-01 07:00:00,-165.54327380954055,170.14661565973074,70731.34654761899,-0.0004372167048037036,-0.0015822029880397518,71006.94886904764,70338.70173813216,70437.73247960747,70785.99464777505,70753.41126963685,70645.45427278978,61.7925418176892,98.47470380815373,205.67983618579436,-17.137313381477725,-54.19885276923014,-68.20249707599578,70923.1220516406,70366.28649393895,10.279242251625105,7.342749763150543,False,True,70184.539,70584.539,70584.539,70534.539,2024-04-01 08:00:00,True,2024-04-01 08:00:00,2024-04-01 08:41:38,,success,True,93.3,5726.859999999992,,8,0,14,4
2024-04-01 13:00:00,69430.234,69536.734,69391.836,69519.836,1450,36421,0,2024-04-01 13:00:00,2024-04-01 13:00:00,-112.44624999997905,-168.86883825018595,69397.98683333333,-0.00159422684128999,-0.002549575113019287,69364.6421904762,67989.19355251055,68948.81695294497,69566.15016711631,69802.10093839151,69542.73090024081,-139.49884683906566,-137.21480118662657,474.2842569613864,52.298221878212644,41.02938011701917,37.050408324677846,70184.51464713868,68902.44715334295,43.709284959868654,49.84684416261127,True,False,70019.836,69619.836,69619.836,69669.836,2024-04-01 14:15:00,True,2024-04-01 14:15:00,2024-04-01 16:27:47,2024-04-01 14:25:50,even,True,18.66,5745.519999999992,,9,0,14,4
2024-04-01 14:00:00,69595.734,69846.594,69568.602,69763.836,1968,36421,0,2024-04-01 14:00:00,2024-04-01 14:00:00,33.344642857133294,-184.51106935122516,69440.18140476184,0.001076310985931299,-0.0017542400288085103,69397.98683333333,69558.86450424127,69338.8318790649,69569.05227214558,69737.1641287277,69499.26983316141,-117.33551221895323,-132.1987447346523,318.01102402402273,51.57501651190978,-2.608003783840104,-32.95143102869042,69930.08471559384,69069.95495072898,65.76333072296596,50.4862054108047,True,False,70263.836,69863.836,69863.836,69913.836,2024-04-01 16:30:00,True,2024-04-01 16:30:00,,2024-04-01 16:33:56,even,True,18.66,5764.179999999992,,10,0,14,4
2024-04-01 15:00:00,69489.492,69664.641,69442.336,69638.734,1183,36421,0,2024-04-01 15:00:00,2024-04-01 15:00:00,42.194571428510244,-201.81142626113433,69653.88223809525,0.0013633637615576401,-0.0014303767383393765,69440.18140476184,69836.8816098853,69459.91264637808,69574.88178272762,69695.71604322636,69572.47739972486,-95.80386807337345,-114.6056954635051,119.61830473595147,26.57196663231298,9.121737874156679,15.302400068743736,69735.4621111184,69410.99268833132,53.50244890137474,59.46014953491224,True,False,70138.734,69738.734,69738.734,69788.734,2024-04-01 16:00:00,True,2024-04-01 16:00:00,,2024-04-01 16:16:25,even,True,18.66,5782.839999999992,,11,0,14,4
2024-04-01 16:00:00,69873.836,69952.336,69793.227,69841.734,1781,36421,0,2024-04-01 16:00:00,2024-04-01 16:00:00,213.7008333334088,-183.42252724456193,69731.39346428568,0.0013632599873264679,0.0007399580432684806,69653.88223809525,69932.39081037557,70342.83146982593,69694.61055974633,69727.88018750772,69757.02842965256,-55.895318711933214,-87.0109412440141,140.9402352612839,46.22575300994504,46.319431716547115,39.79724802201963,69948.7977472553,69566.75911204983,89.2617821912957,85.51525644684091,True,False,70341.734,69941.734,69941.734,69991.734,2024-04-01 16:30:00,True,2024-04-01 16:30:00,,2024-04-01 16:33:19,even,True,18.66,5801.499999999992,,12,0,14,4
2024-04-01 17:00:00,69913.938,69969.734,69650.641,69713.938,2410,36421,0,2024-04-01 17:00:00,2024-04-01 17:00:00,77.51122619042872,-163.82201061054366,69502.12460714283,-0.0013751814619657014,0.0007399656016352277,69731.39346428568,68246.51502981543,70394.78747114148,69793.97926757627,69776.51953999259,69922.18522256626,-24.42770228414156,-52.683268118656784,193.14197661608532,-11.819185414453386,37.16244134842418,68.58271585831244,70182.92689099797,69659.94355413454,65.75106581848955,79.62226164393566,False,True,69213.938,69613.938,69613.938,69563.938,2024-04-01 17:30:00,True,2024-04-01 17:30:00,2024-04-01 17:35:41,2024-04-01 22:57:16,success,True,93.3,5894.799999999992,,13,0,14,4
2024-04-01 22:00:00,68936.773,69187.141,68901.695,69087.641,1885,36421,0,2024-04-01 22:00:00,2024-04-01 22:00:00,-22.51670238087536,-386.1288750202366,68924.44633333333,-0.001575683566750262,-0.0006676952330349213,68678.7147261905,67323.40368003263,69652.2758030816,68800.42823440883,68952.89256884623,68768.23746783624,-119.67699374836229,-145.1090174996772,541.9160334142769,115.34323701407993,112.35350808400835,94.0971792225173,69501.32411294551,68036.65082272697,88.91728337457721,78.83258049893176,True,False,69587.641,69187.641,69187.641,69237.641,2024-04-01 22:30:00,True,2024-04-01 22:30:00,2024-04-01 22:56:54,2024-04-02 03:34:30,success,True,93.3,5988.099999999992,,14,0,14,4
2024-04-02 00:00:00,69741.641,69827.141,69571.836,69738.852,1574,56421,0,2024-04-02 00:00:00,2024-04-02 00:00:00,315.3406428572198,-260.835646271662,69521.974547619,0.0030664781964928603,-0.000101290196777811,69239.78697619055,69935.41201067946,69890.71956212647,69378.50428103682,69232.47680480985,69696.8726697626,22.48917614237871,-37.14431456415232,462.4632050014445,104.51858169928892,122.04978912969818,80.76455073959369,70322.69799651454,69072.54734301065,89.52032695498171,83.7729193011231,True,False,70238.852,69338.852,69838.852,69888.852,,False,,,2024-04-02 03:23:48,fail,False,-74.66,5913.439999999992,,0,1,14,4
2024-04-02 02:00:00,69739.734,69887.234,69669.641,69827.836,1478,36421,0,2024-04-02 02:00:00,2024-04-02 02:00:00,205.3589761904732,-177.54105461819563,69771.57817857144,0.003532140215315525,0.0021166735062824404,69727.33352380947,70699.41862411193,71061.82065335017,69661.04940477839,69472.11606835116,69876.55715892675,77.52308065313264,48.045779754437355,488.3027681908513,-9.183041967597092,-11.344274165894603,7.570158926740987,70535.7658959844,69215.8484218691,82.87237906110207,84.08791069545062,False,True,69327.836,69727.836,69727.836,69677.836,2024-04-02 03:15:00,True,2024-04-02 03:15:00,2024-04-02 03:23:49,,success,True,93.3,6006.7399999999925,,1,0,14,4
2024-04-02 03:00:00,69680.234,69713.336,69490.938,69614.938,1569,36421,0,2024-04-02 03:00:00,2024-04-02 03:00:00,44.24465476196201,-145.2815917616681,69681.27626190479,0.0018001755031912606,0.0006621376273506624,69771.57817857144,69591.32963671818,70270.28288976423,69682.45324230104,69535.68287817024,69775.54259924317,74.11797588334593,65.59439807278758,375.00729225584064,-43.04151324398117,-22.143503611936467,-16.956745785995736,70281.80244378856,69267.78275469778,54.40255325945915,68.19999529317599,False,True,69114.938,69514.938,69514.938,69464.938,2024-04-02 03:30:00,True,2024-04-02 03:30:00,2024-04-02 03:41:36,2024-04-02 03:31:02,even,True,18.66,6025.399999999992,,2,0,14,4
2024-04-02 04:00:00,69387.641,69644.938,69280.664,69527.273,2430,36421,0,2024-04-02 04:00:00,2024-04-02 04:00:00,-90.30191666664905,-141.8923534351925,69578.63489285715,0.0014223550781547261,0.0003988138391369218,69681.27626190479,69581.74926713394,70148.4019999154,69543.0171125146,69497.12793612696,69508.30867079468,39.110867951472756,54.35303849187573,204.68276473978761,-34.53096938424278,-73.62335741311836,-108.79539043686236,69784.6304031934,69230.48693839596,35.08192860857145,27.108023098873343,False,True,69027.273,69427.273,69427.273,69377.273,2024-04-02 05:15:00,True,2024-04-02 05:15:00,2024-04-02 05:23:40,,success,True,93.3,6118.6999999999925,,3,0,14,4
2024-04-02 05:00:00,69409.922,69457.039,69181.742,69275.836,1699,36421,0,2024-04-02 05:00:00,2024-04-02 05:00:00,-102.6413690476329,-135.0429233681789,68656.86438095238,-0.006972350610242955,-0.0026916524477478966,69578.63489285715,63774.26418596422,68685.7802877233,69469.89017577558,69471.22406640735,69373.91049398007,17.885436810276587,37.424901558605555,182.2498454138129,-52.70206639141543,-27.304686962554115,-17.462862401094753,69619.94778528872,69126.37320267143,39.15387204494565,44.52575218023276,False,True,68775.836,69675.836,69175.836,69125.836,,False,2024-04-02 05:30:00,2024-04-02 05:27:23,,success,True,93.3,6211.999999999993,,4,0,14,4
2024-04-02 05:15:00,69275.836,69302.141,68462.641,68470.297,2614,36421,0,2024-04-02 05:00:00,2024-04-02 05:00:00,-102.6413690476329,-135.0429233681789,68656.86438095238,-0.006972350610242955,-0.0026916524477478966,69578.63489285715,63774.26418596422,68685.7802877233,69316.10661027164,69397.08132074754,69166.70861541106,-12.237947344328859,27.492331778018674,289.9382814069027,-207.20187856901612,-52.70206639141543,-27.304686962554115,69558.12529531038,68773.79193551173,22.16943801803788,35.453794215970085,False,True,67970.297,68870.297,68370.297,68320.297,,False,2024-04-02 05:45:00,2024-04-02 05:36:10,,success,True,93.3,6305.299999999993,,5,0,14,4
2024-04-02 08:15:00,66569.336,66570.945,66134.367,66449.234,3721,36421,0,2024-04-02 08:00:00,2024-04-02 08:00:00,-646.54820238096,-617.3018644278782,66783.0227976191,-0.011664418674523147,-0.006201625414340375,67210.4285595238,60404.71369939513,66460.83793142218,67001.84898969773,67758.15698390942,66014.71779635368,-382.63042973434494,-311.5925787841047,1408.8882470594813,-87.40859305119375,-123.57045992437634,-135.87320089436253,67916.71692988399,64111.21866282338,23.684025579289138,25.0490281247675,False,True,65949.234,66849.234,66349.234,66299.234,,False,2024-04-02 12:00:00,2024-04-02 12:03:35,2024-04-02 08:57:03,fail,False,-74.66,6230.639999999993,,0,1,14,4
2024-04-02 10:00:00,66876.047,66914.438,66733.836,66813.039,1116,36421,0,2024-04-02 10:00:00,2024-04-02 10:00:00,-204.14098809522693,-749.5142412072018,66404.70216666664,0.0005085124613788627,-0.0074603287341478905,66578.88180952387,65924.33746292694,64892.76212050193,66909.25782760298,67383.44509634702,66773.94821293425,-310.1531706412352,-331.2611085422991,1119.4842706414686,-2.8603770210320363,154.90661816304782,233.51418403854768,68285.25197830024,65261.144447568266,79.10326219673254,77.18468813624543,True,False,67313.039,66413.039,66913.039,66963.039,,False,,,2024-04-02 11:00:29,fail,False,-74.66,6155.979999999993,,0,2,14,4
2024-04-02 11:00:00,66485.141,66683.734,66400.664,66422.031,2756,36421,0,2024-04-02 11:00:00,2024-04-02 11:00:00,-174.179642857227,-810.8536708042375,66305.44389285713,0.0013345116492944663,-0.006677664017056645,66404.70216666664,66510.25229462607,64923.38478527909,66729.34703945713,67163.22464310535,66705.5665156519,-291.6127220238559,-309.86833963867923,632.610539958505,-56.761679394505336,-24.176158582791686,-8.52494048846711,67559.59074459587,65850.04228670792,35.92901689556582,47.21983837695198,True,False,66922.031,66522.031,66522.031,66572.031,2024-04-02 11:30:00,True,2024-04-02 11:30:00,,2024-04-02 11:36:57,even,True,18.66,6174.639999999993,,1,0,14,4
2024-04-02 12:00:00,66259.156,66393.234,65769.836,66353.563,5239,36421,0,2024-04-02 12:00:00,2024-04-02 12:00:00,-99.25827380950795,-867.1892390548601,66342.08603571427,0.0003275673648600926,-0.006092152584909927,66305.44389285713,65858.73262658058,64913.13794494041,66570.4825580579,66964.42628404852,66504.83790471271,-271.41668218524137,-289.8521627601614,211.8797897215886,-55.435887168947374,-76.85788476090238,-50.512369109055726,66790.87562083686,66217.30018858856,29.80269876459505,32.13400184019633,False,True,65853.563,66253.563,66253.563,66203.563,2024-04-02 12:30:00,True,2024-04-02 12:30:00,2024-04-02 13:45:42,2024-04-02 12:42:15,even,True,18.66,6193.299999999993,,2,0,14,4
2024-04-02 13:00:00,66102.039,66172.438,65897.617,66018.039,3307,36421,0,2024-04-02 13:00:00,2024-04-02 13:00:00,36.64214285713388,-914.4870291195257,66202.67755952379,-0.0020328586506757895,-0.002013187929191968,66342.08603571427,64924.18428124022,66051.43633482482,66343.30516391325,66738.30684550205,66121.55903371166,-266.28544808688457,-276.7079215652399,271.3545419794701,-101.63303061583429,-105.01375816992368,-92.54531406948809,66487.88766538394,65753.73040203938,23.30537803285372,28.32599535394449,True,False,66518.039,66118.039,66118.039,66168.039,2024-04-02 13:30:00,True,2024-04-02 13:30:00,2024-04-03 11:39:07,2024-04-02 13:39:00,even,True,18.66,6211.959999999993,,3,0,14,4
2024-04-02 14:15:00,65772.039,65879.734,65181.957,65249.238,4863,36421,0,2024-04-02 14:00:00,2024-04-02 14:00:00,-139.40847619048145,-947.9857076132903,65961.37002380958,-0.002653125084210843,-0.002686763815422268,66202.67755952379,64389.04944702613,65516.32173443019,66024.9501160792,66445.82204659366,65769.57881045756,-269.1089814999432,-264.53294079948864,417.27369823857595,-154.84044719631493,-58.445277261867886,-46.724477812167606,66332.89830307964,65204.75931783549,23.139602674546225,28.456127675553955,False,True,64749.238,65649.238,65149.238,65099.238,,False,2024-04-02 16:30:00,2024-04-02 16:31:37,2024-04-02 14:59:11,fail,False,-74.66,6137.299999999993,,0,1,14,4
2024-04-02 17:00:00,65242.637,65596.234,65183.238,65558.141,4204,36421,0,2024-04-02 17:00:00,2024-04-02 17:00:00,-236.5131190477041,-1072.2446540883102,65471.85108333335,-0.003540040215044318,-0.0013795514650403091,65440.11782142854,63478.814107163606,65896.81743949204,65470.95345159536,65847.09342425648,65202.61569865838,-251.46978751730057,-260.7284581110762,468.98689411552436,27.63073202612577,-41.98005951150844,-74.23387994492805,65837.24800571434,64569.48339160242,42.800717524772324,28.80588440293648,True,False,66058.141,65658.141,65658.141,65708.141,2024-04-02 17:30:00,True,2024-04-02 17:30:00,2024-04-02 17:30:50,2024-04-02 17:56:03,success,True,93.3,6230.599999999993,,1,0,14,4
2024-04-02 17:45:00,66152.758,66165.641,65589.641,65722.336,3681,36421,0,2024-04-02 17:00:00,2024-04-02 17:00:00,-236.5131190477041,-1072.2446540883102,65471.85108333335,-0.003540040215044318,-0.0013795514650403091,65440.11782142854,63478.814107163606,65896.81743949204,65644.12501687456,65861.3098659761,65517.311574131425,-187.84321944005205,-232.4455137627849,403.69557595041863,80.79047574821016,139.4459776401709,94.45942208466295,66063.8006016645,64972.32254659836,82.08644802724537,75.33165741654194,False,True,65222.335999999996,66122.336,65622.336,65572.336,,False,2024-04-02 19:00:00,2024-04-02 18:50:48,2024-04-02 18:09:09,fail,False,-74.66,6155.939999999993,,0,1,14,4
2024-04-03 00:00:00,65644.875,65778.039,65508.648,65718.336,1559,56421,0,2024-04-03 00:00:00,2024-04-03 00:00:00,19.158642857146333,-824.1442974023521,65764.41969047625,0.0018823975290659296,-0.0001945125905919556,65766.99879761912,65699.06111662716,66127.87347926947,65818.32708473217,65779.26791268833,65966.47482180939,-7.023583328846144,-25.981746353775932,293.1798744967324,-52.41204540770559,-49.31535500509199,13.816002751918859,66362.26765237997,65569.1819912388,48.971538914626684,61.828614947115774,False,True,65218.335999999996,65618.336,65618.336,65568.336,2024-04-03 00:30:00,True,2024-04-03 00:30:00,2024-04-03 00:32:20,2024-04-03 00:38:46,success,True,93.3,6249.239999999993,,1,0,14,4
2024-04-03 03:00:00,65480.504,65632.539,65333.039,65333.039,2649,36421,0,2024-04-03 03:00:00,2024-04-03 03:00:00,-152.39789285714505,-700.0863193196565,65580.71658333334,-0.0017795384453886342,-0.0012202752380987016,65698.04541666668,64016.03167700679,65476.46269382269,65617.00924725943,65680.44083212667,65523.21021568625,-31.883255435197498,-19.562689981579318,203.49794010663084,-43.12772617819428,-44.54273477810784,-40.6246026831941,65797.9324348302,65246.9879965423,29.496226060551166,37.64167488371613,False,True,64833.039,65233.039,65233.039,65183.039,2024-04-03 03:30:00,True,2024-04-03 03:30:00,2024-04-03 03:35:18,2024-04-03 03:42:16,success,True,93.3,6342.539999999994,,2,0,14,4
2024-04-03 05:00:00,65818.336,66071.539,65804.977,65849.438,2999,36421,0,2024-04-03 05:00:00,2024-04-03 05:00:00,33.31226190477901,-623.4091492102598,65707.65472619046,-0.003253263513516998,-0.00029386472425516123,65614.02884523812,63216.28840829686,65991.35874750295,65559.54783581811,65593.57526262762,65451.87749019605,-31.15108697488904,-42.32837709840644,246.12965274694756,72.57209150325798,40.86654764362902,3.6164351565021207,65785.65252140442,65119.60245898767,81.38347491321447,72.75350752486456,True,False,66349.438,65949.438,65949.438,65999.438,2024-04-03 06:45:00,True,2024-04-03 06:45:00,2024-04-03 07:05:49,2024-04-03 08:38:34,success,True,93.3,6435.839999999994,,3,0,14,4
2024-04-03 10:00:00,66363.258,66476.602,66181.836,66453.141,1600,36421,0,2024-04-03 10:00:00,2024-04-03 10:00:00,148.31704761907167,-306.63905804128444,66299.45674999994,0.0036109392614070298,0.0020305815784224606,66299.04097619049,67118.71472261584,67478.26237694138,66227.20991914147,66071.23017297625,66336.0858400413,81.82579713659652,69.59028504773408,306.2481069941974,28.122816649483866,26.726459580342635,6.141312005463988,66751.02078448347,65922.65089559913,76.0577538514318,69.52439336552492,False,True,65953.141,66353.141,66353.141,66303.141,2024-04-03 10:30:00,True,2024-04-03 10:30:00,2024-04-03 14:05:32,2024-04-03 10:40:42,even,True,18.66,6454.499999999994,,4,0,14,4
2024-04-03 11:00:00,66162.938,66164.734,66011.977,66107.938,1468,36421,0,2024-04-03 11:00:00,2024-04-03 11:00:00,0.41577380945091136,-272.1352693795052,66368.89123809521,0.0019710680613119675,0.0010382525975543577,66299.45674999994,66547.84644631435,67073.97013315225,66219.20711999405,66110.47354970136,66246.285373237,69.15982749937393,73.18360975199975,187.8999408754893,-40.199207086407114,-44.88963845878607,-5.032421740703285,66499.95029341891,65991.12045305509,46.40791878720595,59.26449543798932,False,True,65607.938,66507.938,66007.938,65957.938,,False,2024-04-03 14:15:00,2024-04-03 14:09:41,2024-04-03 11:39:07,fail,False,-74.66,6379.839999999994,,0,1,14,4
2024-04-03 12:00:00,66520.492,66647.734,66423.938,66431.836,2418,36421,0,2024-04-03 12:00:00,2024-04-03 12:00:00,69.43448809527035,-213.40658858319512,66418.2613214286,0.0007891319874457698,0.0005954863118024245,66368.89123809521,66278.31025684293,66873.42022046392,66326.4081650444,66195.80148271979,66380.78130925346,77.55573020753218,73.7408621658808,177.0969805195256,29.39906432737189,56.935477468243334,61.817582387360744,66621.36223295482,66141.7003855521,78.03866976867585,67.0208921539451,False,True,65931.836,66331.836,66331.836,66281.836,2024-04-03 13:45:00,True,2024-04-03 13:45:00,2024-04-03 14:05:33,2024-04-03 17:02:13,success,True,93.3,6473.139999999994,,1,0,14,4
2024-04-03 21:00:00,65960.578,65986.539,65666.609,65768.836,2221,36421,0,2024-04-03 21:00:00,2024-04-03 21:00:00,-16.31285714288242,-117.14683865467669,66062.18864285715,-0.00014229365588566453,-0.0004517466551826942,66070.64472619048,65434.15124256531,66665.7962510092,66082.95471984368,66129.52649779464,65997.94148366014,-12.02504659575061,5.2178503480933305,306.72672336664124,-129.8112229102262,-89.0140846232971,-56.868331269331975,66412.0225602051,65582.36040711516,19.079375647047634,26.49257568183086,False,True,65268.835999999996,65668.836,65668.836,65618.836,2024-04-03 23:45:00,True,2024-04-03 23:45:00,2024-04-04 07:18:00,2024-04-03 23:53:19,even,True,18.66,6491.799999999994,,2,0,14,4
2024-04-03 22:30:00,65861.844,65911.141,65721.836,65820.734,2379,36421,0,2024-04-03 22:00:00,2024-04-03 22:00:00,-8.456083333338029,-116.11581061127072,65970.08067857145,-0.0005199511077686142,-0.0017814239877661023,66062.18864285715,65299.088642242066,65834.262940698,65925.25519377895,66018.89947193503,65826.86700584795,-39.89846506546019,-24.01526875583737,324.3695532543934,-1.4316683866636595,10.459382180939429,-33.35300034395186,66264.76590274138,65387.46810895452,30.5653312154373,34.100060791465935,False,True,65320.734,65720.734,65720.734,65670.734,2024-04-03 23:45:00,True,2024-04-03 23:45:00,2024-04-04 07:17:58,2024-04-03 23:54:19,even,True,18.66,6510.459999999994,,3,0,14,4
2024-04-04 01:00:00,65917.734,65986.336,65842.375,65964.641,1545,56421,0,2024-04-04 01:00:00,2024-04-04 01:00:00,-51.08880952380423,-144.28247614999418,65932.27042857144,1.24040600151982e-06,-0.0009167088331582011,65797.66819047615,65472.895417246626,65994.71159946918,65808.87149348241,65880.24277407087,65757.17175541795,-46.52940838418726,-51.50006754223475,227.37112463888676,53.653878912955406,48.08460130721505,23.570140694850124,66065.62277368044,65450.220737155454,58.8187505077593,46.838487266150395,True,False,66464.641,66064.641,66064.641,66114.641,2024-04-04 01:45:00,True,2024-04-04 01:45:00,2024-04-04 13:21:19,2024-04-04 02:39:44,even,True,18.66,6529.1199999999935,,4,0,14,4
2024-04-04 02:00:00,66138.438,66296.641,66121.391,66229.734,2237,36421,0,2024-04-04 02:00:00,2024-04-04 02:00:00,134.6022380952927,-120.74004842102295,65922.50401190479,1.2804069640441032e-06,-0.0006652371342296012,65932.27042857144,65473.000567267925,66115.34269917867,65976.4435222883,65950.71707294964,66007.36733161338,-8.149771117285127,-33.07079449008382,197.74613665143679,74.38102751986298,45.87633470931905,70.25130856553733,66275.82461609282,65740.41004713393,90.91020843618094,86.77724234184767,True,False,66729.734,65829.734,66329.734,66379.734,,False,2024-04-04 14:45:00,2024-04-04 15:45:46,2024-04-04 03:01:22,fail,False,-74.66,6454.459999999994,,0,1,14,4
2024-04-04 05:00:00,66127.516,66144.539,65985.172,66057.836,1496,36421,0,2024-04-04 05:00:00,2024-04-04 05:00:00,53.83647619049589,-70.87376264297927,66035.04961904761,-7.587139548353563e-05,0.0006021081405003491,66117.85832142856,65427.358759340335,66595.8665595197,66127.01974046274,66074.04774839788,66194.36874853808,24.072092528789653,19.097541303749423,226.42339620822406,-44.14531475745025,-22.91565187482047,-33.09943034051685,66500.04033341918,65887.19716365698,53.55867087381685,61.44986248759935,False,True,65557.836,65957.836,65957.836,65907.836,2024-04-04 05:30:00,True,2024-04-04 05:30:00,2024-04-04 05:31:11,2024-04-04 10:10:42,success,True,93.3,6547.759999999994,,1,0,14,4
2024-04-04 09:00:00,65584.852,65706.734,65542.0,65699.484,1697,36421,0,2024-04-04 09:00:00,2024-04-04 09:00:00,-106.24895238087629,-155.56798136675206,65615.79138095235,-0.0025205042779383995,-0.0014595112329391271,65610.41569047622,64090.4947013977,65419.00646377776,65581.76447719077,65697.1074563898,65431.86820020635,-64.93377714410599,-61.80978130262952,325.8238995098657,55.415124526945874,31.560173718607984,8.22657688340405,65873.23046454467,64992.00593586803,63.08275884830626,49.18244437795687,True,False,66199.484,65799.484,65799.484,65849.484,2024-04-04 10:15:00,True,2024-04-04 10:15:00,2024-04-04 10:17:30,,success,True,93.3,6641.059999999994,,2,0,14,4
2024-04-04 10:00:00,65764.102,66063.438,65669.039,66053.234,1697,36421,0,2024-04-04 10:00:00,2024-04-04 10:00:00,5.375690476124873,-149.22353755534277,65724.10982142856,-0.001345647583014712,-0.00013430277987568892,65615.79138095235,64463.76047534672,66252.22693078691,65700.76265769929,65727.40352211491,65691.90995287242,-33.570555987695116,-52.84914941333932,267.2510860771013,96.9460247678362,38.25758307527576,70.71997248034313,66054.1989190765,65331.120986668335,94.23914592000705,88.3506300899082,True,False,66553.234,66153.234,66153.234,66203.234,2024-04-04 11:15:00,True,2024-04-04 11:15:00,2024-04-04 15:12:54,2024-04-04 11:47:43,even,True,18.66,6659.719999999994,,3,0,14,4
2024-04-04 14:00:00,66284.141,66317.141,66107.953,66144.938,1490,36421,0,2024-04-04 14:00:00,2024-04-04 14:00:00,129.00311904764385,-17.128785985332797,66336.42908333326,0.0022359343629789305,0.0021498019573828533,66235.79091666665,66717.26701920068,67453.07543262119,66217.53486609767,66098.8731212755,66325.69744513245,61.5981187436264,54.397232254305266,313.3052229012056,-48.525817681555054,-20.840102167028817,2.2336085311108036,66748.65949604908,65901.23539421582,53.59067625604572,66.99730685608066,False,True,65644.938,66544.938,66044.938,65994.938,,False,,,2024-04-04 15:11:50,fail,False,-74.66,6585.059999999994,,0,1,14,4
2024-04-04 16:00:00,66695.539,67013.039,66666.953,67001.234,2032,36421,0,2024-04-04 16:00:00,2024-04-04 16:00:00,156.25496428571932,59.28924459691916,66762.97254761908,0.0017178191913350825,0.0029463292640538497,66492.68404761898,66805.17698464978,68294.22919622356,66530.86150158582,66328.67942276807,66639.66914826276,101.18945422762772,77.40203188190765,217.62895510862222,107.14908393535006,66.57373477808142,77.74351530785498,66934.9682376594,66345.87005886613,93.48401018755287,91.99461486383352,True,False,67501.234,67101.234,67101.234,67151.234,2024-04-04 16:30:00,True,2024-04-04 16:30:00,2024-04-04 17:09:15,2024-04-04 17:01:36,even,True,18.66,6603.719999999994,,1,0,14,4
2024-04-04 21:00:00,68827.375,69302.039,68683.438,68875.438,4592,36421,0,2024-04-04 21:00:00,2024-04-04 21:00:00,512.59029761907,496.56225178358727,68416.93295238093,0.004140946238316706,0.005119977756749986,68140.45217857145,69156.70873178134,70788.9511931354,68041.3132414899,67580.48877821828,68273.75435913312,255.32575947594887,221.46345631537622,582.406963910114,176.86719814241224,185.0354767802346,28.572408324675052,69061.50376041177,67487.50495785447,83.69210574872164,79.28610218649473,True,False,69375.438,68475.438,68975.438,69025.438,,False,,,2024-04-04 22:00:49,fail,False,-74.66,6529.059999999994,,0,1,14,4
2024-04-04 23:00:00,68465.734,68513.813,67540.438,67732.438,4591,36421,0,2024-04-04 23:00:00,2024-04-04 23:00:00,106.0636309524416,613.620052634782,68380.63384523813,0.0012855976439804062,0.0049225537873991455,68522.99658333337,67627.21962670729,71426.80117637453,68335.80885901143,68001.71597311767,68660.4565603715,230.9545351775596,254.78517995224993,501.2137516460833,-151.07386205720832,-12.568926040490624,61.96238183694368,69337.09512509372,67982.31799564928,40.61291462341595,53.74853884741743,False,True,67232.438,68132.438,67632.438,67582.438,,False,2024-04-05 08:15:00,2024-04-05 08:17:47,2024-04-05 00:03:58,fail,False,-74.66,6454.399999999994,,0,2,14,4
2024-04-05 03:00:00,68473.141,68485.539,68299.734,68328.336,1972,36421,0,2024-04-05 03:00:00,2024-04-05 03:00:00,51.87983333331067,572.0178851282981,68197.71919047623,0.00045542411974386967,-0.0013385096845667556,68136.80442857143,67519.78861013915,68367.95626642587,68183.4009562,68059.16066329557,68229.76249122807,91.61572172539309,93.38380001054011,411.1700027480315,117.76031406947004,136.0646831785416,122.98486480907013,68786.34199493792,67674.68298751823,91.54950279396353,89.29282310369433,True,False,68828.336,68428.336,68428.336,68478.336,2024-04-05 04:00:00,True,2024-04-05 04:00:00,2024-04-08 00:00:05,2024-04-05 04:13:26,even,True,18.66,6473.059999999994,,1,0,14,4
2024-04-05 11:00:00,66922.164,67353.641,66901.844,67297.672,2092,36421,0,2024-04-05 11:00:00,2024-04-05 11:00:00,-195.0262499999808,157.00797087211686,67024.86788095238,-0.0032217762478831888,-0.0019348706868849228,67034.47436904762,64854.83832277951,67144.00844571517,67121.05320773984,67350.13160736802,66835.58284520126,-128.01710878401354,-120.94090345106494,441.88448964066055,61.17460337121156,-16.94759545926354,-38.75600343989208,67433.62690621616,66239.03878418637,46.4544581854116,40.028070209966245,True,False,67797.672,66897.672,67397.672,67447.672,,False,2024-04-05 17:00:00,2024-04-05 17:11:28,2024-04-05 12:07:44,fail,False,-74.66,6398.399999999994,,0,1,14,4
2024-04-05 21:00:00,67431.859,67709.734,67308.438,67641.836,2670,36421,0,2024-04-05 21:00:00,2024-04-05 21:00:00,-55.115309523724136,121.53606346996094,67875.54307142859,0.0034050185246278153,0.0009655287048271412,67877.39411904768,68259.23781603278,69103.99096422791,67695.96985065534,67578.0639497245,67741.50382937738,75.51071978133405,85.38727860946842,530.9977403967405,-75.54043240449391,-142.89769693846756,-124.66028414170432,68458.35077891298,67023.15687984179,16.530583012786973,21.541963994264535,False,True,67141.836,67541.836,67541.836,67491.836,2024-04-05 21:30:00,True,2024-04-05 21:30:00,,2024-04-05 21:30:04,even,True,18.66,6417.059999999994,,1,0,14,4
2024-04-05 22:00:00,67606.445,67865.039,67593.57,67677.836,2067,36421,0,2024-04-05 22:00:00,2024-04-05 22:00:00,-1.8510476190858753,120.02592468819057,67684.32717857145,0.003031585284342494,-0.0010029843842121093,67875.54307142859,68208.46782320415,67939.27190442287,67647.97194059889,67581.25055657567,67544.04086240113,54.40669950096344,69.30066444520183,352.92393335907497,5.272510491966386,-60.64855589954823,-42.84185724120471,68021.98817243589,67067.59355236638,29.781351261889274,25.01210922178852,False,True,67177.836,67577.836,67577.836,67527.836,2024-04-05 23:00:00,True,2024-04-05 23:00:00,,2024-04-05 23:29:12,even,True,18.66,6435.719999999994,,2,0,14,4
2024-04-05 23:00:00,67367.758,67518.938,67304.852,67468.844,2071,36421,0,2024-04-05 23:00:00,2024-04-05 23:00:00,-191.21589285714435,99.11923561770527,67570.10201190478,0.0017133222448420906,-0.0014238193988770928,67684.32717857145,67781.84508217982,67582.95028584784,67592.21834733756,67572.017506866,67460.12269109054,33.481565500449506,53.77106424906126,234.0169920574249,-24.301188510435168,-72.2807285861345,-24.700015823880676,67776.04563036807,67142.69975181301,20.2205676874728,28.863877257538736,False,True,66968.844,67868.844,67368.844,67318.844,,False,,,2024-04-08 00:00:05,fail,False,-74.66,6361.059999999994,,0,1,14,4
2024-04-08 00:00:00,69279.141,69415.234,69220.539,69343.641,1614,53649,0,2024-04-08 00:00:00,2024-04-08 00:00:00,-114.2251666666707,99.40709762097686,67968.90996428567,-1.0514650574302209e-05,0.001763731349267342,67570.10201190478,67301.21308319527,69924.9180490687,67864.47137408947,67708.62677357512,67863.8641675267,75.83385149655805,48.579051391787985,385.80081178156445,339.3765455796529,19.412349501246354,21.59966838666878,68386.19526343181,67343.03307162158,59.16043085323255,44.18497185003923,True,False,69843.641,68943.641,69443.641,69493.641,,False,2024-04-08 04:15:00,2024-04-08 04:20:38,2024-04-08 01:01:58,fail,False,-74.66,6286.399999999994,,0,2,15,4
2024-04-08 05:00:00,69441.734,69441.734,69231.836,69299.836,1340,36421,0,2024-04-08 05:00:00,2024-04-08 05:00:00,224.37846428577905,511.4021053743345,69512.3913214285,0.004425777106563557,0.0015423940686006914,69450.56329761907,70395.2185479244,70401.63939443446,69370.75255636213,69026.1007685822,69515.49885861712,222.10154607903678,230.23869141824443,680.9254518472253,-21.857914688720484,14.221343653305667,78.01656759539037,70434.74821861088,68594.74949862337,55.9497066536027,73.09415875598363,False,True,68799.836,69699.836,69199.836,69149.836,,False,2024-04-09 18:15:00,2024-04-09 17:48:41,2024-04-08 08:42:15,fail,False,-74.66,6211.739999999994,,0,3,15,4
2024-04-08 06:00:00,69239.539,69281.734,69132.836,69272.734,2066,36421,0,2024-04-08 06:00:00,2024-04-08 06:00:00,61.828023809430306,529.7711596554727,69521.96007142865,0.0038292075079354466,0.0015368054819897294,69512.3913214285,70239.03388099477,70506.41061548718,69325.61293938229,69093.39015934302,69385.02737082902,177.47229859161598,207.1559761075867,154.21171701840774,-24.751173030628706,-40.97366391464311,-26.27087650501926,69593.21318880387,69175.34155285417,29.73546510554462,31.579929217197616,False,True,68772.734,69672.734,69172.734,69122.734,,False,2024-04-09 18:15:00,2024-04-09 17:48:43,2024-04-08 08:42:08,fail,False,-74.66,6137.0799999999945,,0,4,15,4
2024-04-08 07:00:00,69466.734,69512.539,69315.938,69337.734,1166,36421,0,2024-04-08 07:00:00,2024-04-08 07:00:00,9.56875000015134,556.6083827001712,69412.22839285713,0.0007547205050584905,0.0007362926254993118,69521.96007142865,69402.52906547696,70212.56230064659,69354.25558108947,69170.24508494334,69370.05369005843,150.10916775849182,178.30646024868403,138.6257359844636,-11.738178878673352,13.167614379082806,10.859030959793017,69557.19843363746,69181.4089464794,43.921440350901435,41.98358933849448,False,True,68837.734,69737.734,69237.734,69187.734,,False,2024-04-09 18:15:00,2024-04-09 17:48:29,2024-04-08 08:45:49,fail,False,-74.66,6062.419999999995,,0,5,15,4
2024-04-08 07:30:00,69354.484,69408.938,69274.25,69408.938,755,36421,0,2024-04-08 07:00:00,2024-04-08 07:00:00,9.56875000015134,556.6083827001712,69412.22839285713,0.0007547205050584905,0.0007362926254993118,69521.96007142865,69402.52906547696,70212.56230064659,69362.67052847234,69200.54798366199,69365.3432029584,136.86046718776925,164.29944755813528,130.53937375666598,4.541877536976244,-9.252364637010032,-11.738178878673352,69543.07135752989,69189.1150483869,34.535366720150456,39.13911296197933,True,False,69908.938,69508.938,69508.938,69558.938,2024-04-08 08:15:00,True,2024-04-08 08:15:00,2024-04-08 10:02:18,2024-04-08 08:28:40,even,True,18.66,6081.0799999999945,,1,0,15,4
2024-04-08 10:30:00,70092.039,70869.734,70087.398,70675.836,4062,36421,0,2024-04-08 10:00:00,2024-04-08 10:00:00,104.70779761907761,609.962503300645,70013.9359404762,0.0018259249386725475,0.0024314824916457796,69611.31723809529,70170.41594457693,71591.71352021566,69878.38631803426,69606.30645412307,70063.72077880974,158.90653404771,139.58514556569293,322.7844739883305,175.7097860336944,76.27826281389571,58.827920536641614,70500.97981869399,69627.9617389255,91.19903369320343,89.97018421768524,True,False,71175.836,70275.836,70775.836,70825.836,,False,2024-04-08 11:15:00,2024-04-08 11:13:11,2024-04-09 10:45:33,success,True,93.3,6174.379999999995,,2,0,15,4
2024-04-08 16:00:00,72220.797,72355.734,72039.398,72116.734,2848,36421,0,2024-04-08 16:00:00,2024-04-08 16:00:00,132.9696190475952,1196.1574283915252,72449.8131428571,0.004575198161016793,0.003619554697871489,72520.53982142857,73117.66309553351,74919.9039611727,72240.61366394661,71748.16303486792,72407.30149982801,340.358716691655,372.1630716182841,783.5861890245683,-117.50449948398455,-79.81855383556103,-27.274880632932764,73465.14285501117,71347.96014464485,39.267053279209165,51.90722828654672,False,True,71616.734,72516.734,72016.734,71966.734,,False,2024-04-08 17:15:00,2024-04-08 17:07:41,,success,True,93.3,6267.679999999995,,3,0,15,4
2024-04-08 17:00:00,71976.539,72025.734,71602.18,71918.539,3322,36421,0,2024-04-08 17:00:00,2024-04-08 17:00:00,-70.72667857146007,1184.1042596656043,72182.80772619047,0.0029762414941541266,0.0006047003362726036,72449.8131428571,72150.05377894444,73136.81274279651,72131.4444000505,71822.0624741397,72172.34703095978,261.6649085367244,322.1834446159397,372.79967771727587,-64.12941795661754,-52.95302992781217,-79.84179497767764,72675.6265958781,71667.56746604145,24.089836623279382,27.589019768816957,False,True,71418.539,71818.539,71818.539,71768.539,2024-04-08 17:30:00,True,2024-04-08 17:30:00,2024-04-08 17:44:00,2024-04-08 18:00:04,success,True,93.3,6360.979999999995,,4,0,15,4
2024-04-08 18:00:00,71762.734,72003.734,71725.836,71945.336,2772,36421,0,2024-04-08 18:00:00,2024-04-08 18:00:00,-267.00541666663776,1144.0313866220386,71940.6745,0.001416646015699189,-0.0003748273140450069,72182.80772619047,71784.1355604866,72668.49687751412,71931.72074700253,71791.44736007726,71761.55911420714,174.8068404882506,246.6304447922094,297.01276181724006,-34.49909769513761,-90.6704815961566,-165.45859717922576,72162.5263426604,71359.09188575386,25.63531027459509,17.4712289654212,False,True,71445.336,71845.336,71845.336,71795.336,2024-04-08 18:30:00,True,2024-04-08 18:30:00,2024-04-08 20:27:44,2024-04-08 18:33:11,even,True,18.66,6379.639999999995,,5,0,15,4
2024-04-08 21:00:00,71720.18,71881.836,71695.836,71772.039,2363,36421,0,2024-04-08 21:00:00,2024-04-08 21:00:00,-92.16636904762709,1001.3383664672147,71751.83801190475,-0.0007401689981841706,-0.001647593368172124,71723.35195238088,70828.58573784988,71651.76880038541,71732.39041822757,71746.961449584,71676.85151324388,47.50615052989451,86.52382147531189,314.3888685715768,25.377427588551654,27.037581699332804,-24.93794599235116,72102.7764858155,71252.42654067226,52.85098231128625,40.167128763141676,True,False,72272.039,71872.039,71872.039,71922.039,2024-04-08 21:30:00,True,2024-04-08 21:30:00,,2024-04-08 21:55:07,even,True,18.66,6398.299999999995,,6,0,15,4
2024-04-08 23:00:00,71782.539,71838.141,71633.609,71649.438,1835,36421,0,2024-04-08 23:00:00,2024-04-08 23:00:00,13.142000000007101,914.0240078940697,71769.97760714285,0.00030815196304852244,-0.0005760067837978933,71764.98001190476,71482.57439451947,71891.18794291523,71802.93077629503,71795.11450273107,71816.90743756451,33.57877606974216,51.95221440009528,166.43907229296434,-19.74009872712486,-14.53743550060608,6.946953904393013,72041.60018516002,71590.71468996901,49.79164594447516,57.88583507804106,True,False,72149.438,71749.438,71749.438,71799.438,2024-04-09 00:15:00,True,2024-04-09 00:15:00,,2024-04-09 00:32:52,even,True,18.66,6416.959999999995,,7,0,15,4
2024-04-09 03:00:00,71666.641,71748.836,71631.836,71748.836,1778,36421,0,2024-04-09 03:00:00,2024-04-09 03:00:00,-47.30766666663112,715.913573229831,71660.95316666667,3.7018478173600234e-05,-0.00027152508210650806,71773.51532142863,71353.45012264546,71948.43461749153,71765.51127182288,71771.28551887187,71785.50221637428,5.587299055157928,11.057269475906,122.58194370154789,1.4845528036385076,-9.651777777835377,7.195766425866168,71952.48784037137,71620.0165923772,31.93932785225711,43.625412159294655,False,True,71248.836,71648.836,71648.836,71598.836,2024-04-09 03:30:00,True,2024-04-09 03:30:00,2024-04-09 04:06:13,2024-04-09 03:37:16,even,True,18.66,6435.619999999994,,8,0,15,4
2024-04-09 14:00:00,70598.836,70942.734,70598.836,70933.836,2439,36421,0,2024-04-09 14:00:00,2024-04-09 14:00:00,-23.100261904794024,16.425803713107598,70555.26769047616,-0.0023973641270978374,-0.0010320045040130728,70469.42019047614,68335.92126300118,70638.11794704152,70587.39918847641,70718.55448365433,70523.93374785001,-103.18906311046157,-124.95264754405268,349.1596815866042,107.21041795662313,68.70712727894715,31.644240110137616,70996.79931799193,70052.56817770809,81.04711812729796,71.06828098395117,True,False,71433.836,70533.836,71033.836,71083.836,,False,2024-04-11 11:45:00,,2024-04-09 16:10:39,fail,False,-74.66,6360.959999999995,,0,1,15,4
2024-04-09 15:00:00,70842.039,70944.734,70692.836,70737.234,2223,36421,0,2024-04-09 15:00:00,2024-04-09 15:00:00,85.84750000001804,8.336450162809342,70616.50727380948,0.0009694751893534814,-0.0007283888024717982,70555.26769047616,70072.39139868613,70794.36396702843,70681.55764302661,70735.50222248843,70802.43675404195,-66.75489567183831,-96.20721709116108,294.8040764418196,40.05991709664522,75.05951805989025,77.443663570637,71201.9222572384,70404.4512508455,80.82154110353059,86.30629242178664,True,False,71237.234,70337.234,70837.234,70887.234,,False,2024-04-11 01:30:00,2024-04-11 01:25:11,2024-04-09 16:49:04,fail,False,-74.66,6286.299999999995,,0,2,15,4
2024-04-09 22:00:00,68900.313,68903.438,68680.109,68743.438,2012,36421,0,2024-04-09 22:00:00,2024-04-09 22:00:00,-181.07278571433562,-497.67867154172563,68774.70486904765,-0.0019211795839516432,-0.0042255093932930966,68777.7060952381,67408.09182737731,67990.66112877037,68934.9645853125,69290.15862617777,68777.59586996902,-229.51128845057974,-238.43667968127232,665.8195208624701,-16.30273443418264,70.64396800829854,77.81768249055312,69676.45222313335,67877.2395168047,56.14882674184597,59.696570604476655,True,False,69243.438,68843.438,68843.438,68893.438,2024-04-09 22:30:00,True,2024-04-09 22:30:00,2024-04-10 00:36:19,2024-04-10 04:06:54,success,True,93.3,6379.599999999995,,1,0,15,4
2024-04-09 23:00:00,69024.688,69186.641,68988.445,69117.273,1987,36421,0,2024-04-09 23:00:00,2024-04-09 23:00:00,-3.001226190448506,-517.7840458686405,68916.2338214286,-0.0017201664001387789,-0.003541660745008274,68774.70486904765,67374.21740043098,68221.79696686586,69003.70076648437,69233.44470763208,68948.69973718606,-179.38197588807088,-212.21076834229356,393.0451787926015,47.08968111453578,20.435348469225573,20.135159958677832,69480.81072855607,68418.08874581606,84.0594994578302,77.60490359364259,True,False,69617.273,69217.273,69217.273,69267.273,2024-04-10 01:45:00,True,2024-04-10 01:45:00,2024-04-10 05:02:39,2024-04-10 02:07:24,even,True,18.66,6398.259999999995,,2,0,15,4
2024-04-10 00:00:00,69186.836,69206.039,68942.961,69047.438,1507,56421,0,2024-04-10 00:00:00,2024-04-10 00:00:00,141.52895238094789,-514.5584098470572,69053.31377380951,0.001546821187749273,-0.0024514234656727667,68916.2338214286,69071.35089603603,68567.15364899616,69049.8128369489,69197.78847901608,69145.66830959743,-137.62750286042865,-175.15048733771494,187.17407907487495,14.891056071472121,73.65298314407119,41.62438355696213,69399.85331634851,68892.98330284635,80.37340757747772,84.89341144559302,True,False,69547.438,69147.438,69147.438,69197.438,2024-04-10 01:00:00,True,2024-04-10 01:00:00,2024-04-10 05:02:20,2024-04-10 02:12:35,even,True,18.66,6416.919999999995,,3,0,15,4
2024-04-10 01:00:00,69227.672,69296.539,69148.664,69217.938,1731,56421,0,2024-04-10 01:00:00,2024-04-10 01:00:00,137.07995238091098,-503.1839723960002,69193.36223809521,0.002565613798668921,0.00010997139301859905,69053.31377380951,69826.06224697211,69482.97020171695,69115.00461089489,69192.82189438462,69194.61565153077,-97.80621237868036,-136.9198401833251,193.23705498807038,25.238286893669283,28.827931888590683,-11.59941623666964,69456.98567576466,68933.74562729687,87.78775757005157,82.52781764687786,True,False,69717.938,69317.938,69317.938,69367.938,2024-04-10 01:45:00,True,2024-04-10 01:45:00,2024-04-10 20:21:38,2024-04-10 01:54:03,even,True,18.66,6435.5799999999945,,4,0,15,4
2024-04-10 02:00:00,69344.523,69357.539,69107.438,69181.836,1381,36421,0,2024-04-10 02:00:00,2024-04-10 02:00:00,140.04846428570454,-478.9654362460715,69263.60186904765,0.0016819225285408554,0.0002392133283579071,69193.36223809521,69380.27859796704,69536.81518688465,69197.87797122341,69218.2138340286,69295.30111936705,-60.77172873329255,-97.25888762883032,208.24209155108204,-4.666541107711964,41.10848469210032,38.83068008258124,69576.42794296102,69012.67429577309,74.6868928498965,83.11164273809435,False,True,68681.836,69081.836,69081.836,69031.836,2024-04-10 02:30:00,True,2024-04-10 02:30:00,2024-04-10 04:24:14,2024-04-10 02:40:59,even,True,18.66,6454.239999999994,,5,0,15,4
2024-04-10 04:00:00,69162.945,69171.641,68785.336,68902.859,2119,36421,0,2024-04-10 04:00:00,2024-04-10 04:00:00,-18.813821428630035,-456.0620534949994,69274.34114285717,-0.00012975475067012599,0.0007327785319332737,69244.78804761902,68590.51197579621,69816.58876495669,69154.64147530342,69186.67216313194,69173.74835431715,-40.953151460169465,-51.587675339223054,139.21952735892367,-67.17453663572087,-13.555463020238676,-4.620952872355701,69361.6947162517,68984.3019923826,39.73906027592201,54.76564069950886,False,True,68402.859,69302.859,68802.859,68752.859,,False,2024-04-10 06:00:00,2024-04-10 15:31:03,2024-04-10 04:59:59,fail,False,-74.66,6379.5799999999945,,0,1,15,4
2024-04-10 11:00:00,69351.906,69361.734,68811.547,69053.438,2809,36421,0,2024-04-10 11:00:00,2024-04-10 11:00:00,66.01161904759647,-300.3547324521496,69246.85288095239,0.000763129287842821,-0.00024909887835310174,69298.40275000002,69029.89130964615,69455.95306556733,69311.30728330286,69258.39431492596,69398.965373581,24.877432771754684,22.021223111006574,229.6492199563157,-74.5839690402936,-15.775575163366739,1.5367874096846208,69708.99182052203,69087.43892663997,58.32615308672779,70.34310353058507,False,True,68553.438,68953.438,68953.438,68903.438,2024-04-10 13:30:00,True,2024-04-10 13:30:00,2024-04-10 15:30:32,2024-04-10 13:53:15,even,True,18.66,6398.239999999994,,1,0,15,4
2024-04-10 15:15:00,69046.648,69118.734,68751.836,68994.461,2177,36421,0,2024-04-10 15:00:00,2024-04-10 15:00:00,-41.44389285714715,-271.5376211630355,68687.99535714283,-0.003364235504007743,-0.0008449949920324193,69085.804452381,66600.56562267398,69009.67598557565,69047.16536801166,69092.63103217035,69016.68542242864,-24.083297671808396,-21.28737023244026,198.92170272993872,16.58524939796189,27.435760921944166,23.678456140420167,69286.72972111405,68748.14112374322,66.30970620443847,68.31562121528069,False,True,68494.461,69394.461,68894.461,68844.461,,False,2024-04-10 15:45:00,2024-04-10 15:31:02,2024-04-10 19:51:41,success,True,93.3,6491.5399999999945,,2,0,15,4
2024-04-11 00:00:00,69822.828,69953.938,69732.266,69866.781,1491,56421,0,2024-04-11 00:00:00,2024-04-11 00:00:00,133.06065476192452,-21.646350679453462,69940.19721428568,0.0032219723347909255,0.00205428219493199,69810.8085238095,70520.3736110147,71139.67875113167,69697.74208124648,69424.7314579439,69871.65988682494,138.06729307837668,113.33122517228423,476.42620647152336,17.689244926092215,10.528882008991786,25.27168937033275,70516.3352655615,69228.48450808838,72.68923826862573,73.63608719345474,False,True,69366.781,69766.781,69766.781,69716.781,2024-04-11 00:30:00,True,2024-04-11 00:30:00,2024-04-12 17:51:12,2024-04-11 00:31:32,even,True,18.66,6510.199999999994,,3,0,15,4
2024-04-11 01:15:00,70501.234,71258.336,70438.578,70955.734,3453,36421,0,2024-04-11 01:00:00,2024-04-11 01:00:00,129.38869047618937,36.78253329334257,70209.6051904762,0.0031476767505849777,0.0036864860595127295,69940.19721428568,70722.3066454157,72363.31332447237,70020.46925482793,69673.60139508336,70261.60315376674,175.25447674318275,136.5356710158156,439.52705354455065,203.2077258341742,131.72082628133649,75.70276126592944,70856.46467605188,69668.24163148161,88.58385273164367,76.15930298014119,True,False,71455.734,70555.734,71055.734,71105.734,,False,2024-04-11 11:45:00,,2024-04-11 01:58:35,fail,False,-74.66,6435.5399999999945,,0,1,15,4
2024-04-11 07:00:00,70888.281,70918.141,70534.992,70643.734,1652,36421,0,2024-04-11 07:00:00,2024-04-11 07:00:00,109.36659523808339,381.17142446957587,70824.24226190474,0.0016748049076477348,-0.0005218551579028749,70882.2510238095,70896.1180001906,70881.17736003561,70778.81325590945,70565.2410961374,70911.52926797382,152.55296246583748,167.6525741096944,182.81876191671233,-23.653679050607025,30.262222222198034,51.80998452012136,71158.33459656138,70663.22393938625,62.06817120631874,70.55792356249971,False,True,70143.734,71043.734,70543.734,70493.734,,False,2024-04-11 14:45:00,2024-04-11 14:41:46,2024-04-11 10:16:34,fail,False,-74.66,6360.879999999995,,0,2,15,4
2024-04-11 08:00:00,70633.953,70720.539,70586.547,70712.336,1488,36421,0,2024-04-11 08:00:00,2024-04-11 08:00:00,-58.008761904755374,382.7964089243178,70740.75822619049,0.0008988058000648391,-0.000521895259880624,70824.24226190474,70727.81427035363,70844.2687339915,70704.6048250331,70579.73859742598,70763.4339287926,112.34879666249617,140.55120455228507,171.3808259519329,-29.50040660475497,-39.373791881647776,-44.125414860696765,70994.7980438277,70530.5698137575,33.31490923895286,27.84475228387193,False,True,70212.336,70612.336,70612.336,70562.336,2024-04-11 08:45:00,True,2024-04-11 08:45:00,2024-04-11 14:40:34,2024-04-11 08:54:38,even,True,18.66,6379.5399999999945,,1,0,15,4
2024-04-11 13:00:00,70646.734,70806.438,70591.734,70672.039,1589,36421,0,2024-04-11 13:00:00,2024-04-11 13:00:00,-78.62671428571048,376.4200739116641,70699.62082142859,8.965843480396389e-05,0.0006883658958914921,70767.24746428571,70467.20835115662,71722.0575056374,70821.19451533885,70776.93213262656,70876.68454179565,50.58092225580185,69.33877208007354,167.98675765938347,-58.82356553147838,-55.92456759548804,-18.034297557533137,71103.46666463582,70648.40241895548,10.323888698712862,21.8923776447002,False,True,70172.039,70572.039,70572.039,70522.039,2024-04-11 14:00:00,True,2024-04-11 14:00:00,2024-04-11 14:40:41,2024-04-11 14:09:18,even,True,18.66,6398.199999999994,,2,0,15,4
2024-04-11 22:00:00,70143.234,70198.336,70024.93,70166.281,1876,36421,0,2024-04-11 22:00:00,2024-04-11 22:00:00,19.952797619087505,58.058651985178585,70155.89029761907,3.439798126389482e-05,-0.0011782784926832352,70067.62750000005,69596.35522745502,70211.8343319906,70153.6019623494,70183.90434204403,70286.35264568284,-38.39534985041246,-55.54295333261548,302.1665078268377,23.695316477431334,7.4305589955620235,46.96910491921881,70695.77743124907,69878.42786011662,67.7106776480025,68.99230780541164,True,False,70666.281,70266.281,70266.281,70316.281,2024-04-11 22:30:00,True,2024-04-11 22:30:00,2024-04-11 23:22:45,2024-04-11 22:51:02,even,True,18.66,6416.859999999994,,3,0,15,4
2024-04-11 23:00:00,70476.539,70588.406,70383.789,70556.641,2066,36421,0,2024-04-11 23:00:00,2024-04-11 23:00:00,88.26279761902697,72.12507570128946,70354.78072619051,0.001765021882603242,-0.0005221654228299152,70155.89029761907,70602.5319062823,70607.4171721704,70314.15599358418,70261.36420678296,70435.68553353978,-0.28373833584191743,-30.050219501309673,257.7549560656696,49.40752906775742,29.508777089853538,54.5265810113051,70785.15472422844,70087.71634285113,94.59611865244123,88.99156400824273,True,False,71056.641,70156.641,70656.641,70706.641,,False,2024-04-12 05:30:00,2024-04-12 07:45:18,2024-04-12 00:31:45,fail,False,-74.66,6342.199999999994,,0,1,15,4
2024-04-12 00:00:00,70519.438,70528.438,70403.938,70491.539,1191,56421,0,2024-04-12 00:00:00,2024-04-12 00:00:00,198.89042857143795,85.72229000080551,70367.13079761907,0.0013747333728739491,0.0009261115127971694,70354.78072619051,70474.3781153645,71100.35122065432,70427.37723609348,70338.56307219162,70540.72447299625,24.685584019869566,-0.41012152573386285,277.229543367207,-15.609928792488063,6.950609563093167,39.2782731338375,70914.98435654199,70164.96458945052,69.0021212559667,77.37243828340924,False,True,69991.539,70391.539,70391.539,70341.539,2024-04-12 00:30:00,True,2024-04-12 00:30:00,2024-04-12 02:26:14,2024-04-12 04:06:12,success,True,93.29,6435.489999999994,,1,0,15,4
2024-04-12 01:00:00,70152.141,70216.641,70043.258,70215.234,1450,56421,0,2024-04-12 01:00:00,2024-04-12 01:00:00,12.350071428561932,65.46026371124026,70303.22179761909,0.001077028555094844,0.0013877485377268577,70367.13079761907,70358.22079890547,71369.3841646759,70310.47757577272,70298.59050660158,70378.06969556243,3.498954952970962,5.206104899812517,225.6922218419563,-33.9370890952996,-37.394420364697,-40.06333746128075,70682.75419504907,70071.88519607579,24.151964990802497,30.301166272929066,False,True,69715.234,70115.234,70115.234,70065.234,2024-04-12 02:30:00,True,2024-04-12 02:30:00,2024-04-12 16:45:13,2024-04-12 02:50:27,even,True,18.66,6454.149999999994,,2,0,15,4
2024-04-12 02:00:00,70185.234,70234.938,70074.273,70075.836,1189,36421,0,2024-04-12 02:00:00,2024-04-12 02:00:00,-63.9089999999851,51.96613754464488,70216.02610714285,0.0003890094808094109,0.0004279499857540025,70303.22179761909,69895.34614194666,70978.97930166892,70242.34418636911,70266.55680276315,70220.56231888544,-9.16468072416319,-0.07190079697997898,164.6230090368565,-56.36351152390125,-45.817475748219294,-34.469649122838746,70442.80338108519,69996.82125668568,15.086926309089423,22.469856741800413,False,True,69575.836,70475.836,69975.836,69925.836,,False,2024-04-12 16:45:00,2024-04-12 17:38:32,2024-04-12 05:06:37,fail,False,-74.66,6379.489999999994,,0,1,15,4
2024-04-12 05:00:00,70305.109,70580.734,70229.258,70562.836,1563,36421,0,2024-04-12 05:00:00,2024-04-12 05:00:00,14.556749999988824,35.87712978363561,70351.20732142853,-0.00043231994542384156,0.00010510981898079006,70237.81016666665,69566.18891825475,70837.50148895319,70294.59461409021,70269.63270098051,70323.6122985896,4.931967734679347,-5.928328864714638,179.22570371316658,65.01582559334929,24.069257998038665,34.70975232186902,70567.06699860239,70081.65759857683,86.4471056671278,78.39000422929873,True,False,71062.836,70662.836,70662.836,70712.836,2024-04-12 05:30:00,True,2024-04-12 05:30:00,2024-04-12 07:45:18,2024-04-12 05:45:51,even,True,18.66,6398.149999999994,,1,0,15,4
2024-04-12 10:00:00,70910.539,71014.734,70824.0,70841.734,966,36421,0,2024-04-12 10:00:00,2024-04-12 10:00:00,52.33445238096465,197.89491774710768,70992.82970238099,0.0011995764532195146,0.0019665718454908677,71038.89204761908,70968.9273011297,72290.99753735,70897.2087502236,70781.58498929706,70958.28053766768,77.96093720555655,85.8455665146415,274.2976735654764,-34.37303061572311,-16.655044031664147,-26.752742690077866,71328.58239698107,70586.4786783543,29.671226462727446,32.34086992409163,False,True,70341.734,70741.734,70741.734,70691.734,2024-04-12 12:45:00,True,2024-04-12 12:45:00,2024-04-12 16:02:43,2024-04-12 13:13:18,even,True,18.66,6416.809999999994,,2,0,15,4
2024-04-12 11:00:00,70801.555,70906.734,70767.961,70899.141,1482,36421,0,2024-04-12 11:00:00,2024-04-12 11:00:00,-46.062345238096896,195.48929413982842,70942.0563095238,0.0009917450169202471,0.00036875126730900903,70992.82970238099,70914.36678199003,71493.79025612633,70865.59591576007,70794.44723939284,70835.99738458896,58.96050028139143,72.72294935290256,137.23521524716824,-11.493328173324699,-21.832842449250165,-55.062153422797564,71021.26492517264,70649.22984400528,29.686360211002633,24.755426158040283,False,True,70399.141,70799.141,70799.141,70749.141,2024-04-12 12:30:00,True,2024-04-12 12:30:00,2024-04-12 15:43:51,2024-04-12 13:15:14,even,True,18.66,6435.469999999994,,3,0,15,4
2024-04-12 12:00:00,70810.141,70909.641,70714.172,70780.641,1404,36421,0,2024-04-12 12:00:00,2024-04-12 12:00:00,-50.77339285718335,191.56062271943665,70822.04339285719,0.0006545830155702188,-0.000780023758807188,70942.0563095238,70744.36099816611,70770.75554546421,70834.62962811679,70796.84804483251,70765.86619091849,41.93119599671627,57.64474282678863,104.62571446098488,-12.845099759142613,-23.34486274518713,-21.983381836893386,70907.11090544082,70623.12147639616,39.05089697296014,38.94585594697187,False,True,70280.641,70680.641,70680.641,70630.641,2024-04-12 15:45:00,True,2024-04-12 15:45:00,2024-04-12 16:07:41,,success,True,93.29,6528.759999999994,,4,0,15,4
2024-04-12 14:00:00,70822.734,70970.734,70790.125,70845.547,1540,36421,0,2024-04-12 14:00:00,2024-04-12 14:00:00,-52.078392857161816,173.24948370203492,70798.59589285715,-0.00044939624050296955,-0.0005252874696449389,70769.96500000003,70356.52063793206,70861.7078425042,70794.61492231491,70783.92532176326,70759.79093085662,19.335549697614624,27.474805277172955,103.68941790261707,18.33083660135162,6.04437392501859,9.007715514206211,70901.27164502515,70619.81021668809,68.58940541338461,60.97374899442196,True,False,71345.547,70445.547,70945.547,70995.547,,False,,,2024-04-12 15:40:08,fail,False,-74.66,6454.099999999994,,0,1,15,4
2024-04-12 15:00:00,70937.141,71009.336,70886.734,70894.602,1316,36421,0,2024-04-12 15:00:00,2024-04-12 15:00:00,28.6308928571234,177.74954568519024,70728.55713095237,-0.0007763937300667195,-0.0003965855203549994,70798.59589285715,70115.4495004809,70891.98460371206,70848.22071417712,70815.42374966512,70852.70947643621,24.447737937254715,24.7268046400332,76.57532136142792,10.769178534552339,32.29886824908317,35.76385724110878,70957.58616027414,70749.33279259829,83.37679415586196,79.83163386012102,True,False,71394.602,70494.602,70994.602,71044.602,,False,,,2024-04-12 15:40:04,fail,False,-74.66,6379.439999999994,,0,2,15,4
2024-04-12 19:30:00,69001.734,69057.734,68743.313,68750.836,3550,36421,0,2024-04-12 19:00:00,2024-04-12 19:00:00,-325.7011785714567,-117.04337291780394,69284.31973809526,-0.0038330249129132606,-0.003597900005037519,69687.31613095237,67602.69307116755,68957.21017176635,69430.8918965652,69864.16090078777,68988.428875817,-210.87973105939454,-158.87330694170703,701.998071298442,-114.50815755066287,-93.95892328860646,-88.14398830423306,69936.1262720699,68039.2314795641,7.7815061042398,7.767877984401383,False,True,68250.836,68650.836,68650.836,68600.836,2024-04-12 20:15:00,True,2024-04-12 20:15:00,2024-04-12 20:22:42,2024-04-12 20:17:09,even,True,18.66,6398.099999999994,,1,0,15,4
2024-04-12 21:30:00,67642.43,67716.641,65091.984,66537.938,7427,36421,0,2024-04-12 21:00:00,2024-04-12 21:00:00,-534.2074404762097,-348.9708059273398,67825.98514285717,-0.011989640508465795,-0.004979376648359158,68750.11229761905,61981.81473650963,67514.70181971775,68225.94605991295,68967.47046094379,67658.21867801859,-370.5726478946308,-284.06616513279687,972.4183250981083,-370.8811117991281,-185.61395046435064,-118.4654729962349,68970.98341690103,66343.95393913615,30.044559661913365,33.046551910772074,False,True,66037.938,66937.938,66437.938,66387.938,,False,2024-04-15 00:15:00,2024-04-15 00:00:07,2024-04-12 22:27:07,fail,False,-74.66,6323.439999999994,,0,1,15,4
2024-04-15 00:00:00,63764.258,63806.738,63482.84,63649.438,2491,56422,0,2024-04-15 00:00:00,2024-04-15 00:00:00,-250.6425000000163,-814.048150447139,65732.67,-0.013407366895857855,-0.007830870884710505,67041.12711904764,59217.06801964009,64838.76421602326,66771.7397817223,67680.87691662053,66120.91768317852,-497.114571608181,-426.69545186640255,1342.973494099113,-618.04502476778,26.812867217027815,40.74033642934228,67933.93190021232,64306.403466144715,41.21258833267523,52.714245150128555,False,True,63149.438,63549.438,63549.438,63499.438,2024-04-15 00:45:00,True,2024-04-15 00:45:00,2024-04-15 21:17:43,2024-04-15 00:52:18,even,True,18.66,6342.099999999994,,1,0,16,4
2024-04-15 03:00:00,65592.672,65822.711,65341.84,65671.336,3166,36421,0,2024-04-15 03:00:00,2024-04-15 03:00:00,-119.08694047621248,-1323.319640908885,65123.24151190476,-0.0072833938320103755,-0.006730908199509025,65140.916928571394,60089.303796430024,64033.03210557711,65466.6736246914,66117.21564965612,64866.14493876849,-478.47184421971906,-549.1084351835757,1372.7713110820746,165.1605538355725,106.85489301691268,94.48841726858518,66720.8862087293,63012.90366880769,57.77078789135316,55.38482291958302,True,False,66171.336,65271.335999999996,65771.336,65821.336,,False,2024-04-15 09:30:00,2024-04-15 09:28:20,2024-04-15 03:36:37,fail,False,-74.66,6267.439999999994,,0,1,16,4
2024-04-15 04:00:00,65435.84,65488.438,65238.051,65344.738,3070,36422,0,2024-04-15 04:00:00,2024-04-15 04:00:00,-17.67541666663601,-1362.7641025874473,65144.83122619051,0.0005718580460111642,-0.0058553206377846894,65123.24151190476,63564.94243715548,64114.89306590456,65455.86119796599,65940.51260583004,65635.79405847954,-394.5679375855252,-471.56419054480676,1209.7717269980094,220.49201031997654,215.07062779500848,210.35634709322767,67270.48588992686,64002.60222703223,85.17203821144062,83.52052423149661,True,False,65844.738,65444.738,65444.738,65494.738,2024-04-15 04:30:00,True,2024-04-15 04:30:00,2024-04-15 09:18:03,2024-04-15 04:32:31,even,True,18.66,6286.099999999994,,1,0,16,4
2024-04-15 06:00:00,65084.34,65268.797,64981.84,65147.738,2782,36422,0,2024-04-15 06:00:00,2024-04-15 06:00:00,-93.70764285721089,-1414.7185287597094,65093.34097619043,0.0044459348349398615,-0.004694764335138491,65051.1235833333,66172.41411718528,64039.99759168951,65241.6827154727,65593.27099919083,65165.092442380555,-294.1855331942352,-345.2771010048212,686.8645217759749,-63.97090608859435,-62.79063501900964,-103.12472205016093,66092.35954677813,64236.32533798299,21.523164384040783,20.62058296153747,True,False,65647.738,64747.738,65247.738,65297.738,,False,2024-04-15 09:00:00,2024-04-15 09:12:41,2024-04-15 07:09:09,fail,False,-74.66,6211.439999999994,,0,1,16,4
2024-04-15 09:00:00,65409.84,65684.57,65300.859,65581.141,3074,36421,0,2024-04-15 09:00:00,2024-04-15 09:00:00,-72.24085714294051,-1358.2923168833222,65522.01180952385,-0.0011381444660278045,0.0015604330747829998,65129.95963095236,64184.847495949616,66931.09752662273,65177.731700497316,65307.39629958574,65135.39133333336,-157.30116071498196,-216.17752936678932,253.22641718675683,115.4793157895183,97.7782414860485,40.098183006550244,65478.74699653548,64793.53567013124,87.58367156760795,75.45653143011832,True,False,66081.141,65181.141,65681.141,65731.141,,False,2024-04-15 09:30:00,2024-04-15 09:18:29,2024-04-15 17:14:38,success,True,93.29,6304.729999999994,,1,0,16,4
2024-04-15 14:00:00,66419.234,66669.734,66136.836,66206.234,2499,36421,0,2024-04-15 14:00:00,2024-04-15 14:00:00,137.6997857143142,-805.2716907722352,66354.81090476192,0.0025226544726187,0.0015575467812866744,66492.09728571432,66465.38953905407,67453.83673480799,66343.9565837266,66141.15249012507,66438.89549535606,102.13592744733614,91.42756314028755,488.73922096905443,-36.17128173369565,8.436504643890657,-34.084991399999126,67098.69344366429,65777.59754704783,42.55850123000002,50.209390805610745,False,True,65706.234,66106.234,66106.234,66056.234,2024-04-15 14:45:00,True,2024-04-15 14:45:00,2024-04-15 16:58:14,2024-04-15 15:14:41,even,True,18.66,6323.389999999994,,2,0,16,4
2024-04-15 15:00:00,65830.336,66109.734,65759.836,66087.734,2575,36421,0,2024-04-15 15:00:00,2024-04-15 15:00:00,-137.28638095239876,-772.7552025652985,66190.97073809522,0.0019879236184682098,0.0015637252343358552,66354.81090476192,66297.81724649329,67561.82304075366,66179.0391404482,66105.92113762225,66207.32216477462,58.5570039285376,79.39943441626102,242.3602467823147,-40.3525761954661,-84.23318438250863,-75.8903371173219,66534.50849793074,65878.6358316185,17.427489128471002,16.08887384459888,False,True,65587.734,65987.734,65987.734,65937.734,2024-04-15 17:00:00,True,2024-04-15 17:00:00,2024-04-15 17:08:30,,success,True,93.29,6416.679999999994,,3,0,16,4
2024-04-15 16:00:00,65983.039,66191.617,65853.641,66113.734,2679,36421,0,2024-04-15 16:00:00,2024-04-15 16:00:00,-163.84016666670504,-726.2915584993025,65986.11307142855,0.0007266239839076921,-0.0010895818963523765,66190.97073809522,65829.28408805419,66227.88996686101,66109.76397938805,66086.54647896509,65994.50541210872,34.58919940130727,56.06381223623627,218.227982625794,-21.45035810105037,-65.49152493986185,-62.320374269009335,66289.11318865354,65698.39763556389,28.420034662484724,25.969951715633442,False,True,65613.734,66013.734,66013.734,65963.734,2024-04-15 17:00:00,True,2024-04-15 17:00:00,2024-04-15 17:08:24,,success,True,93.29,6509.969999999994,,4,0,16,4
2024-04-15 17:00:00,65822.273,65939.438,65114.18,65175.738,4204,36421,0,2024-04-15 17:00:00,2024-04-15 17:00:00,-204.85766666666314,-694.2797968122759,65359.075261904734,-0.004286605586931472,-0.0023880269625628572,65986.11307142855,63027.91324109232,65548.79801966956,65935.55584546132,66007.76091749364,65761.15869212258,-6.161375753217726,32.51702713859659,310.6205947815796,-147.39798830394284,-43.813661162756034,-15.66335569313378,66180.49649507772,65340.32088916745,22.526436522688496,32.089129069299766,False,True,64675.738,65075.738,65075.738,65025.738,2024-04-15 17:45:00,True,2024-04-15 17:45:00,2024-04-15 17:46:32,,success,True,93.29,6603.259999999994,,5,0,16,4
2024-04-16 01:00:00,63210.34,63233.738,62834.539,62933.137,3162,56422,0,2024-04-16 01:00:00,2024-04-16 01:00:00,-1.1405595237956732,-1126.273380136612,63137.793916666684,-0.0040869739781037645,-0.0037967719148198926,63147.569928571465,60458.01703118376,62516.188531032865,63179.883889677934,63601.42500547516,62966.46681802544,-279.92898266653356,-293.3934157043693,482.33573546931103,-35.33665015480801,16.359975232189754,-10.69907258341118,63617.62006090901,62313.81357514187,47.726238287718395,46.78525530422891,True,False,63433.137,62533.137,63033.137,63083.137,,False,2024-04-16 01:45:00,2024-04-16 01:41:42,2024-04-16 07:11:26,success,True,93.29,6696.549999999994,,6,0,16,4
2024-04-16 02:00:00,63411.84,63496.738,63289.934,63481.84,2386,36422,0,2024-04-16 02:00:00,2024-04-16 02:00:00,-9.776011904781626,-1103.2222640830369,63207.73023809525,-0.0005395932561443367,-0.0019413095101356104,63137.793916666684,61954.54719024802,63451.86788559849,63257.41567342792,63527.58243361677,63219.761167870616,-218.65571523638937,-262.63311367867857,368.4780846686496,112.50234915721376,64.3415772273438,69.94941520462453,63718.70658217329,62722.31575356794,81.8760860576438,70.48834010919508,True,False,63981.84,63081.84,63581.84,63631.84,,False,2024-04-17 00:45:00,2024-04-17 00:47:01,2024-04-16 03:37:49,fail,False,-74.66,6621.889999999994,,0,1,16,4
2024-04-16 02:15:00,63481.84,63512.738,63120.281,63236.52,2713,36422,0,2024-04-16 02:00:00,2024-04-16 02:00:00,-9.776011904781626,-1103.2222640830369,63207.73023809525,-0.0005395932561443367,-0.0019413095101356104,63137.793916666684,61954.54719024802,63451.86788559849,63254.20095443901,63506.02225334886,63228.64877364977,-208.30608179704723,-251.7677073023523,286.3355911358781,8.88760577915673,112.50234915721376,64.3415772273438,63616.70182168321,62842.09572561634,78.52930199699951,77.17458370438727,False,True,62736.52,63636.52,63136.52,63086.52,,False,2024-04-16 03:45:00,2024-04-16 05:27:50,2024-04-16 03:16:50,fail,False,-74.66,6547.229999999994,,0,2,16,4
2024-04-16 04:00:00,63223.738,63515.738,63037.965,63478.238,2760,36422,0,2024-04-16 04:00:00,2024-04-16 04:00:00,28.85157142856042,-1054.1014334341235,63239.96263095237,0.0020982335206396908,-0.0003548523747445904,63236.581809523814,63550.61149812339,63767.776730788086,63295.14332405555,63427.67249195582,63372.58979532167,-135.74244752583036,-175.5569374514066,188.87620073993452,55.703706914398936,1.0752249741490232,-25.617536291691067,63629.07266632058,63117.60692432276,59.19763657487386,59.30778143563978,True,False,63978.238,63078.238,63578.238,63628.238,,False,2024-04-17 00:45:00,2024-04-17 00:47:01,2024-04-16 04:58:36,fail,False,-74.66,6472.569999999994,,0,3,16,4
2024-04-16 05:00:00,63090.934,63135.637,62790.891,63014.84,3125,36422,0,2024-04-16 05:00:00,2024-04-16 05:00:00,3.3808214285527356,-1035.494969161242,63270.7958095238,0.0010728634970340002,0.0006829217682888098,63239.96263095237,62966.138289545845,64081.41423939769,63267.37594270149,63383.3246477224,63313.82794668043,-112.73465809188201,-138.56603591244823,203.38397671627814,-85.74992294459662,-58.6445469556711,36.43744306846202,63588.3963152474,63037.75957811346,35.70717243936597,57.028568167885275,False,True,62514.84,62914.84,62914.84,62864.84,2024-04-16 05:30:00,True,2024-04-16 05:30:00,2024-04-16 07:11:26,2024-04-16 05:33:44,even,True,18.66,6491.229999999994,,1,0,16,4
2024-04-16 10:00:00,63154.039,63222.738,63065.637,63122.461,2606,36422,0,2024-04-16 10:00:00,2024-04-16 10:00:00,81.88185714288556,-911.3565036230721,63025.469869047556,-0.002038589337220819,-0.00024757571348047434,62828.4048452381,60753.94777395771,63701.537366908546,62873.2369286828,62938.54061998637,62761.87762779499,-78.3716967782093,-112.12955806971485,383.74825073173787,94.4196504987558,67.2310866874177,47.517222910209966,63281.437766282834,62243.81748930714,87.99142704900494,78.34540392785266,True,False,63622.461,62722.461,63222.461,63272.461,,False,2024-04-16 10:45:00,2024-04-16 10:33:45,2024-04-16 13:19:05,success,True,93.29,6584.519999999994,,2,0,16,4
2024-04-16 13:00:00,63207.738,63299.039,63045.742,63108.637,1902,36422,0,2024-04-16 13:00:00,2024-04-16 13:00:00,60.23123809519893,-717.9649190780692,63041.03884523808,-0.00035538477481402494,0.0010219358889195956,63179.06209523807,61414.99644537137,64227.67946997073,63193.96069257632,63129.45067697976,63345.68304919164,12.830802769509319,-4.892006869699428,380.1509208058624,-38.590509803914756,-22.081912968642428,-10.405452012426395,63858.886792279554,62830.97930610373,37.63642706441244,50.951460092167444,False,True,62608.637,63508.637,63008.637,62958.637,,False,2024-04-16 13:30:00,2024-04-16 13:19:59,2024-04-17 00:19:26,success,True,93.29,6677.809999999994,,3,0,16,4
2024-04-16 16:30:00,63126.438,63279.34,62293.84,62492.719,5607,36422,0,2024-04-16 16:00:00,2024-04-16 16:00:00,-63.85052380950219,-640.0978687656534,62817.717869047614,-0.0031623543095768807,-0.001210783478652009,63003.312607142856,60149.55883911421,62993.96689213671,62861.24230269994,62895.687641355726,62804.11062297902,-28.598081212803663,-33.35451302011785,407.47914949227624,-35.818502579924825,79.5343178534531,28.654331613310205,63354.20747479359,62252.51377116444,71.60747737543116,75.48587126106989,False,True,61992.719,62892.719,62392.719,62342.719,,False,2024-04-16 18:00:00,2024-04-16 17:37:52,2024-04-16 17:15:05,fail,False,-74.66,6603.149999999994,,0,1,16,4
2024-04-16 17:15:00,62829.813,63061.137,62330.84,62376.738,4405,36422,0,2024-04-16 17:00:00,2024-04-16 17:00:00,-185.59473809524206,-630.5824896701743,62506.14190476186,-0.0008767617102553177,-0.0014680219647328022,62817.717869047614,61071.229472545354,62819.52043710865,62759.40379011999,62837.09728446798,62849.24916133467,-43.24780802104942,-35.09540437882671,393.5131691463967,-31.184246646022075,55.80154489164852,20.521240110028884,63380.49193968231,62316.506382987034,47.161478259129346,56.949996096384034,False,True,61876.738,62276.738,62276.738,62226.738,2024-04-16 18:00:00,True,2024-04-16 18:00:00,2024-04-16 18:01:35,2024-04-16 18:05:07,success,True,93.29,6696.439999999994,,1,0,16,4
2024-04-16 20:00:00,62694.164,62931.738,62469.637,62744.938,4927,36422,0,2024-04-16 20:00:00,2024-04-16 20:00:00,81.7059047619332,-656.3799279898813,62315.818952380905,0.00043165592404678383,-0.00041436540131421594,62282.089154761925,61796.7054972124,63142.75745121996,62306.13388302797,62455.77520902424,62021.69550258003,-96.99632044258033,-105.67234570062122,447.73012244102574,126.25651599594858,110.21895734436112,-38.78835775717016,62627.631167875414,61417.25983728464,54.95127909566207,34.572109593304,True,False,63244.938,62344.938,62844.938,62894.938,,False,2024-04-16 20:30:00,2024-04-16 20:26:56,2024-04-16 20:51:13,success,True,93.29,6789.729999999994,,2,0,16,4
2024-04-17 04:00:00,63965.613,63974.34,63592.605,63699.637,2833,36422,0,2024-04-17 04:00:00,2024-04-17 04:00:00,206.61638095239323,-91.93628389375226,63963.15335714276,0.0033613615097765133,0.0017848523793673222,63862.37177380948,64428.447575308855,65245.3177872748,63692.350974038876,63450.61209653155,63841.37197488819,142.90613372677035,139.52823514068248,465.8639352760374,-59.96362125907763,11.19285861721437,-30.761635362912784,64470.28828751084,63210.955662265544,44.15563262852188,51.44778323957133,False,True,63199.637,64099.637,63599.637,63549.637,,False,2024-04-17 10:15:00,2024-04-17 10:06:13,2024-04-17 05:03:25,fail,False,-74.66,6715.069999999994,,0,1,16,4
2024-04-17 06:00:00,63805.539,63987.938,63751.141,63975.039,1824,36422,0,2024-04-17 06:00:00,2024-04-17 06:00:00,25.96745238103904,5.078600179222121,63916.92838095235,0.0026928973162507084,-0.0001499436797712884,63989.120809523796,64385.63242682879,64215.630879026714,63837.84873369215,63652.40479957431,63909.94193120059,125.31337957653159,133.87780854159578,169.0439459678587,20.00937254908058,-9.08530409366358,13.19407155146473,64139.6512582572,63681.73260414398,46.91639656423379,44.99421473101953,False,True,63475.039,63875.039,63875.039,63825.039,2024-04-17 07:00:00,True,2024-04-17 07:00:00,2024-04-17 10:06:10,2024-04-17 07:33:24,even,True,18.66,6733.729999999994,,1,0,16,4
2024-04-17 07:00:00,63785.797,63849.137,63716.34,63759.738,1709,36422,0,2024-04-17 07:00:00,2024-04-17 07:00:00,-72.19242857144854,31.01097431731614,63906.125273809535,0.001587518557868536,-0.00014996541624838036,63916.92838095235,64026.81137697408,64205.961725970155,63833.67646615968,63701.26937410119,63890.253196078396,103.12632158633642,120.9735391034118,115.3456907086206,-19.035706914306502,-13.81766357075685,-8.341111799090868,64045.969878535034,63733.03651362176,35.32742372219293,45.234621135409036,False,True,63259.738,64159.738,63659.738,63609.738,,False,2024-04-17 10:15:00,2024-04-17 10:06:13,2024-04-17 07:52:32,fail,False,-74.66,6659.069999999994,,0,1,16,4
2024-04-17 16:00:00,62268.238,62411.938,62093.41,62176.938,2579,36422,0,2024-04-17 16:00:00,2024-04-17 16:00:00,-271.22641666664276,-184.18132234614313,62508.200976190456,-0.0037061346850812264,-0.0025194898818895746,62591.978761904815,60860.02526559889,62296.6352156506,62606.87747261707,62947.59401939982,62316.11759545921,-166.83868989915936,-126.88386032054835,442.534800538125,-98.51263295493845,-84.8111764705609,-123.84001479198923,62913.53957618568,61717.195614732744,14.77986459895955,13.226975894455334,True,False,62676.938,61776.938,62276.938,62326.938,,False,2024-04-17 16:45:00,2024-04-17 16:37:31,2024-04-17 17:18:10,success,True,93.29,6752.359999999994,,1,0,16,4
2024-04-17 17:00:00,62588.34,62611.539,61811.84,62065.238,5206,36422,0,2024-04-17 17:00:00,2024-04-17 17:00:00,-83.7777857143592,-213.06862746714614,62048.249214285686,-0.005820794376736821,-0.002519387942272016,62508.200976190456,59244.23854083949,62140.71706953758,62502.525628254836,62803.612900465065,62250.24464568283,-165.3534451652231,-148.22374910058366,451.8342829935163,-66.93200997589156,32.21313828685379,33.6676587547845,62860.220927724076,61638.76836364159,44.634130472615,40.874128885427695,False,True,61565.238,62465.238,61965.238,61915.238,,False,2024-04-17 17:30:00,2024-04-17 17:18:27,2024-04-18 14:15:40,success,True,93.29,6845.649999999994,,2,0,16,4
2024-04-17 19:15:00,60906.574,61061.238,60381.938,60696.539,5838,36422,0,2024-04-17 19:00:00,2024-04-17 19:00:00,-723.8742261903899,-515.5661756270274,60751.39141666661,-0.009575286045716468,-0.005151876076537573,61324.3749880953,56869.6313413469,60699.60492009368,61135.59970568452,61803.774271469556,60543.994968352265,-348.6739290998448,-288.23164250517516,932.819992820816,-114.68962573098543,-69.3806143790498,-236.06253181979991,61803.30195866037,59283.18797804416,29.991627131530475,23.271299034232722,False,True,60196.539,61096.539,60596.539,60546.539,,False,2024-04-17 19:45:00,2024-04-17 19:42:20,2024-04-17 20:55:23,success,True,93.29,6938.939999999994,,3,0,16,4
2024-04-17 21:00:00,61224.539,61737.637,61101.84,61601.047,5041,36422,0,2024-04-17 21:00:00,2024-04-17 21:00:00,-28.757380952345557,-671.4745811014946,60816.02665476186,-0.007092245746171439,-0.0032841237804790793,60722.63403571426,56758.49814068446,61095.30222064037,60941.1588172372,61369.54055096029,60469.493039215624,-296.1456410262035,-332.2525133253528,891.6033658333705,263.27878018571937,138.47804575157352,8.225746474054176,61674.65758309067,59265.828495340575,66.95418704697124,50.496449988422036,True,False,62101.047,61701.047,61701.047,61751.047,2024-04-17 21:45:00,True,2024-04-17 21:45:00,2024-04-18 06:10:17,2024-04-17 21:45:48,even,True,18.66,6957.599999999994,,4,0,16,4
2024-04-18 00:00:00,60786.438,61464.539,60786.438,61392.953,3024,56422,0,2024-04-18 00:00:00,2024-04-18 00:00:00,-15.195535714425205,-703.5675768455985,61071.993821428565,0.00392118695560475,-0.0022919332395609626,60797.25811904754,61751.6262573845,61048.743119451916,61113.12935031278,61247.03286702901,61268.34648262811,-137.56890402261342,-178.22616650119022,481.62904223762297,-9.97189232891833,-63.62676436180482,15.069286549631215,61918.545689648905,60616.64727560732,43.02975699098416,48.30706049569258,True,False,61892.953,60992.953,61492.953,61542.953,,False,2024-04-18 02:00:00,2024-04-18 06:06:06,2024-04-18 00:43:53,fail,False,-74.66,6882.939999999994,,0,1,16,4
2024-04-18 01:00:00,61254.438,61306.738,61108.438,61217.539,2732,56422,0,2024-04-18 01:00:00,2024-04-18 01:00:00,274.7357023810255,-675.7740100332521,61363.36230952382,0.003921057924914026,0.00222532569065893,61071.993821428565,61995.445455571484,63025.54805561066,61163.81587283111,61239.49291935927,61081.55928070178,-99.4704087911814,-137.9006519689315,437.5520745521692,-42.54862435494579,-25.796386308953515,-86.45337289298186,61672.25458134721,60489.363980056354,43.78848998873409,46.06245380313985,True,False,61717.539,61317.539,61317.539,61367.539,2024-04-18 01:45:00,True,2024-04-18 01:45:00,2024-04-18 02:07:45,2024-04-18 02:25:24,success,True,93.29,6976.229999999994,,1,0,16,4
2024-04-18 03:00:00,61233.387,61438.039,61013.473,61080.039,2935,36422,0,2024-04-18 03:00:00,2024-04-18 03:00:00,-10.142857142869616,-593.6222846227392,61350.92702380953,0.0019451554587621132,-0.000608692621471114,61353.21945238095,61363.930699601624,61533.28192245801,61264.432915228026,61279.80305697648,61360.67290161672,-43.36705917492509,-63.40780206471782,260.5012736618137,-54.87182008949458,-18.534332989343966,4.26941795663879,61712.34962106017,61007.49618217327,47.94850761517521,54.52652168872509,False,True,60580.039,61480.039,60980.039,60930.039,,False,2024-04-18 09:45:00,2024-04-19 04:48:22,2024-04-18 03:57:46,fail,False,-74.66,6901.569999999994,,0,1,16,4
2024-04-18 05:00:00,61601.738,61881.738,61524.5,61671.84,3092,36422,0,2024-04-18 05:00:00,2024-04-18 05:00:00,113.05950000000303,-500.39027537764196,61587.0788690476,0.0007554364254259993,0.001512416441272551,61463.98652380953,61163.56967944979,62462.5694162063,61443.90097529995,61370.96452984264,61484.38591228065,8.609063307492761,-19.90950756076046,222.63914114837382,34.940306157535815,50.74123116610281,33.35449948396126,61786.448752830955,61183.82307173035,78.28874787757861,77.3312156214057,True,False,62171.84,61771.84,61771.84,61821.84,2024-04-18 06:15:00,True,2024-04-18 06:15:00,2024-04-18 06:23:51,2024-04-18 07:19:06,success,True,93.29,6994.859999999994,,1,0,16,4
2024-04-18 08:00:00,61592.016,61694.738,61555.219,61557.539,2506,36422,0,2024-04-18 08:00:00,2024-04-18 08:00:00,-44.57560714281135,-357.94432849368604,61484.90049999999,0.0001155821285054034,0.0016079083027642777,61696.82767857145,60949.306804884014,62781.63912254011,61715.50442897463,61611.02035846095,61840.36967836257,54.78900055328995,51.87932595235116,279.2297256591112,-67.82300687996758,-58.97683212932316,-24.70021809424361,62217.329808002374,61461.90954872277,32.698731668804385,49.88474902637791,False,True,61057.539,61457.539,61457.539,61407.539,2024-04-18 08:45:00,True,2024-04-18 08:45:00,2024-04-18 08:59:03,2024-04-18 11:42:08,success,True,93.29,7088.149999999994,,2,0,16,4
2024-04-18 12:00:00,61295.438,61663.539,61269.324,61486.938,3257,36422,0,2024-04-18 12:00:00,2024-04-18 12:00:00,-41.96679761901032,-355.2051674917893,61273.9646547619,-0.0018651919949319682,-0.0013802947341679487,61189.271095238124,59957.33971725584,61320.93274227642,61249.580467004766,61313.01416234599,61125.303430684566,-36.8436923546833,-39.056042527489545,375.393257264522,91.75303233576415,67.61165669075126,63.2537918816015,61633.58432799167,60618.52253337746,64.63307336951934,50.015696152120825,True,False,61986.938,61586.938,61586.938,61636.938,2024-04-18 14:00:00,True,2024-04-18 14:00:00,2024-04-18 14:03:26,2024-04-18 15:33:45,success,True,93.29,7181.439999999994,,3,0,16,4
2024-04-18 13:00:00,61590.137,61654.438,61462.813,61488.91,2814,36422,0,2024-04-18 13:00:00,2024-04-18 13:00:00,84.69355952377373,-312.0223506078182,61422.717999999986,0.00013153733892289687,-0.0006690982114286569,61273.9646547619,60812.07208956678,61718.43487172228,61359.49739733961,61354.79059881795,61432.33196869626,-11.205316826686612,-27.436366955366093,295.8024905741958,63.80774819401995,114.35048882011324,57.35866391464515,61833.165330971424,61032.99860642109,79.425484882708,77.02657736339887,True,False,61988.91,61588.91,61588.91,61638.91,2024-04-18 14:00:00,True,2024-04-18 14:00:00,2024-04-18 14:03:26,2024-04-18 15:33:45,success,True,93.29,7274.729999999994,,4,0,16,4
2024-04-18 14:00:00,61770.066,62425.738,61770.066,62356.637,4070,36422,0,2024-04-18 14:00:00,2024-04-18 14:00:00,148.7533452380885,-260.1630342388089,61864.46640476193,0.0005713476361940837,0.002287948640315011,61422.717999999986,61049.37130924985,63618.15799327698,61611.02900215151,61485.03223096311,61781.536069487454,38.772692978192936,-1.427930620812921,323.38906353802815,157.751493636104,81.2066738905778,53.78774613003043,62219.611305263796,61344.96083371111,89.21273336310334,87.4531611205174,True,False,62856.637,61956.637,62456.637,62506.637,,False,2024-04-18 14:30:00,2024-04-18 14:25:18,2024-04-18 15:30:22,success,True,93.29,7368.019999999994,,5,0,16,4
2024-04-18 20:00:00,63481.738,63576.969,63269.742,63458.137,2903,36422,0,2024-04-18 20:00:00,2024-04-18 20:00:00,193.8535714285972,305.40994641739235,63319.1549404762,0.0032692851336094376,0.0046567165474052374,63461.60508333335,63384.92816311966,66054.08722351305,63396.1646774448,62986.79536065068,63831.36208909525,248.96111054189532,247.87667990468728,625.6727335220852,-32.111946336503024,-19.05762951491488,31.971494668025116,64676.020279350065,62985.20389884044,71.25763081993694,74.80782092878593,False,True,62958.137,63358.137,63358.137,63308.137,2024-04-18 20:45:00,True,2024-04-18 20:45:00,2024-04-18 20:52:18,2024-04-18 22:04:20,success,True,93.29,7461.309999999994,,6,0,16,4
2024-04-18 21:00:00,62736.938,62854.137,62250.672,62342.797,3615,36422,0,2024-04-18 21:00:00,2024-04-18 21:00:00,-142.45014285715297,298.8107300342672,63240.65807142854,0.0019196527180413627,0.0025536125930526697,63319.1549404762,62735.70544356799,65245.26865351056,63115.28265286471,62952.67436941481,63130.71863433095,158.22665071989468,216.73219083086968,616.9140380725898,-288.95090368071396,-205.78741864470794,-129.13242518061452,63963.55258572895,62296.384682932956,8.792247303047558,25.385638225230462,False,True,61842.797,62742.797,62242.797,62192.797,,False,2024-04-19 04:15:00,2024-04-19 04:23:25,2024-04-18 21:21:11,fail,False,-74.66,7386.649999999994,,0,1,16,4
2024-04-19 00:00:00,63432.539,63608.039,63358.586,63559.84,2094,56422,0,2024-04-19 00:00:00,2024-04-19 00:00:00,-21.609428571449826,381.9665590741715,63270.11260714291,-0.0003583342118886883,-0.0007900382582958364,63297.68180952381,62093.50251701904,63573.13096169341,63333.09213486335,63172.80459757621,63368.97103508772,116.90046185829124,123.75785616063993,323.3148840951982,93.8982917096946,87.45789852079906,53.48463501895458,63806.94612861624,62932.4959415592,92.93628655942466,90.47803282022663,True,False,64059.84,63159.84,63659.84,63709.84,,False,2024-04-19 10:00:00,2024-04-19 09:48:18,2024-04-19 01:18:42,fail,False,-74.66,7311.989999999994,,0,2,16,4
2024-04-19 03:00:00,63426.738,63431.34,62862.188,62869.352,2224,36422,0,2024-04-19 03:00:00,2024-04-19 03:00:00,61.91053571431257,409.1274136710199,63244.384964285746,0.0009224781841595597,0.0006449932778116033,63427.99995238099,62830.153910598536,64069.1282299025,63337.20849226078,63289.65070314979,63340.62737667701,61.163640458427835,87.3373717860929,277.2091969927492,-120.67105194356554,-16.92007258342346,-27.503185758519976,63714.85979261722,62964.8949607368,30.51955516588046,43.81902640239977,False,True,62369.352,62769.352,62769.352,62719.352,2024-04-19 04:00:00,True,2024-04-19 04:00:00,2024-04-19 04:10:28,2024-04-19 09:38:16,success,True,93.29,7405.279999999994,,1,0,16,4
2024-04-19 04:00:00,62676.039,62741.738,62071.137,62083.34,3828,36422,0,2024-04-19 04:00:00,2024-04-19 04:00:00,-183.61498809524346,345.8170434940839,62438.25847619046,-0.003930516710234889,-0.002995148776346777,63244.384964285746,59614.47511483445,62479.73084059441,62980.967991708625,63117.434153288676,62840.21514585483,-18.028472947473347,43.60340862743156,336.5789457088114,-218.60700722389447,-122.18152253187145,-72.9493464051775,63294.59672256173,62384.33356914794,7.107257468489613,7.867187159662465,False,True,61583.34,62483.34,61983.34,61933.34,,False,2024-04-19 04:45:00,2024-04-19 04:35:24,2024-04-19 07:35:28,success,True,93.29,7498.569999999994,,2,0,16,4
2024-04-19 07:00:00,61731.961,62449.238,61718.289,62212.438,4126,36422,0,2024-04-19 07:00:00,2024-04-19 07:00:00,-248.0920952380693,-28.77798877231544,61715.18658333333,-0.012055820788726617,-0.0029062791630795203,61645.37027380958,55372.03368133318,61970.75744601071,61716.28053311587,62073.40851521331,61102.54439628478,-210.61499639937392,-217.6620026645154,1139.616812011759,205.86543859645462,93.41074681800092,92.32609700727335,62642.527092500655,59564.0617000689,66.38058614372922,63.089507026660925,True,False,62712.438,62312.438,62312.438,62362.438,2024-04-19 07:45:00,True,2024-04-19 07:45:00,2024-04-19 09:38:15,2024-04-19 07:49:51,even,True,18.66,7517.229999999994,,3,0,16,4
2024-04-19 09:00:00,62011.727,62030.137,61778.996,61870.637,2972,36422,0,2024-04-19 09:00:00,2024-04-19 09:00:00,5.911785714299185,-52.89947921233397,62667.82005952378,0.001141606409351751,0.002930800945588491,61721.09836904763,60096.03759198508,65721.97821355838,61974.57424126498,62082.11645621684,62407.40162125908,-104.61115301209065,-138.9875886251003,815.4499941055826,-0.04845166835730197,124.72505572757655,142.27295872030663,63508.25911330162,61305.04412921654,76.14559115736851,77.95722198892598,True,False,62370.637,61470.637,61970.637,62020.637,,False,2024-04-19 09:45:00,2024-04-19 09:36:35,,success,True,93.29,7610.519999999994,,4,0,16,4
2024-04-19 15:00:00,64812.984,65088.738,64708.039,65004.84,3773,36422,0,2024-04-19 15:00:00,2024-04-19 15:00:00,111.09414285720413,593.1421110905358,65017.790488095285,0.007721567419124361,0.0032054872459737114,64967.08200000007,66778.32944563453,67074.91190128335,64733.69013729689,64251.48900932658,64893.072039903716,294.56745363318623,293.3741923424679,796.6512483932377,41.504658754813136,12.148182318538602,104.47303852766345,65970.0512252346,63817.592854572846,69.78236873211803,69.98568268563058,False,True,64504.84,65404.84,64904.84,64854.84,,False,2024-04-19 16:15:00,2024-04-19 16:13:48,2024-04-22 04:21:28,success,True,93.29,7703.809999999994,,5,0,16,4
2024-04-19 16:00:00,64901.48,65024.539,64467.434,64663.539,3916,36422,0,2024-04-19 16:00:00,2024-04-19 16:00:00,50.708488095217035,635.8453673499826,64848.79424999998,0.005907899570341447,0.0010233617627111815,65017.790488095285,65955.45739567974,65824.73829980764,64840.53071300598,64443.428977143645,65005.65412211896,267.31885919750493,287.6176034880036,266.91868042492786,-56.482385965013236,11.088517027863418,68.71069659448403,65365.99434069262,64643.813903545306,52.23778970964389,65.90593575265824,False,True,64163.539,65063.539,64563.539,64513.539,,False,2024-04-19 17:30:00,2024-04-19 17:25:47,2024-04-22 00:07:01,success,True,93.29,7797.099999999994,,6,0,16,4
2024-04-19 17:00:00,64852.637,64910.738,64475.813,64516.137,3614,36422,0,2024-04-19 17:00:00,2024-04-19 17:00:00,-168.9962380953075,657.841076757235,64728.14570238098,-0.000717189901801672,0.0004053882805326223,64848.79424999998,63609.795394758265,65604.32159760215,64773.95132422256,64514.00777572436,64857.397837633274,209.8094606330851,252.780176192788,230.59042283757896,-78.5754943240172,-15.190021671856812,-9.101656346792879,65168.69490846401,64544.60076680254,34.90508027610222,36.41851066281403,False,True,64016.137,64916.137,64416.137,64366.137,,False,2024-04-19 17:30:00,2024-04-19 17:26:41,2024-04-22 00:06:00,success,True,93.29,7890.389999999994,,7,0,16,4
2024-04-22 05:00:00,64616.637,64816.637,64461.84,64696.84,3471,36422,0,2024-04-22 05:00:00,2024-04-22 05:00:00,30.192309523787117,420.72365593478025,64832.38073809519,0.002177311946854711,0.0019499848936472162,64818.31754761904,65036.722202655736,66285.45398616948,64790.73762341167,64717.508972537355,64801.42655452357,59.37308986125572,74.03031108192764,354.22548022112755,-48.47637667703384,-50.05851874776272,-27.124807705564308,65279.63095282209,64321.72215622505,14.74519860526514,23.53281505347891,False,True,64196.84,65096.84,64596.84,64546.84,,False,,,2024-04-22 06:15:44,fail,False,-74.66,7815.729999999994,,0,1,17,4
2024-04-22 06:00:00,64753.887,65069.738,64701.84,65046.738,2638,36422,0,2024-04-22 06:00:00,2024-04-22 06:00:00,14.063190476153977,407.9114762076206,65128.479964285725,0.00217726767568822,0.00230544606082516,64832.38073809519,65178.97712665888,66656.06497444287,64806.458736751876,64742.04395841759,64753.19104781561,51.15756247306854,59.60785990961905,133.87316440168803,51.32983969736233,-15.639641554880654,-28.391414516758232,64935.419819757895,64572.46227587333,31.418993974235818,24.449195330536153,True,False,65546.738,65146.738,65146.738,65196.738,2024-04-22 06:30:00,True,2024-04-22 06:30:00,2024-04-22 06:41:14,,success,True,93.29,7909.019999999994,,1,0,17,4
2024-04-22 06:15:00,65047.34,65265.738,64946.504,65246.738,2487,36422,0,2024-04-22 06:00:00,2024-04-22 06:00:00,14.063190476153977,407.9114762076206,65128.479964285725,0.00217726767568822,0.00230544606082516,64832.38073809519,65178.97712665888,66656.06497444287,64874.194008020815,64779.42870223851,64837.32238114897,61.21740545861394,59.92976901941803,154.86151505208733,84.13133333336009,51.32983969736233,-15.639641554880654,65047.88542646929,64628.259335828654,47.39478838049465,33.540382341894535,True,False,65746.738,65346.738,65346.738,65396.738,2024-04-22 06:45:00,True,2024-04-22 06:45:00,2024-04-22 06:45:25,,success,True,93.29,8002.309999999994,,2,0,17,4
2024-04-22 12:00:00,65917.641,66017.336,65872.031,65923.773,1996,36421,0,2024-04-22 12:00:00,2024-04-22 12:00:00,42.552809523782344,634.2559563030809,66097.52570238095,0.00283340867128838,0.001364249750570104,66159.8648690476,66520.24091801366,67108.82684716256,65971.10401988018,65779.11260399384,66033.21804850356,142.10270805032633,162.8605100332635,310.33738937043336,-51.89199140014534,-47.75820433438639,-33.53283316123998,66452.17352415365,65612.76257285348,22.885693539109997,36.17188516491265,False,True,65423.773,66323.773,65823.773,65773.773,,False,2024-04-22 18:15:00,,2024-04-22 17:29:24,fail,False,-74.66,7927.649999999994,,0,1,17,4
2024-04-22 13:00:00,65895.336,66030.641,65833.813,65958.336,2107,36421,0,2024-04-22 13:00:00,2024-04-22 13:00:00,-62.339166666642996,621.9560130297032,66015.5226666667,0.0024790508375309214,0.00045070777242982025,66097.52570238095,66506.15059757243,66643.62594911321,65939.4380802866,65812.04396407334,65867.74547127621,110.7708660828066,136.94977066938475,200.08323842790537,-11.056323357421206,-39.854822153414716,-59.34546095630503,66137.85784315388,65596.13309939855,21.99460018196036,16.119495000463008,False,True,65458.335999999996,65858.336,65858.336,65808.336,2024-04-22 14:45:00,True,2024-04-22 14:45:00,,2024-04-22 14:52:48,even,True,18.66,7946.309999999994,,1,0,17,4
2024-04-22 14:00:00,66004.539,66067.398,65799.086,65884.234,2020,36421,0,2024-04-22 14:00:00,2024-04-22 14:00:00,-82.0030357142532,613.9615046186009,65931.8267738095,0.00043352733592109374,-0.0005313285369877591,66015.5226666667,65763.91807680164,66145.50148686396,65945.50101934373,65849.79481148452,65904.11244719633,90.08317344641546,113.41963522767917,136.14615626005556,0.8268558651325293,18.926368076950894,3.6356845545378746,66089.4097581474,65720.31513624525,49.43475140385572,45.66846290432869,False,True,65384.234,66284.234,65784.234,65734.234,,False,2024-04-22 18:15:00,,2024-04-22 17:29:19,fail,False,-74.66,7871.649999999994,,0,1,17,4
2024-04-22 16:00:00,65953.234,66220.938,65953.234,66081.734,2537,36421,0,2024-04-22 16:00:00,2024-04-22 16:00:00,-50.964047619039775,569.1129013792233,65942.17453571428,-0.0008633100805301293,-0.0005288522366934635,65880.86272619046,65295.46488313845,66076.82006594753,65920.09884825425,65870.72063574412,65907.09320227038,53.1673268606246,67.04650880518396,81.7817019216421,42.41898383217631,24.37768627447076,-3.7179772962117568,66018.9984998646,65796.68790467616,66.8177802524031,57.85076516888633,True,False,66581.734,65681.734,66181.734,66231.734,,False,2024-04-22 17:30:00,2024-04-22 20:28:00,2024-04-22 16:35:10,fail,False,-74.66,7796.989999999994,,0,2,17,4
2024-04-22 22:45:00,66317.219,66565.539,66300.711,66470.141,1968,36421,0,2024-04-22 22:00:00,2024-04-22 22:00:00,70.40939285712375,496.6977815301507,66348.60577380954,0.0016241070158444235,0.0018531870458559146,66253.4106071429,66469.04599403079,67560.60794968097,66335.54116672813,66234.26978683451,66467.51979291369,65.48898523200478,67.17829050255796,256.6358765836901,-4.803850361116929,-29.144226694232202,-18.171018919849303,66813.97822630167,66119.56135952572,51.15926330229402,48.06086979350629,True,False,66970.141,66570.141,66570.141,66620.141,2024-04-23 01:15:00,True,2024-04-23 01:15:00,2024-04-23 01:53:25,2024-04-23 01:20:51,even,True,18.66,7815.649999999994,,1,0,17,4
2024-04-23 01:45:00,66630.641,67165.867,66607.094,66981.734,3119,36421,0,2024-04-23 01:00:00,2024-04-23 01:00:00,57.30651190473873,481.3166272683011,66670.01576190483,0.0016984468380252117,0.0010891396795837864,66475.04617857137,66849.48918226767,67466.89674308775,66584.75567706543,66445.53378948175,66672.38051702786,78.91864426067332,68.28592654843052,185.10365474228408,97.58723495012964,41.04564258675964,42.466635019052774,66923.77045092995,66422.49058312578,83.67218297691942,85.46997553358305,True,False,67481.734,67081.734,67081.734,67131.734,2024-04-23 02:15:00,True,2024-04-23 02:15:00,,2024-04-23 02:15:23,even,True,18.66,7834.309999999994,,2,0,17,4
2024-04-23 04:00:00,66970.672,67140.641,66903.234,67099.211,2473,36421,0,2024-04-23 04:00:00,2024-04-23 04:00:00,101.30034523803624,518.1659738438611,66848.73490476188,0.0014857836857521064,0.0017261004376534863,66827.34007142848,67075.69947795058,67995.77737789601,66828.0927554294,66667.90019477211,66982.26146714829,94.64725327874476,88.15826380544863,257.9536234770986,51.777732370159356,44.846736842082464,24.507555555566796,67331.99885884237,66634.0240754542,74.28321249141231,62.46670480320636,True,False,67599.211,66699.211,67199.211,67249.211,,False,,,2024-04-23 05:49:22,fail,False,-74.66,7759.649999999994,,0,1,17,4
2024-04-23 05:00:00,66726.141,66867.898,66726.141,66832.938,1866,36421,0,2024-04-23 05:00:00,2024-04-23 05:00:00,21.3948333333974,500.2773236277717,66772.60944047623,0.0009123129194733057,0.0006046018970091399,66848.73490476188,66748.67251566112,67496.03092753982,66830.92216015693,66713.05032090271,66913.04499656004,80.75109627739585,87.0571639264005,223.7660623821196,-28.459582731331466,-43.202327829407295,-8.472836257322342,67215.1291807759,66609.46081234419,38.522368454429206,51.04833339167277,False,True,66332.938,66732.938,66732.938,66682.938,2024-04-23 06:00:00,True,2024-04-23 06:00:00,2024-04-23 07:29:57,2024-04-23 17:13:15,success,True,93.29,7852.939999999994,,1,0,17,4
2024-04-23 06:00:00,66564.539,66705.539,66529.93,66683.438,1852,36421,0,2024-04-23 06:00:00,2024-04-23 06:00:00,-76.1254642856511,467.85338031171705,66649.48229761906,0.00023985530339150596,-0.00011736826817321854,66772.60944047623,66432.6236992237,67128.92316663715,66760.44526805286,66707.28049954862,66726.0550082559,54.02821461384883,72.80285492503651,203.84324344122237,-48.19738630890788,-70.78985311316501,-27.545751290002954,67001.24338690155,66449.36662961026,19.34566930096723,21.377895178939557,False,True,66183.438,66583.438,66583.438,66533.438,2024-04-23 06:45:00,True,2024-04-23 06:45:00,2024-04-23 07:51:21,2024-04-23 09:28:03,success,True,93.29,7946.229999999994,,2,0,17,4
2024-04-23 12:00:00,66159.68,66257.641,66138.086,66231.938,1736,36421,0,2024-04-23 12:00:00,2024-04-23 12:00:00,-27.334904761926737,217.7517817230837,66108.59275,-0.0007746813970076593,-0.0011002397590897466,66169.15895238097,65657.62751363961,66090.93578397647,66204.38473295639,66320.44084830904,66123.99806570346,-59.13989274635969,-49.98045139546372,193.34399082863504,-0.6868716890458018,-21.638132438922185,-19.32685827316891,66385.01245332212,65861.4836780848,35.728638886762845,27.73207796418661,True,False,66731.938,65831.938,66331.938,66381.938,,False,2024-04-23 17:00:00,2024-04-23 17:13:15,2024-04-23 14:37:19,fail,False,-74.66,7871.569999999994,,0,1,17,4
2024-04-23 16:00:00,66091.969,66142.742,65999.602,66056.539,2371,36421,0,2024-04-23 16:00:00,2024-04-23 16:00:00,-22.282666666724253,100.81576488807332,66182.85270238096,-0.0006623054990753493,-0.00019819543236375504,66045.97152380948,65521.44713553789,66462.88978395773,66037.03213253134,66119.90340688046,65981.1730426556,-54.90693880984327,-57.91885734700984,109.43771392094169,0.12167251456412487,6.862995528063038,-54.124817681498826,66130.41395644887,65833.43212886233,45.62733671707756,39.48448160651143,True,False,66556.539,66156.539,66156.539,66206.539,2024-04-23 16:45:00,True,2024-04-23 16:45:00,2024-04-23 17:05:41,2024-04-23 23:07:24,success,True,93.29,7964.859999999994,,1,0,17,4
2024-04-23 22:00:00,66732.656,66735.234,66624.148,66635.039,1573,36421,0,2024-04-23 22:00:00,2024-04-23 22:00:00,69.95261904763174,184.2681144428061,66652.54505952375,0.0012799494667660046,-0.0004365465788740391,66743.05578571426,66683.93243108853,66811.54376067634,66650.73475010597,66557.13639447528,66677.09425421391,54.70734786448884,53.50488447565093,198.7921805677053,-6.2474169247288955,21.170567595487228,6.891056071472121,66945.46369798032,66407.2248104475,67.15342109136931,67.820627121401,False,True,66135.039,66535.039,66535.039,66485.039,2024-04-23 22:45:00,True,2024-04-23 22:45:00,2024-04-23 23:15:54,2024-04-24 03:05:39,success,True,93.29,8058.149999999994,,2,0,17,4
2024-04-23 23:00:00,66432.141,66438.734,66147.18,66186.539,2543,36421,0,2024-04-23 23:00:00,2024-04-23 23:00:00,-90.51072619050683,165.47207543824334,66503.00516666665,-0.00019687024099868138,-0.0010077805436352753,66652.54505952375,65843.65229908933,66398.170635055,66518.59156102032,66513.36041567344,66522.32699243202,22.143089050849085,42.4377359596008,145.71617527399607,-97.40192328866397,-29.012739250043523,-26.289337461290415,66719.04382905191,66324.11015581213,13.313403045304078,26.127980151680294,False,True,65686.539,66586.539,66086.539,66036.539,,False,2024-04-24 16:30:00,2024-04-24 17:22:23,2024-04-24 03:06:06,fail,False,-74.66,7983.489999999994,,0,1,17,4
2024-04-24 03:00:00,66367.852,66611.039,66333.609,66546.836,1913,36421,0,2024-04-24 03:00:00,2024-04-24 03:00:00,-53.40691666668863,86.61709203162172,66415.02527380952,-0.00014827019685335029,-0.0003494629864509203,66308.6033095238,65817.02406258501,66609.04106521081,66366.06499295257,66385.56008442797,66376.11951702791,-11.9723466483847,-14.865084837877001,175.95003793680578,59.02149019614444,29.009245613997336,33.50834743723681,66615.15206824259,66138.58696581323,89.14805966659355,81.29519875711317,True,False,67046.836,66646.836,66646.836,66696.836,2024-04-24 04:00:00,True,2024-04-24 04:00:00,,2024-04-24 04:13:38,even,True,18.66,8002.149999999994,,1,0,17,4
2024-04-24 04:00:00,66703.539,66800.836,66622.539,66657.938,1911,36421,0,2024-04-24 04:00:00,2024-04-24 04:00:00,106.4219642857206,104.02789510971343,66515.96103571428,0.0008120773703852765,9.05011139156642e-05,66415.02527380952,66385.27705510563,66875.74797787156,66496.45908132834,66449.57748477756,66556.00610732709,13.850124174568919,-2.957949595258915,160.2472602675472,40.34611042305187,47.62890333677933,54.42537839694705,66773.83990868829,66339.6723059659,92.76879701592641,89.55947588864471,True,False,67157.938,66757.938,66757.938,66807.938,2024-04-24 04:45:00,True,2024-04-24 04:45:00,,2024-04-24 04:48:54,even,True,18.66,8020.809999999994,,2,0,17,4
2024-04-24 07:45:00,66729.539,67030.938,66719.734,66957.852,2356,36421,0,2024-04-24 07:00:00,2024-04-24 07:00:00,38.10648809521808,104.75351727640373,66732.04764285714,0.0014448799435360644,0.0014430845709039032,66592.1983095238,66931.0329239753,67541.27246869617,66674.72134373123,66599.17959943456,66672.1406332989,37.35711099758919,27.59630373503921,175.4638518027258,44.77094908840081,13.182883384914021,-8.138062951460597,66910.51683323258,66435.26443336521,74.6068536565305,63.3600842360893,True,False,67457.852,66557.852,67057.852,67107.852,,False,,,2024-04-24 09:06:18,fail,False,-74.66,7946.149999999994,,0,1,17,4
2024-04-24 09:00:00,66688.641,66694.141,66540.547,66595.938,1750,36421,0,2024-04-24 09:00:00,2024-04-24 09:00:00,11.27036904761917,133.244331448077,66747.83153571431,0.0009592561986016052,0.0008965072036034702,66743.31801190476,66763.65981340366,67399.0443965613,66685.1964473536,66632.50609622699,66733.03867836259,33.075273654365446,34.36027800494252,115.6317275080613,-0.44724011003563646,8.107390780816786,0.10251909190264996,66889.14151049848,66575.4358462267,38.40027285311722,47.57451222844841,False,True,66095.938,66495.938,66495.938,66445.938,2024-04-24 12:15:00,True,2024-04-24 12:15:00,2024-04-24 16:01:42,2024-04-24 14:26:13,even,True,18.66,7964.809999999994,,1,0,17,4
2024-04-24 10:00:00,66723.414,66784.508,66632.383,66781.734,1222,36421,0,2024-04-24 10:00:00,2024-04-24 10:00:00,4.51352380955359,134.71493258079863,66682.1342738095,0.00042076510183931197,0.0005715878179524216,66747.83153571431,66644.29554052361,67303.90620087917,66700.98584250215,66653.38714068479,66750.44570485034,30.756856510372018,31.61670967687548,109.28576178993995,14.405207086296286,0.7005101479735458,12.746342621278018,66899.48148326676,66602.90992643392,45.94236849660407,37.11703489070353,True,False,67281.734,66381.734,66881.734,66931.734,,False,,,2024-04-24 12:03:06,fail,False,-74.66,7890.149999999994,,0,1,17,4
2024-04-24 11:00:00,66567.742,66641.336,66536.617,66577.438,1059,36421,0,2024-04-24 11:00:00,2024-04-24 11:00:00,-65.69726190481742,121.64000261263573,66624.66773809522,9.249785861221429e-05,1.4414388153116827e-05,66682.1342738095,66456.01008722506,67038.10221393462,66660.86301691378,66645.84137126792,66659.0601293429,18.281501114935963,26.848510991342557,109.78923189194936,-30.41942002075666,-34.49341589258984,-24.322983488222235,66807.27559239704,66509.34466628877,16.027862744321155,28.31145981422687,False,True,66077.438,66477.438,66477.438,66427.438,2024-04-24 12:15:00,True,2024-04-24 12:15:00,2024-04-24 16:01:52,2024-04-24 14:25:58,even,True,18.66,7908.809999999994,,1,0,17,4
2024-04-24 14:00:00,66374.563,66439.539,66331.836,66374.734,1636,36421,0,2024-04-24 14:00:00,2024-04-24 14:00:00,-91.80549999998766,54.82016481315077,66406.19363095239,-0.000959230016127458,-0.00109727315239994,66426.63378571432,65829.7331025792,66292.00316278647,66397.4876172494,66480.56733521346,66263.40721362224,-35.13145615925896,-22.10879336742358,182.46170045208714,-4.267634331001318,-19.711667698604288,-35.96045751632482,66509.73050923256,66015.58391801192,32.37469391740222,25.453297797110782,True,False,66874.734,66474.734,66474.734,66524.734,2024-04-24 14:30:00,True,2024-04-24 14:30:00,,2024-04-24 14:39:06,even,True,18.66,7927.469999999994,,2,0,17,4
2024-04-24 15:00:00,66519.82,66692.336,66462.414,66546.641,2526,36421,0,2024-04-24 15:00:00,2024-04-24 15:00:00,-20.440154761934537,51.959633594655315,66366.00282142856,-0.0008970452073031257,-0.0007227751313725591,66406.19363095239,65795.7147716521,66494.61688770821,66463.96335450959,66494.55723452606,66406.90900378393,-19.60080747725442,-23.238118347500972,156.33803505787006,33.656447540357476,41.70374647404242,35.018734090117505,66619.46535111206,66195.85265645581,68.76980859022335,65.04016221941345,True,False,67046.641,66146.641,66646.641,66696.641,,False,,,2024-04-24 16:01:19,fail,False,-74.66,7852.809999999994,,0,1,17,4
2024-04-24 19:15:00,64670.738,64739.438,64297.344,64387.539,4116,36422,0,2024-04-24 19:00:00,2024-04-24 19:00:00,-501.69610714282317,-230.21250299854728,65033.40930952382,-0.004672157736624149,-0.003988897533600095,65367.80377380953,62878.04312280092,64576.19891966967,65041.69560959318,65552.5346848748,64463.52267870655,-244.29150025242416,-177.20962603094887,775.3080505468427,-153.59254936363868,-132.68333436531248,-177.95807602345303,65510.18854694479,63415.35681046831,6.243685057935159,5.229384357975461,False,True,63887.539,64787.539,64287.539,64237.539,,False,2024-04-24 22:00:00,2024-04-24 22:01:22,2024-04-24 19:54:20,fail,False,-74.66,7778.149999999994,,0,2,17,4
2024-04-25 00:00:00,64046.379,64171.738,63931.637,64088.438,1787,56422,0,2024-04-25 00:00:00,2024-04-25 00:00:00,-111.63267857147002,-591.8772594862021,64118.567059523826,-0.0025159080245179353,-0.0038603679188028662,64042.937738095236,62744.816925534324,63393.22605345315,64207.01432452176,64577.15128706556,63917.76503061576,-235.30274050403386,-237.56663755069897,355.11364274773047,-39.771991744069965,-80.09878981777001,-44.00616477456788,64397.168448325196,63436.86161290632,36.82591323998233,30.493747005493166,True,False,64588.438,64188.438,64188.438,64238.438,2024-04-25 00:45:00,True,2024-04-25 00:45:00,2024-04-25 03:31:51,2024-04-25 01:16:44,even,True,18.66,7796.809999999994,,1,0,17,4
2024-04-25 01:00:00,64333.84,64352.09,64242.566,64279.84,1361,56422,0,2024-04-25 01:00:00,2024-04-25 01:00:00,75.62932142859063,-601.2392420257747,64079.77621428569,-0.0025158319348064675,-0.0022890751019991854,64118.567059523826,62587.26705730759,63754.42130274918,64245.399030402405,64499.419347020616,64061.52385070514,-190.2264381155619,-217.80319207805388,335.30804436605507,52.68372480212565,54.9294313725768,35.79921293428197,64515.68971059931,63608.85799081097,66.56305966238119,58.74464580010686,True,False,64779.84,63879.84,64379.84,64429.84,,False,2024-04-25 03:30:00,2024-04-25 20:07:19,2024-04-25 02:01:33,fail,False,-74.66,7722.149999999994,,0,1,17,4
2024-04-25 02:00:00,64041.645,64168.34,63774.738,64153.637,3345,36422,0,2024-04-25 02:00:00,2024-04-25 02:00:00,-38.79084523813799,-625.0248609154514,64082.84303571428,-0.0020489294251041052,-0.002049393815458697,64079.77621428569,62636.530621560756,63762.50390211598,64198.03924484863,64407.38210021794,64183.328507051934,-164.44741064248228,-190.39957080347352,325.4090710960253,30.94534158926399,9.878899896837538,35.8097282421586,64624.13075303157,63744.0262610723,66.12758131297313,69.12159299665511,True,False,64653.637,64253.637,64253.637,64303.637,2024-04-25 03:15:00,True,2024-04-25 03:15:00,2024-04-25 03:42:58,2024-04-25 04:41:30,success,True,93.29,7815.439999999994,,1,0,17,4
2024-04-25 03:00:00,64229.293,64364.137,64173.438,64344.539,2390,36422,0,2024-04-25 03:00:00,2024-04-25 03:00:00,3.066821428590629,-621.5509855621713,64220.887785714316,-9.740917884047424e-05,-0.0008749926515389574,64082.84303571428,63499.65385751952,64464.36739502628,64215.95221511253,64358.99073974652,64268.4387217062,-130.40965647431585,-162.6409352989188,206.8515229842537,51.557276573817944,34.62223976611858,29.105560715470347,64549.188277734946,63989.18916567746,83.04578350392494,74.85627100865945,True,False,64844.539,64444.539,64444.539,64494.539,2024-04-25 03:45:00,True,2024-04-25 03:45:00,2024-04-25 21:21:25,2024-04-25 04:09:03,even,True,18.66,7834.099999999994,,2,0,17,4
2024-04-25 05:00:00,64005.094,64197.137,63805.039,64186.367,2897,36422,0,2024-04-25 05:00:00,2024-04-25 05:00:00,2.3513333333685296,-598.1323989680168,64249.99580952377,0.0006702209291324859,0.0007732025200680182,64223.239119047685,63979.66573523969,64999.75350811645,64287.3916960242,64352.20159037914,64335.224214998285,-72.13422641169018,-91.72008556652443,190.77868218535906,-18.829231510208047,-60.73284485718614,-16.310952872314374,64592.77543594852,64076.17299404805,42.36825468552113,54.28666363000673,False,True,63686.367,64086.367,64086.367,64036.367,2024-04-25 10:45:00,True,2024-04-25 10:45:00,2024-04-25 11:37:20,2024-04-25 11:17:34,even,True,18.66,7852.759999999994,,3,0,17,4
2024-04-25 10:00:00,64242.238,64303.039,64181.84,64303.039,1330,36422,0,2024-04-25 10:00:00,2024-04-25 10:00:00,-16.93532142855838,-486.0751550159039,64130.1933690476,-7.077329388108645e-05,-0.0007938348300973743,64222.05905952382,63764.12538890275,64129.20758668394,64228.81656618917,64248.44988507456,64222.0316388029,-27.0332270670624,-37.48075442745626,109.60819928643811,14.179316821486282,12.125755761939217,-11.063309253506304,64371.502707839594,64074.06056976621,59.820553401099,56.29534869990019,True,False,64803.039,63903.039,64403.039,64453.039,,False,2024-04-25 20:15:00,2024-04-25 20:07:20,2024-04-25 10:41:41,fail,False,-74.66,7778.099999999994,,0,1,17,4
2024-04-25 10:30:00,64197.285,64221.137,63841.938,63872.914,2106,36422,0,2024-04-25 10:00:00,2024-04-25 10:00:00,-16.93532142855838,-486.0751550159039,64130.1933690476,-7.077329388108645e-05,-0.0007938348300973743,64222.05905952382,63764.12538890275,64129.20758668394,64170.290227863254,64217.29840078409,64149.456380116884,-34.649103721523716,-35.10761675842773,110.86284703266733,-73.14699552804814,0.5717368420300772,14.179316821486282,64299.121223610986,63998.29153662278,47.82094066479834,57.641307419402175,False,True,63372.914,64272.914,63772.914,63722.914,,False,2024-04-25 13:30:00,2024-04-25 13:24:48,2024-04-25 19:47:26,success,True,93.29,7871.389999999994,,1,0,17,4
2024-04-25 13:15:00,63767.039,63820.938,63299.789,63407.738,4237,36422,0,2024-04-25 13:00:00,2024-04-25 13:00:00,-87.47369047620305,-468.99128777677834,63766.03720238096,-0.001812212020808889,-0.0013623676833610116,63983.35274999999,62819.916088771904,63720.47264410732,63872.80716259335,64008.82155803544,63742.78120811832,-70.36931534431642,-53.879927510161735,214.31370346380393,-106.49475713797437,-38.20565393873403,-28.855431028569,64032.10470779446,63451.95770844218,26.66800786379282,32.669718222484754,False,True,62907.738,63807.738,63307.738,63257.738,,False,2024-04-25 16:15:00,2024-04-25 16:10:57,2024-04-25 14:26:16,fail,False,-74.66,7796.729999999994,,0,1,17,4
2024-04-25 15:00:00,63811.34,64113.84,63652.906,64001.5,2884,36422,0,2024-04-25 15:00:00,2024-04-25 15:00:00,-40.74234523814812,-481.67424274822406,63572.74172619047,-0.0021981263201934346,-0.0003233979921283609,63725.29485714281,62446.789254207266,64148.36779952082,63813.82439322049,63903.82893400088,63714.81828104569,-62.90790225060482,-70.72599083639366,251.44780981683954,40.48270691427024,28.270872721048363,44.45815445471817,64055.77282429842,63375.36373779296,69.82596140528635,64.07415629006084,True,False,64501.5,63601.5,64101.5,64151.5,,False,2024-04-25 20:00:00,2024-04-25 20:02:25,2024-04-25 15:46:28,fail,False,-74.66,7722.069999999994,,0,2,17,4
2024-04-26 01:00:00,64638.684,64684.539,64535.039,64608.066,2025,56422,0,2024-04-26 01:00:00,2024-04-26 01:00:00,7.697976190545887,-60.526419127614645,64700.675595238084,0.0029032244147253446,0.001290756354117764,64797.684880952416,65269.99860674627,65657.58495315215,64670.015943101316,64504.182093168936,64731.46555280357,105.42937913012429,110.34703719204401,216.20942289196518,-25.28100584800268,-16.903890264780784,11.18234846919222,65023.34827370773,64438.08283189942,32.78847582980083,45.24039353796335,False,True,64108.066,64508.066,64508.066,64458.066,2024-04-26 02:45:00,True,2024-04-26 02:45:00,2024-04-26 03:33:10,2024-04-26 03:02:07,even,True,18.66,7740.729999999994,,1,0,17,4
2024-04-26 02:00:00,64553.25,64700.637,64425.84,64531.691,1933,36422,0,2024-04-26 02:00:00,2024-04-26 02:00:00,-97.00928571433178,-38.57253171472257,64601.53807142856,0.0010796675611521825,0.0012907027729929174,64700.675595238084,64682.5338923095,65742.38732352454,64626.94937673563,64526.05684478638,64649.733737186085,80.31925216757372,97.78753147413877,106.94562638197779,-42.95186549711798,-25.516619194997475,-13.775297557600425,64794.110332801756,64503.857141570414,17.01499148889584,22.107766360622705,False,True,64031.691,64431.691,64431.691,64381.691,2024-04-26 03:15:00,True,2024-04-26 03:15:00,2024-04-26 04:04:41,2024-04-26 03:19:27,even,True,18.66,7759.389999999994,,2,0,17,4
2024-04-26 03:00:00,64450.078,64519.137,64338.348,64369.137,1432,36422,0,2024-04-26 03:00:00,2024-04-26 03:00:00,-99.13752380952792,-29.101200759148924,64458.37286904762,-0.0005870301308790434,-2.169873749766898e-05,64601.53807142856,63901.600376257746,65218.69035182005,64531.227787289885,64501.663319515574,64482.13649294809,47.65043114601576,74.12692534567923,128.58781607104413,-57.13976332987659,-29.78677296180831,-44.274181630469684,64655.730044644,64307.042941252184,5.514669272524652,6.679733875686016,False,True,63869.137,64269.137,64269.137,64219.137,2024-04-26 03:45:00,True,2024-04-26 03:45:00,2024-04-26 04:11:55,2024-04-26 03:53:33,even,True,18.66,7778.049999999994,,3,0,17,4
2024-04-26 08:00:00,64168.84,64168.84,63975.543,64123.84,1543,36422,0,2024-04-26 08:00:00,2024-04-26 08:00:00,-65.57316666669067,-42.08145205647452,64343.81473809521,-0.0002270167971510804,-0.0003935115547615538,64275.82970238091,63707.276909713524,64444.634203265,64271.3787417768,64329.27412246505,64276.33459167528,-21.79564799095533,-10.234753000396395,131.27816557967063,-48.351668730603706,-22.023335741381743,-11.49454248364782,64453.56011520784,64097.60906814272,31.314062580374483,43.76689355048873,True,False,64623.84,64223.84,64223.84,64273.84,2024-04-26 08:45:00,True,2024-04-26 08:45:00,2024-04-26 17:12:05,2024-04-26 09:42:37,even,True,18.66,7796.709999999994,,4,0,17,4
2024-04-26 23:00:00,63709.453,63947.438,63708.668,63909.84,1187,36422,0,2024-04-26 23:00:00,2024-04-26 23:00:00,-46.31257142851973,-157.60616252088948,63803.72994047621,0.0008666434875813473,-0.001808270860873378,63763.23844047622,63716.97540681938,63595.57380808567,63851.46047472223,63884.24094338226,63964.091389060806,-33.594317908566154,-43.71427353509821,284.8429802896357,5.62136842100881,-40.7319855521564,1.0968861369474325,64350.12941245182,63579.553365669795,49.54403753864525,55.46797375458369,True,False,64409.84,63509.84,64009.84,64059.84,,False,2024-04-30 03:45:00,2024-04-30 03:47:24,2024-04-29 01:06:17,fail,False,-74.66,7722.049999999994,,0,1,17,4
2024-04-29 01:00:00,63612.637,63663.137,63293.32,63401.039,1911,56422,0,2024-04-29 01:00:00,2024-04-29 01:00:00,-3.3581904762759223,-166.4108626955349,63588.487928571456,-0.0013190652856741255,-0.0004794432001035332,63800.37174999993,62391.68785445786,63879.72750690481,63690.299314027325,63782.444290181484,63600.911828689335,-50.1982924646436,-39.75409579219477,180.48725195155376,-81.8925390437289,-50.061701066355454,-62.74271276232321,63844.56961882393,63355.75403855474,12.379551288019657,11.500219450381076,False,True,62901.039,63801.039,63301.039,63251.039,,False,2024-04-29 01:45:00,2024-04-29 01:32:37,2024-04-30 01:32:05,success,True,93.29,7815.339999999994,,1,0,18,4
2024-04-29 05:45:00,62707.039,62826.84,62585.539,62660.039,2364,36422,0,2024-04-29 05:00:00,2024-04-29 05:00:00,-76.48021428566426,-289.75274058107607,62943.55341666664,-0.0018990861179973056,-0.002142349668489278,63139.611190476244,61774.79476455595,62699.80674996481,63026.62281260572,63215.99788501841,62998.87681286549,-110.77802680402237,-101.53416579899122,300.769797927141,-51.850790505704936,-57.32567939461296,23.79546198843309,63404.91604006713,62591.33758566385,35.67426695369307,51.03053839252186,False,True,62160.039,62560.039,62560.039,62510.039,2024-04-29 06:15:00,True,2024-04-29 06:15:00,2024-04-29 06:59:01,2024-04-29 06:16:37,even,True,18.66,7833.999999999994,,2,0,18,4
2024-04-29 06:45:00,62613.863,62631.039,62043.328,62236.938,2222,36422,0,2024-04-29 06:00:00,2024-04-29 06:00:00,-196.05777380960353,-338.34174406249804,62642.987940476196,-0.002185696440329561,-0.00214231836638898,62943.55341666664,61498.9829060293,62566.7316282072,62757.932641691834,63022.427009853054,62616.85514757483,-143.21071132789075,-119.75096056971475,317.26355661323186,-144.66510939110594,-77.18566976260627,-68.06089129695465,63045.1609490027,62187.04934614697,22.17601348214721,20.946293579874776,False,True,61736.938,62636.938,62136.938,62086.938,,False,2024-04-29 16:45:00,2024-04-29 16:50:08,2024-04-29 13:24:56,fail,False,-74.66,7759.339999999994,,0,1,18,4
2024-04-29 08:15:00,62474.039,62474.039,62283.637,62306.938,1484,36422,0,2024-04-29 08:00:00,2024-04-29 08:00:00,-96.60704761898523,-434.3964060344588,62459.460630952446,-0.002189295562178682,-0.0019804949925982026,62546.38089285721,61228.98228512291,62370.78096488466,62562.0550936439,62812.77588909615,62314.845241830066,-148.26302117376326,-139.90517962956574,332.1049582587574,-45.85414138279157,-28.988701066482463,-36.44579876161879,62763.18693547939,61865.00354818074,30.994828576610853,35.32884034983092,False,True,61806.938,62206.938,62206.938,62156.938,2024-04-29 10:00:00,True,2024-04-29 10:00:00,2024-04-29 16:49:36,2024-04-29 10:19:17,even,True,18.66,7777.999999999994,,1,0,18,4
2024-04-29 09:00:00,62400.684,62420.438,62269.84,62278.637,2001,36422,0,2024-04-29 09:00:00,2024-04-29 09:00:00,-86.92026190476463,-458.92071725722053,62290.18090476189,-0.002562070992319296,-0.0025797362240606017,62459.460630952446,60935.41107557116,61948.279491423054,62475.36724517071,62716.29447051402,62259.93223770211,-147.30692810394248,-143.50997264394707,361.3144132438232,-16.902061231492553,-10.376570003405504,-27.634372893058753,62747.70669558127,61770.65777982295,33.648349406469606,31.02801583984379,False,True,61778.637,62178.637,62178.637,62128.637,2024-04-29 10:15:00,True,2024-04-29 10:15:00,2024-04-29 16:49:36,2024-04-29 10:18:09,even,True,18.66,7796.6599999999935,,2,0,18,4
2024-04-29 11:00:00,62343.242,62446.738,62247.938,62289.84,2035,36422,0,2024-04-29 11:00:00,2024-04-29 11:00:00,-54.26364285708405,-498.27561232371954,62247.78277380956,-0.0009290327708478802,-0.002123465622550924,62235.917261904804,61524.57946362804,61912.44298323809,62306.07506048543,62495.39262985246,62219.03873718604,-131.30839953564282,-142.2400144751964,256.2850319920244,15.129641210842237,20.402828689337184,-6.802884760974848,62566.52353037528,61873.053943996805,59.530721422386705,53.73652138413712,True,False,62789.84,62389.84,62389.84,62439.84,2024-04-29 13:00:00,True,2024-04-29 13:00:00,2024-04-29 17:29:13,2024-04-29 13:45:14,even,True,18.66,7815.319999999993,,3,0,18,4
2024-04-29 12:00:00,62352.133,62361.539,62220.32,62333.34,1860,36422,0,2024-04-29 12:00:00,2024-04-29 12:00:00,11.865511904754385,-496.3164683180221,62352.384595238094,-0.0007595084033482506,-0.0014362113429963624,62247.78277380956,61540.195489942664,62251.495683097826,62318.4912130026,62451.80069608125,62262.5236842105,-106.41077905517159,-125.55614978058996,139.07589635766575,27.124922256582067,19.720412796705205,4.406963192297553,62451.77614429335,62074.77122412765,78.8107746710212,74.45605458938697,True,False,62833.34,62433.34,62433.34,62483.34,2024-04-29 13:00:00,True,2024-04-29 13:00:00,2024-04-29 17:30:30,2024-04-29 13:37:50,even,True,18.66,7833.979999999993,,4,0,18,4
2024-04-29 13:00:00,62486.746,62594.039,62437.969,62594.039,1921,36422,0,2024-04-29 13:00:00,2024-04-29 13:00:00,104.60182142853591,-478.0935780763102,62377.01488095233,0.0004482978056237811,-0.00021443504485565377,62352.384595238094,62093.46620093683,62583.33599335878,62374.33633988905,62443.179762721986,62393.20212590297,-76.02466781593102,-103.89042797007671,125.48103227897867,63.44156277948787,41.889661162756965,18.08921018230467,62564.10151947959,62223.80273232635,84.82197209463112,77.4795719481984,True,False,63094.039,62194.039,62694.039,62744.039,,False,2024-04-29 17:30:00,2024-04-29 19:03:30,2024-04-29 14:40:12,fail,False,-74.66,7759.319999999993,,0,1,18,4
2024-04-30 01:00:00,63025.621,63149.738,62982.672,63117.84,1798,56422,0,2024-04-30 01:00:00,2024-04-30 01:00:00,-25.396904761924816,-114.74511991792679,63250.87239285719,0.0001238169702337737,0.0018937283257652391,62955.28125000002,62547.51726607414,64401.62243058761,62938.45205511848,62858.02824547647,62973.52824458208,48.265127082457184,45.10385506458141,139.29778843513634,55.598775369813666,53.5409060887323,8.980105951188307,63163.08025896951,62785.47623019465,85.24309225256009,75.37799332754325,False,True,62617.84,63517.84,63017.84,62967.84,,False,2024-04-30 11:15:00,2024-04-30 11:30:46,2024-04-30 01:30:06,fail,False,-74.66,7684.6599999999935,,0,2,18,4
2024-04-30 03:15:00,63677.254,63957.098,63669.969,63951.84,1785,36422,0,2024-04-30 03:00:00,2024-04-30 03:00:00,257.71023809518374,46.560316613416944,63922.26039285714,0.002109426979214218,0.0033053248729873544,63508.582630952376,63699.529039652254,65558.82051684103,63629.31498947224,63336.05554373743,63939.92481940133,149.74484029403538,119.95221606548976,476.7973125478946,81.07799690393585,25.32617715853121,63.76961369111814,64585.10119134098,63296.24844746167,74.60081368184007,75.05209967056355,True,False,64451.84,64051.84,64051.84,64101.84,2024-04-30 03:45:00,True,2024-04-30 03:45:00,2024-04-30 03:47:39,2024-04-30 04:33:24,success,True,93.29,7777.949999999993,,1,0,18,4
2024-04-30 05:00:00,63562.137,63574.539,63057.719,63471.84,3883,36422,0,2024-04-30 05:00:00,2024-04-30 05:00:00,11.017726190439134,166.29877449239575,63944.81334523811,0.0012840402263609523,0.005224032989136165,63933.27811904758,63386.64313532366,66763.69874120259,63840.55254998627,63609.69886657476,64099.05510732713,149.6613791061027,160.63034961488825,520.5932107331197,-135.96584451325907,-113.91964155484311,-5.877829377343005,64801.85594181684,63394.75427283742,31.534637054998697,49.6533928264763,False,True,62971.84,63371.84,63371.84,63321.84,2024-04-30 08:45:00,True,2024-04-30 08:45:00,2024-04-30 11:12:49,2024-04-30 09:21:22,even,True,18.66,7796.609999999993,,2,0,18,4
2024-04-30 08:00:00,63369.34,63449.039,63213.707,63399.238,1920,36422,0,2024-04-30 08:00:00,2024-04-30 08:00:00,-190.9589523808536,165.87625587548246,63455.80141666665,0.00011272138597813244,-0.002424189440842755,63686.208833333345,63061.18020513746,63328.120698527695,63560.08830114263,63571.375914292534,63349.73515032683,35.875448042555945,71.91944904758665,301.7795381517199,-35.33890780864749,-66.14914447891351,-67.68580873752944,63757.13752683165,62940.83277382201,30.611151010906227,30.579768876738328,False,True,62899.238,63299.238,63299.238,63249.238,2024-04-30 08:45:00,True,2024-04-30 08:45:00,2024-04-30 11:12:50,2024-04-30 08:57:35,even,True,18.66,7815.269999999993,,3,0,18,4
2024-04-30 10:00:00,63356.945,63385.438,63310.852,63374.34,1515,36422,0,2024-04-30 10:00:00,2024-04-30 10:00:00,-103.68120238098345,126.7405730009923,63191.11864285715,-0.0001335030158659058,-0.0030324094401722574,63352.120214285664,62981.55884688723,62637.57369463672,63381.47920697964,63450.19664151136,63253.130933608496,-13.396867632880458,7.015623434669564,289.0222754365503,11.723563467516215,-12.853192294474866,-23.612389748857822,63644.81100544784,62862.95086176915,45.47538236921423,40.82823148807319,True,False,63874.34,62974.34,63474.34,63524.34,,False,,,2024-04-30 11:12:49,fail,False,-74.66,7740.609999999993,,0,1,18,4
2024-04-30 14:15:00,61583.867,61623.938,61155.84,61250.258,2674,36422,0,2024-04-30 14:00:00,2024-04-30 14:00:00,-313.89021428575506,-228.20867193503364,61566.026464285715,-0.00607640577943417,-0.004222315717739977,61971.19453571426,59203.23234679092,61353.51559376489,61855.31280813676,62345.810680514034,61298.941645682746,-250.11873819452012,-204.16992840247445,763.9195971698686,-106.27716718272859,-71.25529652557452,-69.12203199180658,62330.23310186207,60266.15018950342,11.145790133023254,14.012364624192026,False,True,60750.258,61650.258,61150.258,61100.258,,False,2024-04-30 17:00:00,2024-04-30 15:12:47,,success,True,93.29,7833.899999999993,,1,0,18,4
2024-04-30 17:00:00,60773.84,60937.438,60507.84,60536.938,4565,36422,0,2024-04-30 17:00:00,2024-04-30 17:00:00,-307.2619166666773,-503.854099769218,60964.721488095245,-0.004443327018724966,-0.004514380286412147,60971.911154761874,59095.276277084835,60405.02810261896,61145.416316455674,61610.13850759613,60893.81639215683,-277.36424476366665,-265.5048514103483,536.8828843480263,-114.32243894054409,-75.36981148947962,9.98116580669739,61618.60828602666,60167.52449828699,20.74203630086822,34.203180583025706,True,False,61036.938,60636.938,60636.938,60686.938,2024-04-30 17:30:00,True,2024-04-30 17:30:00,2024-04-30 17:35:15,2024-04-30 18:41:42,success,True,93.29,7927.189999999993,,2,0,18,4
2024-04-30 19:00:00,60746.738,60869.539,60281.84,60685.137,4067,36422,0,2024-04-30 19:00:00,2024-04-30 19:00:00,-63.049023809537175,-588.8661603455257,60654.58049999999,-0.0027099459965646464,-0.002605213645412177,60901.67246428571,59392.444196556644,60556.528206211224,60911.90590814345,61263.198192351105,60766.76981320945,-236.04674410189182,-247.58858585510865,347.74240143241354,-48.54919814247842,-37.814122806965315,-39.78567389064119,61236.22205514321,60295.81757127569,24.07598532664329,26.883087416482592,True,False,61185.137,60285.137,60785.137,60835.137,,False,,,2024-04-30 19:18:24,fail,False,-74.66,7852.529999999993,,0,1,18,4
2024-04-30 19:15:00,60689.938,60769.637,60181.84,60230.367,5195,36422,0,2024-04-30 19:00:00,2024-04-30 19:00:00,-63.049023809537175,-588.8661603455257,60654.58049999999,-0.0027099459965646464,-0.002605213645412177,60901.67246428571,59392.444196556644,60556.528206211224,60807.053768429076,61186.69217810288,60639.802417268664,-245.29387177374156,-247.12964303883524,374.21714720985597,-126.96739594078826,-48.54919814247842,-37.814122806965315,61144.99556600197,60133.10926853536,20.29173771095321,23.922253968710397,False,True,59730.367,60130.367,60130.367,60080.367,2024-04-30 22:15:00,True,2024-04-30 22:15:00,2024-04-30 22:16:59,2024-04-30 22:19:05,success,True,93.29,7945.819999999993,,1,0,18,4
2024-04-30 21:30:00,60293.039,60370.34,60138.438,60185.34,2481,36422,0,2024-04-30 21:00:00,2024-04-30 21:00:00,-174.3042023809685,-705.7640226732619,60409.69724999999,-0.0024441142688682873,-0.002624781263452105,60480.27629761902,59229.59264437964,60233.89841078585,60401.11964294766,60737.699433615235,60145.19080529752,-228.57414405895543,-240.34899545707864,391.61333465761084,-74.43168971448904,-39.488389060948975,13.807284485767013,60673.868807085295,59615.012803509744,20.697227063816257,20.53413851396023,False,True,59685.34,60085.34,60085.34,60035.34,2024-04-30 22:15:00,True,2024-04-30 22:15:00,2024-04-30 22:17:02,2024-04-30 22:19:01,success,True,93.29,8039.109999999993,,2,0,18,4
2024-04-30 22:00:00,60369.441,60461.539,59916.855,59952.039,3258,36422,0,2024-04-30 22:00:00,2024-04-30 22:00:00,-70.57904761903046,-730.4552758551799,59969.13853571433,-0.003694070147637483,-0.0030504444129768604,60409.69724999999,58280.94449934284,59872.240485659095,60327.95840708086,60654.27195063034,60091.302592019274,-222.38754553629406,-233.42144379249805,389.780089149256,-43.66493154455384,-10.223281733691692,-74.43168971448904,60617.50571237077,59563.59947166778,19.828447451914982,21.96639638222312,False,True,59452.039,60352.039,59852.039,59802.039,,False,2024-04-30 23:00:00,2024-04-30 22:55:30,2024-05-01 00:41:29,success,True,93.29,8132.399999999993,,3,0,18,4
2024-04-30 22:45:00,60081.539,60159.238,59145.84,59262.238,5503,36422,0,2024-04-30 22:00:00,2024-04-30 22:00:00,-70.57904761903046,-730.4552758551799,59969.13853571433,-0.003694070147637483,-0.0030504444129768604,60409.69724999999,58280.94449934284,59872.240485659095,60097.03772955149,60471.064697078655,59906.489788097744,-236.40526319580385,-229.99482584190028,420.5461413073083,-149.91210526310897,-20.474231854204845,-14.426466804216034,60474.22707886261,59337.25249733288,24.330769076254743,23.70311125744067,False,True,58762.238,59662.238,59162.238,59112.238,,False,2024-05-01 10:15:00,2024-05-01 10:08:08,2024-04-30 23:01:01,fail,False,-74.66,8057.739999999993,,0,1,18,4
2024-05-01 00:00:00,59902.273,60176.238,59897.527,60077.059,2492,56422,0,2024-05-01 00:00:00,2024-05-01 00:00:00,-111.00425000008545,-847.221244371176,59836.74226190477,-0.004522108294569739,-0.0027325474541430657,59858.134285714244,57562.53042896426,59697.53453894485,59986.68513460798,60284.84075888475,59806.3660945992,-208.98374082567898,-225.31924757467604,375.24443273682596,19.55426556582097,-27.09642655657808,4.352026487838884,60314.44607879392,59299.786110404486,59.968933157387404,52.734484015213376,True,False,60577.059,60177.059,60177.059,60227.059,2024-05-01 00:30:00,True,2024-05-01 00:30:00,2024-05-01 01:26:44,2024-05-01 00:32:44,even,True,18.66,8076.399999999993,,1,0,18,5
2024-05-01 01:00:00,60118.113,60421.738,60092.969,60371.738,2798,56422,0,2024-05-01 01:00:00,2024-05-01 01:00:00,-21.392023809472448,-833.9432958924081,60055.85103571431,-0.002525829850292159,-0.0007397539596518513,59836.74226190477,58108.74882950539,60854.53422078789,60114.743391330674,60274.702191301294,60007.870725490175,-149.4815623220784,-191.09044130502548,286.0093744351635,67.08854833158694,37.25410801512771,37.56603543176607,60395.48338097765,59621.7580700027,81.69722306526472,78.94464222684557,True,False,60871.738,60471.738,60471.738,60521.738,2024-05-01 01:30:00,True,2024-05-01 01:30:00,2024-05-01 01:34:43,2024-05-01 01:50:27,success,True,93.29,8169.689999999993,,2,0,18,5
2024-05-01 08:00:00,60244.438,60294.438,60093.84,60128.637,1573,36422,0,2024-05-01 08:00:00,2024-05-01 08:00:00,-25.287357142893597,-612.3456899518351,60050.67311904759,-0.001262031839930444,-0.0017470603693375017,60143.00636904762,59013.15602102989,59873.24094303999,60134.090296079834,60160.50031340275,60147.129876504965,-36.949353654250444,-53.64347628196248,281.7726459572211,37.33927691773715,62.38237667702924,75.00514826281142,60529.022948547215,59766.736804462715,81.98667459885944,81.58523074250324,True,False,60628.637,59728.637,60228.637,60278.637,,False,,,2024-05-01 09:26:19,fail,False,-74.66,8095.029999999993,,0,1,18,5
2024-05-01 09:15:00,59886.938,59957.738,59681.84,59687.902,2461,36422,0,2024-05-01 09:00:00,2024-05-01 09:00:00,-92.33325000003242,-593.6860989354609,59849.84827380959,-0.0005689404059940059,-0.0016667876964317728,60050.67311904759,59266.71934162975,59793.12117135756,59996.718454972084,60079.068850180556,60078.05213828685,-51.739814015913,-47.15905707586684,217.10586503797492,-53.30763364303857,-11.191396972695657,13.510200550299487,60371.14505608811,59783.45922048558,26.68501933141565,44.17862439553593,False,True,59187.902,59587.902,59587.902,59537.902,2024-05-01 10:00:00,True,2024-05-01 10:00:00,2024-05-01 10:05:14,2024-05-03 00:37:52,success,True,93.29,8188.319999999993,,1,0,18,5
2024-05-01 14:00:00,57724.539,57825.637,57516.211,57580.84,3298,36422,0,2024-05-01 14:00:00,2024-05-01 14:00:00,-268.29671428570873,-1072.3840828880566,57306.30400000002,-0.008830748503304507,-0.007507330011237152,57361.72454761909,53150.32613435776,56164.97361601335,57552.042998771416,58102.75961382901,57111.75483935331,-348.79278685977624,-363.0705450097292,1217.397563607298,179.56818507051503,168.36779944961017,117.2180595115642,58756.74155022316,55468.268128483454,67.67780793660278,49.85085053398998,True,False,58080.84,57680.84,57680.84,57730.84,2024-05-01 15:00:00,True,2024-05-01 15:00:00,2024-05-01 15:12:43,2024-05-01 15:05:52,even,True,18.66,8206.979999999994,,2,0,18,5
2024-05-01 15:00:00,57836.238,58193.34,57675.125,58154.438,3757,36422,0,2024-05-01 15:00:00,2024-05-01 15:00:00,-55.42054761906911,-1069.5070027855036,57425.187190476165,-0.003095870486361239,-0.005174652960149926,57306.30400000002,55142.34159376844,57054.07307969243,57686.65990823193,58023.674795151215,57732.109218782294,-267.45117700783885,-324.87056793038835,909.3103057899162,174.1908101135923,139.6611719986031,127.46245889237616,58961.17813159868,56504.54030596591,92.78631660261988,86.2121401736512,True,False,58654.438,57754.438,58254.438,58304.438,,False,2024-05-01 21:45:00,2024-05-01 21:44:28,2024-05-01 16:03:24,fail,False,-74.66,8132.319999999994,,0,1,18,5
2024-05-01 18:00:00,57441.277,57475.738,56901.848,56961.84,3483,36422,0,2024-05-01 18:00:00,2024-05-01 18:00:00,150.75486904761783,-1066.148376589983,57360.78172619045,0.0002919691809226436,0.000811343269287278,57576.56323809523,56699.444141861495,58569.20156271294,57441.47822104885,57696.007523710505,57349.08951255585,-185.65810835756565,-197.89565616526647,324.0758765251222,-138.0070024079978,-61.152696938406734,-99.27767733067594,57786.59194586477,56910.087079246936,23.572238676796545,27.19744670598385,True,False,57461.84,57061.84,57061.84,57111.84,2024-05-01 19:30:00,True,2024-05-01 19:30:00,2024-05-01 20:52:34,2024-05-01 19:40:24,even,True,18.66,8150.979999999994,,1,0,18,5
2024-05-01 21:00:00,57373.738,58128.637,57230.438,57808.539,6788,36422,0,2024-05-01 21:00:00,2024-05-01 21:00:00,-50.915416666648525,-1050.49013991838,57659.574416666685,-0.00046330118035287017,0.003317533063187001,57137.201690476184,56452.10061766011,60201.81205117428,57249.07832653284,57371.16103216905,57169.18672721013,-124.35136680523283,-165.48401212349802,409.368363071674,154.0154760921796,83.53015651871101,47.99700963190844,57723.33401735689,56616.53943706337,69.80827676613255,58.09532854022893,True,False,58308.539,57408.539,57908.539,57958.539,,False,2024-05-01 21:45:00,2024-05-01 21:34:48,2024-05-01 22:34:05,success,True,93.29,8244.269999999995,,2,0,18,5
2024-05-02 03:00:00,58289.438,58547.938,58204.84,58211.938,2251,36422,0,2024-05-02 03:00:00,2024-05-02 03:00:00,168.83555952380266,-631.3298348963872,57856.30483333335,0.0007035225825454497,-0.0024368218169274797,57941.20254761904,57019.85644100824,57982.68990928308,57996.49218420097,57834.01756603091,58279.9164891641,65.38722327360301,35.60834234291925,480.7668199052478,72.74860749918298,141.95931062947056,190.16569590645668,58930.45169603618,57630.881282292015,84.04275884446157,85.93654618303815,True,False,58711.938,57811.938,58311.938,58361.938,,False,2024-05-02 14:45:00,2024-05-02 15:09:12,2024-05-02 03:37:22,fail,False,-74.66,8169.609999999995,,0,1,18,5
2024-05-02 09:00:00,57452.84,57591.539,57361.438,57535.938,2459,36422,0,2024-05-02 09:00:00,2024-05-02 09:00:00,-23.222988095265464,-513.5760932688281,57369.274952380976,0.0007506659188281164,-0.0024635955594521403,57325.02344047617,57316.731096404576,57128.407221976806,57430.77208085558,57493.66025367036,57453.60394702449,-38.835701906376926,-40.42598313086765,259.82400261309596,10.683095975320612,34.88925352599472,22.84504609562282,57805.86635055217,57102.841543496805,60.72274414193069,51.287924571507496,True,False,58035.938,57635.938,57635.938,57685.938,2024-05-02 10:15:00,True,2024-05-02 10:15:00,2024-05-02 14:02:26,2024-05-02 10:36:25,even,True,18.66,8188.269999999995,,1,0,18,5
2024-05-02 10:00:00,57581.871,57911.77,57573.023,57716.637,3020,36422,0,2024-05-02 10:00:00,2024-05-02 10:00:00,44.25151190480392,-473.44206203251815,57508.067928571414,0.0009759550793051524,-0.001561938266590205,57369.274952380976,57488.79529884922,57553.59501385905,57528.35501284292,57529.28455582461,57543.944862057135,-14.885589744859317,-29.73724720121245,168.90154747109008,39.464996904091095,15.055779497721232,12.81946852429246,57773.46195114311,57315.92777297116,75.45082384330982,80.48617679266984,True,False,58216.637,57316.637,57816.637,57866.637,,False,2024-05-02 14:15:00,2024-05-02 14:07:04,,success,True,93.29,8281.559999999996,,2,0,18,5
2024-05-02 11:00:00,57633.27,57822.738,57555.258,57750.184,2572,36422,0,2024-05-02 11:00:00,2024-05-02 11:00:00,138.7929761904379,-433.0248117814772,57657.940666666706,0.0011684797817788852,0.00018615176079398625,57508.067928571414,57621.52398666106,57973.0728833339,57603.80544214254,57569.54891382673,57679.00782937738,3.168903691075684,-13.508826474510574,143.9429735855068,39.3837258341955,35.774417612716206,20.955222566160955,57874.83084371781,57484.68481503694,68.30036737459942,68.26814925780211,True,False,58250.184,57350.184,57850.184,57900.184,,False,2024-05-02 14:15:00,2024-05-02 14:07:05,,success,True,93.29,8374.849999999997,,3,0,18,5
2024-05-02 13:00:00,57754.77,57821.34,57572.738,57755.738,1272,36422,0,2024-05-02 13:00:00,2024-05-02 13:00:00,43.87421428566449,-343.1739232099935,57755.1881071428,0.001296501909450044,0.0011594335735672172,57701.81488095237,57822.595168826556,58380.802766623674,57713.19663067347,57655.79967407698,57792.2809322325,24.109836429473944,15.590974582840651,166.01449869147453,-11.797901272766467,-11.11915995884192,-3.0091190229941276,58016.40050546599,57566.66135899901,57.97778235188013,59.433816814445784,False,True,57255.738,58155.738,57655.738,57605.738,,False,,,2024-05-02 14:03:02,fail,False,-74.66,8300.189999999997,,0,1,18,5
2024-05-02 23:00:00,59304.48,59379.438,59125.27,59302.246,2519,36422,0,2024-05-02 23:00:00,2024-05-02 23:00:00,89.0919047619027,270.87728991724725,59122.425619047586,0.0009729769527798883,0.0007292403749822479,59298.1935714286,58793.18149871509,59798.48670435899,59163.74857677055,58995.69333714799,59217.61364809076,120.31673616041371,130.64122917129203,219.43137836288318,48.755077055357106,53.7659329205344,6.575191606505541,59515.34600888065,58921.381287300865,54.611610029418976,44.53843439959556,False,True,58802.246,59202.246,59202.246,59152.246,2024-05-02 23:30:00,True,2024-05-02 23:30:00,2024-05-02 23:38:38,2024-05-03 00:36:04,success,True,93.29,8393.479999999998,,1,0,18,5
2024-05-03 09:00:00,59476.738,59519.539,59399.039,59466.938,1825,36422,0,2024-05-03 09:00:00,2024-05-03 09:00:00,27.949380952428328,324.6201332943456,59475.31504761901,0.00118469972400018,0.0014385721374127317,59531.234214285716,59462.66802540178,60561.62317148099,59523.32587770045,59445.93601911654,59551.38735775712,61.680128610089014,74.04723905730125,262.4168487530749,-35.898818369430955,-31.514779841847485,-24.69334915712534,59905.650103573775,59195.62461194047,16.061397719092444,24.89305771154652,False,True,58966.938,59366.938,59366.938,59316.938,2024-05-03 09:45:00,True,2024-05-03 09:45:00,2024-05-03 13:41:40,2024-05-03 10:12:28,even,True,18.66,8412.139999999998,,2,0,18,5
2024-05-03 10:00:00,59195.805,59397.969,59163.512,59371.039,1962,36422,0,2024-05-03 10:00:00,2024-05-03 10:00:00,-55.91916666670295,297.34729157113907,59365.693595238125,0.0006077945971660574,-0.0003039748218804197,59475.31504761901,59156.85083900395,59809.86299025112,59417.991839760936,59409.24628489597,59342.672658066695,30.906498626434768,53.47346666018622,159.3386102085473,-33.43910354322725,-66.33510835911875,-42.97458995522902,59557.779781848236,59126.06553428515,12.256185616362174,8.569153651187422,False,True,58871.039,59271.039,59271.039,59221.039,2024-05-03 10:45:00,True,2024-05-03 10:45:00,2024-05-03 13:42:42,2024-05-03 11:28:10,even,True,18.66,8430.799999999997,,3,0,18,5
2024-05-03 12:00:00,59181.738,59291.738,59146.109,59242.938,1405,36422,0,2024-05-03 12:00:00,2024-05-03 12:00:00,-107.01860714287614,244.6246168887228,59261.05882142859,-0.0006632843671990503,-0.0011524482252994385,59258.67498809525,58779.78528528487,59268.73105525355,59283.26717724917,59329.058893086636,59184.45413691096,-6.526025707091321,10.08817278913998,197.4464302932794,-3.6602710697843577,-9.089724114186538,9.447976952178578,59451.00681780688,58916.40145601503,42.210063132010845,43.74396962165614,True,False,59742.938,59342.938,59342.938,59392.938,2024-05-03 12:45:00,True,2024-05-03 12:45:00,2024-05-03 15:30:58,2024-05-03 13:01:21,even,True,18.66,8449.459999999997,,4,0,18,5
2024-05-03 21:00:00,61750.621,61924.539,61735.84,61899.438,1184,36422,0,2024-05-03 21:00:00,2024-05-03 21:00:00,220.37641666673153,748.9055463329933,61931.806809523805,0.007421719955059138,0.0035005888597147306,61905.98136904768,63507.74156574506,63947.15938214625,61672.62995051233,61229.191255470876,61798.1058011696,282.62800267595594,290.7825406146716,763.332073566845,31.36189095287409,-14.858521499794733,-8.078395940829068,62830.10410048484,60767.60750185436,62.43323410813435,58.95087359911624,False,True,61399.438,61799.438,61799.438,61749.438,2024-05-03 21:30:00,True,2024-05-03 21:30:00,,2024-05-03 21:38:38,even,True,18.66,8468.119999999997,,5,0,18,5
2024-05-03 22:00:00,61773.367,61773.367,61544.445,61597.539,1903,36422,0,2024-05-03 22:00:00,2024-05-03 22:00:00,25.82544047612464,779.8500353054842,61909.61219047619,0.0061328474965028365,0.00013148220458512736,61931.806809523805,63077.159510541984,62247.7187676168,61688.2387819562,61356.14053854013,61805.58304747161,239.50992710371065,269.0377394201185,202.18703010704462,-12.71039766085596,12.730671826720936,11.460311661445303,62078.53553811612,61531.130556827105,46.04466889664607,53.79009773176303,False,True,61097.539,61997.539,61497.539,61447.539,,False,,,2024-05-03 22:59:09,fail,False,-74.66,8393.459999999997,,0,1,18,5
2024-05-03 23:00:00,62012.715,62141.773,61902.938,62102.84,2527,36422,0,2024-05-03 23:00:00,2024-05-03 23:00:00,-22.19461904761556,814.3636601664839,62193.302869047664,0.002935177627830158,0.002605052605717039,61909.61219047619,62454.30535416368,63823.00409539736,61804.79695026857,61503.25152981656,61854.219905400685,218.52766740808875,240.5518761375512,170.18391993005488,43.502102511127305,22.71206467148295,-10.088580323361384,62085.46819730626,61624.47161349511,74.52356629020245,54.23906230359345,False,True,61602.84,62502.84,62002.84,61952.84,,False,,,2024-05-03 23:22:57,fail,False,-74.66,8318.799999999997,,0,2,18,5
2024-05-06 04:00:00,64165.539,64363.738,64165.539,64285.039,1984,36422,0,2024-05-06 04:00:00,2024-05-06 04:00:00,334.83889285713667,1254.3031367533258,64213.59095238091,0.005924835238817715,0.005210940779345974,64037.444761904735,65319.8377254909,66562.1767401948,63951.606521834154,63388.95723084712,64246.15117956655,361.6050501950158,367.7586758888715,881.6245967824221,12.579712418373674,-3.194071207472007,-25.335543515640893,65437.84438522282,63055.95797391028,82.43445514156268,80.8826421891866,False,True,63785.039,64185.039,64185.039,64135.039,2024-05-06 05:00:00,True,2024-05-06 05:00:00,2024-05-06 05:59:51,2024-05-06 08:20:45,success,True,93.29,8412.089999999998,,1,0,19,5
2024-05-06 05:00:00,64090.137,64180.738,63969.906,64139.938,1577,36422,0,2024-05-06 05:00:00,2024-05-06 05:00:00,176.14619047617452,1279.748779050533,64146.74857142861,0.005090531391710201,0.0028839303876427203,64213.59095238091,65102.90970020738,65511.317807042644,64047.65697245103,63591.334856564805,64238.85762985896,320.1260549733197,348.20008682619505,549.3457098563675,0.8816580667335074,-0.6277364981142455,8.62154179571371,64981.974338165055,63497.24092155287,59.88392107353443,67.63988602659167,False,True,63639.938,64039.938,64039.938,63989.938,2024-05-06 06:00:00,True,2024-05-06 06:00:00,2024-05-06 15:31:01,2024-05-06 07:48:22,even,True,18.66,8430.749999999998,,2,0,19,5
2024-05-06 06:00:00,63774.938,63890.84,63647.84,63658.84,1876,36422,0,2024-05-06 06:00:00,2024-05-06 06:00:00,-66.84238095230103,1259.5500340805374,64009.354607142806,0.003972420243251974,0.001690729369585574,64146.74857142861,64683.55925465191,65089.062173796345,63957.06019402876,63667.77490687701,64028.80253938764,247.75575592627138,304.54025336899497,212.3444783937241,-100.18802098383458,-84.40539628479019,-25.252041967723926,64315.467585219165,63740.63749355611,10.813943424614637,28.448494114668993,False,True,63158.84,64058.84,63558.84,63508.84,,False,2024-05-06 18:00:00,2024-05-06 17:59:15,2024-05-06 07:48:25,fail,False,-74.66,8356.089999999998,,0,1,19,5
2024-05-06 07:00:00,63814.34,63814.34,63715.457,63783.738,1696,36422,0,2024-05-06 07:00:00,2024-05-06 07:00:00,-137.3939642858022,1232.7213873481378,63981.49121428569,0.000302382670780481,0.0008995786926810107,64009.354607142806,63745.9487484537,64836.01199795964,63879.69706798694,63702.572858241714,63821.41869109043,185.42383577478904,244.88293585725128,193.66164427698448,-47.41424974205438,-33.51004884753638,-61.40804953558836,64082.86191086436,63558.4754713165,18.935347746630622,17.61439333927242,False,True,63283.738,64183.738,63683.738,63633.738,,False,2024-05-06 16:00:00,2024-05-06 17:57:58,2024-05-06 08:20:45,fail,False,-74.66,8281.429999999998,,0,2,19,5
2024-05-06 11:15:00,64456.738,65457.523,64402.723,65334.238,4344,36422,0,2024-05-06 11:00:00,2024-05-06 11:00:00,146.65923809533706,1164.3763381231402,64557.023202380915,0.001967218480036532,0.002306414952493638,64213.606797619104,64736.032972881265,66093.52696866823,64434.42331039512,64181.92433921859,64609.20293670456,156.38042898775893,142.74291911499313,340.50299723277925,189.34961713112716,33.41895596838731,52.62979153764172,65070.381982968815,64149.52389044031,89.5897893372968,88.4837101944425,True,False,65834.238,64934.238,65434.238,65484.238,,False,,,2024-05-06 13:18:41,fail,False,-74.66,8206.769999999999,,0,3,19,5
2024-05-06 21:00:00,63133.539,63211.738,63061.039,63149.438,1775,36422,0,2024-05-06 21:00:00,2024-05-06 21:00:00,-44.348476190418296,450.84752618589846,63214.684214285684,-0.0022397460103106164,-0.0023551001765215293,63233.934702381,61896.78344009212,62969.24179156754,63309.57289258466,63550.30911575853,63122.877457172275,-130.88423318862624,-115.99981335605061,308.80668583205585,-27.51316202274029,-66.42297248019167,-102.25095459236036,63539.766483045554,62704.488431298996,19.874362770181097,21.630206341484705,True,False,63649.438,63249.438,63249.438,63299.438,2024-05-06 22:00:00,True,2024-05-06 22:00:00,2024-05-07 04:12:10,2024-05-06 22:02:13,even,True,18.66,8225.429999999998,,1,0,19,5
2024-05-06 23:00:00,63171.492,63174.539,62997.172,63028.738,1394,36422,0,2024-05-06 23:00:00,2024-05-06 23:00:00,-10.510369047653512,334.90427573164925,63190.179023809564,-0.0009615765449919756,-0.002136713712166239,63204.17384523803,62337.54720064392,62811.43959755918,63153.282405328886,63347.58598964198,63010.382322669415,-121.74618845880468,-122.80691580829371,291.33323705531296,-14.306546267631347,-7.792416580639838,-60.8493040935864,63403.68219269409,62615.58245264474,47.08576300652201,38.059401957887836,True,False,63528.738,63128.738,63128.738,63178.738,2024-05-06 23:30:00,True,2024-05-06 23:30:00,2024-05-07 00:26:39,2024-05-07 02:38:17,success,True,93.29,8318.72,,2,0,19,5
2024-05-07 00:00:00,63252.023,63484.438,63252.023,63442.137,1199,56422,0,2024-05-07 00:00:00,2024-05-07 00:00:00,-13.994821428466821,288.9872155319099,63310.9695476191,-0.0009615485647410635,-0.0013644285973681601,63190.179023809564,62277.40246800404,63214.573339508024,63240.14476469383,63342.04875836809,63215.43297901611,-86.31136794236954,-108.08964946155683,198.44236100874028,62.349171310495876,41.304471620271215,55.732734090153826,63484.830166377906,62947.53579165431,81.40050218526166,74.69820899843054,True,False,63942.137,63042.137,63542.137,63592.137,,False,2024-05-07 04:15:00,2024-05-07 11:18:09,2024-05-07 03:16:39,fail,False,-74.66,8244.06,,0,1,19,5
2024-05-07 01:00:00,63483.023,63513.738,63394.738,63405.438,1541,56422,0,2024-05-07 01:00:00,2024-05-07 01:00:00,120.79052380953362,268.29688955738675,63350.86988095242,0.00023641078765617975,-0.0002725069929480082,63310.9695476191,62745.62750644171,63531.11234759317,63333.51035985724,63366.13504423922,63388.83986412101,-52.500287421287794,-80.55101019087036,188.91405096597487,12.254482284100959,59.794988304012804,47.534070175541274,63645.37383292508,63133.80589531694,83.70245805761125,86.0853355903767,True,False,63905.438,63005.438,63505.438,63555.438,,False,2024-05-07 04:15:00,2024-05-07 04:48:12,2024-05-07 03:17:08,fail,False,-74.66,8169.4,,0,2,19,5
2024-05-07 03:00:00,63110.84,63264.84,63045.465,63089.34,1745,36422,0,2024-05-07 03:00:00,2024-05-07 03:00:00,-29.105821428616764,199.96377553966158,63380.83797619048,0.0008373737006710596,0.0003733803992604952,63321.764059523804,63117.520433279235,63733.507334717586,63255.110558015105,63315.1922604415,63285.151453044324,-45.36501884632162,-46.75755287127677,168.60022390289072,-65.73707258344803,-61.009617819094274,-62.095866185096384,63512.76175531323,63056.04115077542,10.107851473430998,24.523892183303303,False,True,62589.34,63489.34,62989.34,62939.34,,False,2024-05-07 06:30:00,2024-05-08 02:02:10,2024-05-07 03:41:13,fail,False,-74.66,8094.74,,0,3,19,5
2024-05-07 11:15:00,63783.938,64298.34,63766.637,64208.438,3182,36422,0,2024-05-07 11:00:00,2024-05-07 11:00:00,1.2905714285152499,140.14775267036748,63728.5445357143,0.0019163828519729881,0.000994685767721241,63517.326761904726,63889.04543847433,64634.36185689823,63698.30249894449,63576.03751711788,63838.678716890274,49.69638051056245,23.953976833057663,262.5051869574895,106.9759982800606,37.24188888885692,-6.071916064705874,64194.56071928288,63484.296714497665,86.21776032101253,85.14144886002491,True,False,64708.438,63808.438,64308.438,64358.438,,False,,,2024-05-07 13:14:19,fail,False,-74.66,8020.08,,0,4,19,5
2024-05-07 13:00:00,64073.637,64131.738,63784.902,63848.738,1737,36422,0,2024-05-07 13:00:00,2024-05-07 13:00:00,180.47961904759723,207.4197543144619,64041.98447619046,0.002048455804100265,0.0021397222391057427,63909.0241547619,64229.04716565314,65213.810865116924,63966.42749057857,63795.76263444476,64180.88397764021,87.35044740123703,73.08968865038385,335.7900817086574,-20.457142758765258,10.540540419613535,40.34133986929373,64634.2005879469,63726.06736733352,62.715664284818104,74.93920451567033,False,True,63348.738,63748.738,63748.738,63698.738,2024-05-07 14:45:00,True,2024-05-07 14:45:00,2024-05-07 14:47:32,2024-05-07 17:55:27,success,True,93.29,8113.37,,1,0,19,5
2024-05-07 14:00:00,64051.738,64083.238,63849.746,64022.84,1362,36422,0,2024-05-07 14:00:00,2024-05-07 14:00:00,132.96032142855984,221.42851215771225,63885.819190476206,0.0005816822737233436,0.00229687541135267,64041.98447619046,63444.66071737905,65426.6423707791,63969.71482194464,63840.59442839372,64109.21832060538,76.67775112980598,75.79000912159199,295.309663072912,-8.746347437197983,-8.284251806064276,-13.313357413106132,64507.88636575381,63709.05027545695,57.23842994790706,49.182511935100045,False,True,63522.84,64422.84,63922.84,63872.84,,False,2024-05-07 14:45:00,2024-05-07 14:42:21,,success,True,93.29,8206.66,,2,0,19,5
2024-05-07 18:00:00,63988.199,64294.637,63752.848,63832.238,3810,36422,0,2024-05-07 18:00:00,2024-05-07 18:00:00,73.88846428573015,133.4860008692558,63592.819678571424,-0.001557129658733132,-0.00017273932399020054,63640.24914285718,62452.58440269855,64249.436934916914,63594.160327745965,63634.58942465915,63450.457160990656,-17.121915958545287,-15.862689223163722,315.92271499696756,73.77048469209694,91.61211627105513,-17.561789473700628,63878.452826236564,63023.96149574475,67.16510157900707,48.67402939654276,True,False,64332.238,63432.238,63932.238,63982.238,,False,,,2024-05-07 19:31:11,fail,False,-74.66,8132.0,,0,1,19,5
2024-05-08 01:00:00,63012.137,63039.738,62744.176,62760.34,2680,56422,0,2024-05-08 01:00:00,2024-05-08 01:00:00,-143.01676190477883,-76.68877072241594,62877.598642857134,-0.0014424596436051506,-0.0027479643221551527,62962.39448809525,62015.96751633165,62371.329610729634,63007.290560516965,63157.54656302936,62920.82349260404,-86.6385737707169,-80.71674239029778,252.28976210363368,-26.63061231505708,5.837943240418099,0.6942776057912852,63261.41467144394,62578.732313764136,34.93265670339598,44.08973401970124,True,False,63260.34,62860.34,62860.34,62910.34,2024-05-08 01:30:00,True,2024-05-08 01:30:00,,2024-05-08 01:49:46,even,True,18.66,8150.66,,1,0,19,5
2024-05-08 02:00:00,62792.313,62833.539,62194.465,62379.938,3997,36422,0,2024-05-08 02:00:00,2024-05-08 02:00:00,-84.79584523811354,-112.25613737941603,62645.20172619047,-0.0017445342312655018,-0.0020640907177720273,62877.598642857134,61758.44297526833,62416.456097189955,62873.045809759074,63050.54927657321,62784.164972824205,-98.54490365645324,-85.74420545711615,222.62669079726615,-119.5232972136364,-30.94503061580326,4.016828345404065,63084.71100540052,62482.11894024789,34.023760767978345,37.94308459399248,True,False,62879.938,62479.938,62479.938,62529.938,2024-05-08 03:45:00,True,2024-05-08 03:45:00,2024-05-08 06:44:41,2024-05-08 03:45:29,even,True,18.66,8169.32,,2,0,19,5
2024-05-08 02:45:00,62431.941,62468.84,62219.738,62277.738,1664,36422,0,2024-05-08 02:00:00,2024-05-08 02:00:00,-84.79584523811354,-112.25613737941603,62645.20172619047,-0.0017445342312655018,-0.0020640907177720273,62877.598642857134,61758.44297526833,62416.456097189955,62660.697812830826,62903.04614136343,62509.40510182319,-127.03049269550684,-102.47948814565011,279.59579879631553,-94.37694220845151,-70.58542380455765,-109.79750498800422,62886.859430198216,62130.45077344817,14.877970002804732,17.085836062540587,False,True,61777.738,62677.738,62177.738,62127.738,,False,2024-05-08 12:45:00,2024-05-08 16:41:39,2024-05-08 05:05:39,fail,False,-74.66,8094.66,,0,1,19,5
2024-05-08 03:15:00,62423.039,62552.539,62336.84,62394.219,2234,36422,0,2024-05-08 03:00:00,2024-05-08 03:00:00,-232.39691666666477,-180.64360541690257,62573.105833333335,-0.0018591294400017641,-0.001742489668044993,62645.20172619047,61580.1990016257,62409.33039719678,62588.34680090254,62832.213531347246,62399.186512899854,-132.10760935266444,-112.78170523451762,289.4027229881075,-55.0936277950168,-55.12496112832014,-94.37694220845151,62789.8801889338,62006.99283686591,18.3590192480055,17.62706738138313,False,True,61894.219,62794.219,62294.219,62244.219,,False,2024-05-08 09:30:00,2024-05-08 16:09:28,2024-05-08 05:45:47,fail,False,-74.66,8020.0,,0,2,19,5
2024-05-08 04:00:00,62547.738,62650.938,62468.84,62568.438,2389,36422,0,2024-05-08 04:00:00,2024-05-08 04:00:00,-72.09589285713446,-210.62645239308767,62505.26722619047,-0.001862278321248383,-0.0014776516757831711,62573.105833333335,61463.633439180514,62417.01081353717,62576.24046427004,62775.50997466345,62377.501776401805,-120.63249126464507,-118.3400644504489,290.2288636331932,0.9746250430180226,-12.898421396639606,-9.760940144427877,62770.81074230662,61985.69281049699,49.07530705224274,39.872033243359965,True,False,63068.438,62668.438,62668.438,62718.438,2024-05-08 05:45:00,True,2024-05-08 05:45:00,2024-05-10 01:47:21,2024-05-08 06:19:27,even,True,18.66,8038.66,,1,0,19,5
2024-05-08 05:00:00,62481.84,62720.539,62481.84,62676.84,1456,36422,0,2024-05-08 05:00:00,2024-05-08 05:00:00,-67.83860714286129,-236.9738059796291,62533.31584523809,-0.0024428119087096254,-0.0010283127428512141,62505.26722619047,61134.24364005085,62549.83244488549,62567.93380614747,62716.71546849586,62432.19307051939,-103.31667713549541,-113.68976372556071,271.5776249978971,47.741776745795505,11.414169590621896,6.148721362238575,62800.32286426655,62065.56327677223,52.52190970266839,48.48282244286742,True,False,63176.84,62776.84,62776.84,62826.84,2024-05-08 06:45:00,True,2024-05-08 06:45:00,2024-05-10 01:47:46,2024-05-08 07:26:15,even,True,18.66,8057.32,,2,0,19,5
2024-05-08 06:00:00,62705.691,62781.738,62671.082,62701.938,992,36422,0,2024-05-08 06:00:00,2024-05-08 06:00:00,28.04861904761492,-237.02846983256313,62616.82883333335,-0.0014954862078767357,-0.0005053127220285488,62533.31584523809,61393.237560582034,62797.20204624807,62638.7520704389,62715.90192549916,62668.846917096635,-72.55877172992041,-94.42457705367836,238.52268383707283,64.3741723425992,60.812815273537126,52.496147230805946,62992.35254027668,62346.84129391659,89.28023451730637,86.37971946909427,True,False,63201.938,62801.938,62801.938,62851.938,2024-05-08 06:45:00,True,2024-05-08 06:45:00,2024-05-10 01:47:50,2024-05-08 07:25:52,even,True,18.66,8075.98,,3,0,19,5
2024-05-08 07:00:00,62844.773,62901.738,62807.578,62853.539,1499,36422,0,2024-05-08 07:00:00,2024-05-08 07:00:00,83.51298809525906,-223.220374904442,62577.83355952382,2.4998976855170735e-05,-0.00031790389474856584,62616.82883333335,62055.81087887852,62895.59569747144,62727.632377133006,62742.37763961023,62830.770693154416,-41.469006069994066,-69.08425813887787,198.6359717876016,35.05020158235129,28.76493257655966,50.02772411422484,63100.42925506768,62562.612131241156,90.70973768813616,88.94689121222764,True,False,63353.539,62453.539,62953.539,63003.539,,False,2024-05-10 02:00:00,2024-05-10 01:52:26,2024-05-08 07:40:43,fail,False,-74.66,8001.32,,0,1,19,5
2024-05-08 13:00:00,62272.438,62322.938,62219.789,62299.238,1469,36422,0,2024-05-08 13:00:00,2024-05-08 13:00:00,-82.8965595238551,-286.2946989415577,62288.00971428572,-0.000903653332042014,-0.0013007218962405938,62280.44472619047,61635.21766525222,62159.33608926673,62256.02869358305,62358.14751330306,62175.31368524254,-67.78568805861869,-71.03632595629216,206.93542693970846,34.00605813565198,17.96432163731515,-39.33905641549791,62456.17651161114,61895.95085887393,38.764641368720596,31.450613817715844,True,False,62799.238,61899.238,62399.238,62449.238,,False,2024-05-08 17:30:00,2024-05-10 01:37:04,2024-05-08 16:09:28,fail,False,-74.66,7926.66,,0,2,19,5
2024-05-08 14:00:00,62409.938,62472.637,62137.84,62197.738,2137,36422,0,2024-05-08 14:00:00,2024-05-08 14:00:00,7.564988095247827,-276.5556920013187,62265.929464285706,-0.0005783563743151579,-0.0011491749015802304,62288.00971428572,61738.00480477816,62182.52868361994,62293.38119067083,62353.468821735645,62282.32919195044,-49.82724199493532,-60.080514519524606,156.3076257793908,-3.9838321293427725,16.55177158589504,35.22996216030151,62493.34448675262,62069.81389714826,65.28599882835319,70.48953866856012,True,False,62697.738,62297.738,62297.738,62347.738,2024-05-08 15:15:00,True,2024-05-08 15:15:00,2024-05-08 17:44:29,2024-05-08 15:18:48,even,True,18.66,7945.32,,1,0,19,5
2024-05-08 15:00:00,62206.738,62412.039,62181.84,62380.438,1625,36422,0,2024-05-08 15:00:00,2024-05-08 15:00:00,-22.08025000001362,-281.9435846606648,62226.39295238098,-0.0006045321588460656,-0.0006384005359568905,62265.929464285706,61689.977359800345,62272.434620219654,62278.712432079104,62327.608381548445,62297.618605779135,-42.84224767812702,-52.53725130043302,113.45840521435954,27.625584451256145,-17.44312349503889,11.927361541173013,62452.28745281852,62144.44975873975,55.192137076899456,45.447498886696685,True,False,62880.438,61980.438,62480.438,62530.438,,False,2024-05-08 17:45:00,2024-05-10 01:38:13,2024-05-08 16:09:27,fail,False,-74.66,7870.66,,0,1,19,5
2024-05-08 15:30:00,62301.637,62351.738,62071.738,62121.738,1975,36422,0,2024-05-08 15:00:00,2024-05-08 15:00:00,-22.08025000001362,-281.9435846606648,62226.39295238098,-0.0006045321588460656,-0.0006384005359568905,62265.929464285706,61689.977359800345,62272.434620219654,62257.546782731195,62310.5774217665,62264.47945579633,-42.39734479319304,-48.49560284576606,104.40752362332047,-34.51095975230419,1.3718097695018514,27.625584451256145,62405.42961268782,62122.02929890485,50.54155175967813,54.135573970662904,False,True,61621.738,62021.738,62021.738,61971.738,2024-05-08 16:15:00,True,2024-05-08 16:15:00,2024-05-08 23:19:43,2024-05-08 16:16:18,even,True,18.66,7889.32,,1,0,19,5
2024-05-09 01:30:00,61324.738,61396.258,61191.238,61214.066,1928,36422,0,2024-05-09 01:00:00,2024-05-09 01:00:00,-262.9528690476145,-289.7537451757162,61534.10284523812,-0.0018087790936436644,-0.002904598015595655,61799.38317857142,60606.136688374936,61278.5921240534,61556.46883568873,61833.667201702265,61194.11083281734,-129.39042983187392,-90.49547854794837,494.766935441829,-65.08231269347743,-67.804339525268,-127.02334434125078,61862.04619566381,60524.675469970876,12.202859318307949,11.632543362457303,False,True,60714.066,61114.066,61114.066,61064.066,2024-05-09 02:30:00,True,2024-05-09 02:30:00,2024-05-09 13:59:54,2024-05-09 02:47:19,even,True,18.66,7907.98,,2,0,19,5
2024-05-09 04:00:00,61346.441,61492.84,61323.523,61481.84,1468,36422,0,2024-05-09 04:00:00,2024-05-09 04:00:00,-92.69008333334205,-396.5099498359632,61236.76333333335,-0.0029823704344465584,-0.0027354271011613505,61189.49791666664,59742.75086724251,60860.34351090786,61336.737359188104,61521.38353253843,61213.36565806673,-123.42853673836362,-135.33259148367333,374.9779833065864,57.94881768147752,35.57228207773733,62.29757825942943,61721.085935530624,60707.14538060284,69.24370861314092,61.66110166492499,True,False,61981.84,61581.84,61581.84,61631.84,2024-05-09 07:15:00,True,2024-05-09 07:15:00,2024-05-09 18:26:32,2024-05-09 07:21:22,even,True,18.66,7926.639999999999,,3,0,19,5
2024-05-09 05:00:00,61511.438,61527.738,61441.938,61496.34,1131,36422,0,2024-05-09 05:00:00,2024-05-09 05:00:00,47.265416666712554,-388.43948129049386,61367.83946428571,-0.001463046490785692,-0.00195749108664674,61236.76333333335,60203.72781318849,61162.90139842687,61405.28144273216,61509.184959737424,61427.691420364565,-90.07240234357596,-114.57754248466551,228.00730868652323,64.09210698313109,65.72852941171732,35.13637254908099,61737.00128709137,61119.88155363776,93.34641701943387,91.37127543165855,True,False,61996.34,61596.34,61596.34,61646.34,2024-05-09 07:15:00,True,2024-05-09 07:15:00,2024-05-09 18:26:32,2024-05-09 07:21:18,even,True,18.66,7945.299999999999,,4,0,19,5
2024-05-09 06:00:00,61616.238,61760.738,61482.84,61504.738,1506,36422,0,2024-05-09 06:00:00,2024-05-09 06:00:00,131.07613095235865,-369.6567554353096,61505.73411904768,0.0009207926548115706,-0.0010051186559053898,61367.83946428571,61276.87310441132,61510.44688621584,61487.169612444995,61526.88303095815,61613.341996560055,-57.44450775133009,-85.64357440689787,191.855494810928,18.850007911976718,53.30616615062172,49.51131888551754,61873.84691455481,61354.3370785653,86.3103386305163,93.85653837468526,True,False,62004.738,61604.738,61604.738,61654.738,2024-05-09 07:15:00,True,2024-05-09 07:15:00,2024-05-09 18:26:33,2024-05-09 07:20:29,even,True,18.66,7963.959999999999,,5,0,19,5
2024-05-09 07:00:00,61624.754,61710.137,61591.297,61659.539,1164,36422,0,2024-05-09 07:00:00,2024-05-09 07:00:00,137.89465476197074,-349.6691980794276,61530.47328571432,0.0018262942570324938,0.00013261460926390303,61505.73411904768,61836.60616717001,61801.37446836959,61545.2558220583,61546.41165104316,61651.09760165116,-33.27520481339161,-59.649571809937434,203.22451700826724,3.2718108015469625,0.6470261438371381,24.296158926663338,61926.950699612324,61376.74450369,75.16783170315288,70.22528155952871,True,False,62159.539,61259.539,61759.539,61809.539,,False,2024-05-09 18:15:00,2024-05-09 18:28:03,2024-05-09 10:36:50,fail,False,-74.66,7889.299999999999,,0,1,19,5
2024-05-09 08:00:00,61458.34,61542.039,61442.629,61532.84,901,36422,0,2024-05-09 08:00:00,2024-05-09 08:00:00,24.739166666637175,-343.29667652619537,61570.772833333336,0.0015729620343405584,0.000763089531534979,61530.47328571432,61792.541542848274,62044.95187497732,61523.85370332816,61534.255707366836,61570.91559098728,-27.597316603678337,-41.89786226982423,193.02675545601608,-7.661220158224751,-26.047298245626735,-19.784048503570375,61831.5017108529,61308.82947112166,33.534298580478044,39.10280908092648,False,True,61032.84,61432.84,61432.84,61382.84,2024-05-09 11:00:00,True,2024-05-09 11:00:00,2024-05-09 12:22:45,2024-05-09 15:31:27,success,True,93.29,7982.589999999999,,1,0,19,5
2024-05-09 10:00:00,61559.07,61600.438,61443.453,61531.738,1649,36422,0,2024-05-09 10:00:00,2024-05-09 10:00:00,13.113749999996799,-311.0174396635048,61446.401523809516,-6.180053803485168e-05,-0.0001359628624014468,61583.88658333333,61053.24699730763,61692.74554674497,61560.66149899832,61551.77184003285,61567.54633505331,-8.696345770324115,-17.874747167271234,76.52495669332599,0.1591503268064116,-0.48998348812165204,-6.187652218854055,61672.3550265893,61464.23764351732,48.197920300592294,60.84940826601083,False,True,61031.738,61431.738,61431.738,61381.738,2024-05-09 11:00:00,True,2024-05-09 11:00:00,2024-05-09 12:22:48,2024-05-09 15:31:27,success,True,93.29,8075.879999999999,,2,0,19,5
2024-05-09 13:15:00,61141.16,61141.16,60931.848,60983.738,2042,36422,0,2024-05-09 13:00:00,2024-05-09 13:00:00,-66.797702381009,-318.99821961231646,61090.524892857204,-0.0015536796153981707,-0.0013990397149061912,61291.28727380949,60329.976917485896,61045.84016015107,61203.78563605974,61321.802003955425,61043.593934296536,-60.13927477157267,-46.54008474651991,204.17629286086233,-53.94930650153401,-29.77997213623894,-19.18892122467514,61319.2319296587,60766.45593893437,31.50085099186536,29.635590665712908,False,True,60483.738,60883.738,60883.738,60833.738,2024-05-09 14:00:00,True,2024-05-09 14:00:00,2024-05-10 19:05:45,2024-05-09 14:00:41,even,True,18.66,8094.539999999999,,3,0,19,5
2024-05-09 15:00:00,61009.934,61188.438,60978.07,61171.738,1613,36422,0,2024-05-09 15:00:00,2024-05-09 15:00:00,-64.7066666667015,-354.70548505484476,61122.91145238094,-0.0022422136795279077,-0.000399739711310099,61025.8182261905,59845.949673968214,61487.349451115006,61075.037156750754,61188.30338610348,60974.92093842447,-68.22132645973034,-67.40038688286731,252.0475775750654,35.762480908146244,5.7492184382426785,22.483243894013867,61316.685168150805,60634.65670869813,64.9695742044718,57.423108190260514,True,False,61671.738,61271.738,61271.738,61321.738,2024-05-09 15:45:00,True,2024-05-09 15:45:00,2024-05-09 18:06:20,2024-05-09 16:31:43,even,True,18.66,8113.199999999999,,4,0,19,5
2024-05-10 01:00:00,62472.238,62608.438,62424.969,62563.035,1822,56422,0,2024-05-10 01:00:00,2024-05-10 01:00:00,59.4138452380721,115.91037397990294,62733.67330952378,0.002386822261312114,0.0020727250886434768,62451.591190476174,63030.08854404792,63938.0934678016,62421.805026837275,62223.975877550525,62588.5101940145,122.19195945023239,120.9548796268519,236.4091113137924,27.400298589636805,8.397014447917172,4.617984864089522,62909.162494288124,62269.35789374088,65.66568656461946,67.10933922862559,False,True,62063.035,62963.035,62463.035,62413.035,,False,2024-05-10 17:30:00,2024-05-10 17:31:40,2024-05-10 01:43:39,fail,False,-74.66,8038.539999999999,,0,1,19,5
2024-05-10 01:45:00,62928.895,63403.242,62881.84,63234.539,2898,36422,0,2024-05-10 01:00:00,2024-05-10 01:00:00,59.4138452380721,115.91037397990294,62733.67330952378,0.002386822261312114,0.0020727250886434768,62451.591190476174,63030.08854404792,63938.0934678016,62645.18703446537,62378.367189896206,62822.26447884423,148.82367628700013,129.20416873767704,338.06410565688435,120.32653594776639,79.9498145854086,33.47793429654848,63280.15102148102,62365.877936207435,90.94164637769661,84.93051764092827,True,False,63734.539,62834.539,63334.539,63384.539,,False,,,2024-05-10 02:35:54,fail,False,-74.66,7963.879999999999,,0,2,19,5
2024-05-10 04:00:00,62800.637,62887.738,62614.41,62697.738,1678,36422,0,2024-05-10 04:00:00,2024-05-10 04:00:00,24.32444047617173,279.4763706500016,62946.10614285718,0.0017905278182587315,0.002669726201980213,62957.331619047596,63070.14797042982,64607.84120510259,62799.19248707382,62620.3643019715,62942.98715514281,126.24867147185432,139.96865419881476,276.7918019474138,-39.62043446845928,-22.491156174786738,-3.5054351564103854,63316.656087771815,62567.8182225138,39.28255468237679,44.05293681875841,False,True,62197.738,63097.738,62597.738,62547.738,,False,2024-05-10 17:15:00,2024-05-10 17:28:41,2024-05-10 09:52:08,fail,False,-74.66,7889.219999999999,,0,3,19,5
2024-05-10 05:00:00,62831.801,62844.84,62719.938,62719.938,1797,36422,0,2024-05-10 05:00:00,2024-05-10 05:00:00,-11.225476190418703,294.3857057892965,62932.10313095237,0.0013206809472031235,0.00035559400899079117,62946.10614285718,63033.724814262525,63585.01160261479,62779.972881245325,62657.557155009905,62822.942933952574,100.67866967082955,121.3905044037467,221.80515179348126,-51.94500343994878,-19.727387340855785,-31.03249191602663,63122.37988887377,62522.005979031375,20.531872315154704,26.302323874276926,False,True,62219.938,63119.938,62619.938,62569.938,,False,2024-05-10 17:15:00,2024-05-10 17:28:35,2024-05-10 09:53:17,fail,False,-74.66,7814.5599999999995,,0,4,19,5
2024-05-10 06:00:00,62856.238,62862.137,62736.293,62785.938,1648,36422,0,2024-05-10 06:00:00,2024-05-10 06:00:00,-14.003011904809682,304.6610571857309,62908.913130952365,0.0010376619465431375,-0.0011132218204689443,62932.10313095237,63000.88729453211,62767.746828245676,62815.45825448383,62710.23518430783,62758.74568902652,87.85782256459788,104.67324258940006,187.40954515477483,-11.861679050605744,-16.604049879475497,-8.09431682153081,63011.74857498546,62504.24280306757,47.45117450426196,44.18319862309837,False,True,62285.938,63185.938,62685.938,62635.938,,False,2024-05-10 17:15:00,2024-05-10 17:19:19,2024-05-10 10:00:45,fail,False,-74.66,7739.9,,0,5,19,5
2024-05-10 07:00:00,62868.039,62909.34,62741.871,62843.738,1080,36422,0,2024-05-10 07:00:00,2024-05-10 07:00:00,-23.19000000000233,309.6783717306753,62888.59432142852,0.0008719359196253756,-0.0011676140056781287,62908.913130952365,62964.25679835407,62663.56350894388,62826.06942291578,62743.73583629838,62811.229701066404,72.92980370944133,88.4644325946599,132.0706103800909,4.7844743721871055,10.554466804293043,5.59696491232171,62991.02502507953,62632.93437705328,57.46860565562113,52.48853472708138,False,True,62343.738,62743.738,62743.738,62693.738,2024-05-10 08:30:00,True,2024-05-10 08:30:00,2024-05-10 17:19:08,2024-05-10 08:38:38,even,True,18.66,7758.5599999999995,,1,0,19,5
2024-05-10 08:00:00,62888.34,62929.738,62732.074,62735.723,1325,36422,0,2024-05-10 08:00:00,2024-05-10 08:00:00,-20.31880952384381,312.20231478747155,62780.50670238094,0.00044418905627856373,-0.0010723049709732279,62888.59432142852,62731.97764711024,62656.42738835755,62831.04201081579,62769.96441405924,62858.51130753355,59.3472350578304,74.83004408767744,88.43778471286302,-16.992478156054858,16.624423804532853,6.907987272061291,62977.90231689591,62737.62029817118,46.85244039502815,62.16452981794078,False,True,62235.723,63135.723,62635.723,62585.723,,False,2024-05-10 17:15:00,2024-05-10 17:20:11,2024-05-10 09:54:26,fail,False,-74.66,7683.9,,0,1,19,5
2024-05-10 09:00:00,62708.711,62869.539,62684.863,62869.539,1113,36422,0,2024-05-10 09:00:00,2024-05-10 09:00:00,-108.08761904758285,297.1322836805557,62897.78351190477,1.4952772590874809e-05,-0.00026984968780904806,62780.50670238094,62623.50175403978,63109.25885684954,62789.024921688804,62761.173940975365,62775.907586859226,39.673885756827076,55.82060242490635,81.82730702986416,3.1718603370245546,-18.601685930487292,-34.47752218783717,62887.87445134954,62665.44072236891,37.22729829712836,22.269181883954484,True,False,63369.539,62969.539,62969.539,63019.539,2024-05-10 10:00:00,True,2024-05-10 10:00:00,2024-05-10 15:02:40,2024-05-10 10:08:45,even,True,18.66,7702.5599999999995,,1,0,19,5
2024-05-10 12:15:00,62861.133,62919.738,62813.637,62881.738,1201,36422,0,2024-05-10 12:00:00,2024-05-10 12:00:00,26.79185714286723,312.6827903344529,63041.57735714287,0.0005111276947685408,0.001129790618585178,62994.44490476192,62876.89035598032,63778.86261520209,62935.68334245402,62893.36217412969,63020.03875232202,37.81768695464416,46.698074953293116,141.0969491187911,-7.817102855122357,-15.413591331292992,22.80198486414156,63210.519633632386,62828.05787101165,37.343224582284584,40.85840932967117,True,False,63381.738,62981.738,62981.738,63031.738,2024-05-10 12:45:00,True,2024-05-10 12:45:00,2024-05-10 15:02:44,2024-05-10 13:05:17,even,True,18.66,7721.219999999999,,2,0,19,5
2024-05-10 13:15:00,62899.836,63043.539,62891.84,63035.039,552,36422,0,2024-05-10 13:00:00,2024-05-10 13:00:00,47.1324523809526,313.0112898414736,63042.861238095196,0.0006347336105044543,0.0009616213652325989,63041.57735714287,62979.43503442646,63775.184450866094,62982.9982183001,62931.70332603884,63003.60377296183,38.87283954472514,42.98303483854099,151.56262281043809,-11.059501547941181,-36.59888200899877,3.3498596491626813,63208.21331375592,62797.494232167744,39.34302504745971,46.40365286811532,True,False,63535.039,63135.039,63135.039,63185.039,2024-05-10 15:00:00,True,2024-05-10 15:00:00,,2024-05-10 15:19:48,even,True,18.66,7739.879999999999,,3,0,19,5
2024-05-10 22:00:00,60665.84,60847.539,60610.637,60694.84,2287,36422,0,2024-05-10 22:00:00,2024-05-10 22:00:00,-270.3906190476555,-362.85396944308013,60437.54971428566,-0.0037209607148948015,-0.007131776600289718,60530.726809523774,58632.85725514486,59128.89262930092,60715.17959283448,61199.93099324955,60472.213580323296,-291.6879587669755,-289.47029148635346,897.1067036025858,72.50708978324838,79.06206811143056,61.95603371172183,61684.807630186784,59261.11953045981,45.85184062261671,36.570952542193375,True,False,61194.84,60294.84,60794.84,60844.84,,False,2024-05-13 00:15:00,2024-05-13 00:00:02,,success,True,93.29,7833.169999999999,,4,0,19,5
2024-05-10 23:00:00,60664.238,60918.637,60546.641,60792.035,2126,36422,0,2024-05-10 23:00:00,2024-05-10 23:00:00,-93.17709523811209,-418.15667058519466,60391.91864285711,-0.003721040123967166,-0.00574811484610443,60437.54971428566,58415.35591604037,59527.603192342,60704.164701120055,61063.719668125166,60557.42700997595,-248.33262914545776,-274.2679142446908,532.2415668382912,45.31696972825739,35.056266253879585,4.493810457563086,61277.45312520765,59838.900894744256,57.723152359573,51.24343186858297,True,False,61292.035,60892.035,60892.035,60942.035,2024-05-13 00:15:00,True,2024-05-13 00:15:00,2024-05-13 01:08:58,2024-05-13 00:25:12,even,True,18.66,7851.829999999999,,5,0,19,5
2024-05-13 00:00:00,61225.25,61234.84,61131.84,61200.039,973,52422,0,2024-05-13 00:00:00,2024-05-13 00:00:00,-45.63107142855006,-472.54630059014744,60733.98071428568,0.0007076853567692119,-0.004101162894881862,60391.91864285711,60465.65323884186,60268.72190187755,60732.820294425925,60979.02771405555,60714.98849638804,-199.94775360384665,-242.47065625751233,234.70586629625151,131.3084203646722,-14.51657378742675,22.58118610252859,61033.34141588798,60398.1355768881,66.2726211069517,60.827455778052006,True,False,61700.039,61300.039,61300.039,61350.039,2024-05-13 02:15:00,True,2024-05-13 02:15:00,2024-05-13 03:30:17,2024-05-13 04:18:38,success,True,93.29,7945.119999999999,,6,0,20,5
2024-05-13 01:00:00,61191.738,61308.738,61149.047,61281.938,1177,56422,0,2024-05-13 01:00:00,2024-05-13 01:00:00,342.06207142856874,-451.86772238217236,60938.02194047624,0.0008405037935194336,0.00025237105945889336,60733.98071428568,60581.21749681834,61440.347601743015,60953.46275840097,61031.47742122069,61103.869511179895,-121.5436519349314,-185.3482706758108,280.43896825581504,94.19913484690187,77.84060096321627,107.3028627450185,61483.962118325246,60725.276904034545,93.47671705413838,89.96209431024192,True,False,61781.938,61381.938,61381.938,61431.938,2024-05-13 02:45:00,True,2024-05-13 02:45:00,2024-05-13 10:52:44,2024-05-13 04:13:16,even,True,18.66,7963.779999999999,,7,0,20,5
2024-05-13 04:00:00,61464.305,61506.773,61343.867,61390.738,1432,36422,0,2024-05-13 04:00:00,2024-05-13 04:00:00,213.19839285713533,-345.4804469048904,61427.44283333336,0.0024254285176188786,0.0026993144107248087,61367.1127857143,61736.838452716525,62613.21233006892,61392.6086103799,61282.650261919116,61591.384907808686,17.332672601987724,-18.534456927472352,367.46214587960054,-37.461487100117665,-4.502249054065032,27.759029239699885,62087.458804746144,61093.81101087123,58.07491136128592,74.49116480474144,False,True,60890.738,61290.738,61290.738,61240.738,2024-05-13 04:45:00,True,2024-05-13 04:45:00,2024-05-13 06:05:34,2024-05-13 04:46:27,even,True,18.66,7982.439999999999,,8,0,20,5
2024-05-13 05:00:00,61366.906,61468.238,61283.063,61291.637,1736,36422,0,2024-05-13 05:00:00,2024-05-13 05:00:00,60.33004761906341,-319.36081501384615,61347.787226190514,0.0013792162450315764,0.00262994007733511,61427.44283333336,61241.600877629746,62756.10532324962,61355.771284849,61292.22303831311,61427.521197110356,14.356665687737404,1.7001133059187417,305.1645992768133,-34.67018197460857,-27.756575851388334,-43.76043997247325,61839.493406134054,61014.04898808666,21.985682948974027,26.110228541416376,False,True,60791.637,61191.637,61191.637,61141.637,2024-05-13 05:30:00,True,2024-05-13 05:30:00,2024-05-13 06:18:22,2024-05-13 05:41:31,even,True,18.66,8001.0999999999985,,9,0,20,5
2024-05-13 06:00:00,61005.039,61069.539,60831.84,60831.84,2447,36422,0,2024-05-13 06:00:00,2024-05-13 06:00:00,-79.65560714284948,-324.8368434181393,61286.764011904794,0.0007823357295677555,0.0011891877166152057,61347.787226190514,60923.44913649141,62287.23371586582,61166.39210978167,61208.44431335004,61103.44312693496,-19.50192367080308,-4.007081598688275,194.75585931368593,-100.36492707260186,-71.94396869622142,-78.12325249403511,61366.36353700844,60839.02271686148,8.036043483715975,10.658408468192212,False,True,60331.84,61231.84,60731.84,60681.84,,False,,,2024-05-13 09:40:14,fail,False,-74.66,7926.439999999999,,0,1,20,5
2024-05-13 09:00:00,60819.539,61115.738,60747.852,61098.754,1513,36422,0,2024-05-13 09:00:00,2024-05-13 09:00:00,-141.6620476190219,-329.4139415708778,61076.181833333336,-0.0018190226984068731,-0.0006623595714845651,60967.621892857154,59961.85418261887,61359.845795512556,60976.46676257329,61050.311130350834,60883.56913587891,-42.7062619434073,-39.689693245566765,258.2598386966302,36.209602339156845,-6.292776401765877,1.7062841416845913,61233.719918119365,60534.91835363846,44.62885580010549,30.874823618674174,True,False,61598.754,61198.754,61198.754,61248.754,2024-05-13 09:45:00,True,2024-05-13 09:45:00,2024-05-13 10:03:08,2024-05-14 15:30:22,success,True,93.29,8019.729999999999,,1,0,20,5
2024-05-13 10:00:00,61460.84,61724.539,61410.059,61481.84,2744,36422,0,2024-05-13 10:00:00,2024-05-13 10:00:00,108.55994047618151,-281.6443301676554,61467.99639285717,8.458062161090317e-05,0.0014702326338287375,61076.181833333336,60773.67808599925,62779.6601321876,61186.00003532214,61142.038844355804,61245.59405435154,1.9085334592236904,-23.785598207859714,222.70065081200332,86.94080770551955,95.81724045403826,111.19950808394788,61547.73993294774,60944.94817575534,87.55487309073534,91.18565480198333,True,False,61981.84,61581.84,61581.84,61631.84,2024-05-13 10:30:00,True,2024-05-13 10:30:00,2024-05-13 10:52:50,2024-05-13 10:32:02,even,True,18.66,8038.3899999999985,,2,0,20,5
2024-05-13 15:00:00,62683.738,62806.34,62552.547,62580.738,2098,36422,0,2024-05-13 15:00:00,2024-05-13 15:00:00,162.21261904764106,174.44850728466554,62934.03257142855,0.004424926075261452,0.0030490788614330067,62851.46161904763,63507.78753766012,64650.238558655336,62592.58530481912,62319.99524859713,62655.25752390779,179.28569311368483,192.78732570725901,621.4051642218803,-102.72396388030029,-72.78298830414133,-79.31246095620736,63494.154495607334,61814.86055220825,32.20306944636783,34.45194136523468,False,True,62080.738,62980.738,62480.738,62430.738,,False,2024-05-14 09:15:00,2024-05-14 09:10:31,2024-05-13 16:23:32,fail,False,-74.66,7963.729999999999,,0,1,20,5
2024-05-13 17:00:00,62725.871,62941.84,62710.691,62934.137,2011,36422,0,2024-05-13 17:00:00,2024-05-13 17:00:00,-69.70628571428824,250.24421141215862,62767.91164285713,0.002918492650425788,-0.0005734182105832301,62864.32628571426,63421.98614292299,62930.139644965,62731.146715678085,62528.54082536181,62750.60895080836,146.37611231248593,161.89178670472901,153.4222507260893,65.98566941866738,31.41090540066216,-0.7705992431292543,62959.22898928858,62543.48891232814,63.53873422485187,59.20876308679997,False,True,62434.137,62834.137,62834.137,62784.137,2024-05-13 17:45:00,True,2024-05-13 17:45:00,2024-05-14 06:02:47,2024-05-13 17:56:13,even,True,18.66,7982.3899999999985,,1,0,20,5
2024-05-13 18:00:00,62711.84,62943.84,62666.137,62862.637,2103,36422,0,2024-05-13 18:00:00,2024-05-13 18:00:00,-96.414642857133,268.64244716529356,62796.18442857138,0.00041821411539487506,-0.0002532521237291435,62767.91164285713,62566.538341520085,63096.78408756361,62776.76526046857,62608.070716785034,62856.29728758162,128.60334665409027,146.17580467242965,155.41687522507996,17.05055589951371,-6.87823632612708,12.85297901611193,63067.61006913548,62646.48450602776,57.011368283385764,65.73605494335226,False,True,62362.637,63262.637,62762.637,62712.637,,False,2024-05-13 20:30:00,2024-05-14 06:34:10,2024-05-13 19:25:50,fail,False,-74.66,7907.729999999999,,0,1,20,5
2024-05-13 20:45:00,62655.738,62818.637,62655.738,62765.84,1968,36422,0,2024-05-13 20:00:00,2024-05-13 20:00:00,110.79404761915794,334.5901309438923,62910.93166666664,0.0005941878139080632,0.0009649558814614612,62906.97847619054,62718.564604087005,63725.84808562548,62841.241103853776,62766.75039209848,62887.4625077399,79.3987309239601,106.38558527470694,160.17795302483606,-27.9396800825416,-46.27071929829981,-56.5729779841713,63103.70274432343,62669.72227115637,12.816423871158696,19.805729065694113,True,False,63265.84,62865.84,62865.84,62915.84,2024-05-13 22:30:00,True,2024-05-13 22:30:00,2024-05-15 15:30:13,2024-05-14 00:43:08,even,True,18.66,7926.3899999999985,,1,0,20,5
2024-05-14 03:00:00,62893.938,62912.238,62783.965,62796.84,1832,36422,0,2024-05-14 03:00:00,2024-05-14 03:00:00,-4.391130952433741,289.4990821835163,62848.70475000001,0.000427397070055649,-0.0002527921981414349,62860.451119047626,62790.913432660185,63015.43982645528,62840.72777292587,62845.02585655875,62756.091042999666,12.332428287903895,22.591355714687943,146.21889330543695,-12.212031991766708,-2.6340911592851626,-7.745560371418833,62953.486548962006,62557.195537037325,43.46053430471588,42.74771263044541,True,False,63296.84,62896.84,62896.84,62946.84,2024-05-14 04:30:00,True,2024-05-14 04:30:00,2024-05-15 15:30:16,2024-05-14 04:40:37,even,True,18.66,7945.049999999998,,2,0,20,5
2024-05-14 15:00:00,61746.715,62002.34,61704.777,61971.738,1862,36422,0,2024-05-14 15:00:00,2024-05-14 15:00:00,-68.28290476187249,-146.57817106025323,61589.28167857147,-0.0011028574963721466,-0.0016008059648705622,61685.7101309524,60680.39655068628,61665.93781302295,61790.77623645562,61906.20790112478,61726.47979635363,-89.05334013233369,-105.14987602398632,122.83637759946043,46.10740970077313,6.166339869327203,-0.8093501892944914,61893.80890611291,61560.65068659436,72.98372063413272,65.04794887441075,True,False,62471.738,61571.738,62071.738,62121.738,,False,2024-05-15 11:00:00,2024-05-15 12:45:24,2024-05-14 15:30:08,fail,False,-74.66,7870.3899999999985,,0,1,20,5
2024-05-14 15:45:00,61746.938,61793.738,61512.328,61518.238,3052,36422,0,2024-05-14 15:00:00,2024-05-14 15:00:00,-68.28290476187249,-146.57817106025323,61589.28167857147,-0.0011028574963721466,-0.0016008059648705622,61685.7101309524,60680.39655068628,61665.93781302295,61755.4766202651,61866.34397495679,61730.52844272444,-83.10188088483119,-93.53957843997776,127.36481492381226,-37.59106948745466,-0.6555576195460162,42.29527347780822,61902.47094287159,61557.085942577294,65.06357356143944,73.71095621541046,False,True,61018.238,61918.238,61418.238,61368.238,,False,2024-05-14 19:45:00,,2024-05-14 16:24:10,fail,False,-74.66,7795.729999999999,,0,2,20,5
2024-05-14 23:00:00,61545.438,61626.738,61497.203,61590.637,867,36422,0,2024-05-14 23:00:00,2024-05-14 23:00:00,24.502345238128328,-254.9548107309529,61453.24332142861,0.0001331122936202026,-0.0016262551494610317,61444.542773809575,61157.216066292945,61258.396672275536,61487.260570312654,61533.42235092063,61453.37090952869,-47.0258707362882,-63.79064948076694,206.73652673625753,52.940650498749164,53.7457227382547,62.92204712757666,61733.96522062264,61174.27659843474,90.38629860480025,82.35190994114333,True,False,62090.637,61690.637,61690.637,61740.637,2024-05-15 05:15:00,True,2024-05-15 05:15:00,2024-05-15 10:38:47,,success,True,93.29,7889.019999999999,,1,0,20,5
2024-05-15 00:00:00,61561.34,61592.137,61528.516,61554.84,368,56422,0,2024-05-15 00:00:00,2024-05-15 00:00:00,8.700547619031568,-244.0547618382334,61504.226178571465,0.0001330588492799516,-0.0012111365967883397,61453.24332142861,61165.310644123914,61439.419533529304,61529.691709602164,61544.70663303804,61602.47605435155,-29.456682450203516,-46.07485331680411,177.83048348087027,16.27428895766934,29.48288544897514,45.384520811756374,61844.047207050724,61362.40490165238,84.1370487018912,87.20147444406162,True,False,62054.84,61654.84,61654.84,61704.84,2024-05-15 05:15:00,True,2024-05-15 05:15:00,2024-05-15 10:38:31,,success,True,93.29,7982.309999999999,,2,0,20,5
2024-05-15 01:00:00,61628.691,61670.137,61589.523,61609.637,1138,56422,0,2024-05-15 01:00:00,2024-05-15 01:00:00,50.98285714285885,-226.31193422327487,61577.64736904762,0.0010995358572018737,-0.0006272436981025071,61504.226178571465,61708.90361291794,61560.840336558045,61568.1567893381,61560.60504444047,61657.37710870311,-15.059520534719923,-30.697019010708125,143.16849771410884,-1.9010006880271249,26.064951152424328,33.992475060164,61850.654580617156,61462.59963678907,82.94802696575861,79.81052145636203,True,False,62109.637,61709.637,61709.637,61759.637,2024-05-15 05:15:00,True,2024-05-15 05:15:00,2024-05-15 10:38:49,2024-05-15 05:33:15,even,True,18.66,8000.969999999998,,3,0,20,5
2024-05-15 02:00:00,61663.938,61676.238,61566.691,61586.738,878,36422,0,2024-05-15 02:00:00,2024-05-15 02:00:00,73.42119047615415,-208.24450023179816,61610.25255952381,0.0010528936530849158,-0.00010139591763041954,61577.64736904762,61747.87584980227,61702.295902795086,61593.39380479321,61576.25959879376,61639.18807636733,-5.495761529127776,-17.32507516986825,150.5990086383985,-15.466887856942776,-6.643733402182988,13.963138974882895,61842.49673802917,61434.379414705494,69.10226556556727,69.01244696515987,True,False,62086.738,61686.738,61686.738,61736.738,2024-05-15 05:15:00,True,2024-05-15 05:15:00,2024-05-15 10:38:47,,success,True,93.29,8094.259999999998,,4,0,20,5
2024-05-15 03:00:00,61531.949,61634.137,61508.156,61575.84,1044,36422,0,2024-05-15 03:00:00,2024-05-15 03:00:00,32.60519047619164,-202.03829411049082,61559.6402976191,0.0004576008008159436,0.0007976051869228328,61610.25255952381,61408.42300766638,62087.84651346283,61571.4834577913,61568.67584072139,61582.96147196422,-6.542399577898323,-10.997160823577303,115.10324259613544,1.0017588578921277,-10.496460612259398,-27.961185414482316,61739.850849469,61427.572094459436,38.443980394755926,39.57654951982365,False,True,61075.84,61475.84,61475.84,61425.84,2024-05-15 04:00:00,True,2024-05-15 04:00:00,,2024-05-15 04:01:57,even,True,18.66,8112.919999999998,,5,0,20,5
2024-05-15 09:00:00,61890.438,61938.039,61859.188,61886.238,1224,36422,0,2024-05-15 09:00:00,2024-05-15 09:00:00,67.2545238096136,-80.69026317566022,61908.30692857143,0.0012997164614360508,0.0008936330742644518,61842.148595238126,62099.24749350421,62370.55205195276,61865.20793946776,61791.86426499374,61926.283610939085,40.579266359280155,37.26514872438054,145.03911384017695,-3.412712418299634,-2.9298710010625655,-3.700971104190103,62122.08641462332,61728.98080725485,60.64587205101029,68.91898118679134,False,True,61386.238,62286.238,61786.238,61736.238,,False,,,2024-05-15 12:44:14,fail,False,-74.66,8038.259999999998,,0,1,20,5
2024-05-15 12:00:00,62088.77,62114.938,61868.855,61926.539,1498,36422,0,2024-05-15 12:00:00,2024-05-15 12:00:00,37.72988095234177,0.4778763979265932,62255.686166666674,0.0005353244976045463,0.0023309899284092435,62053.287095238054,62002.56434344034,63476.01457544986,61996.83824480293,61920.359856549345,62049.55980736152,46.3047641496305,45.313294248458234,95.41708428400003,-14.97444306849502,18.401282765778888,15.946541107659868,62178.372871144915,61919.24674357812,56.05773117540935,62.40699712919834,False,True,61426.539,62326.539,61826.539,61776.539,,False,,,2024-05-15 12:44:16,fail,False,-74.66,7963.5999999999985,,0,2,20,5
2024-05-15 12:30:00,61990.117,62431.637,61954.859,62406.352,1600,36422,0,2024-05-15 12:00:00,2024-05-15 12:00:00,37.72988095234177,0.4778763979265932,62255.686166666674,0.0005353244976045463,0.0023309899284092435,62053.287095238054,62002.56434344034,63476.01457544986,62060.33487349795,61961.86525149978,62129.81762676294,54.47240537113976,47.03127677305787,133.16671418474277,82.39913587884075,-2.1413164774203324,-14.97444306849502,62311.092690912345,61950.04256261353,59.9520922728397,55.917603483987214,True,False,62906.352,62506.352,62506.352,62556.352,2024-05-15 13:00:00,True,2024-05-15 13:00:00,2024-05-15 13:32:34,2024-05-15 13:03:52,even,True,18.66,7982.259999999998,,1,0,20,5
2024-05-15 15:30:00,62610.633,64180.84,62610.633,63621.738,6230,36422,0,2024-05-15 15:00:00,2024-05-15 15:00:00,67.86022619053256,128.52999297884526,62943.760083333356,0.002601131220065632,0.004920557215717997,62484.4915714286,63012.94478458047,65478.95115390431,62634.281142010426,62390.87282486076,62837.78523667016,125.77210176905646,99.08922648578996,397.33402658363485,205.49798555222515,28.617333333306306,10.296972824253317,63375.68617255807,62301.38430078226,67.00945310041534,59.66146131743198,True,False,64121.738,63221.738,63721.738,63771.738,,False,2024-05-15 16:30:00,2024-05-15 16:29:06,,success,True,93.29,8075.549999999998,,2,0,20,5
2024-05-15 21:00:00,64983.891,65166.039,64900.059,65151.34,1934,36422,0,2024-05-15 21:00:00,2024-05-15 21:00:00,290.73663095237134,739.7409716651237,65262.59751190472,0.006671370679766368,0.0035593240129978745,64883.17896428574,66691.76820059553,66733.9186294305,64818.03046276512,64301.50850968639,65128.952128654964,323.86405936868687,325.14234938656614,708.4736195724621,66.34229067766864,41.57773546609678,23.030572411495086,66086.89151507779,64172.51274223214,95.25630771024662,94.00574863739088,False,True,64651.34,65551.34,65051.34,65001.34,,False,2024-05-16 20:30:00,2024-05-16 20:36:12,2024-05-15 21:57:42,fail,False,-74.66,8000.8899999999985,,0,1,20,5
2024-05-15 23:00:00,65936.648,66015.734,65686.352,65761.742,2120,36421,0,2024-05-15 23:00:00,2024-05-15 23:00:00,261.92378571435256,939.9793971055915,65738.43578571432,0.004382164095339082,0.004469726803635291,65524.521297619074,66656.78332028002,67893.54032320462,65538.6457737575,64970.04003605718,65885.14302614384,350.62353747184534,341.32621409687823,579.4045833276142,50.56844444449234,120.33837633296207,219.58994633646216,66668.83921363612,65102.94683865156,79.11606385715741,86.13763987356657,False,True,65261.742,66161.742,65661.742,65611.742,,False,2024-05-16 18:00:00,2024-05-16 19:31:16,2024-05-16 01:27:45,fail,False,-74.66,7926.229999999999,,0,2,20,5
2024-05-16 00:00:00,65874.734,65913.734,65715.656,65787.641,1091,56421,0,2024-05-16 00:00:00,2024-05-16 00:00:00,213.91448809524445,998.0966339535589,65855.27534523809,0.003730899591105643,0.0050987167103248646,65738.43578571432,66641.03326150494,68460.43561500852,65682.25847496878,65199.81140237736,66046.1278796009,321.499879361887,336.26160194888604,502.6804382813721,8.894662538659759,35.45605916752538,43.7241627106996,66726.24647128076,65367.50928792105,63.169162361991084,66.06406922807366,False,True,65287.641,66187.641,65687.641,65637.641,,False,2024-05-16 18:00:00,2024-05-16 19:31:16,2024-05-16 01:28:19,fail,False,-74.66,7851.569999999999,,0,3,20,5
2024-05-16 02:00:00,66060.438,66177.156,66011.141,66100.539,1410,36421,0,2024-05-16 02:00:00,2024-05-16 02:00:00,150.21732142855763,1058.1943780911533,66122.12355952385,0.0029327316577852213,0.002076835869327756,66005.49266666664,66655.6011919227,67490.35116108414,65926.9717161753,65565.74354391906,66027.33555383552,262.17702258963254,287.50712343205635,404.257025092897,-1.228657034705975,-5.117863433173625,4.120514619891765,66573.08253771093,65480.08856996011,62.32880955939405,66.01979716726744,False,True,65600.539,66500.539,66000.539,65950.539,,False,2024-05-16 04:45:00,2024-05-16 17:58:58,2024-05-16 03:09:04,fail,False,-74.66,7776.909999999999,,0,4,20,5
2024-05-16 03:00:00,66155.188,66625.734,66151.836,66318.938,2806,36421,0,2024-05-16 03:00:00,2024-05-16 03:00:00,116.63089285721071,1078.2727962433055,66117.28965476189,0.0025705005287228475,0.0008742461254504241,66122.12355952385,66582.84806608992,66894.51350853796,66080.66758742771,65744.17246119773,66202.31619470242,243.77802088164026,265.03795157753615,308.8362696339946,93.07974922603171,21.327951496379683,29.30744134845736,66620.74515870832,65785.38723069652,72.50149569921412,73.83323824643736,False,True,65818.938,66218.938,66218.938,66168.938,2024-05-16 03:30:00,True,2024-05-16 03:30:00,2024-05-16 04:47:46,2024-05-16 11:09:38,success,True,93.29,7870.199999999999,,1,0,20,5
2024-05-16 04:00:00,66031.953,66166.539,65981.836,66070.336,1389,36421,0,2024-05-16 04:00:00,2024-05-16 04:00:00,-4.833904761966551,1072.2154452657196,66042.32198809525,0.001973144127241422,0.0007890109870753965,66117.28965476189,66336.44184480181,66894.3694718146,66073.0795939053,65829.76165572728,66190.39850636393,199.28428244542738,234.35799796259596,195.00543315613712,-16.042459580334253,-1.7605184038402513,-20.171765393810347,66453.65584112471,65925.64117160314,32.46665888636625,39.27171679943387,False,True,65570.336,65970.336,65970.336,65920.336,2024-05-16 05:45:00,True,2024-05-16 05:45:00,2024-05-16 17:58:58,2024-05-16 06:25:41,even,True,18.66,7888.859999999999,,2,0,20,5
2024-05-16 05:00:00,65948.836,66069.734,65865.625,66065.906,1104,36421,0,2024-05-16 05:00:00,2024-05-16 05:00:00,-74.96766666663461,1048.0387236136012,65983.19145238092,0.0010389193476006572,0.0007889794599587646,66042.32198809525,65998.4163453799,66947.08048232984,66032.40883800875,65871.2722421952,66069.37828138979,154.14061185326136,194.07825265356047,153.70164352186683,-12.02752528381825,-39.37101995179546,-44.74650601990288,66276.8755001443,65860.38106263526,20.611672664922576,20.95404108756154,False,True,65565.906,65965.906,65965.906,65915.906,2024-05-16 05:45:00,True,2024-05-16 05:45:00,2024-05-16 17:58:58,2024-05-16 06:25:08,even,True,18.66,7907.519999999999,,3,0,20,5
2024-05-16 06:00:00,65871.602,65959.734,65761.836,65811.234,1269,36421,0,2024-05-16 06:00:00,2024-05-16 06:00:00,-59.13053571432829,1011.322605810783,65968.92042857141,8.126425669795136e-05,0.0005148138588154241,65983.19145238092,65745.59685272841,66869.63839684683,65952.07548171584,65871.64083209897,65891.19560268316,108.03626257188444,151.8355092066161,144.5966896406131,-44.11171826624195,-36.957231510124984,-56.60613347098115,66086.40113369799,65694.49007166833,10.849388569014009,14.992495169920465,False,True,65311.234,66211.234,65711.234,65661.234,,False,2024-05-16 18:00:00,2024-05-16 19:31:16,2024-05-16 10:42:56,fail,False,-74.66,7832.859999999999,,0,1,20,5
2024-05-16 09:00:00,65739.141,65741.539,65614.836,65741.539,952,36421,0,2024-05-16 09:00:00,2024-05-16 09:00:00,-91.27826190475025,869.2395008725944,65810.42058333335,-0.0005684675634134477,-0.0017012645696635963,65801.12267857147,65416.14053668901,65491.072103250044,65810.348204384,65834.38342378405,65746.62018747845,24.728375129052438,52.71089041534853,144.10317150943837,-18.7008462332451,-18.951127278996864,-14.134993120038416,65941.15946901619,65550.5809059407,17.36581868014631,13.507351041472079,True,False,66241.539,65841.539,65841.539,65891.539,2024-05-16 09:30:00,True,2024-05-16 09:30:00,2024-05-16 11:09:39,2024-05-16 09:49:54,even,True,18.66,7851.519999999999,,1,0,20,5
2024-05-16 10:00:00,65913.219,66039.734,65886.836,66010.93,1238,36421,0,2024-05-16 10:00:00,2024-05-16 10:00:00,9.297904761886457,831.352017946163,65897.99976190476,-0.0003942086061775546,-0.000885686776905323,65810.42058333335,65483.16341565712,65973.89910228686,65871.74373671741,65860.26838632254,65841.75098796013,27.069954383856384,36.52812957376879,101.19076910774521,30.891263845944195,24.350389748899033,24.32186859297508,65979.85852625559,65705.14344966467,76.28991617028122,66.14251347945135,True,False,66510.93,66110.93,66110.93,66160.93,2024-05-16 11:15:00,True,2024-05-16 11:15:00,2024-05-16 14:59:45,2024-05-16 11:26:17,even,True,18.66,7870.1799999999985,,2,0,20,5
2024-05-16 11:00:00,66078.906,66392.438,66035.836,66219.539,1312,36421,0,2024-05-16 11:00:00,2024-05-16 11:00:00,87.57917857141001,805.5402633120975,66026.01963095233,-0.0002674694201218036,0.00048547410173858577,65897.99976190476,65507.906560300806,66524.16500869424,65994.34740230664,65928.4522254234,66036.20971620225,42.84198043389188,36.932703122343355,129.86101511060716,71.04141210865055,45.605621947092004,39.366108703106875,66213.02208660157,65860.89734580294,78.85373585211065,84.12897216429494,True,False,66719.539,66319.539,66319.539,66369.539,2024-05-16 15:00:00,True,2024-05-16 15:00:00,2024-05-16 15:30:17,2024-05-16 15:04:29,even,True,18.66,7888.839999999998,,3,0,20,5
2024-05-16 14:00:00,66110.125,66140.938,65990.047,65999.938,1251,36421,0,2024-05-16 14:00:00,2024-05-16 14:00:00,28.865523809479782,734.2163800931885,66318.30723809525,0.0009982276996458085,0.0015644913923924175,66178.26396428574,66214.0209827402,67134.62214697766,66137.2558787433,66076.36782603106,66205.86560509111,45.62472952782991,52.24030593910888,186.24191752729737,-48.41689680083073,-22.69022463033616,-18.522577227311558,66457.29219375296,65952.93901642926,26.41830466213744,44.637712767894186,False,True,65499.937999999995,66399.938,65899.938,65849.938,,False,2024-05-16 16:15:00,2024-05-16 18:00:44,2024-05-16 14:57:22,fail,False,-74.66,7814.1799999999985,,0,1,20,5
2024-05-16 14:45:00,66094.734,66545.938,66077.172,66465.641,1755,36421,0,2024-05-16 14:00:00,2024-05-16 14:00:00,28.865523809479782,734.2163800931885,66318.30723809525,0.0009982276996458085,0.0015644913923924175,66178.26396428574,66214.0209827402,67134.62214697766,66183.31981820997,66110.98285117793,66208.09637977298,47.95983658709156,48.43310958772578,169.4178023633149,46.961277261783835,-25.69404231167573,-19.036460268238443,66438.31041296346,65979.3823465825,57.36760443596474,37.312192396862734,True,False,66965.641,66065.641,66565.641,66615.641,,False,2024-05-17 18:00:00,2024-05-17 18:19:32,2024-05-16 15:30:41,fail,False,-74.66,7739.519999999999,,0,2,20,5
2024-05-16 16:00:00,65958.641,65992.039,65718.648,65837.836,2227,36421,0,2024-05-16 16:00:00,2024-05-16 16:00:00,-84.34401190477365,668.4346330815097,66241.80875000003,0.0002245001224766962,0.0012847130293449172,66233.96322619048,65779.0652764366,67172.70254783401,66097.8517311787,66092.05180433163,66073.0819408325,22.29933640251693,39.55176362287035,128.83696437959193,-65.05541348466068,-49.06718782248208,-28.706404196855146,66247.01184274495,65897.65203892006,15.39205812318889,29.76024505392688,False,True,65337.835999999996,66237.836,65737.836,65687.836,,False,2024-05-16 18:00:00,2024-05-16 18:02:18,2024-05-16 16:50:52,fail,False,-74.66,7664.859999999999,,0,3,20,5
2024-05-16 22:00:00,65061.309,65311.738,65044.539,65250.984,1606,36422,0,2024-05-16 22:00:00,2024-05-16 22:00:00,-187.5852142857184,232.33771909507777,65057.94784523805,-0.0037905986915406217,-0.002588947375328548,65112.976011904735,63083.693194414125,64844.40879221473,65147.57333091983,65392.093012672696,64880.980428964554,-133.8453055277496,-122.50534233901075,454.97022210905897,53.29605159953644,-2.922481596178841,-10.901091847183125,65496.690228811785,64266.77062911732,43.89995939514019,35.54502688970114,True,False,65750.984,65350.984,65350.984,65400.984,2024-05-16 22:30:00,True,2024-05-16 22:30:00,2024-05-17 06:42:37,2024-05-16 22:32:18,even,True,18.66,7683.519999999999,,1,0,20,5
2024-05-17 00:00:00,65219.738,65359.238,65219.148,65314.34,1312,56422,0,2024-05-17 00:00:00,2024-05-17 00:00:00,-19.896238095170702,142.64380309143598,65168.81741666667,3.094282984783493e-05,-0.0019436526478432729,65038.05160714288,64571.29960809408,64933.02220071676,65193.51750687698,65307.59067230181,65236.72301823179,-88.36879894316371,-105.76266979396232,306.3636963188932,64.51322394215822,52.132101823233825,64.1022497419035,65651.8140082623,64823.13202820128,70.14291812150117,63.65466997960885,True,False,65814.34,65414.34,65414.34,65464.34,2024-05-17 06:30:00,True,2024-05-17 06:30:00,2024-05-17 06:44:30,2024-05-17 07:33:43,success,True,93.29,7776.809999999999,,2,0,20,5
2024-05-17 01:00:00,65397.211,65428.738,65072.168,65083.34,1517,56422,0,2024-05-17 01:00:00,2024-05-17 01:00:00,130.765809523793,126.69967638287198,65238.80791666666,0.0014287370748793287,-0.0009514423747287992,65168.81741666667,65398.37724812512,65174.091407589425,65229.36734421715,65298.3477080389,65302.04553938764,-65.45459304764518,-84.64437458672963,232.20905115635344,-51.93129033369041,17.558240454090992,75.85720536635199,65615.52775844872,64987.06332032656,62.422769097207755,69.4978264639351,True,False,65583.34,65183.34,65183.34,65233.34,2024-05-17 01:45:00,True,2024-05-17 01:45:00,2024-05-17 06:29:16,2024-05-17 02:26:48,even,True,18.66,7795.469999999998,,3,0,20,5
2024-05-17 03:00:00,65196.363,65327.738,65192.379,65292.539,892,36422,0,2024-05-17 03:00:00,2024-05-17 03:00:00,55.882130952420994,82.6607431113589,65376.837428571394,0.001404644452551011,-0.00022579833339122314,65294.69004761908,65568.17804317463,65400.37701871969,65257.87428198777,65285.88086240104,65301.51516615071,-36.34172590641538,-49.90396017686938,148.62139360718675,4.506167526698846,12.400059855557629,2.884579979334376,65503.65404752042,65100.87628478101,52.82457938730662,53.42594630566813,True,False,65792.53899999999,65392.539,65392.539,65442.539,2024-05-17 04:00:00,True,2024-05-17 04:00:00,2024-05-17 06:42:37,2024-05-17 04:00:31,even,True,18.66,7814.129999999998,,4,0,20,5
2024-05-17 04:00:00,65456.926,65459.738,65216.5,65221.938,1262,36422,0,2024-05-17 04:00:00,2024-05-17 04:00:00,82.14738095231587,80.75906764603133,65360.38785714292,0.0005569847084242347,-0.00019249073902669961,65376.837428571394,65191.2363902245,65407.588082270195,65288.65867170558,65295.94996111216,65300.706539731655,-22.545423931638652,-35.434262897912724,115.25031332685444,-18.84164189889998,20.798584451353236,-15.497597179222794,65456.29446272291,65143.6186167404,62.67797130282323,66.41092957133988,False,True,64721.938,65621.938,65121.938,65071.938,,False,,,2024-05-17 06:41:26,fail,False,-74.66,7739.469999999998,,0,1,20,5
2024-05-17 09:30:00,65646.734,65813.336,65616.68,65802.734,1331,36421,0,2024-05-17 09:00:00,2024-05-17 09:00:00,98.28073809525813,73.03757556693745,65662.6233452381,0.001222925962559737,0.0014986579031117271,65502.812107142854,65770.24615043482,66532.62822217599,65568.1432452297,65478.60275348045,65641.95261231507,39.54004320292006,25.494103829174,176.26809063599353,32.46076848989469,21.573112830970786,15.045730650163023,65881.41453467366,65403.99068995648,70.78024863904074,66.15541868018008,True,False,66302.734,65402.734,65902.734,65952.734,,False,2024-05-17 10:15:00,2024-05-17 10:13:27,,success,True,93.29,7832.759999999998,,1,0,20,5
2024-05-17 14:00:00,66446.734,66529.359,66147.836,66183.938,1637,36421,0,2024-05-17 14:00:00,2024-05-17 14:00:00,139.90795238093415,254.2109887689585,66342.71526190476,0.0019161886160927312,0.001606798533555124,66335.51407142857,66659.4663363975,67329.533071596,66229.652515279,66050.31726892931,66299.69104953557,109.16043371449632,107.94610107019008,312.50224657461354,-38.67562229106261,8.528874096969957,-7.703399724749033,66721.5690824113,65876.31301665984,65.61020537835522,74.30096842229484,False,True,65683.938,66083.938,66083.938,66033.938,2024-05-17 16:45:00,True,2024-05-17 16:45:00,,2024-05-17 17:08:16,even,True,18.66,7851.419999999998,,2,0,20,5
2024-05-17 15:00:00,66163.555,66212.141,66139.664,66154.438,1027,36421,0,2024-05-17 15:00:00,2024-05-17 15:00:00,7.2011904761893675,256.3672312114941,66349.21878571423,0.0014603751085943842,0.0005796852977101066,66342.71526190476,66450.15372464422,66810.03713843519,66211.34195624101,66088.78388115238,66249.04863089093,88.68566991754051,100.77986632948465,213.43100140505473,-19.194512899877736,-9.8521754386893,6.1586095632228535,66537.18048278775,65959.41677899411,33.2197735596504,36.8767873855253,False,True,65654.438,66054.438,66054.438,66004.438,2024-05-17 16:45:00,True,2024-05-17 16:45:00,,2024-05-17 17:04:54,even,True,18.66,7870.079999999998,,3,0,20,5
2024-05-17 16:00:00,66328.719,66406.039,66099.141,66171.734,2106,36421,0,2024-05-17 16:00:00,2024-05-17 16:00:00,6.503523809471517,268.23384587488545,66194.00976190476,0.000530770346095877,0.0002694784542224181,66349.21878571423,65908.52561220461,66638.87476017741,66220.59011033665,66126.46152615087,66243.9038531132,74.57811955129728,88.00468018472348,90.67181286085001,-26.364042311659432,11.856078431403148,1.0986143790796632,66366.31080047534,66119.99690575105,38.12541988579114,37.797129847909225,False,True,65671.734,66071.734,66071.734,66021.734,2024-05-17 16:45:00,True,2024-05-17 16:45:00,,2024-05-17 17:08:02,even,True,18.66,7888.739999999998,,4,0,20,5
2024-05-17 21:30:00,66430.336,66505.336,66342.398,66494.039,904,36421,0,2024-05-17 21:00:00,2024-05-17 21:00:00,29.0947500000766,366.4033146810543,66849.71746428571,0.0011774707561991013,0.0019726374641957046,66786.02798809527,66473.91465342174,68333.78883039844,66658.24787966938,66590.44494606268,66704.04132370141,72.47422832615848,101.98828634983953,417.43009741788956,-114.14612005505478,-130.58988407283323,-140.93804609568906,67267.57195521556,66139.01069218726,23.148320014588496,28.284630509435516,True,False,66994.039,66594.039,66594.039,66644.039,2024-05-17 22:00:00,True,2024-05-17 22:00:00,2024-05-17 22:45:23,2024-05-20 00:00:03,success,True,93.29,7982.029999999998,,5,0,20,5
2024-05-20 04:00:00,66406.898,66531.734,66168.195,66292.336,1940,36421,0,2024-05-20 04:00:00,2024-05-20 04:00:00,-28.02205952379154,214.61964914522832,66327.34451190481,-0.0011391492427835163,-0.0013725376720996308,66336.35897619049,65322.77909618561,66157.24234840689,66288.32304643311,66367.80252476757,66232.88305813554,-40.253602147859056,-36.79602078394724,300.80262755571624,39.91209219128359,66.86464155478461,39.28632198153355,66640.46660533577,65826.79951093532,73.47712192003739,65.70589038413858,True,False,66792.336,66392.336,66392.336,66442.336,2024-05-20 05:00:00,True,2024-05-20 05:00:00,2024-05-20 07:34:34,2024-05-20 09:54:55,success,True,93.29,8075.319999999998,,6,0,21,5
2024-05-20 05:00:00,66476.039,66651.734,66446.031,66550.141,1872,36421,0,2024-05-20 05:00:00,2024-05-20 05:00:00,-9.014464285675786,201.0766140283813,66391.7568214286,0.0002486194432805993,-0.0006461564886199839,66327.34451190481,66076.86269646845,66552.44952711489,66354.29192608196,66379.44964547962,66362.82325455797,-22.70014199358411,-33.44828508074987,227.90742060475839,39.37059855523694,29.760172686656006,14.581456140309456,66671.99827237439,66055.14823674154,80.02996366059752,63.459097218302304,True,False,67050.141,66150.141,66650.141,66700.141,,False,2024-05-20 07:45:00,2024-05-20 07:42:51,,success,True,93.29,8168.609999999998,,7,0,21,5
2024-05-20 06:00:00,66610.727,66718.836,66589.539,66607.07,1333,36421,0,2024-05-20 06:00:00,2024-05-20 06:00:00,64.41230952378828,199.4940011701401,66499.8893452381,0.0002486352226643546,-0.0005790899763282666,66391.7568214286,66093.31978294745,66559.69724989297,66488.55964328161,66446.29089294103,66583.50108943925,6.40012639251654,-14.06765881521222,176.51506172843978,41.416936360430554,53.61294599251414,63.29954179569904,66823.29642277265,66345.20575610585,86.23393823761346,89.23327661259798,True,False,67107.07,66707.07,66707.07,66757.07,2024-05-20 07:45:00,True,2024-05-20 07:45:00,2024-05-20 07:56:16,2024-05-20 09:52:29,success,True,93.29,8261.899999999998,,8,0,21,5
2024-05-20 07:00:00,66616.141,66695.234,66576.836,66600.109,1185,36421,0,2024-05-20 07:00:00,2024-05-20 07:00:00,108.13252380950144,196.54716772086977,66758.45701190479,0.0008460073445653476,0.0017442681681945416,66499.8893452381,66390.36235117364,67593.0499886639,66546.20104538657,66488.40249321955,66679.54537942898,18.67396267586446,3.191440992806452,181.86111706347216,11.209385620924877,20.749913312727585,39.936256277927896,66926.55788746466,66434.0328713933,86.42581769280599,83.93328457188825,True,False,67100.109,66700.109,66700.109,66750.109,2024-05-20 07:45:00,True,2024-05-20 07:45:00,2024-05-20 07:56:15,2024-05-20 09:52:33,success,True,93.29,8355.189999999999,,9,0,21,5
2024-05-20 09:00:00,67089.336,67115.539,66865.641,66965.336,1297,36421,0,2024-05-20 09:00:00,2024-05-20 09:00:00,159.97273809518083,251.44145093066618,66792.72288095242,0.0006801168901797558,0.0021236395416381814,66918.42974999997,66402.77258825391,67986.11261240182,66898.09827382666,66730.22448727519,67059.69632851734,77.623052665469,54.73134322967357,309.0118302060647,5.319059167479281,31.20948194016819,39.185943240474444,67478.36229929554,66642.53035773915,70.26396775767004,75.86660885770618,False,True,66465.336,67365.336,66865.336,66815.336,,False,2024-05-20 10:00:00,2024-05-20 09:54:30,2024-05-20 18:25:32,success,True,93.29,8448.48,,10,0,21,5
2024-05-20 16:00:00,66876.492,67055.641,66846.461,66987.336,1091,36421,0,2024-05-20 16:00:00,2024-05-20 16:00:00,40.6717261904123,206.32093075083685,67016.89124999997,0.0010604386923939433,0.0007117611328406023,66910.43709523809,67003.09528380167,67648.58798272685,66950.22556997568,66912.64895191403,66997.10497179226,33.233680279547116,42.05899777597145,146.08533072177136,-8.057676986514707,-19.084582043331466,-40.26568558654981,67194.32016826665,66798.38977531786,24.265339558964005,23.56314617433594,False,True,66487.336,66887.336,66887.336,66837.336,2024-05-20 17:15:00,True,2024-05-20 17:15:00,,2024-05-20 17:21:11,even,True,18.66,8467.14,,11,0,21,5
2024-05-20 16:45:00,66841.141,67139.141,66781.844,67044.234,1861,36421,0,2024-05-20 16:00:00,2024-05-20 16:00:00,40.6717261904123,206.32093075083685,67016.89124999997,0.0010604386923939433,0.0007117611328406023,66910.43709523809,67003.09528380167,67648.58798272685,66949.55269897025,66919.33856097427,66944.05921121433,28.094047492500977,35.38779542676024,124.21861828800698,6.391351909245714,-33.01885104927351,-26.418261437895126,67113.25434590314,66776.36407652553,39.22177501574529,35.79859215083556,True,False,67544.234,67144.234,67144.234,67194.234,2024-05-20 18:30:00,True,2024-05-20 18:30:00,2024-05-20 19:01:38,2024-05-20 18:30:52,even,True,18.66,8485.8,,12,0,21,5
2024-05-20 17:45:00,66769.234,66966.938,66749.547,66944.734,1345,36421,0,2024-05-20 17:00:00,2024-05-20 17:00:00,106.45415476188646,211.27923262484546,66987.84880952378,0.0008650497793884219,6.491125664962057e-05,67016.89124999997,66936.64756368971,67342.99570397675,66895.70991987757,66896.56233001326,66831.21699312002,12.706330474946299,23.378336789281782,125.45937505482961,10.242055039518164,-33.20328448571672,-41.58289336084272,67002.08714944404,66661.846836796,28.201900556990655,24.447708584257825,True,False,67444.734,66544.734,67044.734,67094.734,,False,2024-05-20 18:30:00,2024-05-20 18:26:01,,success,True,93.29,8579.09,,13,0,21,5
2024-05-20 22:30:00,69135.445,69966.336,69098.93,69722.836,5138,36421,0,2024-05-20 22:00:00,2024-05-20 22:00:00,403.5241785714752,461.61578039491724,68939.51052380959,0.004842790595690423,0.006330315343476912,68207.78222619051,69529.91044001596,71950.71838008167,68609.16338769991,68074.90527448324,69087.16761093913,266.5041412503342,204.02698683781395,823.2461519913352,211.09214482281823,130.6608851049823,49.27639766079665,70200.04991612743,67975.78530575082,90.04359737814825,92.18930021643217,True,False,70222.836,69822.836,69822.836,69872.836,2024-05-20 23:00:00,True,2024-05-20 23:00:00,2024-05-20 23:00:08,2024-05-20 23:06:14,success,True,93.29,8672.380000000001,,14,0,21,5
2024-05-21 00:00:00,69461.734,69499.336,68979.109,68989.477,2525,56421,0,2024-05-21 00:00:00,2024-05-21 00:00:00,368.2974404761044,704.0331609646964,69614.77129761904,0.004979507709929084,0.008524111147512904,69307.80796428569,70306.3767950517,73855.09760814162,69114.17192668263,68582.41553712744,69576.8483247334,303.41862511522777,283.45291494151695,836.8213782499035,-28.367448916396825,46.806488476038794,31.206535947683733,70706.55718537077,68445.63946409602,51.00744621368037,57.158318676641464,False,True,68489.477,69389.477,68889.477,68839.477,,False,,,2024-05-21 00:52:37,fail,False,-74.66,8597.720000000001,,0,1,21,5
2024-05-21 02:15:00,70041.938,71635.969,70038.195,71453.039,3667,36421,0,2024-05-21 02:00:00,2024-05-21 02:00:00,101.66823809522612,812.675684954389,70351.97501190477,0.004900712451958408,0.005485671730019521,69716.43953571426,70979.79158109667,73297.30668536952,69801.3251767963,69226.71226662188,70014.45735190915,328.6397005892504,293.14870285816943,730.8252883240098,311.3635524595302,65.83095424842031,-24.863461988352356,71002.57149114656,69027.84321267174,71.17151856401482,60.94589208771728,True,False,71953.039,71053.039,71553.039,71603.039,,False,,2024-05-21 03:18:39,2024-05-21 04:19:01,success,True,93.29,8691.010000000002,,1,0,21,5
2024-05-21 03:15:00,71281.836,72074.859,71219.383,71452.641,3294,36421,0,2024-05-21 03:00:00,2024-05-21 03:00:00,635.5354761905037,983.9203551530081,70816.6865833333,0.0049006509675930355,0.005606700671100627,70351.97501190477,71336.2628289843,73785.6134451827,70580.0261180447,69802.3438750589,71084.62626006186,422.11003382211493,356.5997948628825,944.2911002635277,285.95194599246315,255.32656415535894,269.7359442724701,72360.91924541762,69809.8332747061,87.02399149386328,90.22030335812046,True,False,71952.641,71052.641,71552.641,71602.641,,False,,,2024-05-21 04:19:01,fail,False,-74.66,8616.350000000002,,0,1,21,5
2024-05-21 07:00:00,71299.023,71314.336,71128.617,71153.383,1126,36421,0,2024-05-21 07:00:00,2024-05-21 07:00:00,202.58978571435728,1227.7023400547914,71333.3340119048,0.0040375328921802974,0.0015581661883100559,71405.25179761909,72048.50183914788,72998.80464030372,71167.78134743977,70760.11992754834,71188.02951221186,301.5528272181691,338.3388536052022,651.8130972014884,1.0327856896910816,30.178272101809853,-72.00091056071687,72069.47719343386,70308.08183098985,55.92120119925513,50.55693195517063,False,True,70653.383,71053.383,71053.383,71003.383,2024-05-21 07:45:00,True,2024-05-21 07:45:00,2024-05-21 16:50:46,2024-05-21 08:09:47,even,True,18.66,8635.010000000002,,1,0,21,5
2024-05-21 08:00:00,70935.367,71067.734,70857.836,70925.234,1879,36421,0,2024-05-21 08:00:00,2024-05-21 08:00:00,-71.91778571429313,1203.748505042342,71296.54686904764,0.00310442600722473,-0.0014911984948977784,71333.3340119048,71781.39426133518,71095.58564129745,71069.21799390308,70815.6646063111,71102.17009735125,229.38142767795944,287.0152162435751,295.4068046085041,-21.54838011690299,-20.774934640547144,-29.35104919159494,71500.96928357273,70701.87091112976,26.07143013852158,35.990637456101844,False,True,70425.234,71325.234,70825.234,70775.234,,False,2024-05-21 17:00:00,2024-05-21 17:28:05,2024-05-21 09:38:44,fail,False,-74.66,8560.350000000002,,0,1,21,5
2024-05-21 10:00:00,71219.391,71259.734,71025.039,71047.039,1212,36421,0,2024-05-21 10:00:00,2024-05-21 10:00:00,-140.1171547619888,1173.1779687926028,71078.98233333335,0.00042625515154224637,-0.0014687498570114265,71156.42971428565,71029.8619849934,70901.6247230826,71163.33337792468,70989.79148373324,71137.6760330237,162.3215525557025,199.76226052384072,149.99808807359602,-14.535278637806186,-5.2326288268959615,22.85400412789022,71340.17345192305,70933.67861412435,61.560224595780646,72.22833235055332,False,True,70547.039,71447.039,70947.039,70897.039,,False,2024-05-21 17:00:00,2024-05-21 16:51:36,2024-05-21 14:49:22,fail,False,-74.66,8485.690000000002,,0,2,21,5
2024-05-21 11:00:00,70905.016,71087.438,70886.422,71032.438,1364,36421,0,2024-05-21 11:00:00,2024-05-21 11:00:00,-77.44738095230423,1117.9861330824351,71031.05155952382,0.0003272483311907301,4.240591031334735e-05,71078.98233333335,70981.60322618595,71461.842313374,71083.66862687563,70993.30468874493,71086.86349741995,115.04477628192399,158.0922994461475,153.97174316901808,3.1068424491822952,-28.648162366705947,-30.76615892672271,71296.22535069812,70879.00164414178,19.306470178818596,25.989354677516047,True,False,71532.438,71132.438,71132.438,71182.438,2024-05-21 13:15:00,True,2024-05-21 13:15:00,,2024-05-21 13:24:53,even,True,18.66,8504.350000000002,,1,0,21,5
2024-05-21 22:00:00,69865.984,69966.734,69832.078,69926.039,1934,36421,0,2024-05-21 22:00:00,2024-05-21 22:00:00,-120.63660714290745,315.98283624637406,69526.19548809524,-0.0029642895180660637,-0.0033034277140617596,69756.68560714282,68041.22041220443,69015.06920957424,69891.11992997892,70150.41489717146,69709.58275644998,-152.81259814217628,-150.2411876951212,450.9887121378504,40.61004093570227,18.638837289297953,1.0498417612543562,70319.91751783607,69100.74799506388,36.11907539094702,25.287347311564133,True,False,70426.039,69526.039,70026.039,70076.039,,False,2024-05-22 02:00:00,2024-05-22 18:42:37,2024-05-21 22:27:16,fail,False,-74.66,8429.690000000002,,0,1,21,5
2024-05-22 00:00:00,69721.563,69741.734,69584.43,69670.836,1384,56421,0,2024-05-22 00:00:00,2024-05-22 00:00:00,54.056547618994955,161.7511382198427,69623.67515476192,-0.001965138231462882,-0.0023084992547987436,69580.25203571423,68328.19148638181,69144.10216510348,69676.02269499228,69884.80222637318,69588.45237598896,-142.68874855784816,-155.76863250083363,258.8472016903571,10.345387684908928,31.859060887480155,22.530925008642953,69939.39609827094,69239.00865370697,63.60764491041587,61.5441594102817,True,False,70170.836,69770.836,69770.836,69820.836,2024-05-22 01:15:00,True,2024-05-22 01:15:00,2024-05-22 01:53:00,2024-05-22 07:27:34,success,True,93.29,8522.980000000003,,1,0,21,5
2024-05-22 01:00:00,69723.445,69854.938,69712.977,69832.938,1582,56421,0,2024-05-22 01:00:00,2024-05-22 01:00:00,43.42311904768576,120.86097657241044,69831.56198809529,-0.0009050036179342147,-0.0006086909667636362,69623.67515476192,68712.55874495769,70042.34319301603,69681.52978542003,69829.67859270365,69621.67903267975,-117.03281728188449,-139.37575276496239,190.07844267173778,48.760186102590524,31.05783212929964,-33.60027726183762,69879.7849302866,69365.0731350729,65.51196747293828,58.04177264472329,True,False,70332.938,69932.938,69932.938,69982.938,2024-05-22 01:45:00,True,2024-05-22 01:45:00,2024-05-22 02:29:11,2024-05-22 06:13:21,success,True,93.29,8616.270000000004,,2,0,21,5
2024-05-22 02:00:00,70224.336,70228.734,70112.539,70176.234,2270,36421,0,2024-05-22 02:00:00,2024-05-22 02:00:00,207.88683333336667,127.10141429511714,69962.90497619049,0.0010298017759474538,0.00019125940511097276,69831.56198809529,69742.18731493228,70430.28535522136,69888.0316484834,69900.17831841891,69957.77500447196,-57.29918057475879,-102.15463490253543,228.76598236442095,86.62473065016093,104.32821568626969,66.93097936015693,70268.10908066393,69648.94092827999,93.17378775043538,90.75667174366087,True,False,70676.234,69776.234,70276.234,70326.234,,False,2024-05-22 18:45:00,2024-05-22 19:14:59,2024-05-22 07:27:34,fail,False,-74.66,8541.610000000004,,0,1,21,5
2024-05-22 05:00:00,70165.0,70345.836,70155.133,70224.438,1208,36421,0,2024-05-22 05:00:00,2024-05-22 05:00:00,103.3560119047761,117.64244482218055,70179.76194047616,0.00168957602165415,0.00144112261448392,70147.20439285711,70437.21819128231,71104.34446872049,70136.64811820386,70069.31982255915,70238.83276780181,16.121174088373664,-1.173317401416527,259.9741205278404,-25.064515995894908,-17.65474131407973,-13.019916408724384,70589.79783051439,69886.36770508923,57.50457196519875,59.35188534792502,False,True,69724.438,70124.438,70124.438,70074.438,2024-05-22 05:45:00,True,2024-05-22 05:45:00,2024-05-22 07:34:58,2024-05-22 05:51:33,even,True,18.66,8560.270000000004,,1,0,21,5
2024-05-22 06:00:00,70023.734,70078.539,69892.344,69963.039,1531,36421,0,2024-05-22 06:00:00,2024-05-22 06:00:00,32.557547619057004,103.3130215574929,70107.98936904762,0.001252541611223833,0.0005102797441266453,70179.76194047616,70213.06027115483,70668.48714085939,70097.4713562068,70068.44210977544,70082.92471413821,9.506801719398936,7.926829758511199,221.62963367346836,-53.92279153772688,-44.362422772624996,-46.49032954941504,70382.12471959738,69782.22470867903,18.88292734021883,34.71738110158771,False,True,69463.039,69863.039,69863.039,69813.039,2024-05-22 07:30:00,True,2024-05-22 07:30:00,2024-05-22 07:40:48,2024-05-22 07:31:21,even,True,18.66,8578.930000000004,,2,0,21,5
2024-05-22 07:00:00,69978.039,70031.836,69835.18,69836.836,1282,36421,0,2024-05-22 07:00:00,2024-05-22 07:00:00,-71.77257142854796,87.71802587652928,69938.09772619043,-0.0004591035028016226,0.0001045648203349996,70107.98936904762,69091.92992048267,70441.6699762344,70015.36332986323,70032.86843818416,69969.43410319918,-6.077761346285115,3.019173055395466,136.01676245799743,-36.218934296572115,-12.919543515585246,-39.47838046094694,70153.05673251748,69784.31147388088,13.312589818749396,17.281722374114764,False,True,69336.836,69736.836,69736.836,69686.836,2024-05-22 07:45:00,True,2024-05-22 07:45:00,2024-05-22 07:45:07,2024-05-22 08:12:06,success,True,93.29,8672.220000000005,,3,0,21,5
2024-05-22 11:00:00,69733.922,69948.141,69661.836,69941.141,1625,36421,0,2024-05-22 11:00:00,2024-05-22 11:00:00,-59.69935714287567,6.976038894033991,69857.75583333331,2.255823302514811e-05,-0.0003434826281535346,69801.4934523809,69236.26908879603,70150.42946172101,69847.70944815477,69886.63157633496,69859.33955693155,-25.15305737052404,-26.086987635073886,180.98378387101897,32.37805297556042,-2.2789845201332355,6.817636050967849,70105.16766515742,69615.01144870567,69.12129111790975,63.956203728313,True,False,70441.141,70041.141,70041.141,70091.141,2024-05-22 13:30:00,True,2024-05-22 13:30:00,2024-05-22 18:42:37,2024-05-22 14:31:19,even,True,18.66,8690.880000000005,,4,0,21,5
2024-05-22 14:00:00,70208.438,70302.336,70164.688,70214.453,1590,36421,0,2024-05-22 14:00:00,2024-05-22 14:00:00,117.0254404762236,35.5022900471231,69986.36819047618,0.0010764350313995116,0.0007826375358616793,70038.18432142858,70059.58093485422,70645.53299123565,70079.28933392132,70008.56558868053,70173.49199724797,24.976913266815245,7.842758131313473,141.43842578228524,40.73462951493275,44.28957137944235,53.78775782592129,70365.93387205405,69982.55012244188,90.86932728737197,87.76632324266234,False,True,69714.453,70114.453,70114.453,70064.453,2024-05-22 14:45:00,True,2024-05-22 14:45:00,2024-05-22 15:00:11,2024-05-22 15:17:32,success,True,93.29,8784.170000000006,,5,0,21,5
2024-05-22 15:00:00,69748.859,70036.336,69650.938,70036.336,2346,36421,0,2024-05-22 15:00:00,2024-05-22 15:00:00,-51.81613095240027,13.00340784175205,69869.39638095236,-3.552511003054786e-05,0.0002480115716700533,69986.36819047618,69518.34225924453,70392.32616344135,70025.07453093176,69998.7796789377,70088.36736979702,13.553999704643502,13.59377502618707,142.4031192427782,-12.065386996866437,-76.63869453046937,-6.398705882369541,70280.61158077477,69894.62315881927,33.15101928436257,43.87541878891603,False,True,69536.336,69936.336,69936.336,69886.336,2024-05-22 15:45:00,True,2024-05-22 15:45:00,2024-05-22 15:53:17,2024-05-22 17:17:35,success,True,93.29,8877.460000000006,,6,0,21,5
2024-05-23 03:00:00,69208.641,69368.734,69208.641,69344.938,1729,36421,0,2024-05-23 03:00:00,2024-05-23 03:00:00,-77.58363095237291,-152.8627512746316,69325.98086904765,-0.0014751116889042807,-0.0016630198457987825,69250.09788095242,68130.37674137818,69171.98685293112,69287.9920188716,69446.74388090239,69144.75920055032,-92.98943140958727,-89.47327784305594,208.96837653870656,20.667892328856396,-15.07524974210537,-34.261640866840025,69428.36650887757,68862.65189222308,42.91462770889465,33.71971198902458,True,False,69844.938,69444.938,69444.938,69494.938,2024-05-23 03:45:00,True,2024-05-23 03:45:00,2024-05-23 10:40:04,2024-05-23 04:04:10,even,True,18.66,8896.120000000006,,7,0,21,5
2024-05-23 04:00:00,69519.664,69557.336,69280.93,69399.539,1336,36421,0,2024-05-23 04:00:00,2024-05-23 04:00:00,75.8829880952253,-148.21976478876604,69383.04364285711,0.00017807036327989036,-0.0009316551135642131,69325.98086904765,68952.17992845048,69376.71702223523,69375.98701447075,69452.70421213549,69351.53293326455,-62.8947903465596,-78.52690172957398,199.79695007477065,29.961892672843533,59.93539387691999,85.35319745435845,69622.75881586548,69081.80705066361,71.94173056740061,71.31918983871786,True,False,69899.539,69499.539,69499.539,69549.539,2024-05-23 04:45:00,True,2024-05-23 04:45:00,2024-05-23 14:23:50,2024-05-23 04:55:32,even,True,18.66,8914.780000000006,,8,0,21,5
2024-05-23 07:00:00,69462.211,69541.641,69438.836,69498.266,1374,36421,0,2024-05-23 07:00:00,2024-05-23 07:00:00,36.515214285842376,-137.32381473612622,69519.33215476184,0.0011256318308179075,-0.00013630373686077265,69464.38532142865,69721.6759767741,69577.70954218965,69460.11617530338,69470.37614333443,69500.62983281733,-20.074331826719572,-29.521012823629626,151.3478180542345,-15.64547127620608,-19.7957031303813,-34.29994530446129,69704.94938719054,69294.81027844411,42.4438177507711,42.974488326368636,True,False,69998.266,69598.266,69598.266,69648.266,2024-05-23 10:45:00,True,2024-05-23 10:45:00,2024-05-23 14:31:18,2024-05-23 13:56:00,even,True,18.66,8933.440000000006,,9,0,21,5
2024-05-23 08:00:00,69564.695,69580.734,69425.742,69483.539,1296,36421,0,2024-05-23 08:00:00,2024-05-23 08:00:00,54.946833333189716,-126.11192077906162,69547.29214285716,0.0007408626250913269,0.0006422580674979967,69519.33215476184,69567.41092113922,70061.67676922987,69497.0446808101,69488.24073690966,69500.79350189195,-8.421769925902481,-18.529984228163357,138.23093052121106,2.1772511179297,4.404970416246215,4.839244582050014,69688.90525809559,69314.18174568831,70.68589804776883,71.00634697121366,False,True,68983.539,69883.539,69383.539,69333.539,,False,2024-05-23 16:30:00,2024-05-23 15:56:40,2024-05-23 14:23:15,fail,False,-74.66,8858.780000000006,,0,1,21,5
2024-05-23 10:00:00,69576.836,69623.234,69467.938,69524.836,1778,36421,0,2024-05-23 10:00:00,2024-05-23 10:00:00,10.21708333332208,-111.49287982138048,69606.91159523815,0.0004196437569319424,0.0004721178604491138,69557.50922619048,69533.1886975741,70018.93746697687,69498.38783299913,69489.29811709501,69505.83003543173,-2.6018143837864045,-8.516218009489188,59.44897142984661,6.464693842484849,17.84561988299538,16.9422291022056,69587.58614686203,69425.57392400144,64.81592276843331,60.43561841243284,False,True,69024.836,69924.836,69424.836,69374.836,,False,2024-05-23 16:30:00,2024-05-23 15:56:39,2024-05-23 14:24:58,fail,False,-74.66,8784.120000000006,,0,2,21,5
2024-05-23 22:00:00,67397.336,67457.836,67241.602,67351.938,2244,36421,0,2024-05-23 22:00:00,2024-05-23 22:00:00,-235.12054761905165,-532.15403842456,67358.39965476189,-0.0030740437285718663,-0.004994139386961077,67466.74384523815,65706.78972733527,66324.31182357798,67590.82871343961,68040.78816060664,67352.80042655663,-258.8711413700803,-239.83955407095706,572.2365888371113,-81.72955177153926,-74.06588235293748,-115.96406845540332,68125.31982148673,66578.78103162652,35.956113649535546,27.395969339466514,True,False,67851.938,67451.938,67451.938,67501.938,2024-05-23 22:45:00,True,2024-05-23 22:45:00,2024-05-23 23:56:37,2024-05-23 22:45:13,even,True,18.66,8802.780000000006,,1,0,21,5
2024-05-23 23:00:00,67220.539,67225.734,66183.836,66764.336,5251,36421,0,2024-05-23 23:00:00,2024-05-23 23:00:00,-108.34419047625852,-589.9635302487441,67529.9519285714,-0.0034093832209844068,-0.00338118481648366,67358.39965476189,65265.0805928283,67007.63718083475,67400.56911737927,67825.70617248755,67114.83672721019,-255.57729202699556,-245.45135588425657,418.07908230674326,-125.33773202617886,-50.05195940827252,-3.1901558307145024,67679.2434883243,66548.92996609608,39.868753949163,45.39425807377332,True,False,67264.336,66364.336,66864.336,66914.336,,False,2024-05-23 23:30:00,2024-05-23 23:17:22,,success,True,93.29,8896.070000000007,,2,0,21,5
2024-05-24 00:00:00,67803.234,68351.141,67722.836,67830.938,4871,56421,0,2024-05-24 00:00:00,2024-05-24 00:00:00,171.55227380951692,-582.1613653788227,67660.67747619042,-0.003576428348733956,-1.8072471069397735e-07,67529.9519285714,64984.28443290038,68351.08995338828,67546.69861669933,67788.93097942378,67374.16583969732,-189.26841284931288,-225.8655204082597,404.8739849247722,108.64838011696702,90.29389336088207,33.921305125564686,67922.24571934577,66827.58596004888,76.49251625424627,68.68553081718208,True,False,68330.938,67430.938,67930.938,67980.938,,False,2024-05-24 01:00:00,2024-05-24 18:13:13,2024-05-24 00:16:23,fail,False,-74.66,8821.410000000007,,0,1,21,5
2024-05-24 05:00:00,67742.953,67838.539,67709.266,67795.141,1057,36421,0,2024-05-24 05:00:00,2024-05-24 05:00:00,7.9709642856469145,-482.76683678470727,67929.15648809524,0.0036210721995923087,-0.0009807924004759262,67881.15582142855,68654.61971596011,67741.98489289136,67756.61285224046,67764.69784239805,67771.55303921572,-34.09107544446306,-52.92728781675265,237.2985549802812,13.05391296876769,-28.281270037885406,5.9989291365782265,68093.40608843911,67451.19998999234,51.562262800805065,46.21672204494809,False,True,67295.141,67695.141,67695.141,67645.141,2024-05-24 08:15:00,True,2024-05-24 08:15:00,2024-05-24 08:37:45,2024-05-24 17:26:08,success,True,93.29,8914.700000000008,,1,0,21,5
2024-05-24 06:00:00,67983.438,68024.641,67903.359,67966.969,1804,36421,0,2024-05-24 06:00:00,2024-05-24 06:00:00,48.00066666668863,-447.4019623266795,67883.96375,0.0034797414505763503,-0.0007996746643981927,67929.15648809524,68796.08158232534,67799.81397209337,67810.82773599148,67789.21159910646,67847.37549535609,-14.97432061813015,-35.486032788051766,136.81199543714385,28.991556587599916,35.572361541126156,-6.674136566944071,68033.57168919624,67662.67930151593,71.64245734361498,59.73573807036709,True,False,68466.969,67566.969,68066.969,68116.969,,False,2024-05-24 18:15:00,2024-05-24 19:01:37,2024-05-24 08:16:43,fail,False,-74.66,8840.040000000008,,0,1,21,5
2024-05-24 07:00:00,67889.539,67925.938,67825.836,67883.438,1133,36421,0,2024-05-24 07:00:00,2024-05-24 07:00:00,-45.1927380952402,-422.2459044199495,67824.45472619048,0.0011196398040334756,-0.0007996701253109296,67883.96375,67962.9125844996,67745.69993613032,67855.57116153675,67819.71745265977,67875.80959614721,-0.9016150658426341,-16.947022697025794,121.42716754576335,5.348112487103208,3.1067664258589502,1.9057688337925356,68041.23627233399,67711.88291996044,68.43056417515807,72.72057042765267,False,True,67383.438,67783.438,67783.438,67733.438,2024-05-24 07:45:00,True,2024-05-24 07:45:00,2024-05-24 08:29:05,2024-05-24 17:26:47,success,True,93.29,8933.330000000009,,1,0,21,5
2024-05-24 08:00:00,67713.047,67713.063,67582.992,67622.039,1112,36421,0,2024-05-24 08:00:00,2024-05-24 08:00:00,-59.509023809514474,-411.52291996972053,67655.65972619045,-0.000990950553121401,-3.775404780664317e-05,67824.45472619048,66802.17474007726,68008.9176065486,67772.09343314517,67784.8556377269,67792.4470010319,-13.1328274452826,-12.141294672387618,120.84450343776484,-24.49512659102038,-22.9167234262859,-33.231003783934284,67955.58708067289,67627.80692139092,13.694644901032603,22.762744534419905,False,True,67122.039,67522.039,67522.039,67472.039,2024-05-24 08:30:00,True,2024-05-24 08:30:00,2024-05-24 08:41:07,2024-05-24 09:11:21,success,True,93.29,9026.62000000001,,2,0,21,5
2024-05-24 09:15:00,67586.336,67599.039,67046.555,67167.234,2179,36421,0,2024-05-24 09:00:00,2024-05-24 09:00:00,-168.79500000002736,-432.1300413267163,67354.71853571429,-0.0013934553978580452,-0.0014421127328856566,67655.65972619045,66450.81246837856,67328.94875844338,67524.64321255036,67642.31071310623,67408.86646886828,-54.60310147317068,-33.07165927835371,222.28283347049185,-99.76351427583722,-23.238653250751668,-88.20563880293048,67708.94829405344,67107.28464368312,29.769087962247813,26.480725124630954,False,True,66667.234,67067.234,67067.234,67017.234,2024-05-24 10:00:00,True,2024-05-24 10:00:00,2024-05-24 11:27:14,2024-05-24 10:12:36,even,True,18.66,9045.28000000001,,3,0,21,5
2024-05-24 10:30:00,67261.641,67328.836,66957.055,66997.336,1689,36421,0,2024-05-24 10:00:00,2024-05-24 10:00:00,-300.9411904761655,-474.81332966822083,67233.74248809525,-0.001988104743876218,-0.0014421008052658156,67354.71853571429,66156.32276003005,67232.31683443657,67279.3842560793,67466.82125325853,67034.25284176125,-91.07551432853506,-66.12745685786818,329.41535835903284,-59.620520123804454,-20.415296181672602,-85.77274165807466,67478.96357554595,66588.04210797655,25.88674149117972,21.32112057177144,False,True,66497.336,66897.336,66897.336,66847.336,2024-05-24 11:30:00,True,2024-05-24 11:30:00,,2024-05-24 11:37:30,even,True,18.66,9063.94000000001,,4,0,21,5
2024-05-24 11:15:00,67013.734,67040.938,66621.039,66703.641,2263,36421,0,2024-05-24 11:00:00,2024-05-24 11:00:00,-120.97604761904222,-480.88202190537413,67147.88071428573,-0.0024641788195867136,-0.001859641514416665,67233.74248809525,65833.66716250168,66908.46543849411,67144.34401858969,67360.46744450362,66903.73830546951,-107.97696234760224,-82.53817689429707,380.8867376293736,-81.03906157557503,-33.20326522187679,-16.27220949428738,67417.93540126916,66388.04120966986,21.419176063637494,25.380393533849837,False,True,66203.641,67103.641,66603.641,66553.641,,False,,,2024-05-24 11:42:14,fail,False,-74.66,8989.28000000001,,0,1,21,5
2024-05-24 12:00:00,67191.438,67236.734,67122.141,67171.836,1676,36421,0,2024-05-24 12:00:00,2024-05-24 12:00:00,-85.86177380951995,-478.9362848044984,67149.59235714286,-0.002655001189871914,-0.0013980784189980826,67147.88071428573,65581.56071019334,67068.37275797833,67148.6602980168,67317.7117593034,66967.85662469902,-97.15545368567109,-91.51894016115463,368.61797308188085,27.141219470227952,27.17593292053789,9.801166838748031,67466.99088835956,66470.22236103848,53.775990593452605,38.67678513361252,True,False,67671.836,67271.836,67271.836,67321.836,2024-05-24 13:00:00,True,2024-05-24 13:00:00,2024-05-24 17:26:00,2024-05-24 16:18:39,even,True,18.66,9007.94000000001,,1,0,21,5
2024-05-24 13:00:00,67373.82,67453.234,67359.938,67394.625,1303,36421,0,2024-05-24 13:00:00,2024-05-24 13:00:00,1.7116428571316646,-456.7012225766957,67201.82478571431,-0.0015844402318851796,-0.0010603440320415584,67149.59235714286,65978.45707147373,67227.25573046862,67235.1836097918,67317.7373175534,67180.28278809767,-66.88630579074379,-83.45700577123314,284.9801680093135,49.37350292397605,64.01027003780473,64.61040006886469,67566.50601491024,66795.5595612851,84.78953301920244,72.45454811071862,True,False,67894.625,66994.625,67494.625,67544.625,,False,2024-05-24 17:30:00,2024-05-24 17:28:49,2024-05-24 16:54:05,fail,False,-74.66,8933.28000000001,,0,1,21,5
2024-05-24 15:00:00,67364.141,67503.734,67345.438,67484.539,1297,36421,0,2024-05-24 15:00:00,2024-05-24 15:00:00,76.12167857142049,-413.5614998120145,67406.38807142856,0.0015875860694477386,-0.0002484917669498685,67277.94646428573,67485.1654130864,67526.1927173625,67362.3318631258,67359.5122596307,67483.10971104236,-21.6811128728732,-40.89364691571649,206.01080243906736,22.630246646076557,25.852699690440204,6.633980736034573,67762.7242943351,67204.99512774961,83.91565899630054,82.93213259873619,True,False,67984.539,67084.539,67584.539,67634.539,,False,2024-05-24 17:30:00,2024-05-24 17:31:50,2024-05-24 16:53:29,fail,False,-74.66,8858.62000000001,,0,2,21,5
2024-05-24 23:00:00,69109.141,69193.938,69010.047,69067.539,2405,36421,0,2024-05-24 23:00:00,2024-05-24 23:00:00,254.46773809519073,119.44406908015662,69051.21717857145,0.004479264255730991,0.0038774832919693204,68975.06958333329,70110.29145973656,70893.2702230929,68854.10699858252,68512.59641624492,69147.67221947025,195.2484780132072,182.34295060320215,516.0425736000379,32.47723323010723,56.64329962164629,31.48731647747627,69845.8296938303,68451.0147451102,82.41327956646812,78.09732920190362,False,True,68567.539,68967.539,68967.539,68917.539,2024-05-24 23:30:00,True,2024-05-24 23:30:00,2024-05-27 00:13:44,2024-05-24 23:37:21,even,True,18.66,8877.28000000001,,1,0,21,5
2024-05-27 00:00:00,68700.023,68700.023,68531.82,68567.836,780,56421,0,2024-05-27 00:00:00,2024-05-27 00:00:00,76.14759523815883,157.48237530328333,68886.31154761901,0.0023870703358014724,0.002428899094381736,69051.21717857145,68801.05406801919,70434.69293452252,68824.28679220777,68590.54982212829,68969.9356921225,160.7497349509067,178.28290215954704,359.16649396487855,-103.58888716886577,-56.73739938084327,-18.956226350201177,69454.81045897509,68483.5609252699,36.354725610339614,53.56098562075226,False,True,68067.836,68467.836,68467.836,68417.836,2024-05-27 00:45:00,True,2024-05-27 00:45:00,2024-05-28 06:35:27,2024-05-27 00:50:08,even,True,18.66,8895.94000000001,,2,0,22,5
2024-05-27 01:00:00,68505.539,68589.938,68452.711,68589.938,1553,56421,0,2024-05-27 01:00:00,2024-05-27 01:00:00,-164.90563095243124,161.0477904319123,68757.72673809518,0.0006362690300529967,0.00033815807258540787,68886.31154761901,68349.3221546656,69414.89234064575,68678.65028916053,68572.82375405145,68604.6296384589,106.53855345926422,144.42411968820875,314.5441556051308,-62.67823323010816,-91.59975816997758,-122.06108187134669,69029.26424852583,68178.49502839196,32.94131866121691,22.68045663733096,False,True,68089.938,68489.938,68489.938,68439.938,2024-05-27 02:30:00,True,2024-05-27 02:30:00,2024-05-28 06:35:27,2024-05-27 02:43:07,even,True,18.66,8914.60000000001,,3,0,22,5
2024-05-27 04:00:00,68833.336,68836.734,68745.641,68745.641,1120,36421,0,2024-05-27 04:00:00,2024-05-27 04:00:00,-9.661059523830772,184.31502471222484,68750.03817857141,7.293064769422992e-05,0.00015813919032140334,68631.77021428567,68166.18780329556,69358.8001553049,68648.24254983607,68600.74740960685,68630.36878775372,48.78343467699597,58.85021904620716,203.65786193509302,59.74186446508975,68.41951943591994,57.47247162014537,68906.80690136609,68355.43067414135,91.70102648150718,84.90630211215586,True,False,69245.641,68345.641,68845.641,68895.641,,False,2024-05-27 04:45:00,2024-05-27 04:40:58,2024-05-27 08:30:26,success,True,93.29,9007.89000000001,,4,0,22,5
2024-05-27 07:00:00,68882.336,68916.836,68802.75,68822.234,1209,36421,0,2024-05-27 07:00:00,2024-05-27 07:00:00,64.53988095240493,247.11512167462206,68942.29422619042,0.001308160183685637,0.0015922596631320922,68944.02928571429,69125.64365342674,70105.91041398613,68944.45522688355,68849.23308737014,69097.81799690399,68.71312946689432,76.68167816552267,250.79634891707576,-49.75777089786425,-36.97966701067344,-13.814340557262767,69436.39306794204,68757.74292586594,36.759263179186256,51.690665222778854,False,True,68322.234,68722.234,68722.234,68672.234,2024-05-27 08:30:00,True,2024-05-27 08:30:00,2024-05-27 08:30:28,2024-05-27 10:47:56,success,True,93.29,9101.180000000011,,5,0,22,5
2024-05-27 08:00:00,68766.539,68791.734,68718.25,68732.539,1071,36421,0,2024-05-27 08:00:00,2024-05-27 08:00:00,-1.735059523867676,235.42025195559836,68820.69372619041,-6.461761188891532e-05,9.758987879965515e-05,68942.29422619042,68290.90578340534,69368.41125485355,68864.80321413124,68832.31549358813,68872.57523495008,42.036520525449305,61.35194176024474,236.68449821475863,-60.66160130723438,-66.0061778465606,-51.45682146544277,69192.09930754,68551.55116236016,5.6050806419701225,10.951069199720143,False,True,68232.539,68632.539,68632.539,68582.539,2024-05-27 08:30:00,True,2024-05-27 08:30:00,2024-05-28 06:26:21,2024-05-27 10:41:11,even,True,18.66,9119.840000000011,,6,0,22,5
2024-05-27 11:00:00,68641.938,68850.039,68641.938,68761.539,1171,36421,0,2024-05-27 11:00:00,2024-05-27 11:00:00,-76.78238095235429,157.13975013271556,68543.10942857145,-0.0014936536456026858,-0.0008345595782151619,68585.78627380953,67585.01552896935,68697.221402255,68626.62035539179,68671.61849733678,68524.0118806329,-15.99716767782229,-10.383657620209613,252.60467208808325,48.01592019258533,30.844805641580024,39.81006363951019,68866.52818795182,68182.99557331398,69.66581175877278,55.317947609547524,True,False,69261.539,68361.539,68861.539,68911.539,,False,2024-05-27 16:45:00,2024-05-27 17:36:01,2024-05-27 14:38:13,fail,False,-74.66,9045.180000000011,,0,1,22,5
2024-05-27 20:00:00,70209.539,70399.234,70209.539,70373.711,1225,36421,0,2024-05-27 20:00:00,2024-05-27 20:00:00,364.68017857136147,361.59023516414163,70146.71905952378,0.0038344084659698782,0.00562317785018067,69875.93079761903,70757.2716139365,73054.60659974944,70018.03537009403,69550.75418244614,70562.9763302374,227.02175929372606,172.84918210791375,790.6434589234889,74.50135706923902,57.529970760209835,111.74713725486072,71631.84499978411,69495.6076606907,79.27575977104861,83.30785250445162,True,False,70873.711,69973.711,70473.711,70523.711,,False,,,2024-05-27 21:47:05,fail,False,-74.66,8970.520000000011,,0,2,22,5
2024-05-27 22:00:00,70026.438,70163.336,69918.25,69918.25,1714,36421,0,2024-05-27 22:00:00,2024-05-27 22:00:00,107.35340476190322,436.8942428052542,70006.2394642857,0.0014515095464929751,0.002271684778156866,70254.07246428568,69498.52318702576,71885.99699912152,70061.22788746092,69802.06181032598,70184.18927347778,175.74539429736615,194.4131955073751,593.6045811742689,-125.71852459578076,-98.89002373589028,-87.04908049534424,70985.55545806304,69381.32308889252,19.198717385775705,34.224514058506244,False,True,69418.25,70318.25,69818.25,69768.25,,False,2024-05-27 23:00:00,2024-05-27 22:48:48,,success,True,93.29,9063.810000000012,,1,0,22,5
2024-05-27 23:00:00,69273.648,69526.734,69182.484,69475.539,2309,36421,0,2024-05-27 23:00:00,2024-05-27 23:00:00,-247.83299999998417,389.39771460687916,69866.28779761904,0.0011600475803493734,0.00025410089342053454,70006.2394642857,69495.94452358663,70873.10542029195,69842.6875352514,69758.02653019354,69694.50039181282,105.50188626044837,157.37694088910476,457.1442686274225,-109.99337839701911,-206.00309184727666,-84.52006707938563,70311.64515445984,69075.8556291658,17.99525955836252,13.37411460113706,False,True,68975.539,69875.539,69375.539,69325.539,,False,2024-05-28 03:45:00,2024-05-28 04:46:21,2024-05-28 00:58:08,fail,False,-74.66,8989.150000000012,,0,1,22,5
2024-05-28 03:00:00,69440.789,69486.734,69391.938,69421.836,1067,36421,0,2024-05-28 03:00:00,2024-05-28 03:00:00,-82.27629761910066,322.062816329475,69454.50341666667,8.847892190385438e-05,-0.001452671293699805,69525.71197619042,69137.74617978676,69268.25416025746,69552.86388407306,69627.07095682823,69536.11555486752,-9.166144371891278,19.34473577292835,240.84509760591547,-10.508113863208564,-3.7791744065470994,-28.899941176408902,69861.2564366355,69209.47467309952,15.846930589968245,22.93259205469073,True,False,69921.836,69021.836,69521.836,69571.836,,False,,,2024-05-28 04:46:01,fail,False,-74.66,8914.490000000013,,0,2,22,5
2024-05-28 10:00:00,67968.961,68034.141,67849.836,67932.734,1576,36421,0,2024-05-28 10:00:00,2024-05-28 10:00:00,-113.13035714284342,-194.35824154839793,67769.82585714287,-0.0034752042448547103,-0.0038171548428586497,67904.17145238098,65832.0355637272,66970.02739106584,67997.02080950278,68292.56897020995,67825.9927241142,-192.84806660067989,-204.16683606557942,541.4776431577683,40.81847265221586,44.52067217064905,41.58530787748168,68558.48754237719,67094.99790585121,59.36953090141406,47.67505197060748,True,False,68432.734,68032.734,68032.734,68082.734,2024-05-28 12:00:00,True,2024-05-28 12:00:00,2024-05-28 12:47:13,2024-05-28 12:20:23,even,True,18.66,8933.150000000012,,1,0,22,5
2024-05-28 11:00:00,67693.836,67938.039,67584.734,67931.836,1862,36421,0,2024-05-28 11:00:00,2024-05-28 11:00:00,-134.34559523810458,-254.834005566212,67885.71316666667,-0.0011668605634915358,-0.0028021571443577965,67769.82585714287,66845.38261933223,67472.05102294005,67912.35444942159,68167.57113849753,67884.78065737875,-176.2606661082973,-191.59244784584547,338.1204441172738,7.254108359178645,-9.903599243232748,24.832155830736156,68342.74325693707,67428.31805782043,51.82772920222512,52.83370167431499,True,False,68431.836,68031.836,68031.836,68081.836,2024-05-28 12:00:00,True,2024-05-28 12:00:00,2024-05-28 12:47:13,2024-05-28 12:20:25,even,True,18.66,8951.810000000012,,2,0,22,5
2024-05-28 12:00:00,68154.266,68205.734,68065.836,68130.938,1967,36421,0,2024-05-28 12:00:00,2024-05-28 12:00:00,115.8873095237941,-262.4565100751497,68026.59476190475,0.00038338151082838737,-0.0006592021827325689,67885.71316666667,67718.39365532168,68347.4032321276,68004.84663730196,68148.97919003914,68014.70775197799,-128.92411280970555,-163.35815781497837,181.8168662481978,16.285747505986365,36.46971276230761,37.99418679052906,68261.66052141305,67769.25498254292,87.48644620182226,85.89114688054262,True,False,68630.938,68230.938,68230.938,68280.938,2024-05-28 12:45:00,True,2024-05-28 12:45:00,2024-05-28 13:12:20,2024-05-28 15:59:32,success,True,93.29,9045.100000000013,,3,0,22,5
2024-05-28 16:00:00,68208.914,68333.734,68066.836,68184.141,2048,36421,0,2024-05-28 16:00:00,2024-05-28 16:00:00,-18.6347976190591,-209.93859800195787,68212.04478571426,0.0002142746377148607,0.00177870727882921,68356.12284523807,67717.62367892002,69783.29996463718,68331.58698311346,68322.71603231317,68390.17850051605,-9.779833261112799,-14.772867205899196,281.96493051248683,-65.44114035084203,-63.79123529406206,-49.03274957000394,68770.8311567079,68008.02584432419,19.189168899575545,28.195248544011893,False,True,67684.141,68584.141,68084.141,68034.141,,False,2024-05-28 17:00:00,2024-05-28 16:57:30,2024-05-28 22:53:14,success,True,93.29,9138.390000000014,,4,0,22,5
2024-05-28 19:00:00,68381.641,68468.141,68259.055,68342.836,1943,36421,0,2024-05-28 19:00:00,2024-05-28 19:00:00,14.640345238018199,-222.97372604555858,67970.54933333334,-0.0014605491532099365,-0.0010543593930487762,68147.84369047616,66930.58557207757,68170.34797669297,68175.90836606435,68200.47106737219,68084.99532542139,-24.81091535143787,-33.98685276866178,258.58175453131435,57.48380116961198,68.53003267980239,51.13719332637265,68435.58069403867,67735.90995680411,78.86501578327614,65.99055365291927,True,False,68842.836,67942.836,68442.836,68492.836,,False,2024-05-29 01:15:00,2024-05-29 05:29:00,2024-05-28 19:29:27,fail,False,-74.66,9063.730000000014,,0,1,22,5
2024-05-28 20:45:00,68101.164,68130.992,67770.148,67792.938,1985,36421,0,2024-05-28 20:00:00,2024-05-28 20:00:00,-177.29435714281863,-250.14990412135376,67865.51279761903,-0.0018254165586332719,-0.0010544402496910528,67970.54933333334,66659.49307514919,68098.78569743353,67997.71993151044,68080.55701387177,67987.95058582725,-47.330303584152716,-42.060704098368575,218.21060280787884,-12.38546508437139,23.160362229173188,-4.5413391813781345,68282.53489961788,67691.86627203661,38.87676483095334,44.18679291056686,False,True,67292.938,68192.938,67692.938,67642.938,,False,2024-05-28 21:45:00,2024-05-28 21:39:52,2024-05-28 22:06:20,success,True,93.29,9157.020000000015,,1,0,22,5
2024-05-29 03:00:00,68422.438,68453.734,68283.156,68401.234,1079,36421,0,2024-05-29 03:00:00,2024-05-29 03:00:00,98.73374999989755,-88.63757246870955,68553.23134523805,0.0025172584718666235,0.0003878917723645854,68519.0185833333,68997.65952781502,68871.37982829529,68445.16317964238,68362.67854905633,68500.8685139319,45.903382649761625,44.23952838867811,258.3742523282452,-14.631212934298674,-18.798468524226337,-9.05677502580511,68849.67375457504,68150.56327328876,53.14462432322202,57.33559149162459,False,True,67901.234,68801.234,68301.234,68251.234,,False,2024-05-29 10:30:00,2024-05-29 11:01:38,2024-05-29 05:28:53,fail,False,-74.66,9082.360000000015,,0,1,22,5
2024-05-29 04:00:00,68514.938,68621.734,68458.742,68458.742,1630,36421,0,2024-05-29 04:00:00,2024-05-29 04:00:00,34.21276190475328,-64.93220688791189,68573.33449999995,0.002241290904026737,0.00030752268099017144,68553.23134523805,68959.49108735532,68842.02821055576,68465.83983583012,68395.60602615743,68505.63363089094,43.03051037514524,44.11031554899551,106.34368956491865,-15.52465806674445,2.1174537323822733,26.042921568616293,68649.19761180358,68360.5696499783,56.2132567098563,53.1675964465866,False,True,67958.742,68858.742,68358.742,68308.742,,False,2024-05-29 10:30:00,2024-05-29 10:58:58,2024-05-29 05:29:06,fail,False,-74.66,9007.700000000015,,0,2,22,5
2024-05-29 05:00:00,68587.734,68651.734,68456.242,68527.438,1903,36421,0,2024-05-29 05:00:00,2024-05-29 05:00:00,20.1031547619059,-39.955841183444136,68599.51894047615,0.0010802270255417577,0.0006701372812002173,68573.33449999995,68703.80977102541,69141.3440598909,68517.17341417978,68442.17028724872,68523.74194977635,45.575916265384876,44.89363365829424,105.80789008038626,-6.842256277988781,9.471142414928181,26.465682146386825,68666.58260138487,68379.40129816782,71.33369801621815,67.21240513742669,False,True,68027.438,68927.438,68427.438,68377.438,,False,2024-05-29 10:15:00,2024-05-29 10:58:32,2024-05-29 05:29:23,fail,False,-74.66,8933.040000000015,,0,3,22,5
2024-05-29 08:15:00,68622.539,68753.539,68622.539,68735.938,954,36421,0,2024-05-29 08:00:00,2024-05-29 08:00:00,72.70776190480683,52.18034058045305,68742.23596428573,0.0005963640459037105,0.0008267414716328432,68776.47201190479,68656.19802766705,69357.93677126506,68765.67552523082,68671.42327567177,68866.36351943584,62.15132480263128,66.16563754802381,182.2251823884264,-16.709141726823873,-34.661938768520486,5.476052975587663,69112.36751566021,68618.85952321146,57.17515056258153,72.3809662900749,True,False,69235.938,68335.938,68835.938,68885.938,,False,2024-05-30 20:15:00,2024-05-30 20:36:25,2024-05-29 10:08:43,fail,False,-74.66,8858.380000000016,,0,4,22,5
2024-05-29 09:00:00,68611.836,68688.641,68591.836,68629.141,884,36421,0,2024-05-29 09:00:00,2024-05-29 09:00:00,-34.23604761905153,53.575456827820744,68702.19219047618,0.0004978551760017714,0.00014433567621697566,68742.23596428573,68628.54662679158,69030.76397625194,68724.45237782532,68670.07963015654,68764.15943137257,46.68317114606907,59.21282321591315,167.739663261076,-30.245747506036423,-51.92579463357106,-20.032545923662838,68990.60797677502,68536.21088597011,25.591065641324047,38.27986911918139,False,True,68129.141,68529.141,68529.141,68479.141,2024-05-29 10:15:00,True,2024-05-29 10:15:00,2024-05-29 10:30:16,2024-05-30 16:46:11,success,True,93.29,8951.670000000016,,1,0,22,5
2024-05-29 10:00:00,68541.734,68564.836,68245.109,68370.641,1331,36421,0,2024-05-29 10:00:00,2024-05-29 10:00:00,-40.04377380954975,47.86747717174876,68451.82441666666,-0.0006818700096740069,1.579649302785503e-05,68702.19219047618,67767.0575026833,68959.00637498753,68619.89973515425,68630.32164847254,68565.35362263503,18.31830679794075,41.405160374692905,159.8556746610506,-77.24926900585706,-27.02967733053083,-62.2088290334068,68781.15878342744,68348.04846184261,11.247558369553673,12.363333223709205,False,True,67870.641,68270.641,68270.641,68220.641,2024-05-29 10:30:00,True,2024-05-29 10:30:00,2024-05-29 11:02:06,2024-05-29 10:38:47,even,True,18.66,8970.330000000016,,2,0,22,5
2024-05-29 15:00:00,67798.641,67981.641,67778.055,67980.734,1327,36421,0,2024-05-29 15:00:00,2024-05-29 15:00:00,-106.00994047620043,-126.01433167709911,67839.56967857141,-0.0013807007729465474,-0.001685287959177901,67837.70820238096,66864.06159544564,67584.29506882094,67949.8603363057,68082.99952674493,67932.94734090127,-80.74054328625789,-81.3117667750381,269.5577293712415,36.46024664603465,-9.079369453058462,21.665193670472945,68298.35027555245,67569.04440625009,55.20405269249028,55.70252252113851,True,False,68480.734,68080.734,68080.734,68130.734,2024-05-29 16:15:00,True,2024-05-29 16:15:00,2024-05-30 16:46:06,2024-05-29 16:17:49,even,True,18.66,8988.990000000016,,3,0,22,5
2024-05-29 16:00:00,67926.141,68286.641,67841.836,68218.141,2164,36421,0,2024-05-29 16:00:00,2024-05-29 16:00:00,1.8614761904464103,-137.9046881764225,67852.96949999995,-0.0003238017516362696,-0.0007911016755441923,67839.56967857141,67418.62289009223,68088.21716844746,67964.8928256662,68052.17230499856,67959.55343068461,-65.12927040336945,-77.11797594124114,145.50192015931086,54.739223598269746,6.200030271793366,-29.13613691095088,68157.48102289968,67763.12583846954,69.36174758583485,59.58118601285983,True,False,68718.141,67818.141,68318.141,68368.141,,False,2024-05-30 17:00:00,2024-05-30 17:02:09,2024-05-29 16:20:07,fail,False,-74.66,8914.330000000016,,0,1,22,5
2024-05-29 20:30:00,67656.031,67715.836,67551.5,67553.234,1614,36421,0,2024-05-29 20:00:00,2024-05-29 20:00:00,-67.67463095231506,-224.9586710766307,67574.06497619044,-0.0017557308368160189,-0.0012226760999566283,67597.58432142861,66510.91653988804,67636.04031844433,67584.12903282054,67704.62106032333,67457.56931441349,-80.21030956110917,-84.77278748942827,220.13852640957265,29.634228414215613,18.235282077715965,-15.977706570352893,67756.25632506641,67160.38230376056,54.28717028446559,52.7394211291544,False,True,67053.234,67453.234,67453.234,67403.234,2024-05-29 21:30:00,True,2024-05-29 21:30:00,2024-05-31 19:06:34,2024-05-29 21:42:15,even,True,18.66,8932.990000000016,,1,0,22,5
2024-05-29 21:00:00,67640.336,67651.734,67452.633,67484.836,1802,36421,0,2024-05-29 21:00:00,2024-05-29 21:00:00,-23.519345238179085,-228.0204142096336,67509.57646428572,-0.0017786188226021483,-0.001890717974678328,67574.06497619044,66385.13843107657,67143.05550609053,67576.17006491884,67683.93155926213,67476.36652528381,-74.86130671401042,-81.25247682706815,220.177475667237,-3.583981768169906,22.381192638495122,29.634228414215613,67773.60611743458,67177.62693313304,55.413887767283406,56.6298714995467,False,True,66984.836,67384.836,67384.836,67334.836,2024-05-29 23:00:00,True,2024-05-29 23:00:00,2024-05-31 19:06:49,2024-05-29 23:36:10,even,True,18.66,8951.650000000016,,2,0,22,5
2024-05-29 22:00:00,67417.156,67567.438,67372.031,67557.039,1234,36421,0,2024-05-29 22:00:00,2024-05-29 22:00:00,-64.48851190471032,-244.90005439406377,67405.80520238097,-0.0011968830365312768,-0.001322918130176256,67509.57646428572,66542.05801434783,67402.34302996822,67519.19219433761,67622.6602189345,67486.0486068111,-72.20275196050352,-77.84790560240532,214.50043572753245,24.921188166408683,-8.19983316132857,10.10576367386966,67777.12419504327,67196.47301857894,54.25189045012764,45.48510339170509,True,False,68057.039,67657.039,67657.039,67707.039,2024-05-29 22:30:00,True,2024-05-29 22:30:00,2024-05-30 05:21:09,2024-05-29 22:31:20,even,True,18.66,8970.310000000016,,3,0,22,5
2024-05-29 22:30:00,67736.492,67740.438,67385.344,67388.039,1740,36421,0,2024-05-29 22:00:00,2024-05-29 22:00:00,-64.48851190471032,-244.90005439406377,67405.80520238097,-0.0011968830365312768,-0.001322918130176256,67509.57646428572,66542.05801434783,67402.34302996822,67527.7640681352,67613.33154023878,67521.54919470243,-64.27441772571183,-72.70431303882452,173.5582666458849,-18.852382524855784,54.35297041617741,24.921188166408683,67755.85285467438,67285.74553473048,65.13705404835339,63.64497422898224,False,True,66888.039,67788.039,67288.039,67238.039,,False,2024-05-30 11:15:00,2024-05-31 19:09:17,2024-05-30 00:48:39,fail,False,-74.66,8895.650000000016,,0,1,22,5
2024-05-30 00:00:00,67488.039,67521.734,67397.203,67435.906,1281,56421,0,2024-05-30 00:00:00,2024-05-30 00:00:00,6.917916666629026,-263.76864706657943,67516.75996428574,0.0001538779280379432,-0.00034239025135632365,67412.7231190476,67205.44790878586,67730.85751880711,67441.71361487138,67527.86777523308,67382.43103646369,-62.324382218386745,-68.32206773795465,134.34696245462905,2.351982800042606,-9.633842449169606,-35.34920261433581,67565.29943577744,67201.06263714994,46.75349398484451,39.17271157817678,True,False,67935.906,67535.906,67535.906,67585.906,2024-05-30 00:45:00,True,2024-05-30 00:45:00,2024-05-30 05:05:47,2024-05-30 04:02:20,even,True,18.66,8914.310000000016,,1,0,22,5
2024-05-30 09:00:00,68162.141,68206.641,67915.141,67968.336,1803,36421,0,2024-05-30 09:00:00,2024-05-30 09:00:00,83.70969047618564,-27.096118803616264,68088.49377380949,0.0008047772068978437,0.001638545842977206,68132.9362023809,67980.16451749398,69146.11939077471,68076.17088854735,67979.02093048686,68152.77437839704,59.41369131171086,60.765864505292555,190.62227895585858,-42.85084176118835,-8.718087375309551,-5.331271757837385,68410.11445498744,67893.93430180663,31.208150260092395,40.02059678062127,False,True,67468.336,67868.336,67868.336,67818.336,2024-05-30 10:30:00,True,2024-05-30 10:30:00,2024-05-30 11:07:11,2024-05-30 10:34:45,even,True,18.66,8932.970000000016,,2,0,22,5
2024-05-30 10:00:00,67855.617,67957.438,67735.242,67904.734,2060,36421,0,2024-05-30 10:00:00,2024-05-30 10:00:00,-44.44242857140489,-28.571372164646164,67946.01694047615,0.0001289550159050197,0.0009642678443979756,68088.49377380949,67570.97206656265,68927.1954303693,67999.76985922139,67963.93920202887,68009.0518228414,36.07100592429924,50.46185784005375,156.03861667300305,-28.258508083905326,-37.1887131062831,-32.5555424837803,68219.70395534995,67796.89969033285,24.03720532514573,22.9669354331625,False,True,67404.734,67804.734,67804.734,67754.734,2024-05-30 11:00:00,True,2024-05-30 11:00:00,2024-05-30 11:07:13,2024-05-30 13:35:00,success,True,93.28,9026.250000000016,,3,0,22,5
2024-05-30 13:00:00,67769.469,67781.836,67623.992,67624.008,1138,36421,0,2024-05-30 13:00:00,2024-05-30 13:00:00,-69.21917857152584,-58.144499089437886,67775.8368452381,-0.0023243477468021536,-0.0010534727448349753,67759.95423809516,66200.29302027084,67728.56272305874,67689.31079061709,67767.19193314492,67543.48055452356,-31.48784635469201,-19.42205689751094,272.0281862240631,2.713209494322655,24.71930581354536,-18.960623322986066,67912.21860592604,67176.24250312107,55.864217540068715,52.71212318027642,True,False,68124.008,67724.008,67724.008,67774.008,2024-05-30 13:45:00,True,2024-05-30 13:45:00,2024-05-30 14:28:57,2024-05-31 17:25:55,success,True,93.28,9119.530000000017,,4,0,22,5
2024-05-30 14:00:00,67955.43,68030.641,67911.945,67987.938,1329,36421,0,2024-05-30 14:00:00,2024-05-30 14:00:00,15.88260714293574,-42.98247553000692,67777.10351190479,-0.0014312644238067352,-0.0006690666776401657,67775.8368452381,66467.56461835332,67947.20107097097,67800.97751246192,67804.9524716624,67776.0212139663,-8.1797822680237,-17.967734199273927,236.24895951586905,73.53179738561448,63.87539972482773,64.35164258688746,68096.45730931273,67457.08511861989,88.1795425895915,77.56271084699021,True,False,68487.938,68087.938,68087.938,68137.938,2024-05-30 15:45:00,True,2024-05-30 15:45:00,2024-05-30 16:46:07,2024-05-30 16:04:01,even,True,18.66,9138.190000000017,,5,0,22,5
2024-05-30 20:00:00,68690.508,68901.539,68685.383,68901.539,951,36421,0,2024-05-30 20:00:00,2024-05-30 20:00:00,134.6803809524572,144.542612682053,68890.33935714292,0.0018649277396013556,0.0030426013127174243,68591.32577380954,68939.71433738396,70433.44861557144,68526.5532237092,68351.06191015917,68630.89398864811,95.33558486904076,82.12800219936099,262.38538766789344,74.21207774338836,29.364203646357055,-11.132299621531274,68986.61426199977,68276.67371529645,77.79105148418721,62.52825333747503,True,False,69401.539,68501.539,69001.539,69051.539,,False,2024-05-30 20:45:00,2024-05-30 20:40:26,2024-05-30 22:49:03,success,True,93.28,9231.470000000018,,6,0,22,5
2024-05-30 20:15:00,68893.656,69150.539,68799.758,69026.836,2279,36421,0,2024-05-30 20:00:00,2024-05-30 20:00:00,134.6803809524572,144.542612682053,68890.33935714292,0.0018649277396013556,0.0030426013127174243,68591.32577380954,68939.71433738396,70433.44861557144,68603.51980467701,68401.11925014739,68710.42601651188,106.38734047034814,86.97986985355843,286.07724139731573,79.53202786376642,74.21207774338836,29.364203646357055,69098.13029239826,68324.2217406255,89.62399313995418,75.98015424876108,True,False,69526.836,69126.836,69126.836,69176.836,2024-05-30 20:45:00,True,2024-05-30 20:45:00,2024-05-30 20:52:23,2024-05-30 21:16:25,success,True,93.28,9324.750000000018,,7,0,22,5
2024-05-30 21:15:00,69168.672,69454.336,69116.922,69320.438,1498,36421,0,2024-05-30 21:00:00,2024-05-30 21:00:00,299.013583333377,223.5984817911085,69139.5354880952,0.0022206655778818306,0.003042809242497455,68890.33935714292,69244.95277714687,70647.87874421444,68948.85353854123,68643.98344453443,69152.22721396631,154.83366754748567,121.13044991243794,395.5243864661273,113.19334640524175,65.11993395253376,112.73226762987906,69687.68513569559,68618.26929223703,80.67539666718756,84.95795044159922,True,False,69820.438,68920.438,69420.438,69470.438,,False,,,2024-05-30 22:36:10,fail,False,-74.66,9250.090000000018,,0,1,22,5
2024-05-30 23:00:00,68686.836,68693.734,68047.656,68201.734,2687,36421,0,2024-05-30 23:00:00,2024-05-30 23:00:00,-92.74058333330322,276.5012300153321,68887.3152619047,-3.748869300118868e-05,0.0016942807969331439,69046.7949047619,68037.12630671513,70395.88966447469,68854.50318143315,68742.57156281617,69039.43027347783,99.68449878919637,133.1504399685465,395.452722920994,-179.8546198830445,-86.01411317507154,-81.15099655999802,69573.29144942117,68504.06909753449,21.537754457710417,36.191500926413504,False,True,67701.734,68601.734,68101.734,68051.734,,False,2024-05-31 12:30:00,2024-05-31 17:26:02,2024-05-31 04:03:45,fail,False,-74.66,9175.430000000018,,0,2,22,5
2024-05-31 04:00:00,68492.844,68649.734,68452.188,68649.734,1248,36421,0,2024-05-31 04:00:00,2024-05-31 04:00:00,-79.35270238101657,153.1253235816257,68349.97549999996,0.00029679800019681454,-0.0018130181263847993,68335.6290238095,68232.3405542454,68138.10401669366,68454.81856404536,68493.5469224978,68437.92827863777,-16.204322647186927,-14.857761488065623,224.97281644867027,56.92070347443223,22.280705538287293,-27.1726518747746,68743.14158084348,68134.21497643206,69.30937858751727,49.75236100522154,True,False,69149.734,68249.734,68749.734,68799.734,,False,2024-05-31 15:45:00,2024-06-03 09:30:04,2024-05-31 09:56:29,fail,False,-74.66,9100.770000000019,,0,3,22,5
2024-05-31 05:00:00,68461.734,68652.039,68445.242,68636.141,1414,36421,0,2024-05-31 05:00:00,2024-05-31 05:00:00,14.346476190461544,139.4697420028824,68458.1891428571,0.0008169880354220737,-0.0013210409455376394,68349.97549999996,68613.37371668733,68388.21180659738,68495.39160968413,68504.35006191977,68524.23123185422,-7.0843093848379795,-12.45924806498009,97.68318522137554,38.61593292064208,5.836873753039981,12.429913656611461,68657.60353190308,68392.35893180537,69.55493574255104,68.95173795186479,True,False,69136.141,68236.141,68736.141,68786.141,,False,2024-05-31 15:45:00,2024-06-03 09:30:03,2024-05-31 09:57:53,fail,False,-74.66,9026.110000000019,,0,4,22,5
2024-05-31 06:00:00,68562.938,68584.641,68526.102,68529.836,314,36421,0,2024-05-31 06:00:00,2024-05-31 06:00:00,108.21364285713935,135.23108701095043,68511.62319047614,0.0008170282015211994,0.0001680896061559043,68458.1891428571,68669.53014813634,68822.44846628795,68526.62876052607,68519.30039291928,68580.02029618162,0.051689259431441315,-5.9227893607292055,96.3699045791666,3.7591320949723013,12.501519435769296,19.402396284873248,68711.6196673635,68449.92092499975,57.93039869622525,63.679102726844455,True,False,69029.836,68129.836,68629.836,68679.836,,False,2024-05-31 15:45:00,2024-05-31 15:38:04,2024-05-31 10:53:00,fail,False,-74.66,8951.450000000019,,0,5,22,5
2024-05-31 07:00:00,68559.836,68675.734,68559.836,68656.539,745,36421,0,2024-05-31 07:00:00,2024-05-31 07:00:00,53.43404761904094,129.8262594587286,68540.86676190472,0.00045779461172437355,0.0005961610785146745,68511.62319047614,68549.74600931551,69015.78279125878,68558.11195640426,68537.25426003656,68616.78236085313,6.547667898557847,-0.3024583254521227,106.56115684601755,18.374343653267715,7.897083591407863,15.820425180500024,68762.13992259526,68472.924799111,65.68072286038479,58.744504882427954,False,True,68156.539,68556.539,68556.539,68506.539,2024-05-31 08:15:00,True,2024-05-31 08:15:00,2024-05-31 10:48:32,2024-05-31 15:23:29,success,True,93.28,9044.73000000002,,1,0,22,5
2024-05-31 07:30:00,68546.539,68574.734,68494.68,68566.836,740,36421,0,2024-05-31 07:00:00,2024-05-31 07:00:00,53.43404761904094,129.8262594587286,68540.86676190472,0.00045779461172437355,0.0005961610785146745,68511.62319047614,68549.74600931551,69015.78279125878,68557.94757825395,68540.08231347441,68604.92681183355,6.542572570993798,2.1152636787258867,100.19236625436763,-5.142159614682896,-6.7133894049038645,18.374343653267715,68740.18650627694,68468.16711739016,60.34581255681491,62.172001493412616,True,False,69066.836,68166.836,68666.836,68716.836,,False,2024-05-31 15:45:00,2024-06-03 09:28:49,2024-05-31 10:46:00,fail,False,-74.66,8970.07000000002,,0,1,22,5
2024-05-31 08:00:00,68531.727,68544.336,68397.641,68500.438,1036,36421,0,2024-05-31 08:00:00,2024-05-31 08:00:00,29.243571428582072,122.87573918893759,68534.98580952379,0.00011659858786333747,0.0005100234675026309,68540.86676190472,68344.75428391839,69014.43058909805,68546.80731934159,68537.16309728601,68560.96238734087,4.344027795363218,3.1808541226243543,91.57617495463566,-27.224337805324467,-16.740086687350413,-5.142159614682896,68684.59022352962,68435.83455115212,47.99940665685249,53.28383735805059,False,True,68000.438,68400.438,68400.438,68350.438,2024-05-31 09:15:00,True,2024-05-31 09:15:00,2024-05-31 12:19:21,2024-05-31 09:28:10,even,True,18.66,8988.73000000002,,1,0,22,5
2024-05-31 14:00:00,68352.836,68450.539,68296.836,68425.336,1227,36421,0,2024-05-31 14:00:00,2024-05-31 14:00:00,34.48333333338087,-2.2826289902004646,68209.72583333329,-0.001358250050474495,-0.000402741069448902,68158.12458333337,67327.12006564805,68367.80258601574,68243.58354023426,68286.07471897159,68190.41380254562,-33.73647845827509,-42.960384749866535,148.24086062926435,53.25235466111917,43.164213966345415,16.88795665637008,68392.03896439512,67990.28864069612,85.35666520727762,71.42295347154972,True,False,68925.336,68025.336,68525.336,68575.336,,False,2024-05-31 15:45:00,2024-05-31 15:30:11,2024-05-31 17:00:22,success,True,93.28,9082.01000000002,,2,0,22,5
2024-05-31 15:00:00,68369.641,68486.539,68332.758,68404.234,1168,36421,0,2024-05-31 15:00:00,2024-05-31 15:00:00,51.60124999991967,1.1903860158199677,68365.09416666665,-0.00040187024410734504,0.001075650124772581,68209.72583333329,67695.87198758208,69370.17057716641,68309.97275811667,68310.26348351421,68336.57207361537,-15.213444714157959,-29.950794586866653,135.31208806950215,31.23310423109797,42.32649982802104,48.915450636297464,68520.7433925092,68153.90075472154,85.42636006691991,84.52130513190619,True,False,68904.234,68504.234,68504.234,68554.234,2024-05-31 15:30:00,True,2024-05-31 15:30:00,2024-05-31 15:30:11,2024-05-31 16:32:42,success,True,93.28,9175.29000000002,,3,0,22,5
2024-05-31 21:00:00,67357.375,67457.836,67305.063,67404.336,1424,36421,0,2024-05-31 21:00:00,2024-05-31 21:00:00,-183.00849999999627,-225.04909936974582,67264.76604761905,-0.004467122973722615,-0.0030784934918478522,67331.36395238091,64884.8769306231,66943.42249874,67374.53866635867,67612.34645659616,67145.50385861716,-141.2946477390651,-140.12653763942023,628.6786854189331,83.00334812523215,80.11874750599964,51.25008255937428,67995.72008393271,66296.7876333016,62.44420867885564,53.654499412366384,True,False,67904.336,67504.336,67504.336,67554.336,2024-05-31 22:30:00,True,2024-05-31 22:30:00,2024-05-31 22:43:59,,success,True,93.28,9268.570000000022,,4,0,22,5
2024-05-31 22:00:00,67437.938,67461.734,67365.305,67461.734,1164,36421,0,2024-05-31 22:00:00,2024-05-31 22:00:00,-66.59790476186026,-240.9475921872654,67336.92807142854,-0.0029727999673403046,-0.002150316668439501,67264.76604761905,65285.66862933274,67428.83164617358,67400.69336774474,67562.51335821263,67363.25597557619,-114.79449176108756,-130.49026018236623,485.9648496722629,34.8938706570334,63.463092535268515,64.69328345372924,68020.80852263374,66707.20342851864,93.96375144038008,87.32553459098968,True,False,67961.734,67561.734,67561.734,67611.734,2024-05-31 22:45:00,True,2024-05-31 22:45:00,2024-05-31 22:45:58,,success,True,93.28,9361.850000000022,,5,0,22,5
2024-06-03 00:00:00,67845.734,67925.039,67797.742,67891.734,839,56421,0,2024-06-03 00:00:00,2024-06-03 00:00:00,168.03040476191381,-217.23826933799137,67680.37233333336,0.0027091667689171342,-0.00020788252397500352,67504.95847619046,68350.5958369292,67943.31071414656,67657.76982338358,67643.81931837372,67792.3930976952,-32.08747006155318,-67.27841946511599,263.8438963170742,30.44662641901232,14.127230822035926,10.739803233693237,68150.08235772325,67436.20383766714,69.93138926274798,65.35587699736874,True,False,68391.734,67991.734,67991.734,68041.734,2024-06-03 04:15:00,True,2024-06-03 04:15:00,2024-06-03 04:51:00,,success,True,93.28,9455.130000000023,,6,0,23,6
2024-06-03 02:00:00,67959.539,68019.438,67890.539,67918.141,782,36421,0,2024-06-03 02:00:00,2024-06-03 02:00:00,155.46235714282375,-166.84024528774898,67867.07627380957,0.0023406832478579053,0.001027943894986502,67835.83469047619,68440.89317326107,68601.29221220607,67843.69305680308,67763.13624215472,67969.27214688678,17.85683252646413,-6.706074467244165,231.16544163129672,4.744997592002619,11.29888200883579,18.44370209846238,68282.84549308903,67657.19880068453,80.83925874735911,83.50401948876332,False,True,67418.141,67818.141,67818.141,67768.141,2024-06-03 03:30:00,True,2024-06-03 03:30:00,,2024-06-03 03:50:49,even,True,18.66,9473.790000000023,,7,0,23,6
2024-06-03 03:00:00,67787.734,67858.234,67697.836,67858.234,723,36421,0,2024-06-03 03:00:00,2024-06-03 03:00:00,31.241583333379822,-155.4436957467551,67883.06966666666,0.001058157462587307,0.00011941369812555651,67867.07627380957,67918.84325392771,68104.71571379343,67848.71987411694,67787.9114493155,67925.17784829717,20.05556586975581,9.279714442386169,193.03215670501217,7.395010319829453,-30.24435328511754,-17.750201238435693,68187.27125984893,67664.58443674541,54.63401650689644,62.07298234597527,False,True,67358.234,67758.234,67758.234,67708.234,2024-06-03 03:30:00,True,2024-06-03 03:30:00,,2024-06-03 03:47:41,even,True,18.66,9492.450000000023,,8,0,23,6
2024-06-03 12:00:00,69157.102,69217.641,69067.938,69116.141,1553,36421,0,2024-06-03 12:00:00,2024-06-03 12:00:00,97.39730952390528,230.21392660720448,69070.27078571422,0.001810951858286931,0.001471523063372322,68999.5622619048,69452.79335444103,69967.85851929132,69054.66447003385,68827.56042765148,69239.81803164777,138.1692729814822,134.7693161826284,335.7508635493067,-7.706470588236698,4.2301874785043765,49.00172858616861,69693.08169743932,68785.05436585621,77.21633209603665,84.8023835052943,False,True,68616.141,69016.141,69016.141,68966.141,2024-06-03 14:00:00,True,2024-06-03 14:00:00,2024-06-03 17:55:37,2024-06-03 14:05:46,even,True,18.66,9511.110000000022,,9,0,23,6
2024-06-03 13:00:00,69037.336,69184.734,69037.336,69102.938,922,36421,0,2024-06-03 13:00:00,2024-06-03 13:00:00,70.70852380942961,251.23586071989848,69070.08666666666,0.0014109355433874564,0.0012423294778208173,69070.27078571422,69296.94961324181,69940.877319399,69056.75267293742,68888.25546544086,69136.34714241484,117.03577271218819,127.67441493198729,286.6431213843443,-12.273296181650949,-34.15963123495749,-30.1253464052279,69523.31535628371,68747.87892854598,45.643358718272644,49.099600582930954,False,True,68602.938,69002.938,69002.938,68952.938,2024-06-03 14:00:00,True,2024-06-03 14:00:00,2024-06-03 17:55:37,2024-06-03 14:05:36,even,True,18.66,9529.770000000022,,10,0,23,6
2024-06-03 14:00:00,68931.836,69099.641,68864.242,69092.141,1220,36421,0,2024-06-03 14:00:00,2024-06-03 14:00:00,-0.18411904756794684,257.49578219601244,69092.61724999998,0.0011504593840557854,0.0009429215227435038,69070.08666666666,69193.68247469755,69835.70925164274,69068.19636618035,68940.44065210217,69100.94857585139,98.78294565831311,114.72699873025635,194.35652085699374,9.106499140005326,-27.53023839009984,-11.921916064660763,69364.82987900834,68838.56727269445,40.934475841013544,49.37648853458288,False,True,68592.141,69492.141,68992.141,68942.141,,False,2024-06-03 18:00:00,2024-06-03 17:55:37,2024-06-03 15:30:46,fail,False,-74.66,9455.110000000022,,0,1,23,6
2024-06-03 15:00:00,69107.234,69279.438,69102.508,69269.938,793,36421,0,2024-06-03 15:00:00,2024-06-03 15:00:00,22.53058333332592,272.82767757248075,69312.31110714287,0.0009481599016584051,0.0013837312248293383,69092.61724999998,69200.89347246329,70215.73916202797,69126.61154536768,69005.58046817126,69142.0106484348,91.1860368832713,102.01958106144082,119.56609746423274,16.06547127624799,-14.052887168887537,12.428699002441135,69304.92488001152,68980.5964168581,63.00315775023711,59.49535254794509,True,False,69769.938,69369.938,69369.938,69419.938,2024-06-03 15:30:00,True,2024-06-03 15:30:00,2024-06-03 15:40:03,2024-06-03 15:32:29,even,True,18.66,9473.770000000022,,1,0,23,6
2024-06-03 23:00:00,69238.938,69516.539,69173.094,69449.938,957,36421,0,2024-06-03 23:00:00,2024-06-03 23:00:00,-71.86702380953648,298.62606300796324,69191.4036904762,0.0013623261447672584,-0.0016219860586865861,69216.56409523812,69493.57372984072,69057.52148199588,69265.78101724408,69273.6437099533,69228.21070553835,7.32130653274362,13.723689529626544,255.21001289773716,35.962786377669545,-10.44236532501236,-39.262344685252174,69574.24422295029,68883.67718812641,65.18520790412369,49.905517399306405,True,False,69949.938,69049.938,69549.938,69599.938,,False,2024-06-04 17:15:00,2024-06-04 17:07:46,2024-06-04 00:14:50,fail,False,-74.66,9399.110000000022,,0,1,23,6
2024-06-04 00:00:00,69103.617,69215.539,69041.836,69041.836,824,56421,0,2024-06-04 00:00:00,2024-06-04 00:00:00,-25.16040476191847,272.5481987226958,69202.04192857146,0.0007828440824108444,-0.0014106122111720099,69191.4036904762,69140.22868363137,69021.06249584813,69227.33965874692,69254.38360490913,69238.61810010318,-2.578315244143596,8.146173780171482,137.40234494128939,-42.82786962504906,-21.432556931540603,12.807966288251919,69424.11126577391,69051.62493443245,20.850198058213596,48.05824041258695,False,True,68541.836,68941.836,68941.836,68891.836,2024-06-04 01:15:00,True,2024-06-04 01:15:00,,2024-06-04 01:20:50,even,True,18.66,9417.770000000022,,1,0,23,6
2024-06-04 01:00:00,69100.836,69100.836,68821.836,68889.641,1218,56421,0,2024-06-04 01:00:00,2024-06-04 01:00:00,10.638238095256384,247.33564751660742,69100.42489285712,8.434037388211323e-05,-0.0007489051067444538,69202.04192857146,68846.54131360541,69205.29662907856,69134.45804942802,69198.54254371347,69086.435247334,-20.95814531513315,-4.936097567921243,137.08618253664105,-50.85383040943998,-29.047690058374428,-26.646723770274548,69271.50159375847,68899.86890090953,26.313152005464232,25.810824757634308,False,True,68389.641,69289.641,68789.641,68739.641,,False,2024-06-04 12:30:00,,2024-06-04 05:13:01,fail,False,-74.66,9343.110000000022,,0,1,23,6
2024-06-04 04:00:00,69022.938,69133.836,68917.07,69086.336,1249,36421,0,2024-06-04 04:00:00,2024-06-04 04:00:00,-42.05327380953531,162.1865053336369,69043.4006785714,-0.0011787714377305002,-0.0008146775476234492,68980.91680952381,68226.15340725445,69008.40780785336,68983.73331127998,69051.14461662865,68917.25650464393,-39.23756255717308,-39.6461278846193,169.47531857613257,40.92802373577433,36.691380460964865,31.560041967677535,69147.5481847217,68688.46482456615,72.06867145045645,55.60389181762141,True,False,69586.336,69186.336,69186.336,69236.336,2024-06-04 05:00:00,True,2024-06-04 05:00:00,2024-06-04 16:44:24,2024-06-04 05:05:43,even,True,18.66,9361.770000000022,,1,0,23,6
2024-06-04 05:00:00,69235.734,69305.836,69181.836,69284.039,1133,36421,0,2024-06-04 05:00:00,2024-06-04 05:00:00,62.48386904758809,162.8361997520842,69084.97645238094,-0.000979558681778157,-0.00046432757275675083,69043.4006785714,68229.01237587532,69197.69165883328,69080.4744259112,69083.23280400752,69084.93793257653,-15.472293834405718,-30.935283616794123,173.75402387308583,67.69792397650599,53.59897798430757,26.668627450955682,69321.00586480519,68850.37000034787,92.37201585334945,85.12611321267201,True,False,69784.039,68884.039,69384.039,69434.039,,False,2024-06-04 16:30:00,2024-06-04 16:55:42,2024-06-04 09:01:06,fail,False,-74.66,9287.110000000022,,0,1,23,6
2024-06-04 08:00:00,69073.656,69140.641,69001.781,69136.836,861,36421,0,2024-06-04 08:00:00,2024-06-04 08:00:00,-1.4288452381297247,133.46844295435585,69097.71126190474,0.0008468582145181563,0.0006469189663219274,69131.4592380952,69174.24791732137,69666.31119870937,69173.9082054257,69153.80682498355,69221.95634158929,7.899766356757027,5.953989547806174,163.5438209172317,-21.723885448896908,-48.85729308563168,-17.431280701755895,69442.74049982756,68999.67218335102,31.77290329521219,46.144933517521544,False,True,68636.836,69036.836,69036.836,68986.836,2024-06-04 09:00:00,True,2024-06-04 09:00:00,2024-06-04 12:18:00,2024-06-04 09:34:08,even,True,18.66,9305.770000000022,,1,0,23,6
2024-06-04 09:00:00,68977.141,68977.141,68768.203,68907.836,1312,36421,0,2024-06-04 09:00:00,2024-06-04 09:00:00,-33.74797619045421,112.40256576391403,69048.45751190472,0.00031053312070490374,0.0003034756525816312,69097.71126190474,68857.28116600396,69540.5166799332,69086.23716332193,69113.53678947466,69045.21878121773,-8.874655267572962,1.1682561729429874,139.48126609297958,-58.74102855176898,-52.87315514283546,-41.16032335741329,69233.51849044325,68855.4190719922,12.187585200472967,17.395113259650184,False,True,68407.836,68807.836,68807.836,68757.836,2024-06-04 12:30:00,True,2024-06-04 12:30:00,,2024-06-04 12:33:31,even,True,18.66,9324.430000000022,,2,0,23,6
2024-06-04 19:15:00,70545.906,70955.734,70531.852,70902.641,2918,36421,0,2024-06-04 19:00:00,2024-06-04 19:00:00,454.93082142852654,203.94282454432687,70265.43836904764,0.003676750306510951,0.004351642663820454,69799.92409523808,70805.73816063613,72341.74970251252,70069.19400472837,69674.1143568604,70452.36960853114,178.19748910260387,115.01182165489186,591.5023322426797,185.68169934635807,139.185408668709,152.469581355399,71252.39775705876,69653.84146000352,95.61259103483594,94.55790272722412,True,False,71402.641,70502.641,71002.641,71052.641,,False,2024-06-05 07:30:00,2024-06-05 10:45:02,2024-06-04 20:33:01,fail,False,-74.66,9249.770000000022,,0,1,23,6
2024-06-04 22:00:00,70729.742,70759.336,70531.836,70584.859,1592,36421,0,2024-06-04 22:00:00,2024-06-04 22:00:00,206.06408333325817,415.5232417990046,70730.76305952382,0.002724485070378089,0.004017000709774335,70717.41627380946,70900.57123764079,73115.52245874442,70617.31739233414,70273.18053402226,70903.88126659782,207.70618553207896,205.74757553889282,554.026720715958,-64.37341279670363,-2.6914974200481083,49.5511589267262,71651.81733956437,70154.44519363127,65.13235896709863,77.10671518239651,False,True,70084.859,70484.859,70484.859,70434.859,2024-06-04 22:45:00,True,2024-06-04 22:45:00,,2024-06-04 22:59:18,even,True,18.66,9268.430000000022,,1,0,23,6
2024-06-05 02:00:00,70592.039,70619.234,70532.492,70585.781,1040,36421,0,2024-06-05 02:00:00,2024-06-05 02:00:00,-74.47113095239911,449.58287837986427,70530.50774999996,0.00035142214525984164,-0.001220307463375037,70554.8945952381,70303.33878192061,70312.725896201,70557.3212868905,70448.55048765248,70569.66353869965,91.85991152015049,107.8599105189997,171.16055924823996,44.92568386650237,46.85049707609869,22.33648434803763,70802.23029368477,70338.59678371453,72.0106057230452,75.14117722236539,False,True,70085.781,70485.781,70485.781,70435.781,2024-06-05 02:30:00,True,2024-06-05 02:30:00,2024-06-06 23:02:02,2024-06-05 02:30:35,even,True,18.66,9287.090000000022,,2,0,23,6
2024-06-05 03:00:00,70559.234,70632.539,70501.734,70501.734,1170,36421,0,2024-06-05 03:00:00,2024-06-05 03:00:00,-24.386845238142996,444.89903554171906,70633.20252380957,0.0008939769776738837,-0.0004008999332804371,70530.50774999996,70678.54106801742,70814.26739758081,70537.61957366212,70466.15304113393,70599.11054626762,70.62774156472005,89.2057312529735,168.6729315707384,-11.552217062344425,14.278532851749333,21.287806329593877,70826.81900388811,70369.90208864713,56.01135942201816,57.66072767177452,True,False,71001.734,70601.734,70601.734,70651.734,2024-06-05 03:30:00,True,2024-06-05 03:30:00,2024-06-05 04:25:56,2024-06-05 03:31:04,even,True,18.66,9305.750000000022,,3,0,23,6
2024-06-05 04:15:00,70692.727,71047.836,70665.125,71021.039,1201,36421,0,2024-06-05 04:00:00,2024-06-05 04:00:00,102.69477380960598,455.3127195227571,70768.94870238089,0.0009740219886827685,0.0005319267977541135,70633.20252380957,70799.54008306804,71527.50510424493,70690.78312187371,70571.3246373798,70747.1637853457,80.73629382713989,79.69244390343957,168.24607575568413,66.30444857245311,5.948941176422522,25.49917027859192,70975.79598761589,70520.03158307553,74.36817145004248,71.14504846745339,True,False,71521.039,71121.039,71121.039,71171.039,2024-06-05 07:45:00,True,2024-06-05 07:45:00,2024-06-05 18:27:35,2024-06-05 08:02:08,even,True,18.66,9324.410000000022,,4,0,23,6
2024-06-05 05:15:00,70807.039,71023.734,70807.039,71010.438,913,36421,0,2024-06-05 05:00:00,2024-06-05 05:00:00,135.74617857132398,474.28519877258805,70856.4281309524,0.0009702251287589213,0.0014325339545434705,70768.94870238089,70866.22033484797,71900.30641039413,70820.4466066788,70674.12059990571,70915.34277055379,90.77116892882623,85.44012344426089,211.9954599640592,51.630487100061146,3.1283360853412887,52.17488613688329,71203.03664150527,70629.14889960231,54.25009695046777,61.10823073814387,True,False,71510.438,71110.438,71110.438,71160.438,2024-06-05 07:45:00,True,2024-06-05 07:45:00,2024-06-05 18:27:35,2024-06-05 08:02:09,even,True,18.66,9343.070000000022,,5,0,23,6
2024-06-05 06:45:00,70850.938,71038.438,70850.938,70975.836,1037,36421,0,2024-06-05 06:00:00,2024-06-05 06:00:00,87.47942857150338,473.48594805639004,70928.61842857143,0.0009568061845055542,0.0022507303801104607,70856.4281309524,70928.3025130781,72367.61860680403,70877.11445842388,70761.22695020722,70997.49155796353,79.74216552665166,84.03181763659114,184.98291710598573,0.4966081871825736,-4.5477939457050525,10.51042586856056,71248.71849605661,70747.76461987045,48.04061935968346,47.16690146970911,True,False,71475.836,71075.836,71075.836,71125.836,2024-06-05 07:45:00,True,2024-06-05 07:45:00,2024-06-05 18:27:26,2024-06-05 08:06:55,even,True,18.66,9361.730000000021,,6,0,23,6
2024-06-05 07:30:00,71069.695,71301.734,71042.672,71241.734,1414,36421,0,2024-06-05 07:00:00,2024-06-05 07:00:00,72.19029761903221,475.5925186000386,71040.83082142858,0.001143746931223135,0.0017958785612239088,70928.61842857143,71104.74619086366,72294.97214429722,70970.65007745205,70832.47167957059,71052.57452528381,86.71276307181688,83.49992074703815,214.08208370721243,33.80626590982138,14.884414516709512,6.392286893751589,71343.08533828854,70763.56371227908,62.1459155548049,53.68481597612839,True,False,71741.734,70841.734,71341.734,71391.734,,False,2024-06-05 18:30:00,2024-06-05 18:42:21,2024-06-05 13:04:00,fail,False,-74.66,9287.070000000022,,0,1,23,6
2024-06-05 09:00:00,71015.008,71025.141,70854.273,70892.648,1359,36421,0,2024-06-05 09:00:00,2024-06-05 09:00:00,32.7146071428142,480.59895248530665,71121.55792857139,0.0009673188319003697,-0.00015459109889448715,71073.5454285714,71140.54502847648,71268.3034842659,70978.36805417306,70891.64494479093,71023.50099484008,67.40110340910906,78.11612315177004,165.00347663360756,-12.463519779819762,9.054081871392555,-36.47394840043853,71246.25568829545,70799.24630138472,28.023354179583226,37.1279257147743,False,True,70392.648,71292.648,70792.648,70742.648,,False,2024-06-05 17:00:00,2024-06-06 23:01:23,2024-06-05 10:38:52,fail,False,-74.66,9212.410000000022,,0,2,23,6
2024-06-05 10:30:00,71094.141,71401.438,71052.734,71381.836,1137,36421,0,2024-06-05 10:00:00,2024-06-05 10:00:00,48.01249999999709,478.1994000675768,71159.30352380947,0.000970559009863475,9.717430663650943e-05,71121.55792857139,71211.46357956393,71440.04777938382,71104.81205428117,70992.33576084796,71156.33023323012,72.36654395950609,70.5874193426986,137.4215052105398,52.0184509804094,2.8705510835861787,30.89407671142544,71343.34926526435,70970.8112011959,73.55893146568327,68.6559120016907,True,False,71881.836,70981.836,71481.836,71531.836,,False,2024-06-05 18:30:00,,2024-06-05 11:47:57,fail,False,-74.66,9137.750000000022,,0,3,23,6
2024-06-05 12:00:00,70944.352,71023.438,70881.836,70931.234,1323,36421,0,2024-06-05 12:00:00,2024-06-05 12:00:00,-58.178595238001435,449.449231399165,71054.56814285718,0.0003401826648763238,0.0005171301643754207,71101.12492857147,70951.0034482847,71639.99851583046,71062.31138667479,71014.34649010446,71096.08090230484,47.066817707251175,61.66264909543251,134.5911659810895,-15.744814241421409,-29.10470278642606,-15.76881596140447,71277.77897637931,70912.88282823036,22.739408377147857,33.34710609551353,False,True,70431.234,70831.234,70831.234,70781.234,2024-06-05 17:00:00,True,2024-06-05 17:00:00,2024-06-05 17:15:13,2024-06-05 17:31:24,success,True,93.28,9231.030000000022,,1,0,23,6
2024-06-05 13:00:00,70931.734,70946.734,70823.141,70863.773,1042,36421,0,2024-06-05 13:00:00,2024-06-05 13:00:00,-46.55678571428871,420.592658319918,70958.0414166667,-0.0001018277622616257,5.63816959587299e-05,71054.56814285718,70719.6639479864,71440.6072419644,70989.07267267624,70988.3861965205,70976.80059786722,23.947201577902888,43.86047940536137,131.64539265411878,-47.874974544203724,-23.772603371166042,-50.00771001029352,71154.52187795028,70797.57931778416,7.630230866671375,12.728890345852811,False,True,70363.773,70763.773,70763.773,70713.773,2024-06-05 17:15:00,True,2024-06-05 17:15:00,2024-06-06 23:01:23,2024-06-05 17:26:37,even,True,18.66,9249.690000000022,,2,0,23,6
2024-06-05 16:00:00,70974.141,71129.336,70914.859,71043.734,1347,36421,0,2024-06-05 16:00:00,2024-06-05 16:00:00,3.3029642857291037,344.96690555033274,70851.32572619041,-0.0004834263135428194,-0.00048666291512262634,70938.56841666669,70472.87093436523,71058.37089880227,70954.36558597557,70954.34792897076,70948.22065497072,5.136746042728191,6.18697020231484,144.15564874782845,35.626166838614154,26.905149638841976,38.165595459140604,71144.33078078029,70753.61052916115,74.58585124630957,60.8110805260676,True,False,71543.734,70643.734,71143.734,71193.734,,False,2024-06-05 18:30:00,2024-06-05 18:27:39,2024-06-05 16:50:13,fail,False,-74.66,9175.030000000022,,0,1,23,6
2024-06-05 22:00:00,71114.281,71197.734,70891.039,70960.234,1293,36421,0,2024-06-05 22:00:00,2024-06-05 22:00:00,-46.20173809523112,321.01920527218317,71382.24363095233,0.0013751120190699704,0.0006920403082101925,71361.85910714285,71299.25437899573,72179.197046253,71253.40290508786,71226.00469885807,71291.5061011352,35.72147776671045,56.86727732376329,350.87441054668545,-116.49419195049268,-97.83503887169354,-118.7766047471232,71765.18655537322,70816.32564689717,16.397847697765556,26.706204702272213,False,True,70460.234,71360.234,70860.234,70810.234,,False,2024-06-06 22:45:00,2024-06-06 23:00:24,2024-06-05 22:52:07,fail,False,-74.66,9100.370000000023,,0,2,23,6
2024-06-06 01:00:00,71148.938,71276.734,71108.648,71203.836,751,56421,0,2024-06-06 01:00:00,2024-06-06 01:00:00,-96.03159523806244,267.7587732367829,71159.01175,0.0003782778425494354,-0.0015025272160881279,71254.03145238101,71084.31282754202,70893.60743693536,71181.17260557612,71193.51275460001,71130.54757103544,4.726701782710734,13.901207151890397,213.3346818987326,27.99227554182289,7.921752666021348,10.241447196356603,71420.04939159873,70842.54575047214,52.42385258737577,41.340864006466596,False,True,70703.836,71603.836,71103.836,71053.836,,False,2024-06-06 02:30:00,2024-06-06 02:28:32,2024-06-06 18:28:16,success,True,93.28,9193.650000000023,,1,0,23,6
2024-06-06 02:00:00,71154.242,71312.836,71142.539,71296.039,557,36421,0,2024-06-06 02:00:00,2024-06-06 02:00:00,-95.0197023810033,247.85886365147599,71134.77071428573,-0.0006470548289343506,-0.0012792946033123435,71159.01175,70502.44621151719,70932.27457442989,71202.69023508421,71200.92455839808,71223.03308049534,6.352794528545928,8.516020320850313,169.3033991372512,19.86283178529993,1.375769521924667,37.379294805650716,71453.09266933062,70994.47349166006,62.276549137964025,59.345594696395864,True,False,71796.039,70896.039,71396.039,71446.039,,False,2024-06-06 16:45:00,2024-06-07 15:00:27,2024-06-06 02:28:28,fail,False,-74.66,9118.990000000023,,0,1,23,6
2024-06-06 04:00:00,71032.836,71049.938,70910.195,70973.734,1194,36421,0,2024-06-06 04:00:00,2024-06-06 04:00:00,-61.17376190480718,199.2273276420019,71111.42202380949,-0.0006509102968367986,-0.0011214745383182154,71073.59695238092,70408.76981138317,70876.02304661408,71095.21439919615,71136.02575353786,71069.9532229102,-14.939802580076503,-6.196348567050443,112.88857037180277,-22.805620227067266,-12.415889920928748,-16.983425524565973,71222.35279291213,70916.05365290827,52.06986207363081,62.00199967996477,True,False,71473.734,71073.734,71073.734,71123.734,2024-06-06 04:45:00,True,2024-06-06 04:45:00,2024-06-06 16:41:42,2024-06-06 06:40:19,even,True,18.66,9137.650000000023,,1,0,23,6
2024-06-06 05:00:00,71149.438,71240.336,71114.32,71221.836,721,36421,0,2024-06-06 05:00:00,2024-06-06 05:00:00,37.82507142856775,185.11106711722095,71114.91535714282,-0.0004276340447304638,-0.0003097885928726378,71111.42202380949,70475.58884591961,71168.94773167955,71131.47109718256,71144.08082186306,71105.17320571035,-7.259535973484162,-8.638175214803079,96.52144422855262,19.489070519412053,-1.0633470932079945,10.629395252894028,71236.97715541889,70974.86925600181,78.22582637150407,71.59423464987839,True,False,71721.836,71321.836,71321.836,71371.836,2024-06-06 15:30:00,True,2024-06-06 15:30:00,2024-06-07 14:55:33,2024-06-06 15:31:13,even,True,18.66,9156.310000000023,,2,0,23,6
2024-06-06 06:00:00,71174.875,71205.734,71154.781,71176.938,477,36421,0,2024-06-06 06:00:00,2024-06-06 06:00:00,3.493333333331975,174.60601893265266,71104.39226190472,0.0002638463969531858,-0.00023412898414205567,71114.91535714282,70844.63648283748,71175.79290758607,71158.66386855677,71155.94850989716,71168.43195631233,-1.2095609281095676,-4.923445920487655,91.65169894692006,19.74279704154469,9.442178534605773,14.051244238042273,71293.66174989067,71044.70216273399,79.10296951341293,81.87636501814133,True,False,71676.938,71276.938,71276.938,71326.938,2024-06-06 15:30:00,True,2024-06-06 15:30:00,2024-06-06 18:28:38,2024-06-06 15:31:16,even,True,18.66,9174.970000000023,,3,0,23,6
2024-06-06 08:00:00,71070.914,71109.641,70893.836,70894.938,956,36421,0,2024-06-06 08:00:00,2024-06-06 08:00:00,-8.773571428580908,139.6665273890976,71037.62878571427,0.000330799083247408,-0.000288645368991007,71095.61869047614,70930.24921445911,71114.36352296834,71062.05814423467,71102.41764118588,71052.00156518753,-17.526952276020893,-9.90638526999758,105.47108732108683,-46.553117303032195,-2.1511400068266084,-1.9393746130663203,71194.387533071,70908.11559730406,29.18693205408225,31.397089152973123,False,True,70394.938,71294.938,70794.938,70744.938,,False,2024-06-06 23:00:00,2024-06-06 23:01:23,2024-06-06 15:15:42,fail,False,-74.66,9100.310000000023,,0,1,23,6
2024-06-06 14:15:00,71002.75,71091.141,70960.141,71037.836,808,36421,0,2024-06-06 14:00:00,2024-06-06 14:00:00,25.279226190396002,53.917002135916846,71064.21130952377,0.0002915942744588045,0.0002093352637859192,70988.25285714283,71023.9610645187,71292.29502618784,70997.29706880984,71002.40175698326,71009.98148262812,-8.98810022464022,-13.852856453659355,59.49040882624089,5.0271991743939,-2.787597523216391,12.698712418263312,71091.79353454354,70929.6694307127,43.689127882999344,37.62022275258948,True,False,71537.836,71137.836,71137.836,71187.836,2024-06-06 15:00:00,True,2024-06-06 15:00:00,2024-06-06 16:41:50,2024-06-06 15:42:20,even,True,18.66,9118.970000000023,,1,0,23,6
2024-06-07 01:00:00,70748.352,70835.938,70745.141,70803.539,258,56421,0,2024-06-07 01:00:00,2024-06-07 01:00:00,-83.15433333333931,-35.925972327095224,70763.2148095238,-0.002688388942213723,-0.001556206098476094,70719.16073809526,68922.12672834765,70460.5058422238,70770.09721989946,70872.8664014989,70638.82863708292,-57.950554578972515,-55.54122026221879,211.45532220343821,19.693292053678306,13.591175782581558,-3.558518403893686,70925.79332205755,70353.36395210828,64.76025211314706,62.34373721661637,True,False,71303.539,70903.539,70903.539,70953.539,2024-06-07 06:30:00,True,2024-06-07 06:30:00,2024-06-07 08:20:57,2024-06-07 15:30:12,success,True,93.28,9212.250000000024,,2,0,23,6
2024-06-07 02:00:00,70919.836,70969.734,70862.078,70886.266,1061,36421,0,2024-06-07 02:00:00,2024-06-07 02:00:00,44.05407142853073,-36.22064720779599,70780.11397619046,-0.0010885399619041643,-0.0008715809610687551,70763.2148095238,69529.56288277141,70711.55693370508,70815.37128680888,70869.08333454042,70777.56452012384,-41.13787261719699,-50.601474889925015,198.43981195850256,46.66587719296513,49.143544891659985,21.77663914684672,71046.95826626781,70509.67077397986,89.58371426335475,81.24640492623071,True,False,71386.266,70986.266,70986.266,71036.266,2024-06-07 07:15:00,True,2024-06-07 07:15:00,2024-06-07 08:45:02,2024-06-07 15:30:12,success,True,93.28,9305.530000000024,,3,0,23,6
2024-06-07 03:00:00,70817.836,70838.234,70754.0,70785.938,621,36421,0,2024-06-07 03:00:00,2024-06-07 03:00:00,16.89916666666977,-44.66226829998777,70807.97505952379,0.0007733349180064659,-0.0006462090024129285,70780.11397619046,70518.1076700823,70732.36699746383,70813.92427107485,70854.48954288973,70890.42753147575,-33.79367951367749,-41.66740781679373,162.02686539811623,9.594618507020641,31.379221534283715,32.070458204325405,71110.6637997632,70671.6912631883,60.15610692915561,72.09394403112408,True,False,71285.938,70885.938,70885.938,70935.938,2024-06-07 06:30:00,True,2024-06-07 06:30:00,2024-06-07 08:01:59,2024-06-07 15:30:12,success,True,93.28,9398.810000000025,,4,0,23,6
2024-06-07 04:00:00,70905.984,70910.336,70815.039,70841.273,427,36421,0,2024-06-07 04:00:00,2024-06-07 04:00:00,27.861083333322313,-43.13259515797836,70843.25802380955,0.0017473229206282164,-0.0005076553920444896,70807.97505952379,71205.47767275643,70779.2593054037,70838.74212026215,70857.27652168219,70872.49351668391,-22.732765476350323,-32.262008679920015,128.3732728093014,-9.300036807660945,5.003429996533669,-14.078252493971377,71045.79743497647,70697.68959839136,64.26338494883633,62.331580199924666,True,False,71341.273,70941.273,70941.273,70991.273,2024-06-07 06:30:00,True,2024-06-07 06:30:00,2024-06-07 08:21:23,2024-06-07 06:32:58,even,True,18.66,9417.470000000025,,5,0,23,6
2024-06-07 05:00:00,70848.867,70895.539,70798.836,70798.836,545,36421,0,2024-06-07 05:00:00,2024-06-07 05:00:00,35.282964285768685,-45.88621768025041,70891.72073809523,0.0014407760012735199,-0.00042403534948771233,70843.25802380955,71108.0515149601,70773.95508334809,70824.33219602809,70844.19231590733,70834.98323185416,-20.21385834328248,-25.832846725929596,106.96531664093679,-10.533791537600337,-4.862290333796409,-6.081308221517247,70979.38640931943,70689.08005438889,47.19527492729449,44.72355876931524,False,True,70298.836,71198.836,70698.836,70648.836,,False,2024-06-07 20:30:00,2024-06-07 20:40:47,2024-06-07 07:07:35,fail,False,-74.66,9342.810000000025,,0,1,23,6
2024-06-07 06:00:00,70841.516,70889.734,70757.039,70833.734,752,36421,0,2024-06-07 06:00:00,2024-06-07 06:00:00,48.462714285677066,-47.560580423567444,70924.74526190475,0.0013868587806663306,0.00026191665603856587,70891.72073809523,71167.82261101542,71121.78169654874,70814.81740114307,70832.86991471359,70798.8993594771,-17.646623137639835,-22.085154710108792,53.00649279836469,1.3739566563017434,-0.29089611281233374,-19.873995184039813,70871.95812475489,70727.34059419931,50.57032994494239,40.38333532825097,True,False,71333.734,70933.734,70933.734,70983.734,2024-06-07 06:30:00,True,2024-06-07 06:30:00,2024-06-07 08:21:20,2024-06-07 06:32:58,even,True,18.66,9361.470000000025,,1,0,23,6
2024-06-07 11:00:00,71133.836,71156.734,71066.836,71110.836,449,36421,0,2024-06-07 11:00:00,2024-06-07 11:00:00,1.086976190461428,41.30771674345306,71229.23207142853,0.0009070035045158606,0.0012034896979047829,71228.86513095238,71336.92653578015,72077.32288800066,71183.95432468707,71122.4343776793,71223.46344650838,40.39314337470569,44.98225966545755,188.63190931339386,-40.64219745445007,-30.05517612650874,-38.844912280736025,71478.11652408146,70967.3103689353,13.47959587868668,29.68939645562044,False,True,70610.836,71510.836,71010.836,70960.836,,False,2024-06-07 20:00:00,2024-06-07 20:15:20,2024-06-07 14:32:11,fail,False,-74.66,9286.810000000025,,0,1,23,6
2024-06-07 12:00:00,71143.234,71151.141,71081.531,71132.234,496,36421,0,2024-06-07 12:00:00,2024-06-07 12:00:00,0.36694047614582814,43.94635013547668,71264.30648809523,0.0008069688603382157,0.0003703994729077727,71229.23207142853,71321.92208616606,71674.44000067853,71167.296942395,71130.18095465908,71141.48200447201,30.547878908284474,38.46224298951568,121.57559654208956,-24.47180426554405,-18.302546611608705,-16.43046783625323,71305.60905980383,70975.8549491402,19.02465604838171,21.376619419331963,False,True,70632.234,71532.234,71032.234,70982.234,,False,2024-06-07 18:45:00,2024-06-07 20:15:13,2024-06-07 14:33:07,fail,False,-74.66,9212.150000000025,,0,2,23,6
2024-06-10 00:00:00,69678.539,69731.734,69663.242,69708.734,596,56421,0,2024-06-10 00:00:00,2024-06-10 00:00:00,-321.96927380959096,-371.42518139501044,69308.73851190475,-0.006406468134012463,-0.003975754576328895,69325.78074999999,65323.01442977466,68689.82525358249,69447.6380669955,69882.2974132336,68993.27278052979,-258.21573044774414,-256.35126507512183,914.3239413024921,151.8026460268884,59.71820502237824,2.139235294132959,70229.11010128816,67758.93545977143,47.80379753401467,37.7338863837422,True,False,70208.734,69308.734,69808.734,69858.734,,False,2024-06-10 18:30:00,,2024-06-10 10:54:52,fail,False,-74.66,9137.490000000025,,0,3,24,6
2024-06-10 01:00:00,69746.734,69788.141,69682.273,69690.836,723,56421,0,2024-06-10 01:00:00,2024-06-10 01:00:00,-17.042238095236826,-389.7779811841465,69350.5052380953,-0.0011268068728828128,-0.0034250364231358647,69308.73851190475,67759.80682008232,68801.7589675518,69575.20295980117,69836.5573170312,69605.74929755762,-195.35445472683932,-230.92891840075137,752.9130503317112,142.97125730988046,158.57909459926304,151.40387822502817,70623.68191550543,68589.31667960981,91.03257998323022,88.46816192059532,True,False,70190.836,69290.836,69790.836,69840.836,,False,2024-06-10 18:30:00,2024-06-10 18:54:36,2024-06-10 10:59:33,fail,False,-74.66,9062.830000000025,,0,4,24,6
2024-06-10 02:00:00,69637.594,69660.141,69602.07,69607.836,484,36421,0,2024-06-10 02:00:00,2024-06-10 02:00:00,41.76672619054443,-407.54897838435136,69454.95720238097,0.002425555079064727,-0.0031158436664833213,69350.5052380953,69919.76887347607,68803.64344958495,69604.78794413531,69783.74245587246,69729.01971241829,-154.3904418952152,-192.5462956568216,474.13799385363063,17.84239009291923,17.454148606731906,-11.8366037151427,70370.6060041207,69088.93342071588,78.22448755653271,80.7393105940216,True,False,70107.836,69707.836,69707.836,69757.836,2024-06-10 05:30:00,True,2024-06-10 05:30:00,2024-06-10 18:45:37,2024-06-10 06:01:59,even,True,18.66,9081.490000000025,,1,0,24,6
2024-06-10 03:00:00,69656.234,69665.641,69537.234,69539.938,745,36421,0,2024-06-10 03:00:00,2024-06-10 03:00:00,104.45196428567579,-416.7397827049135,69592.66435714284,0.0025334906280778434,-0.0025013531524393498,69454.95720238097,70165.99118003788,68945.27700670391,69610.68235790361,69740.67789666807,69739.99721568622,-123.05110869028431,-156.1287454865125,305.88876614087314,-3.2874929481185973,0.6822538699052529,-1.614704162318958,70152.9470499764,69325.54738139604,70.98478083096238,75.6081119540636,True,False,70039.938,69639.938,69639.938,69689.938,2024-06-10 05:15:00,True,2024-06-10 05:15:00,2024-06-10 18:43:45,2024-06-10 06:48:10,even,True,18.66,9100.150000000025,,2,0,24,6
2024-06-10 04:00:00,69581.938,69621.734,69525.563,69580.641,302,36421,0,2024-06-10 04:00:00,2024-06-10 04:00:00,137.70715476186888,-424.5361133526021,69669.2144047619,0.0023641560075783508,-0.00035102814555128974,69592.66435714284,70211.53810452763,69633.41701295071,69580.74032751188,69689.06882973269,69583.28872377025,-103.31470312908641,-129.08263669260717,217.70799372555948,-38.36053732369328,-41.79932473336521,-47.79019573444384,69877.19451529977,69287.88293224074,25.871241893747495,20.814099544707346,True,False,70080.641,69680.641,69680.641,69730.641,2024-06-10 05:30:00,True,2024-06-10 05:30:00,2024-06-10 18:45:24,2024-06-10 06:45:58,even,True,18.66,9118.810000000025,,3,0,24,6
2024-06-10 05:00:00,69625.0,69697.734,69603.844,69697.734,673,36421,0,2024-06-10 05:00:00,2024-06-10 05:00:00,76.55004761905002,-422.2165876395011,69697.68028571428,0.0016378580908913895,-5.61241517256534e-05,69669.2144047619,70079.28488111185,69797.77401499318,69616.34239295198,69678.91705609528,69593.15482696939,-75.69449260467081,-102.74307562379566,186.60454073294744,19.21467217062309,7.599179566488601,16.289840041310526,69846.57095695887,69341.23869697991,83.38852672454516,67.12251009378268,False,True,69197.734,69597.734,69597.734,69547.734,2024-06-10 09:45:00,True,2024-06-10 09:45:00,2024-06-10 12:31:18,2024-06-10 17:35:14,success,True,93.28,9212.090000000026,,4,0,24,6
2024-06-10 06:00:00,69727.438,69729.234,69682.234,69727.438,270,36421,0,2024-06-10 06:00:00,2024-06-10 06:00:00,28.465880952382577,-407.5787531048554,69671.21914285715,0.0012197420116950722,-5.6053827122271824e-05,69697.68028571428,69923.37210707316,69793.90861527412,69680.20178429362,69697.60492208021,69703.57818025454,-47.33212043745152,-74.27735062650665,75.37728571787859,19.029779153715936,18.639289301732788,34.09832714138611,69806.83751597368,69601.8188445354,81.54504158635864,87.27537052418124,False,True,69227.438,69627.438,69627.438,69577.438,2024-06-10 07:15:00,True,2024-06-10 07:15:00,2024-06-10 12:31:17,2024-06-10 07:26:03,even,True,18.66,9230.750000000025,,5,0,24,6
2024-06-10 07:00:00,69607.148,69645.938,69568.836,69577.141,582,36421,0,2024-06-10 07:00:00,2024-06-10 07:00:00,-26.461142857122468,-400.0883955280733,69651.52082142854,7.148844742930051e-05,-5.61447294952557e-05,69671.21914285715,69472.29863171413,69789.93060826525,69665.2751205435,69686.64461058438,69713.35046267629,-37.96315035446605,-53.26252489222888,75.57737687332278,-13.447435500536812,-4.97171035426436,6.920714482286712,69815.37992145527,69609.8210038973,52.4345909354469,65.62298865784526,False,True,69077.141,69477.141,69477.141,69427.141,2024-06-10 10:15:00,True,2024-06-10 10:15:00,2024-06-11 04:53:00,2024-06-10 10:17:15,even,True,18.66,9249.410000000025,,6,0,24,6
2024-06-10 09:00:00,69576.836,69576.836,69492.43,69575.234,714,36421,0,2024-06-10 09:00:00,2024-06-10 09:00:00,-15.529107142821886,-376.39481957574026,69569.16465476186,-0.0002463422761727654,-0.0002230155628960888,69635.99171428572,69258.50508179529,69687.94289784768,69618.61922257133,69650.78335409527,69588.50451427588,-30.33194238721626,-34.705942468554696,80.07543247914734,-15.865144478855655,-24.18451049189025,-22.39100894398871,69696.60634812272,69478.90268042903,22.10842067846853,19.470403089395727,False,True,69075.234,69475.234,69475.234,69425.234,2024-06-10 10:15:00,True,2024-06-10 10:15:00,2024-06-11 04:53:00,2024-06-10 10:17:15,even,True,18.66,9268.070000000025,,7,0,24,6
2024-06-10 13:00:00,69453.438,69487.539,69383.539,69432.438,666,36421,0,2024-06-10 13:00:00,2024-06-10 13:00:00,-20.0105833333364,-362.8595767589286,69403.53647619051,-0.0008236355415657803,-0.0005996221718884059,69398.71651190476,68840.40269320291,69314.21420189488,69432.55894197467,69490.06649618656,69382.2864083247,-39.057546009804355,-40.96100095760145,105.91782379935277,7.71688200889912,6.747244582089479,-1.6220873753190972,69526.77547045382,69239.29734619557,62.87937457467117,47.66946055110851,True,False,69932.438,69532.438,69532.438,69582.438,2024-06-10 17:45:00,True,2024-06-10 17:45:00,2024-06-10 18:18:06,2024-06-10 22:07:08,success,True,93.28,9361.350000000026,,8,0,24,6
2024-06-10 14:00:00,69456.938,69458.641,69372.875,69394.641,709,36421,0,2024-06-10 14:00:00,2024-06-10 14:00:00,4.819964285750757,-347.90436088886054,69420.68220238098,-0.0004499762125275797,-0.0002705109370168829,69403.53647619051,68994.13493655079,69491.9803998187,69419.14399809009,69467.20430683531,69405.09394358446,-34.904322910660994,-38.38832425702587,86.57598709273752,2.8321451668743975,18.22645717233536,4.025431028523599,69523.47152615966,69288.21636100927,69.54031918220649,67.13129567320776,True,False,69894.641,69494.641,69494.641,69544.641,2024-06-10 17:45:00,True,2024-06-10 17:45:00,2024-06-10 18:18:05,2024-06-10 22:54:54,success,True,93.28,9454.630000000026,,9,0,24,6
2024-06-10 22:00:00,69856.781,69856.781,69503.422,69678.039,1413,36421,0,2024-06-10 22:00:00,2024-06-10 22:00:00,23.57827380951494,-102.912980593057,69867.43898809524,0.0003867502416482027,0.0006499110644841655,69983.22585714287,69509.87192014453,70575.66790058432,69863.43416701979,69784.99978745155,69911.96264671483,50.51670439924055,55.46099411903597,244.56599891496563,-67.27287925696874,-38.095811489532935,-31.63270416238811,70242.12674525003,69580.29854817963,32.19816937785947,42.36110464753134,False,True,69178.039,69578.039,69578.039,69528.039,2024-06-10 23:00:00,True,2024-06-10 23:00:00,2024-06-11 04:52:59,2024-06-10 23:28:35,even,True,18.66,9473.290000000026,,10,0,24,6
2024-06-10 23:00:00,69509.336,69534.641,69331.844,69372.539,1778,36421,0,2024-06-10 23:00:00,2024-06-10 23:00:00,-115.78686904763163,-115.38176530363853,69774.43310714286,0.00019703851148699948,-0.00026404600750026103,69867.43898809524,69389.1716715105,70033.19897997532,69715.01400957028,69729.1827668495,69658.45681148954,14.873369054519571,39.92372110408607,209.53763926226796,-82.27775025799929,-75.05354420364893,-50.66802923975047,69941.3326244936,69374.08099848547,17.173723841332976,26.12650996942269,False,True,68872.539,69772.539,69272.539,69222.539,,False,2024-06-11 05:00:00,2024-06-11 04:53:01,2024-06-12 17:22:35,success,True,93.28,9566.570000000027,,11,0,24,6
2024-06-11 03:00:00,69534.039,69581.734,69498.648,69543.438,628,36421,0,2024-06-11 03:00:00,2024-06-11 03:00:00,-35.995059523775126,-120.88790594077727,69464.50908333335,-0.000950411590227924,-0.0013517956194379834,69516.6690595238,68797.69424320909,69191.80497327683,69550.3044609824,69600.80001336693,69533.06267629856,-22.916020947144716,-17.35360554681691,163.73794460049513,11.847650842784788,12.487228758109268,4.799360165168764,69755.60890150923,69312.0164510879,50.90334595214605,49.266891538923424,True,False,70043.438,69143.438,69643.438,69693.438,,False,2024-06-12 17:30:00,,2024-06-11 04:53:00,fail,False,-74.66,9491.910000000027,,0,1,24,6
2024-06-11 04:00:00,69431.836,69517.141,69389.219,69517.141,931,36421,0,2024-06-11 04:00:00,2024-06-11 04:00:00,-52.159976190450834,-128.33448051681626,69217.31329761907,-0.002217529352473519,-0.0012247113307705649,69464.50908333335,67856.86483453083,69195.66725862249,69515.33497591973,69568.23446145002,69470.45815858275,-26.72413917047379,-22.57027024700287,90.78294376366757,-0.25866769861022476,-17.22469865846506,-33.04309253524116,69593.0151326637,69346.40118450181,30.624786921302142,28.98440297113733,True,False,70017.141,69117.141,69617.141,69667.141,,False,2024-06-12 17:30:00,,2024-06-11 04:53:00,fail,False,-74.66,9417.250000000027,,0,2,24,6
2024-06-11 04:45:00,69389.117,69453.438,68481.836,68723.234,2935,36421,0,2024-06-11 04:00:00,2024-06-11 04:00:00,-52.159976190450834,-128.33448051681626,69217.31329761907,-0.002217529352473519,-0.0012247113307705649,69464.50908333335,67856.86483453083,69195.66725862249,69371.09709009975,69486.56217457484,69309.45438906089,-50.88320484792348,-30.040521430900018,176.48392548225323,-142.61662229101057,-11.539972824219149,-6.847174406633712,69547.70768846193,69069.70108965985,18.44935312652834,27.869001470099857,False,True,68223.234,68623.234,68623.234,68573.234,2024-06-11 05:15:00,True,2024-06-11 05:15:00,2024-06-11 05:18:12,2024-06-12 15:30:18,success,True,93.28,9510.530000000028,,1,0,24,6
2024-06-11 12:00:00,67523.539,67672.539,67507.125,67542.984,1055,36421,0,2024-06-11 12:00:00,2024-06-11 12:00:00,-78.40727380960016,-584.8033235852636,67381.2255714286,-0.002104189784228683,-0.002685751318368473,67593.09497619045,66294.5468500914,66926.83669004308,67645.19618128533,67936.97565768794,67500.39050154797,-193.2682373264688,-201.52776896719652,302.1537077953608,-7.725299277633894,-32.4569349844387,-10.88293945651094,67908.2980070717,67090.98299602424,38.81543046692049,32.44747377578142,True,False,68042.984,67142.984,67642.984,67692.984,,False,2024-06-12 13:00:00,2024-06-12 13:58:10,2024-06-11 12:47:22,fail,False,-74.66,9435.870000000028,,0,1,24,6
2024-06-11 15:00:00,66901.336,67180.734,66801.828,67171.836,2147,36421,0,2024-06-11 15:00:00,2024-06-11 15:00:00,-135.24486904763035,-720.9962074900395,66963.7405952381,-0.0023521228322630856,-0.0019449156423556897,67027.21676190474,65720.12145218096,66742.51253954934,67144.51111145652,67423.79373874782,66964.97216546266,-187.67147171167016,-196.1648967621524,313.4414478410296,20.109063639494707,-30.275195046444423,-28.438568627505447,67389.61812004805,66541.82621087728,35.46074072890281,32.23619920695602,True,False,67671.836,66771.836,67271.836,67321.836,,False,2024-06-11 23:00:00,2024-06-12 12:54:30,2024-06-11 16:48:38,fail,False,-74.66,9361.210000000028,,0,2,24,6
2024-06-11 16:00:00,67022.625,67221.734,66849.836,67197.938,1826,36421,0,2024-06-11 16:00:00,2024-06-11 16:00:00,-63.47616666664544,-729.1079404458433,66872.76701190475,-0.0022463639118984226,-0.0015184806738036654,66963.7405952381,65615.67168200767,66850.55757560823,67097.00086743584,67320.65297334299,66946.6691606467,-164.52365833005751,-184.05680186090333,291.58799088744166,49.027692122530425,-5.064630890992703,-9.515527691852185,67341.81294834476,66553.02537294866,58.833302426801104,43.24838186168379,True,False,67697.938,66797.938,67297.938,67347.938,,False,2024-06-11 23:00:00,2024-06-12 12:54:54,2024-06-11 16:48:36,fail,False,-74.66,9286.550000000028,,0,3,24,6
2024-06-11 16:45:00,66972.539,67048.336,66506.836,66814.734,3371,36421,0,2024-06-11 16:00:00,2024-06-11 16:00:00,-63.47616666664544,-729.1079404458433,66872.76701190475,-0.0022463639118984226,-0.0015184806738036654,66963.7405952381,65615.67168200767,66850.55757560823,67053.40411404512,67254.34061273608,66988.7641922944,-150.29191756393993,-167.75597490182733,236.0405796745413,-23.877645338929142,10.954919160722056,55.01775782590266,67307.41897485503,66668.60940973378,57.50298592306998,68.13383022866269,False,True,66314.734,67214.734,66714.734,66664.734,,False,2024-06-11 18:45:00,2024-06-11 18:40:59,2024-06-11 21:40:27,success,True,93.28,9379.830000000029,,1,0,24,6
2024-06-11 18:30:00,66863.141,66879.234,65981.836,66092.883,3552,36421,0,2024-06-11 18:00:00,2024-06-11 18:00:00,-46.27488095233275,-744.967959097281,66614.01504761908,-0.0020810859197458544,-0.0014849943394011733,66826.49213095242,65421.63424039907,66663.17942770683,66848.41715997597,67064.68436757164,66799.19930443758,-142.64546883443836,-140.67425676792493,230.36103175469475,-158.9595534914988,-31.969573099457193,15.014765393847483,67110.18669730642,66486.71191156875,41.5469124461612,52.34845276156863,False,True,65592.883,66492.883,65992.883,65942.883,,False,,,2024-06-11 19:05:26,fail,False,-74.66,9305.17000000003,,0,1,24,6
2024-06-11 19:45:00,66648.867,66708.938,66321.836,66488.438,2003,36421,0,2024-06-11 19:00:00,2024-06-11 19:00:00,-212.47708333334594,-784.6118970479729,66553.68696428572,-0.002081051810424265,-0.0014881840645358379,66614.01504761908,65285.26865075394,66562.99939117314,66672.94302614186,66894.49382858451,66494.47151014792,-144.86903086217353,-145.37468770559514,282.5777181378271,-68.85091572061356,-12.64274716208456,-50.65540144473198,66875.95142963399,66111.49159066186,46.82253634500872,45.64367267361192,False,True,65988.438,66388.438,66388.438,66338.438,2024-06-11 20:30:00,True,2024-06-11 20:30:00,,2024-06-11 20:32:18,even,True,18.66,9323.830000000029,,1,0,24,6
2024-06-11 21:00:00,66766.891,66831.734,66651.836,66811.438,1210,36421,0,2024-06-11 21:00:00,2024-06-11 21:00:00,30.77280952381261,-758.7911088007677,66732.74709523805,-0.0016529807552554297,-0.0001408120963687125,66584.45977380953,65211.20856095397,67182.7870887336,66645.85990736472,66802.66112145242,66502.00345407629,-119.88957561321149,-137.42852466059463,303.9035401509182,49.053868592964136,57.68059614721278,-3.1843422772508347,66913.77323328002,66091.73367487255,64.12946094152453,51.91710533201019,True,False,67311.438,66911.438,66911.438,66961.438,2024-06-11 21:30:00,True,2024-06-11 21:30:00,2024-06-11 22:45:02,2024-06-12 04:25:48,success,True,93.28,9417.11000000003,,2,0,24,6
2024-06-12 02:00:00,67351.039,67586.734,67351.039,67474.836,963,36421,0,2024-06-12 02:00:00,2024-06-12 02:00:00,122.98251190478913,-455.12946601529256,67411.33183333333,0.0027772987407860485,0.0013387446757895814,67419.17747619047,68058.4632769229,68311.71272206804,67329.9661684309,67212.73573487891,67401.05855452354,49.907085784943774,34.43782474010722,317.4565723612794,22.506181974546053,-12.646842105314136,-28.994775713785202,67831.12492721126,66972.49218183581,57.07558918440895,58.56766175238581,False,True,66974.836,67374.836,67374.836,67324.836,2024-06-12 02:45:00,True,2024-06-12 02:45:00,2024-06-12 04:25:46,2024-06-12 03:13:32,even,True,18.66,9435.77000000003,,3,0,24,6
2024-06-12 03:00:00,67294.039,67406.336,67269.234,67406.336,397,36421,0,2024-06-12 03:00:00,2024-06-12 03:00:00,-7.845642857137136,-414.3757119746879,67341.04997619051,0.0021632042298577415,0.0001856053898900041,67411.33183333333,67783.20182968996,67687.50361977678,67338.0469748257,67247.58273639609,67367.13611936706,46.336159005601075,41.77038293678545,150.40800716850276,7.817379772954155,-20.70873890601797,-8.252910904790042,67571.68692904453,67164.08530968959,43.76754890678905,44.92049610024255,False,True,66906.336,67306.336,67306.336,67256.336,2024-06-12 03:30:00,True,2024-06-12 03:30:00,2024-06-12 04:26:25,2024-06-12 05:07:02,success,True,93.28,9529.05000000003,,4,0,24,6
2024-06-12 04:00:00,67199.266,67243.438,67135.539,67146.539,782,36421,0,2024-06-12 04:00:00,2024-06-12 04:00:00,-70.28185714282154,-385.8687911511515,67257.67271428573,0.0005344146512778463,5.3149707332026625e-05,67341.04997619051,67048.7829491411,67608.70782743863,67271.69268815598,67236.39379372071,67277.41396560031,27.974845492222812,37.259400746619264,92.54393065767694,-42.743141726823524,-24.58783625731303,-4.582671138632577,67402.34827198817,67150.97965921245,9.9705568831902,17.68030653389978,False,True,66646.539,67046.539,67046.539,66996.539,2024-06-12 04:30:00,True,2024-06-12 04:30:00,2024-06-13 18:40:01,2024-06-12 04:33:18,even,True,18.66,9547.71000000003,,5,0,24,6
2024-06-12 10:00:00,67260.438,67323.336,67221.922,67314.641,664,36421,0,2024-06-12 10:00:00,2024-06-12 10:00:00,-13.738869047607295,-219.20004142985272,67367.85341666665,0.0007990526424650984,5.9580533064164636e-05,67325.06629761907,67443.99286840514,67630.74485221133,67336.32473803774,67331.4051113583,67315.90646646032,12.687624084646814,21.340837367561985,152.96421069949199,-14.491072239368805,-14.887135190831032,-12.1316618508572,67522.40815090464,67107.904782016,29.55427046685888,32.30942994499464,False,True,66814.641,67714.641,67214.641,67164.641,,False,2024-06-13 18:30:00,2024-06-13 18:36:37,2024-06-12 12:55:09,fail,False,-74.66,9473.05000000003,,0,1,24,6
2024-06-12 12:00:00,67381.234,67485.039,67327.219,67481.836,381,36421,0,2024-06-12 12:00:00,2024-06-12 12:00:00,3.8680238095257664,-170.9575146957941,67480.67139285718,0.00030421220321959674,0.00044097538221053,67371.72144047618,67347.13600686399,67925.76286896295,67402.97011577383,67373.82444059143,67414.68512796698,18.594692464597756,17.683389145854925,87.66189490523912,39.61082318543049,11.848671138723148,17.546803577439277,67534.52868608905,67296.34156984491,71.85177869057192,67.88753640621097,False,True,66981.836,67881.836,67381.836,67331.836,,False,2024-06-13 06:45:00,2024-06-13 06:38:24,2024-06-12 13:01:57,fail,False,-74.66,9398.39000000003,,0,2,24,6
2024-06-12 21:00:00,69779.234,69783.938,68792.469,69162.141,5417,36421,0,2024-06-12 21:00:00,2024-06-12 21:00:00,116.51051190473663,542.2990656613256,69585.73799999998,0.002055666713267332,0.0018952835982931245,69877.17991666663,69147.90701750021,71059.2472077252,69517.70289160722,69241.49900145992,69541.89800584795,208.68257505194924,242.4609819030074,510.60702310184354,-103.32920295836811,-5.267672170593869,-10.127861713190214,70231.21748703544,68851.07852466046,50.780744023981946,52.52041126915585,False,True,68662.141,69562.141,69062.141,69012.141,,False,2024-06-12 22:00:00,2024-06-12 21:49:04,,success,True,93.28,9491.670000000031,,1,0,24,6
2024-06-12 22:00:00,68815.547,69025.039,68792.352,68910.141,2519,36421,0,2024-06-12 22:00:00,2024-06-12 22:00:00,-291.44191666664847,498.0431691153208,68778.63891666666,-0.0011102615052350998,-0.0010030834321843604,69585.73799999998,66891.48023185103,69424.73352716709,69263.67029144714,69179.89425609102,69125.30352941174,124.08018449919473,188.51571782600843,295.08870311978484,-98.03250429999025,-121.34175197797595,-85.61364981080987,69523.67327862345,68725.43378020004,27.235924971120543,29.429216692546706,False,True,68410.141,68810.141,68810.141,68760.141,2024-06-12 22:30:00,True,2024-06-12 22:30:00,2024-06-12 22:30:16,,success,True,93.28,9584.950000000032,,2,0,24,6
2024-06-13 03:00:00,68250.156,68280.836,68061.039,68085.938,1024,36421,0,2024-06-13 03:00:00,2024-06-13 03:00:00,-46.65135714283679,181.43694680029876,68142.82485714286,0.0016798511430318078,-0.0033846050925996915,68100.83253571429,68235.52994058208,67431.2213648111,68265.57057648759,68430.45077729331,68354.34024630197,-85.1308761396358,-75.37032230259882,420.1552576771189,-29.379520123897237,37.31224355006998,54.95802098386048,68921.54984416609,67785.63064843786,36.69947787080992,51.88683037126722,True,False,68585.938,68185.938,68185.938,68235.938,2024-06-13 04:00:00,True,2024-06-13 04:00:00,,2024-06-13 04:18:03,even,True,18.66,9603.610000000032,,3,0,24,6
2024-06-13 04:00:00,68309.898,68352.141,68209.078,68281.836,1054,36421,0,2024-06-13 04:00:00,2024-06-13 04:00:00,41.992321428566356,154.55714528988756,68171.65545238099,0.0016613402393691233,-0.0029627393645750414,68142.82485714286,68337.25042675807,67519.83357941447,68258.55789147281,68381.76244899472,68218.3205868594,-74.8511537098093,-77.7907021768036,269.65456681498654,-0.9202665978227742,-20.854405228747055,-49.35657825929229,68582.35425205962,67852.78692165916,44.156739411278444,34.71110595537095,True,False,68781.836,67881.836,68381.836,68431.836,,False,,,2024-06-13 04:59:00,fail,False,-74.66,9528.950000000032,,0,1,24,6
2024-06-13 07:45:00,67599.641,67599.641,67304.734,67309.641,1417,36421,0,2024-06-13 07:00:00,2024-06-13 07:00:00,-292.23952380944684,-24.66031615335669,67543.77051190478,-0.002798765060945569,-0.0016311479058690036,67799.63284523813,65987.02063870651,67562.60821967472,67638.94064655445,67880.97006843855,67397.44332920536,-135.595738618038,-121.42598429870915,335.83446878056344,-73.83611867905711,-35.64088441692002,-20.70514895080123,67850.81986205911,66942.5667963516,42.89443458175523,45.25485162013231,False,True,66809.641,67709.641,67209.641,67159.641,,False,2024-06-13 18:30:00,2024-06-13 18:36:37,2024-06-13 10:56:32,fail,False,-74.66,9454.290000000032,,0,2,24,6
2024-06-13 10:00:00,67492.359,67558.836,67376.484,67545.734,996,36421,0,2024-06-13 10:00:00,2024-06-13 10:00:00,-57.17816666663566,-145.99319745482353,67480.46597619048,-0.000619412215277596,-0.0015751967946428039,67428.33478571428,66603.0842653899,67270.86230264447,67530.14311557001,67693.15621663125,67473.00091916062,-111.14584890728293,-119.22437295340414,276.39786022328474,30.329274853749666,31.583218782179756,-18.068196422274923,67847.63803046205,67099.86380785919,63.94499399629265,58.45613056265713,True,False,68045.734,67645.734,67645.734,67695.734,2024-06-13 11:00:00,True,2024-06-13 11:00:00,2024-06-13 15:30:04,2024-06-13 11:13:06,even,True,18.66,9472.950000000032,,1,0,24,6
2024-06-13 11:00:00,67700.773,67730.938,67636.969,67655.438,960,36421,0,2024-06-13 11:00:00,2024-06-13 11:00:00,52.131190476196934,-149.19296841965115,67521.04073809525,0.0009926359496236195,-0.001305574582221206,67480.46597619048,67547.54751439493,67366.68387349286,67594.8614775064,67684.98126815504,67589.65687650497,-80.3812562484527,-101.54510889580514,191.17906093723659,-2.887701754385489,28.676819745422108,46.225839353282936,67847.74860877024,67330.0651442397,88.41964456882074,87.53798242454569,True,False,68155.438,67255.438,67755.438,67805.438,,False,2024-06-13 14:15:00,2024-06-13 15:30:06,2024-06-13 12:31:51,fail,False,-74.66,9398.290000000032,,0,1,24,6
2024-06-13 22:00:00,66850.094,66876.734,66695.867,66700.703,1001,36421,0,2024-06-13 22:00:00,2024-06-13 22:00:00,-82.57032142850221,-309.4459078840009,66685.70660714278,-0.001564152598318705,-0.003581051258272833,66804.06339285716,65501.47936448175,65899.00952914907,66860.20401633537,67032.94237005993,66772.08324423798,-106.84324601244589,-107.35768083453344,445.1719929567522,22.3735631233576,20.497807361651212,20.279371860990068,67374.5654347296,66171.10105374636,62.052765386268184,57.58979292853192,True,False,67200.703,66800.703,66800.703,66850.703,2024-06-14 00:45:00,True,2024-06-14 00:45:00,2024-06-14 08:46:47,2024-06-14 02:02:56,even,True,18.66,9416.950000000032,,1,0,24,6
2024-06-13 23:00:00,66604.836,66801.391,66553.898,66642.039,1104,36421,0,2024-06-13 23:00:00,2024-06-13 23:00:00,-118.35678571437893,-337.84323957898596,66664.82428571426,-0.0007530435294819972,-0.0030485976268087326,66685.70660714278,65829.9210486763,65969.2009808824,66772.04723578188,66941.02700258103,66780.37836876506,-106.11840268799278,-106.04683920179116,278.6857221926912,-38.22554454760393,-17.237431028624997,21.318982800192316,67156.6040937252,66402.65264380492,19.215865814218876,36.32071410503423,True,False,67142.039,66742.039,66742.039,66792.039,2024-06-14 00:45:00,True,2024-06-14 00:45:00,2024-06-14 08:45:56,2024-06-14 02:04:31,even,True,18.66,9435.610000000032,,2,0,24,6
2024-06-14 00:00:00,66697.234,66785.539,66660.242,66719.555,835,56421,0,2024-06-14 00:00:00,2024-06-14 00:00:00,-20.88232142852212,-348.69591552713246,66768.27405952383,0.0009175739198396169,-0.001613242729769037,66664.82428571426,66788.74456054941,66512.2857144928,66718.38423497365,66866.07833807179,66637.00797660828,-98.8490480898763,-104.09637467378448,175.69549475526625,-18.084683866400155,-24.306448572519002,-55.012042655594996,66874.1968945279,66398.31905868866,31.3666968100202,23.54505979976895,True,False,67219.555,66819.555,66819.555,66869.555,2024-06-14 01:00:00,True,2024-06-14 01:00:00,2024-06-14 11:18:16,2024-06-14 02:02:12,even,True,18.66,9454.270000000031,,3,0,24,6
2024-06-14 01:00:00,66956.234,66956.234,66857.203,66862.641,1299,56421,0,2024-06-14 01:00:00,2024-06-14 01:00:00,103.44977380956698,-332.65120391355595,66849.52960714283,0.0010231003707014403,-0.0011622823587411828,66768.27405952383,66921.56606835614,66652.9085801305,66783.56746466333,66860.75327668602,66731.39581596143,-70.23237125850574,-89.90439129386499,122.2080309193782,25.76413931886782,33.33890952865477,32.83659649123729,66897.87665770258,66566.41497422027,84.87060853044558,70.4655289201781,True,False,67362.641,66462.641,66962.641,67012.641,,False,2024-06-14 08:45:00,,2024-06-14 04:33:30,fail,False,-74.66,9379.610000000032,,0,1,24,6
2024-06-14 03:00:00,66768.641,66885.734,66732.719,66732.719,1091,36421,0,2024-06-14 03:00:00,2024-06-14 03:00:00,-55.048857142814086,-319.6147850603593,66775.48784523808,0.0002805924408831169,-0.0002690790139494068,66794.48075000002,66655.35420837926,66862.14133871227,66800.37500579898,66840.64714248315,66863.47689714476,-42.21674419970077,-53.74662485251584,112.8391159186796,-12.69194117654115,4.821688338444801,4.867255589910201,67015.80970363498,66709.64409065455,56.88282820400894,62.42372664234665,False,True,66232.719,67132.719,66632.719,66582.719,,False,2024-06-14 19:00:00,2024-06-14 19:08:05,2024-06-14 08:37:45,fail,False,-74.66,9304.950000000032,,0,2,24,6
2024-06-14 13:00:00,66894.063,66947.141,66810.555,66931.336,950,36421,0,2024-06-14 13:00:00,2024-06-14 13:00:00,-13.332297618981102,-159.56097602006048,66954.94754761903,0.0003513280655680471,8.645335919250531e-05,66970.60479761905,66907.08732472536,67256.7998233262,66983.12032482856,66947.28897942704,67009.5026130031,23.156011460494483,26.297531913889095,135.19546745515305,-5.970878912921762,-37.33583316138538,-38.709547299629776,67192.01649406756,66825.48873193865,20.367913367013582,30.476547124446782,False,True,66431.336,67331.336,66831.336,66781.336,,False,2024-06-14 17:30:00,2024-06-14 18:51:11,2024-06-14 16:34:04,fail,False,-74.66,9230.290000000032,,0,3,24,6
2024-06-14 14:00:00,66847.938,66908.836,66748.156,66883.336,1035,36421,0,2024-06-14 14:00:00,2024-06-14 14:00:00,-15.657250000018394,-154.0245855759713,66971.54536904758,0.00013701171431484957,8.652889084453496e-05,66954.94754761903,66785.74162209955,67262.6738913101,66928.853349246,66927.42967735778,66920.04246474027,9.389854054403258,18.576397955621456,110.7657620361481,-20.022601995136938,-32.92869865841931,-22.926517715939553,67069.57624348906,66769.00868599147,16.24927369916534,17.221698213790265,False,True,66383.336,67283.336,66783.336,66733.336,,False,2024-06-14 17:30:00,2024-06-14 18:51:38,2024-06-14 16:27:38,fail,False,-74.66,9155.630000000032,,0,4,24,6
2024-06-14 23:00:00,65505.137,65626.734,65443.438,65611.336,1227,36421,0,2024-06-14 23:00:00,2024-06-14 23:00:00,-175.95083333340153,-416.78326823229145,65400.6798095238,-0.0028186569929393563,-0.00331764336617383,65403.20135714279,63712.51117008238,65054.253302171135,65539.99420032173,65831.58650170782,65384.48366322668,-184.9284913459269,-193.69668809272264,662.9830268403337,114.39240006883483,96.39051117983036,57.85097248029342,66281.01074946113,64489.456576992234,64.78763276298754,49.87796041456884,True,False,66111.336,65711.336,65711.336,65761.336,2024-06-14 23:30:00,True,2024-06-14 23:30:00,2024-06-17 00:00:02,2024-06-14 23:43:09,even,True,18.66,9174.290000000032,,1,0,24,6
2024-06-17 00:00:00,66475.641,66491.734,66434.719,66484.938,227,56421,0,2024-06-17 00:00:00,2024-06-17 00:00:00,-2.5215476189914625,-420.82427090716374,65726.10391666663,1.4216463675652507e-06,-0.0013786568795957491,65400.6798095238,65037.601261172196,66120.45601011279,65760.9571721197,65868.32164998112,65836.54476504985,-114.35098638977797,-162.79854132626593,515.4422381455639,172.41171138628852,39.29756725147308,86.66887547298393,66533.89178654636,65140.69774355334,83.68512330957563,84.34887897561471,True,False,66984.938,66584.938,66584.938,66634.938,2024-06-17 01:15:00,True,2024-06-17 01:15:00,2024-06-17 21:17:13,2024-06-17 01:15:31,even,True,18.66,9192.950000000032,,2,0,25,6
2024-06-17 01:00:00,66482.336,66932.039,66482.336,66675.664,1608,56421,0,2024-06-17 01:00:00,2024-06-17 01:00:00,325.42410714283324,-359.07076279309695,66150.68778571422,0.002335608680655677,-0.0002487871168985194,65726.10391666663,66297.60779733404,66862.94859680689,66135.416542033,66041.3570429227,66422.506375989,-21.407229733478744,-95.38242143584998,460.68799913030955,160.22031234945462,139.16316959066899,134.4314485724317,67045.93517481492,65800.57757716309,92.82091623434371,96.1023331142756,True,False,67175.664,66275.664,66775.664,66825.664,,False,2024-06-17 21:15:00,2024-06-17 21:34:16,2024-06-17 04:16:30,fail,False,-74.66,9118.290000000032,,0,1,25,6
2024-06-17 04:00:00,66543.453,66578.938,66497.133,66572.336,704,36421,0,2024-06-17 04:00:00,2024-06-17 04:00:00,124.5157976190385,-198.9650380826788,66629.62797619049,0.0025815666394954583,0.003657427985162978,66602.70240476186,66946.25060790237,68694.42841784723,66573.55067704202,66406.63626119704,66739.26995837635,72.81584353445214,53.40976643999883,494.9848051892425,-60.83165978672332,-43.328163054728066,-2.834884760915884,67407.49944538182,66069.54047137087,42.12391044622229,54.59266171926388,False,True,66072.336,66472.336,66472.336,66422.336,2024-06-17 04:30:00,True,2024-06-17 04:30:00,2024-06-17 09:54:16,2024-06-17 04:55:50,even,True,18.66,9136.950000000032,,1,0,25,6
2024-06-17 05:00:00,66431.164,66442.234,66289.461,66366.539,1317,36421,0,2024-06-17 05:00:00,2024-06-17 05:00:00,26.925571428626426,-177.00933382823132,66568.49652380955,0.001860968814412891,0.0010330097442119897,66629.62797619049,66630.34455553268,67494.7193778315,66474.65207774841,66396.79013607172,66468.80773305814,47.17039816877514,53.72020500873925,335.74163448643066,-55.267487100107246,-38.917418644661666,-65.56212005503767,66922.05893961483,66014.05652650146,19.22863715734973,19.246928218770396,False,True,65866.539,66266.539,66266.539,66216.539,2024-06-17 07:00:00,True,2024-06-17 07:00:00,2024-06-17 12:53:31,2024-06-17 07:17:33,even,True,18.66,9155.610000000032,,2,0,25,6
2024-06-17 06:00:00,66306.234,66396.734,66286.602,66365.039,634,36421,0,2024-06-17 06:00:00,2024-06-17 06:00:00,-61.13145238094148,-167.75135090718686,66418.03911904762,0.001417679167773524,-0.0003141658578676692,66568.49652380955,66481.30933046721,66740.8882839773,66395.97138532664,66373.53343358343,66306.0428582731,25.36993941097171,39.733492781216455,156.75692978965782,-20.601306501586805,-31.454583075334085,-36.98331372549001,66517.66471348914,66092.92100305705,26.804073999257422,22.517325367276232,False,True,65865.039,66265.039,66265.039,66215.039,2024-06-17 07:00:00,True,2024-06-17 07:00:00,2024-06-17 12:53:31,2024-06-17 07:17:33,even,True,18.66,9174.270000000031,,3,0,25,6
2024-06-17 07:00:00,66193.438,66260.438,66129.039,66208.539,962,36421,0,2024-06-17 07:00:00,2024-06-17 07:00:00,-150.4574047619244,-168.51787310971122,66335.50514285712,-0.0008726455829013833,-0.001167584268224544,66418.03911904762,65772.32406938846,66260.73239434982,66318.37535333383,66338.3974337086,66195.75391159266,5.441470439094701,23.35043794712846,189.51428313646755,-26.656760577927344,-41.423065015507746,-21.99476883385796,66451.5981938269,65938.40962935843,16.135262445533343,19.973424163509435,False,True,65708.539,66108.539,66108.539,66058.539,2024-06-17 10:15:00,True,2024-06-17 10:15:00,2024-06-17 12:56:51,2024-06-17 10:24:40,even,True,18.66,9192.930000000031,,4,0,25,6
2024-06-17 09:00:00,66322.438,66353.734,66204.438,66212.734,1231,36421,0,2024-06-17 09:00:00,2024-06-17 09:00:00,-46.127035714293015,-139.5819275297108,66210.67289285715,-0.0007718248876505059,-0.0010872595382135555,66289.37810714282,65711.34088335183,66159.91360748492,66346.04742817584,66349.90176891096,66343.46118335059,4.758298423883389,10.595435263775377,156.4905451346035,-25.979287237656536,-0.7072438940376742,33.50434296524327,66554.72341928231,66130.69894741887,50.625884142163954,69.85478443601623,False,True,65712.734,66112.734,66112.734,66062.734,2024-06-17 10:15:00,True,2024-06-17 10:15:00,2024-06-17 12:56:51,2024-06-17 10:24:42,even,True,18.66,9211.590000000031,,5,0,25,6
2024-06-17 09:30:00,66255.914,66270.938,66150.641,66156.938,951,36421,0,2024-06-17 09:00:00,2024-06-17 09:00:00,-46.127035714293015,-139.5819275297108,66210.67289285715,-0.0007718248876505059,-0.0010872595382135555,66289.37810714282,65711.34088335183,66159.91360748492,66305.92614680044,66329.53368665205,66313.47338906089,-3.6323136606661137,6.347841557619917,139.26960805658712,-26.40201547992183,-3.585778809778276,-25.979287237656536,66501.48735993728,66123.9594181845,26.504407819085582,38.626667138720926,False,True,65656.938,66056.938,66056.938,66006.938,2024-06-17 10:15:00,True,2024-06-17 10:15:00,2024-06-17 12:56:51,2024-06-17 10:23:49,even,True,18.66,9230.250000000031,,6,0,25,6
2024-06-17 11:00:00,66129.234,66271.234,66071.438,66270.039,1184,36421,0,2024-06-17 11:00:00,2024-06-17 11:00:00,-39.54411904767039,-150.8130280993937,66157.0604285714,-0.0007093147760705496,-0.0003052585196436392,66171.12877380948,65652.12977414674,66384.57470477202,66211.2314410133,66261.68708357532,66163.45919779842,-21.14705215250433,-13.311012109097554,122.60861496468263,5.585706914353068,-21.838943240436492,-14.986043687604251,66330.48082800074,65997.9375675961,46.04529680365264,41.75225918677922,True,False,66770.039,65870.039,66370.039,66420.039,,False,2024-06-17 21:00:00,2024-06-17 21:08:29,2024-06-17 12:53:31,fail,False,-74.66,9155.590000000031,,0,1,25,6
2024-06-17 12:30:00,66163.727,66213.734,65981.836,65981.836,1120,36421,0,2024-06-17 12:00:00,2024-06-17 12:00:00,-14.06834523807629,-148.80204501826665,65991.33259523808,-0.0012193061886767195,-0.0006647766202244475,66157.0604285714,65235.81480182209,66171.33932409775,66138.64765906149,66202.84700003969,66059.88631854154,-30.969669380807318,-23.45907700043609,138.1899582535825,-19.916448916337686,7.08167423462146,-24.205536979687167,66246.44276218387,65871.82987489921,38.69601407721643,41.15339630492909,False,True,65481.835999999996,65881.836,65881.836,65831.836,2024-06-17 13:00:00,True,2024-06-17 13:00:00,2024-06-17 16:06:54,2024-06-17 13:48:52,even,True,18.66,9174.250000000031,,1,0,25,6
2024-06-17 15:00:00,65769.836,65794.938,65659.539,65673.336,952,36421,0,2024-06-17 15:00:00,2024-06-17 15:00:00,-98.48982142860768,-208.3611878183001,65703.69859523805,-0.0017622523880482612,-0.0013522029757236705,65809.62676190474,64748.00700484201,65581.58712926887,65848.91309237856,65975.41579519454,65712.94626315785,-68.4034962519072,-59.769966376023916,209.1886419905321,-35.60799208807293,-16.82317715861427,-34.11760784310172,65995.35092984507,65429.04159647063,34.02773131985939,42.61695337406402,False,True,65173.335999999996,65573.336,65573.336,65523.335999999996,2024-06-17 16:45:00,True,2024-06-17 16:45:00,2024-06-17 16:58:57,2024-06-17 17:34:03,success,True,93.28,9267.530000000032,,2,0,25,6
2024-06-17 15:45:00,65620.672,65627.641,65483.539,65576.836,1132,36421,0,2024-06-17 15:00:00,2024-06-17 15:00:00,-98.48982142860768,-208.3611878183001,65703.69859523805,-0.0017622523880482612,-0.0013522029757236705,65809.62676190474,64748.00700484201,65581.58712926887,65757.04215655706,65901.8147532345,65629.3028286894,-78.20358166411461,-67.32426527511078,223.46059078530772,-31.486841073288815,-19.895511523864116,-32.26108187130012,65930.97462624956,65326.13103112923,17.396753095590363,21.876277070293966,False,True,65076.835999999996,65476.835999999996,65476.835999999996,65426.835999999996,2024-06-17 16:45:00,True,2024-06-17 16:45:00,2024-06-18 04:43:34,2024-06-17 17:20:45,even,True,18.66,9286.190000000031,,3,0,25,6
2024-06-17 16:45:00,65362.313,65431.738,65146.84,65162.438,2184,36422,0,2024-06-17 16:00:00,2024-06-17 16:00:00,-105.92816666669387,-231.57823268962966,65495.938023809504,-0.0015857701331802665,-0.0018429221552783061,65703.69859523805,64726.87573310644,65270.63274237271,65598.59416239457,65782.89545055843,65508.36147299616,-96.54825967631768,-78.2898245054424,270.9560894238333,-70.84021224632306,-52.103169246649486,4.616471964196535,65874.15219371834,65141.07075227399,17.5467680258697,27.713494041907296,False,True,64662.438,65562.438,65062.438,65012.438,,False,2024-06-18 04:45:00,2024-06-18 04:43:56,2024-06-17 17:33:53,fail,False,-74.66,9211.530000000032,,0,1,25,6
2024-06-17 18:45:00,65537.672,65627.734,65231.84,65323.637,1830,36421,0,2024-06-17 18:00:00,2024-06-17 18:00:00,-83.43174999998155,-294.00908944902767,65339.88941666673,-0.0015856975504075419,-0.0012956993004976528,65412.50627380952,64521.85171627249,65352.84178081089,65487.16616258079,65631.53203872118,65375.0035507396,-89.77037240780191,-89.40140176217245,199.7208383762233,-14.832818369402958,20.631701754384267,-26.697856553240854,65644.6266825475,65103.8804189317,47.81962242931608,49.04727672214123,False,True,64823.637,65723.637,65223.637,65173.637,,False,2024-06-18 04:45:00,2024-06-18 04:43:56,2024-06-17 19:25:11,fail,False,-74.66,9136.870000000032,,0,2,25,6
2024-06-18 00:00:00,66353.438,66528.234,61226.27,66437.141,1359,0,0,2024-06-18 00:00:00,2024-06-18 00:00:00,79.33415476190567,-9.758735097871977,66682.01721428573,-0.008714041954742173,0.0037014474036963,66649.76955952382,59117.416666718105,69055.35587855599,66487.5632609702,66323.20515339426,66669.54130065363,98.29558391029423,102.28349807055719,547.5167394228854,-65.49451909180789,-84.70822635023796,-55.94721362229029,67408.68889887452,65928.89370243273,55.58833270821666,46.465288754833516,False,True,65937.141,66337.141,66337.141,66287.141,2024-06-18 03:45:00,True,2024-06-18 03:45:00,2024-06-18 03:45:24,,success,True,93.28,9230.150000000032,,1,0,25,6
2024-06-18 07:00:00,65441.563,65541.938,65296.438,65541.938,1094,36421,0,2024-06-18 07:00:00,2024-06-18 07:00:00,-136.3824285714436,-158.6329870440677,65354.01222619043,0.009195195311198515,-0.003095935769544266,65441.775761904726,67797.18338694071,64894.11195389512,65466.23877889005,65691.77451757192,65139.40993326452,-124.38408594354405,-118.3496579455639,618.8527637250472,70.10809803919256,41.12888304093212,36.82634812515607,65976.36116429334,64303.95870223571,54.694670895668054,48.24969533804571,False,True,65041.937999999995,65441.937999999995,65441.937999999995,65391.937999999995,2024-06-18 13:15:00,True,2024-06-18 13:15:00,2024-06-18 15:25:25,2024-06-18 13:29:02,even,True,18.66,9248.810000000032,,2,0,25,6
2024-06-18 10:00:00,65451.738,65566.734,65451.738,65518.938,718,36421,0,2024-06-18 10:00:00,2024-06-18 10:00:00,35.55895238100493,-195.77079858261277,65528.46814285718,0.002747448423413481,-0.0016834840726541688,65387.82600000004,66178.94588222002,65309.44587585474,65546.93353881821,65622.85837687763,65600.90285552114,-62.057069632428465,-73.55431444114367,268.7908867546717,-25.58171792232315,-36.02099931193516,-54.328622635031934,65963.77055263995,65236.53515840234,39.94000410148871,46.01371911959697,True,False,66018.938,65618.938,65618.938,65668.938,2024-06-18 10:45:00,True,2024-06-18 10:45:00,,2024-06-18 10:51:05,even,True,18.66,9267.470000000032,,3,0,25,6
2024-06-18 11:00:00,65621.773,65699.734,65575.734,65634.992,1131,36421,0,2024-06-18 11:00:00,2024-06-18 11:00:00,140.64214285714115,-189.15638129416038,65630.13770238099,0.0025512273389915775,-0.00041956005340291265,65528.46814285718,66230.04296771315,65620.71494598665,65596.64444178555,65629.92307093323,65607.95016167866,-41.14988674593042,-57.72598450039514,197.82425496358368,-0.900248366073356,-4.538507739896886,10.536973512163968,65875.0129058795,65339.38741747782,69.60643727061543,66.98360795619577,True,False,66134.992,65234.992,65734.992,65784.992,,False,2024-06-20 10:30:00,,2024-06-18 14:14:45,fail,False,-74.66,9192.810000000032,,0,1,25,6
2024-06-18 13:00:00,65437.238,65460.039,65303.09,65331.84,1125,36422,0,2024-06-18 13:00:00,2024-06-18 13:00:00,-67.51682142860955,-185.92538712051464,65507.336499999976,0.00019176443934223385,-0.0003644824784448594,65562.62088095238,65354.93745720008,65591.3469485394,65542.40609713961,65590.40082677265,65550.06722015819,-34.994715443084715,-35.131599746032876,98.70056083238075,-40.53974853808177,-18.903410388724296,-4.672136222856352,65683.31297728191,65415.321463034474,28.202811019754265,45.025642002613985,False,True,64831.84,65231.84,65231.84,65181.84,2024-06-18 14:30:00,True,2024-06-18 14:30:00,2024-06-18 16:05:01,2024-06-18 14:31:05,even,True,18.66,9211.470000000032,,1,0,25,6
2024-06-18 17:45:00,65146.641,65246.137,64531.84,64595.84,2215,36422,0,2024-06-18 17:00:00,2024-06-18 17:00:00,-205.07408333328203,-259.75696415845596,64887.76471428576,-0.002549981410961269,-0.0009687374065095928,65131.4560714286,63617.978306164485,65105.41397661879,64974.65920652041,65148.353789265515,64816.31249810799,-97.57864385758876,-87.4360986607199,292.15646374741414,-64.43635259717848,24.051733058164245,6.733226350108453,65210.723724167,64420.40127204898,56.57161675487499,54.54916524583854,False,True,64095.84,64495.84,64495.84,64445.84,2024-06-18 18:15:00,True,2024-06-18 18:15:00,2024-06-18 22:47:43,2024-06-18 18:20:29,even,True,18.66,9230.130000000032,,2,0,25,6
2024-06-18 20:15:00,64741.637,64785.137,64404.238,64442.34,1922,36422,0,2024-06-18 20:00:00,2024-06-18 20:00:00,-82.70001190469338,-350.981198334106,64570.05141666665,-0.0027997486192557026,-0.0013997785793944538,64656.31941666673,63021.58093813637,64719.14429294508,64642.443251200835,64832.506583536146,64506.53782249733,-117.41809305476636,-116.532154592473,284.97869691514825,-15.096247678062355,22.418441692418128,-5.745699346443871,64891.259063332785,64120.31658166188,35.58363382492232,35.08556746853035,False,True,63942.34,64842.34,64342.34,64292.34,,False,,,2024-06-18 23:50:42,fail,False,-74.66,9155.470000000032,,0,1,25,6
2024-06-18 20:45:00,64756.469,64756.805,64544.637,64563.539,2081,36422,0,2024-06-18 20:00:00,2024-06-18 20:00:00,-82.70001190469338,-350.981198334106,64570.05141666665,-0.0027997486192557026,-0.0013997785793944538,64656.31941666673,63021.58093813637,64719.14429294508,64645.29977156983,64807.447970795736,64531.71006742339,-107.56633009215147,-113.60534056565317,269.03585317815623,-8.799461988332041,33.97170691438805,-15.096247678062355,64894.9084692139,64167.011665632876,33.48039274522145,35.87800031968632,False,True,64063.539,64463.539,64463.539,64413.539,2024-06-18 22:45:00,True,2024-06-18 22:45:00,2024-06-18 22:47:44,2024-06-18 22:58:50,success,True,93.28,9248.750000000033,,1,0,25,6
2024-06-18 23:00:00,64382.777,64654.438,64137.57,64398.238,2716,36422,0,2024-06-18 23:00:00,2024-06-18 23:00:00,-66.02436904761271,-389.8911217610512,64627.415083333384,-0.0007519468618342953,-0.0009243206584626455,64489.81498809527,63761.64846383152,64757.431541443,64524.23289507437,64662.352635670795,64500.212914000665,-91.92890159565286,-93.61574859529608,206.48877849574583,-18.66982284138794,-54.540735466107435,-63.24904093567602,64778.97276496992,64219.95306303141,34.666527598582974,32.34741493570903,True,False,64898.238,64498.238,64498.238,64548.238,2024-06-18 23:45:00,True,2024-06-18 23:45:00,2024-06-18 23:51:25,,success,True,93.28,9342.030000000033,,2,0,25,6
2024-06-19 00:00:00,64885.738,64983.137,59742.26,64980.738,1976,0,0,2024-06-19 00:00:00,2024-06-19 00:00:00,137.6000952381146,-360.5008459839228,64824.73707142858,-0.010463359530464105,-0.0002465389521315396,64627.415083333384,57294.76607639016,65185.33416131339,64636.08087583711,64680.82509999587,64600.95343756449,-55.840947193981265,-81.08287134395133,172.57732658966393,67.49679497765464,62.173844169214135,-12.87931578946882,64835.432828460536,64367.97404666844,84.74896933073951,69.07722908318395,True,False,65480.738,65080.738,65080.738,65130.738,2024-06-19 01:00:00,True,2024-06-19 01:00:00,2024-06-19 06:25:51,2024-06-19 01:01:38,even,True,18.66,9360.690000000033,,3,0,25,6
2024-06-19 06:00:00,65278.152,65408.938,65251.91,65285.84,1806,36422,0,2024-06-19 06:00:00,2024-06-19 06:00:00,71.91358333326934,-154.6136531295415,65237.003714285696,0.014633682426943632,0.0006683478620304516,65215.59234523803,69243.48167309165,65735.8114202204,65167.85146274115,65068.845810042745,65196.59306019946,50.08155125308258,40.61690379997271,135.5999881637039,41.53055968356057,32.69346577223041,16.177180254519044,65381.15304422046,65013.533076178464,70.10312277145933,71.68105443581157,False,True,64785.84,65685.84,65185.84,65135.84,,False,2024-06-19 11:30:00,2024-06-19 17:33:24,2024-06-19 07:15:50,fail,False,-74.66,9286.030000000033,,0,1,25,6
2024-06-19 07:00:00,65358.84,65639.336,65299.574,65566.836,1831,36421,0,2024-06-19 07:00:00,2024-06-19 07:00:00,21.411369047666085,-118.45294068392832,65286.27260714281,0.012706877953765879,0.0009658532708386987,65237.003714285696,68780.30949764601,65953.8421177455,65310.66504555139,65171.66527615285,65422.954136566914,69.62637438814272,54.23562130415113,179.41945624687565,65.22234055734589,35.2686542827214,58.29455383562163,65666.6704025002,65180.73787063363,85.0280945821355,83.63068719269444,False,True,65066.835999999996,65466.835999999996,65466.835999999996,65416.835999999996,2024-06-19 08:00:00,True,2024-06-19 08:00:00,2024-06-19 11:31:08,2024-06-19 08:09:09,even,True,18.66,9304.690000000033,,1,0,25,6
2024-06-19 08:00:00,65403.738,65489.539,65361.555,65399.34,1006,36422,0,2024-06-19 08:00:00,2024-06-19 08:00:00,49.268892857115134,-85.19040027003211,65328.15879761905,0.0012294979464833845,0.0010968372690915319,65286.27260714281,65405.98666167735,66061.42617556578,65375.306280449484,65245.101948357784,65497.79114413488,72.4083175325577,65.82577466748177,206.11806333324714,-6.803972136222001,-5.9860113519462175,25.880065703539003,65776.05052963475,65218.03175863499,70.73501778996409,76.95842102990396,False,True,64899.34,65299.34,65299.34,65249.34,2024-06-19 10:30:00,True,2024-06-19 10:30:00,2024-06-19 17:16:20,2024-06-19 10:39:00,even,True,18.66,9323.350000000033,,2,0,25,6
2024-06-19 10:00:00,65550.438,65607.141,65442.805,65478.938,1417,36421,0,2024-06-19 10:00:00,2024-06-19 10:00:00,106.74247619043308,-27.916824668791378,65417.079547619076,0.0009406431323738893,0.0008956249406068609,65434.90127380948,65376.13167113753,66112.20688126964,65438.460304831766,65340.5965693482,65477.94345579638,63.06188727895642,64.7551100854912,166.73613676130523,-7.951714138274838,26.8888121774944,-8.07356931540562,65703.03724042415,65251.349671168624,56.053012161332425,53.88901033410708,False,True,64978.938,65378.938,65378.938,65328.938,2024-06-19 10:30:00,True,2024-06-19 10:30:00,2024-06-19 14:38:32,2024-06-19 13:58:28,even,True,18.66,9342.010000000033,,3,0,25,6
2024-06-19 11:00:00,65274.715,65304.738,65157.637,65163.309,853,36422,0,2024-06-19 11:00:00,2024-06-19 11:00:00,-17.82172619040648,-22.388118346236297,65339.86591666658,0.000655929928580463,-0.00034042280446451367,65417.079547619076,65231.4299171411,65513.03919278385,65331.5065228473,65308.69177076222,65303.707388716895,33.24351431278046,51.20285322954041,122.57311570624901,-43.14018025450787,-27.31065015484637,-45.80259373924491,65469.18109492033,65136.73368251346,20.511511719862828,21.722816403732384,False,True,64663.309,65063.309,65063.309,65013.309,2024-06-19 17:15:00,True,2024-06-19 17:15:00,2024-06-19 23:18:22,2024-06-19 18:13:59,even,True,18.66,9360.670000000033,,4,0,25,6
2024-06-19 12:00:00,65134.375,65224.84,65125.395,65172.828,951,36422,0,2024-06-19 12:00:00,2024-06-19 12:00:00,-77.21363095249399,-28.722013753387728,65282.408476190496,0.00013049164925610729,-0.0004424836745091599,65339.86591666658,65052.8219438106,65430.053658083285,65239.41443426376,65264.21001202765,65171.095772273795,8.655032007474802,29.61642707103548,141.2428095058364,-20.16386308912479,-23.844058823575324,-35.53842690053716,65361.773565106676,64978.917979440914,15.307211114560191,10.310443374321592,False,True,64672.828,65072.828,65072.828,65022.828,2024-06-19 17:15:00,True,2024-06-19 17:15:00,2024-06-19 23:18:18,2024-06-19 18:14:03,even,True,18.66,9379.330000000033,,5,0,25,6
2024-06-19 18:15:00,65043.086,65054.738,64894.469,64896.039,1070,36422,0,2024-06-19 18:00:00,2024-06-19 18:00:00,-75.76486904756894,-55.02241845069511,64975.25096428571,-0.0007960631890459101,-0.0009353084694474338,65060.04209523811,64485.153866167275,65002.732243338425,65003.26292390855,65083.282149241575,64903.146307877505,-38.2540669717273,-28.63954644012679,153.04717625248858,-5.973069143430621,-2.8326618507053354,-45.086707946349634,65109.759995818364,64695.03261993665,31.9400317793248,26.18212056238009,False,True,64396.039,64796.039,64796.039,64746.039,2024-06-19 23:45:00,True,2024-06-19 23:45:00,2024-06-21 06:58:34,2024-06-19 23:57:30,even,True,18.66,9397.990000000033,,6,0,25,6
2024-06-19 20:00:00,64882.738,65086.738,64845.84,65061.539,1276,36422,0,2024-06-19 20:00:00,2024-06-19 20:00:00,-77.71619047616696,-86.5255310418288,64903.4941547619,-0.0009877760535374448,-0.0006569227174522496,64897.534773809544,64306.8346149394,65062.89133083069,64967.60074647233,65024.16296622839,64905.03307808732,-35.679611065897916,-37.75992208306046,147.32263567770144,22.572220846210257,-11.254155830705713,8.802329549303977,65105.418636252216,64706.14751992242,63.644114715977764,59.24714044176645,True,False,65561.53899999999,64661.539,65161.539,65211.539,,False,2024-06-20 04:30:00,2024-06-20 08:56:13,2024-06-19 23:19:31,fail,False,-74.66,9323.330000000033,,0,1,25,6
2024-06-19 20:30:00,65117.488,65117.609,64991.016,65023.238,1348,36422,0,2024-06-19 20:00:00,2024-06-19 20:00:00,-77.71619047616696,-86.5255310418288,64903.4941547619,-0.0009877760535374448,-0.0006569227174522496,64897.534773809544,64306.8346149394,65062.89133083069,64996.25156404232,65030.80055678017,64966.54664189891,-27.463860025789472,-34.42695424930876,105.55757011234228,19.75071035444853,41.76285345714132,22.572220846210257,65110.54936155057,64824.04392224725,73.52701228841161,68.12408208973424,False,True,64523.238,64923.238,64923.238,64873.238,2024-06-19 22:30:00,True,2024-06-19 22:30:00,2024-06-20 19:19:11,2024-06-20 00:13:45,even,True,18.66,9341.990000000033,,1,0,25,6
2024-06-20 03:00:00,64922.34,64961.738,64785.449,64959.637,1401,36422,0,2024-06-20 03:00:00,2024-06-20 03:00:00,7.206559523830947,-105.33080126889399,64913.30183333326,-0.00738885158409531,-0.0004075294017232916,64863.793571428556,56775.53188325532,64943.767725159836,64896.77103250498,64911.183010610526,64922.07585483315,-15.260736650750914,-20.307351005995418,89.29123834248327,9.921212934343203,3.7731296868732898,-4.317915032603196,65044.1190265955,64801.5326830708,97.53584755020056,97.10744752906203,True,False,65459.637,65059.637,65059.637,65109.637,2024-06-20 04:15:00,True,2024-06-20 04:15:00,2024-06-20 08:54:15,2024-06-20 04:16:02,even,True,18.66,9360.650000000032,,2,0,25,6
2024-06-20 04:00:00,65041.969,65128.738,64987.84,65120.938,1213,36422,0,2024-06-20 04:00:00,2024-06-20 04:00:00,49.50826190470252,-89.39622317126486,64998.91007142857,0.00746541793539433,0.0005387262191086117,64913.30183333326,63544.79576192112,65503.82726885416,64955.1916893283,64936.55761209191,64963.11639766083,-1.2014894656458637,-12.956993945560255,96.25578553872778,23.60154454766598,20.244001375969674,6.8566257310521905,65094.56170813811,64833.171087183546,92.16275638070663,91.91981138071428,True,False,65620.938,65220.938,65220.938,65270.938,2024-06-20 08:30:00,True,2024-06-20 08:30:00,2024-06-20 10:17:03,2024-06-20 16:26:44,success,True,93.28,9453.930000000033,,3,0,25,6
2024-06-20 06:00:00,65153.238,65181.34,65043.16,65069.137,987,36422,0,2024-06-20 06:00:00,2024-06-20 06:00:00,76.605773809526,-51.57112691245857,65120.451904761896,0.013923198194784945,0.0012586563361899755,65075.51584523809,68840.57778516859,65862.25611196861,65068.04883109435,65018.018203611835,65158.33458617127,20.606241817615228,12.663017039227876,117.4989125794773,4.078363261054619,25.269105607134406,12.292147230837145,65318.45811815357,64999.71105418898,56.455304160583445,55.59511788628248,False,True,64569.137,65469.137,64969.137,64919.137,,False,2024-06-20 17:15:00,2024-06-20 19:09:07,2024-06-20 08:55:23,fail,False,-74.66,9379.270000000033,,0,1,25,6
2024-06-20 07:00:00,65137.84,65149.938,65032.734,65041.738,662,36422,0,2024-06-20 07:00:00,2024-06-20 07:00:00,44.936059523803124,-37.56228428580653,65186.5272142857,0.011927229796631853,0.0009979634659096031,65120.451904761896,68278.51799802536,65823.62484002997,65084.43592605484,65040.83196797739,65141.75180460955,21.641025683973567,18.382081499713795,124.22200585911271,-23.31642586858652,1.940842105243064,8.507596147224831,65309.45151251935,64972.55209669975,52.52606553447445,55.233732525013174,False,True,64541.738,65441.738,64941.738,64891.738,,False,2024-06-20 17:15:00,2024-06-20 19:19:11,2024-06-20 08:52:24,fail,False,-74.66,9304.610000000033,,0,2,25,6
2024-06-20 08:00:00,65265.539,65349.738,65201.938,65264.16,1576,36422,0,2024-06-20 08:00:00,2024-06-20 08:00:00,66.0753095238033,-16.38655534145073,65313.8729285714,0.0009499730340847319,0.0008407943486491911,65186.5272142857,65347.65712562945,65805.88511422832,65139.86142023629,65080.68450552587,65155.86999243202,29.100560111204686,22.431872080147528,123.53793602647781,16.434942208397842,10.243526659796771,-5.317066047449771,65324.14620606776,64989.093778796276,67.74695291262317,55.12300799430913,False,True,64764.16,65664.16,65164.16,65114.16,,False,2024-06-20 17:00:00,2024-06-20 17:11:21,2024-06-20 10:17:03,fail,False,-74.66,9229.950000000033,,0,3,25,6
2024-06-20 10:15:00,65538.422,65940.336,65535.0,65796.336,2352,36421,0,2024-06-20 10:00:00,2024-06-20 10:00:00,56.590000000054715,39.165753920024144,65536.30183333336,0.0011517754811596163,0.0014754591865627274,65370.462928571455,65565.86425068576,66340.10126751382,65442.85099730658,65293.16006675623,65583.70652975574,73.2303055064549,54.45355539666567,199.78713179969944,86.20455521154508,39.27047334018425,23.15902339181048,65854.91915768533,65313.99390182615,80.63791083410378,77.21504729155647,True,False,66296.336,65896.336,65896.336,65946.336,2024-06-20 14:00:00,True,2024-06-20 14:00:00,2024-06-20 14:07:58,2024-06-20 15:22:24,success,True,93.28,9323.230000000034,,1,0,25,6
2024-06-20 13:45:00,65727.453,66246.039,65724.547,66165.734,1453,36421,0,2024-06-20 13:00:00,2024-06-20 13:00:00,63.637500000040745,130.41524113700143,65877.46577380957,0.0014388958784274674,0.0022010186160450335,65679.8129404762,65984.54785222367,66979.06143119528,65728.80496297467,65584.13982867531,65788.77900997596,85.3472180669778,79.15121580598155,202.40981103689256,83.00170485043782,8.648950120303198,-5.16869659438089,66063.53225487577,65515.525765076156,61.62522814601322,55.44907764409508,True,False,66665.734,66265.734,66265.734,66315.734,2024-06-20 14:15:00,True,2024-06-20 14:15:00,,2024-06-20 14:23:09,even,True,18.66,9341.890000000034,,2,0,25,6
2024-06-20 16:00:00,65944.336,65956.734,65725.055,65725.336,1812,36421,0,2024-06-20 16:00:00,2024-06-20 16:00:00,18.85847619039123,230.86445268362877,65748.0059642857,-0.0005507374258291019,0.00192252489124329,66020.17641666663,64935.6430947596,67232.17280113309,65944.06714506229,65815.530771535,66105.81206123151,90.65666589366447,101.89057643657767,245.22165482699603,-52.41395493633172,-3.7733849329670193,10.561609219163074,66436.86129524796,65773.26282721506,35.92183557035665,45.26870889202609,False,True,65225.335999999996,66125.336,65625.336,65575.336,,False,2024-06-20 16:30:00,2024-06-20 16:26:43,,success,True,93.28,9435.170000000035,,3,0,25,6
2024-06-20 21:00:00,64929.738,65071.438,64887.34,64948.34,1560,36422,0,2024-06-20 21:00:00,2024-06-20 21:00:00,-137.58976190476096,-30.152468247855722,64814.35485714288,-0.00212553131335951,-0.002735727465985138,64791.07376190472,63507.07315872201,64463.92920492205,64880.67649269318,65065.303409849876,64787.78567870663,-104.17054851035209,-100.734803013222,461.51254805053526,57.87307705543208,45.729244926063984,22.916976608146797,65412.32761857485,64164.743738838406,59.29835044359519,46.03712458195116,True,False,65448.34,65048.34,65048.34,65098.34,2024-06-20 21:30:00,True,2024-06-20 21:30:00,,2024-06-20 21:33:53,even,True,18.66,9453.830000000034,,4,0,25,6
2024-06-20 23:00:00,65007.223,65134.539,64977.68,65029.738,847,36422,0,2024-06-20 23:00:00,2024-06-20 23:00:00,65.2499047618694,-52.39970065938542,64996.16600000001,0.00045247265059027934,-0.0017933467279289607,64879.604761904746,64744.072992432164,64658.601881262555,64990.18721153424,65050.5412589301,65069.8132944616,-55.44557477479975,-72.49106565115198,135.3589730730345,35.76570313025877,13.144638802950794,24.379409700690303,65254.047908110195,64887.07868081301,73.92432681918281,75.50081413085196,True,False,65529.738,64629.738,65129.738,65179.738,,False,,,2024-06-21 03:18:21,fail,False,-74.66,9379.170000000035,,0,1,25,6
2024-06-21 00:00:00,65050.637,65071.637,65016.039,65047.238,351,56422,0,2024-06-21 00:00:00,2024-06-21 00:00:00,116.56123809526616,-58.327916052956425,65023.43134523809,0.0013736971674433024,7.387555692814503e-05,64996.16600000001,65317.58040568661,65204.30875622171,65006.68733153856,65042.78209674746,65071.973595115225,-41.10896837046312,-56.87303035772115,137.91704952773904,4.7624269005827955,-3.4904093566947267,-2.286585139328963,65259.66161197767,64885.78557825278,73.74341250304099,70.45160723791713,True,False,65547.238,64647.238,65147.238,65197.238,,False,,,2024-06-21 03:17:51,fail,False,-74.66,9304.510000000035,,0,2,25,6
2024-06-21 01:00:00,64979.91,65096.84,64977.402,65073.555,448,56422,0,2024-06-21 01:00:00,2024-06-21 01:00:00,27.265345238076407,-67.61266696184612,65017.88352380952,0.001057071754559864,0.0001301971481488162,65023.43134523809,65198.85375167061,65239.47018758851,65027.13291148965,65044.77735782896,65046.430995872004,-28.38724406133406,-41.91567240841552,138.621584033466,-15.299996560024738,-25.601519435884256,-3.9491317509600776,65233.57013431718,64857.791857426826,66.58301279925765,70.21405622437463,False,True,64573.555,64973.555,64973.555,64923.555,2024-06-21 02:30:00,True,2024-06-21 02:30:00,2024-06-21 06:57:12,2024-06-21 04:33:14,even,True,18.66,9323.170000000035,,1,0,25,6
2024-06-21 02:00:00,64947.84,65018.238,64933.57,64939.938,598,36422,0,2024-06-21 02:00:00,2024-06-21 02:00:00,-5.547821428568568,-77.01201691084862,64951.8187857143,0.0006753385116250436,-0.00016204997338382167,65017.88352380952,64992.243496558316,65074.99568574514,64992.205209310596,65021.59817168781,64988.89316924658,-27.967419766784587,-33.550372496534095,102.76559523080573,-15.001312349508225,-6.37329824565677,-21.98664602682402,65127.62672280816,64848.65961568499,34.32190615682988,47.65283462787295,False,True,64439.938,64839.938,64839.938,64789.938,2024-06-21 03:15:00,True,2024-06-21 03:15:00,2024-06-21 06:58:33,2024-06-21 03:28:49,even,True,18.66,9341.830000000034,,2,0,25,6
2024-06-21 03:00:00,64829.664,64888.738,64657.504,64679.84,1108,36422,0,2024-06-21 03:00:00,2024-06-21 03:00:00,-66.0647380952214,-92.92473818815051,64879.98277380954,-0.00013131103922730066,-0.00018809440904919746,64951.8187857143,64547.99365808867,65046.74901433411,64905.17868833432,64968.87525135538,64868.78217371862,-38.27988293758972,-33.24806591161858,93.27867447533264,-57.82058376332134,-28.031387340866786,-20.970119367011648,64994.70838426032,64741.35596317692,4.655321068305562,6.523350473041456,False,True,64179.84,64579.84,64579.84,64529.84,2024-06-21 07:00:00,True,2024-06-21 07:00:00,2024-06-21 10:58:36,2024-06-21 07:23:43,even,True,18.66,9360.490000000034,,3,0,25,6
2024-06-21 05:00:00,64937.637,65034.039,64835.488,64891.84,1315,36422,0,2024-06-21 05:00:00,2024-06-21 05:00:00,-9.069392857156345,-106.00500566529809,64817.33453571429,-0.0006426055198233728,-0.0003034957707789034,64870.913380952385,64330.228673350066,64953.5070530281,64863.85518302305,64909.36711678756,64798.86659270726,-33.51682173538575,-37.74018177196262,117.65383157889704,13.003821121492365,27.34511179906258,5.100492259982275,64959.19926533877,64640.033920075744,69.25278899239447,59.193078474665185,True,False,65391.84,64491.84,64991.84,65041.84,,False,,,2024-06-21 06:58:32,fail,False,-74.66,9285.830000000034,,0,1,25,6
2024-06-21 10:45:00,64506.938,64521.238,64148.84,64161.238,2073,36422,0,2024-06-21 10:00:00,2024-06-21 10:00:00,-22.678404761871207,-172.2864324606635,64425.63247619045,-0.0005406488869779973,-0.0010600226098672356,64585.923476190466,64008.49458100777,64410.645922178664,64538.14232204412,64626.86836157201,64525.161628138994,-52.40303233150189,-47.36651370046022,159.6880102329636,-67.26619848635892,-4.674175094543898,27.018704850255745,64740.740441953494,64308.082814324494,40.206377143256,62.06379792922818,False,True,63661.238,64561.238,64061.238,64011.238,,False,2024-06-21 12:00:00,2024-06-21 11:49:48,,success,True,93.28,9379.110000000035,,1,0,25,6
2024-06-21 14:30:00,63941.539,63949.539,63636.738,63686.84,1512,36422,0,2024-06-21 14:00:00,2024-06-21 14:00:00,-112.75977380949917,-320.9158271348351,63786.37654761906,-0.002803845980780427,-0.001879283789954841,63930.09178571431,62222.70559799838,63716.33890977374,63944.03754513932,64138.80409145537,63759.06671998621,-114.67732672484271,-108.58846059714678,358.5232445267892,-22.060051943619328,11.683406948730408,2.670251118048327,64243.073100097376,63273.56033987504,41.976756158076846,41.497919613955496,False,True,63186.84,64086.84,63586.84,63536.84,,False,2024-06-21 18:45:00,2024-06-24 02:36:52,2024-06-21 17:24:04,fail,False,-74.66,9304.450000000035,,0,1,25,6
2024-06-21 15:00:00,63722.992,63892.438,63518.266,63559.039,1986,36422,0,2024-06-21 15:00:00,2024-06-21 15:00:00,-143.7152380952466,-347.4482832375361,63732.88127380958,-0.0016225097268599772,-0.002456221761083792,63786.37654761906,62642.41191191638,63265.20384733252,63856.03184001098,64067.3391812889,63736.064955624315,-122.28725348312582,-112.62047701758794,367.9837971151394,-27.723002751998138,4.721238390106009,-22.060051943619328,64232.843081729756,63237.786829518875,23.19261777862532,34.25421553057391,False,True,63059.039,63959.039,63459.039,63409.039,,False,2024-06-24 02:45:00,2024-06-24 03:05:17,2024-06-21 17:16:03,fail,False,-74.66,9229.790000000035,,0,2,25,6
2024-06-21 16:00:00,63788.039,63822.039,63615.91,63699.738,1584,36422,0,2024-06-21 16:00:00,2024-06-21 16:00:00,-53.49527380947984,-359.08736100190436,63656.74986904764,-0.0005682969581213668,-0.0022005330178095956,63732.88127380958,63141.03290344406,63272.734191321586,63789.40746695147,63974.93207213779,63736.500586515285,-116.20732158492319,-116.31779415641176,312.43285617256595,7.0560361197640304,17.58706432741019,-8.126935672516993,64159.78494234825,63314.71623068232,30.931731215122536,28.05922479297449,True,False,64199.738,63799.738,63799.738,63849.738,2024-06-21 17:30:00,True,2024-06-21 17:30:00,2024-06-21 17:34:11,2024-06-21 18:34:58,success,True,93.28,9323.070000000036,,1,0,25,6
2024-06-21 17:00:00,63575.938,63780.738,63408.988,63780.738,2186,36422,0,2024-06-21 17:00:00,2024-06-21 17:00:00,-76.13140476193803,-381.0338708058698,63837.995238095275,-0.0003769868506592089,-0.0008307768946526937,63656.74986904764,63227.23358928067,64097.35058146949,63738.964950024034,63897.22071525686,63634.115050223576,-106.7617789191936,-113.41437860161685,203.950703982072,22.95376539393328,-41.47398417619843,-24.250947712418565,63910.94850059937,63358.78159984778,53.14060077499001,42.05306938013304,True,False,64280.738,63880.738,63880.738,63930.738,2024-06-21 17:30:00,True,2024-06-21 17:30:00,2024-06-21 17:51:04,2024-06-21 18:26:46,success,True,93.28,9416.350000000037,,2,0,25,6
2024-06-21 18:00:00,64174.34,64296.738,64114.629,64138.438,1988,36422,0,2024-06-21 18:00:00,2024-06-21 18:00:00,181.24536904763227,-346.1503913553461,63824.38505952381,-0.0003771069171021183,-4.4645752621599446e-05,63837.995238095275,63203.35896599911,64299.94764931266,63914.68948857889,63949.17163232646,63918.601790849614,-56.594262746570166,-89.01766710161132,180.22454060296596,75.0452614378737,81.1060110078979,65.85849019607849,64163.40492066362,63675.29866103561,83.39374969579872,81.89945477273302,True,False,64638.438,63738.438,64238.438,64288.438,,False,,,2024-06-21 18:35:11,fail,False,-74.66,9341.690000000037,,0,1,25,6
2024-06-21 23:00:00,64192.176,64349.938,64162.258,64228.738,1637,36422,0,2024-06-21 23:00:00,2024-06-21 23:00:00,125.31265476196859,-274.5790893721569,64062.22427380948,0.0011908742082792003,0.0002715137459552845,63970.96292857146,63961.88493627221,64491.28026885876,63999.153964191544,63921.62519052333,64124.138108015155,13.397440835702582,-16.66163700050124,227.89431898935086,47.25333746131946,85.43075851398316,92.94666838666308,64433.29543865078,63816.48077737953,91.82699514107446,86.30516068375148,True,False,64728.738,63828.738,64328.738,64378.738,,False,,,2024-06-24 00:00:01,fail,False,-74.66,9267.030000000037,,0,2,25,6
2024-06-24 05:00:00,63272.438,63338.637,63171.855,63195.84,1331,36422,0,2024-06-24 05:00:00,2024-06-24 05:00:00,-159.96759523802757,-343.0237486436381,63018.00544047616,-0.0032191610826804396,-0.0028214862325846276,63227.33092857144,61658.74796363652,62617.88037405183,63254.88761427124,63434.866326423115,63045.38462882699,-98.57502335822937,-88.77684790638722,382.61674011740325,3.607947368436726,1.4462910216971068,-27.591616099096427,63563.41722798549,62528.852029668495,41.633190666737825,36.734322345708996,True,False,63695.84,62795.84,63295.84,63345.84,,False,,,2024-06-24 05:55:03,fail,False,-74.66,9192.370000000037,,0,3,26,6
2024-06-24 07:00:00,62814.84,62844.34,62607.84,62645.637,1294,36422,0,2024-06-24 07:00:00,2024-06-24 07:00:00,-131.37076190472726,-406.4032710473184,62824.63698809528,-0.0019775681221822572,-0.0017756637743449916,62886.634678571434,61878.060067280065,62661.90062079171,62961.73387323764,63181.00525686507,62870.24042036456,-122.71183906363149,-109.21628316606132,293.7514631282754,-56.67764671486657,-18.577418300650606,-14.887821465541492,63266.80489558773,62472.17594514138,21.27407357585645,31.970529928148824,True,False,63145.637,62745.637,62745.637,62795.637,2024-06-24 07:45:00,True,2024-06-24 07:45:00,,2024-06-24 08:07:31,even,True,18.66,9211.030000000037,,1,0,26,6
2024-06-24 08:30:00,62591.84,62614.238,62225.34,62240.738,2645,36422,0,2024-06-24 08:00:00,2024-06-24 08:00:00,-61.997690476157004,-424.0512465938082,62615.635345238115,-0.002060534964663648,-0.0018781422638525702,62824.63698809528,61710.267606401154,62505.68335533555,62732.62825549938,62975.882754198,62550.96917578261,-137.75071600174124,-122.86765828125624,254.54749033069797,-121.2366594426785,-60.3967715858671,-33.02914138282358,62894.60828772905,62205.83006383617,9.881417396906803,17.401928933614794,False,True,61740.738,62640.738,62140.738,62090.738,,False,2024-06-24 12:45:00,2024-06-24 12:30:39,2024-06-24 11:23:32,fail,False,-74.66,9136.370000000037,,0,1,26,6
2024-06-24 11:00:00,62415.438,62524.539,62284.098,62343.039,1227,36422,0,2024-06-24 11:00:00,2024-06-24 11:00:00,-86.54726190479414,-514.09295194687,62445.99760714284,-0.0019184180983782522,-0.0010621092836099633,62414.771297619045,61391.266217030185,62665.60735538877,62422.420508681476,62634.32928211019,62256.53474716199,-139.3022883188969,-145.7191384626498,310.1963244277065,-0.38035397319617914,14.762440316531865,28.236174062563805,62675.299785139396,61836.269709184584,39.881845891442254,35.26817779088949,True,False,62843.039,62443.039,62443.039,62493.039,2024-06-24 11:30:00,True,2024-06-24 11:30:00,2024-06-24 11:37:01,2024-06-24 12:07:21,success,True,93.28,9229.650000000038,,1,0,26,6
2024-06-24 19:45:00,60502.172,60511.738,59950.973,60126.238,4153,36422,0,2024-06-24 19:00:00,2024-06-24 19:00:00,-147.4487142857397,-764.9904178184006,60785.006142857135,-0.0012581799634880262,-0.0037739451598911584,61023.307345238136,59650.44219117955,60272.53967000988,60851.828245776145,61151.2893952448,60735.13215514273,-180.2090733537334,-164.28149392108108,294.43971868792073,-168.73359236329998,-105.53147058819013,-63.297373925066495,61132.62577537142,60336.13853491404,15.487987697386144,18.719721813269278,False,True,59626.238,60026.238,60026.238,59976.238,2024-06-24 20:30:00,True,2024-06-24 20:30:00,2024-06-24 22:49:27,2024-06-24 20:31:46,even,True,18.66,9248.310000000038,,2,0,26,6
2024-06-24 22:45:00,59824.59,59845.438,58992.938,59293.34,3930,36422,0,2024-06-24 22:00:00,2024-06-24 22:00:00,-160.56360714285984,-880.9857900451025,59918.55800000006,-0.004944493107002032,-0.0039819426306863855,60376.75283333334,57841.88002977471,59484.42728225118,60082.096047286024,60470.3551635612,59787.85707877536,-228.68522371244762,-210.26118610855193,589.0722017549734,-127.39195906431269,-53.49576917786908,-30.543293429655023,60583.10455114458,58991.10960640615,17.18019000526017,24.653209083435414,False,True,58793.34,59693.34,59193.34,59143.34,,False,2024-06-24 23:30:00,2024-06-24 23:29:14,2024-06-25 00:19:32,success,True,93.28,9341.590000000038,,3,0,26,6
2024-06-24 23:15:00,59273.07,59337.738,58693.859,58870.438,2814,56422,0,2024-06-24 23:00:00,2024-06-24 23:00:00,-458.1948333332766,-962.8330828716571,59624.02151190483,-0.006475883466724987,-0.003981782683229078,59918.55800000006,56712.35100184116,59251.3296489905,59791.51177350065,60270.32596601612,59491.2007784658,-265.2388101045799,-226.48963662343357,653.1401607045184,-186.67085964907892,-109.98544066048635,-127.39195906431269,60372.9399954169,58607.9615615147,14.774218392899671,15.738854781766761,False,True,58370.438,59270.438,58770.438,58720.438,,False,,2024-06-24 23:30:16,2024-06-24 23:37:21,success,True,93.28,9434.870000000039,,4,0,26,6
2024-06-25 01:00:00,60053.34,60060.039,59926.137,60028.039,851,56422,0,2024-06-25 01:00:00,2024-06-25 01:00:00,53.59589285712718,-974.9363892039619,59766.46625000001,-0.006532717617965719,-0.0025480415161288367,59677.61740476196,55952.817599494374,59625.541028812804,59790.097483503974,60049.71105703362,59549.464607843096,-197.3981806391821,-231.0727809337302,490.50997409090195,77.6851630546953,57.61006019949855,37.11287753700162,60213.15307286581,58887.27614282038,79.19705919242342,74.02361600778029,True,False,60528.039,60128.039,60128.039,60178.039,2024-06-25 02:45:00,True,2024-06-25 02:45:00,2024-06-25 03:53:57,,success,True,93.28,9528.15000000004,,5,0,26,6
2024-06-25 02:00:00,59993.863,60241.039,59953.137,60161.938,754,36422,0,2024-06-25 02:00:00,2024-06-25 02:00:00,88.84884523805522,-945.7623155554757,59946.578607142845,-0.002201165685655438,-0.0013876628916309741,59766.46625000001,57299.9474745456,60075.53913930256,59939.87129582233,60062.112554849475,59915.96864293082,-134.0395867731495,-184.461645679207,399.9600729674254,111.98842346053425,90.73932748538937,65.8440818714007,60457.41474143684,59376.0225444248,92.54728991140263,89.48006649846468,True,False,60661.938,60261.938,60261.938,60311.938,2024-06-25 02:45:00,True,2024-06-25 02:45:00,2024-06-25 05:32:41,2024-06-25 02:58:29,even,True,18.66,9546.81000000004,,6,0,26,6
2024-06-25 03:00:00,60255.738,60300.539,60215.145,60221.32,1268,36422,0,2024-06-25 03:00:00,2024-06-25 03:00:00,180.11235714283248,-892.559046280403,60100.172571428564,0.0036154477610592884,0.0002173430947076787,59946.578607142845,59898.69481518747,60662.05564901003,60091.89340177637,60112.36362852711,60380.70610354317,-77.41724398678343,-130.36049136568718,412.47016349666814,82.77670450635196,109.33794186448358,146.7786013071891,60939.04082426367,59823.87138282267,92.08153408286535,94.85760121325923,True,False,60721.32,60321.32,60321.32,60371.32,2024-06-25 04:15:00,True,2024-06-25 04:15:00,2024-06-25 06:04:01,2024-06-25 04:26:16,even,True,18.66,9565.47000000004,,7,0,26,6
2024-06-25 05:00:00,60452.039,60600.34,60414.855,60414.938,1632,36422,0,2024-06-25 05:00:00,2024-06-25 05:00:00,179.59061904760893,-767.8330229394705,60525.39544047618,0.006107821724834458,0.0005649597067044318,60279.76319047617,61857.81746422255,60818.9865452655,60302.71310086336,60231.84825652239,60425.10915411082,-5.065551825289731,-40.9587401973665,433.0049886432918,5.053533195794444,12.813403852771444,-12.676892328832764,61011.165888779266,59840.55241944237,68.23905740827884,64.28934922274881,False,True,59914.938,60814.938,60314.938,60264.938,,False,,,2024-06-25 06:04:38,fail,False,-74.66,9490.81000000004,,0,1,26,6
2024-06-25 07:00:00,61252.938,61333.813,61111.84,61141.738,1518,36422,0,2024-06-25 07:00:00,2024-06-25 07:00:00,285.6500238095541,-580.3393503745392,61029.60788095239,0.0033718958653351895,0.004098140899460884,60811.04546428574,61599.767714687776,62828.27532554279,60886.180604781526,60603.26417263436,61140.71966322677,109.39983351559204,53.7289330553113,428.52752174432953,83.84972583424678,103.63159477125737,174.63740901272104,61720.73181758162,60562.20750887193,81.82948392011697,88.37916551693439,False,True,60641.738,61041.738,61041.738,60991.738,2024-06-25 08:45:00,True,2024-06-25 08:45:00,2024-06-25 10:50:44,2024-06-25 09:19:39,even,True,18.66,9509.47000000004,,1,0,26,6
2024-06-25 08:00:00,61331.738,61372.238,61282.129,61306.137,862,36422,0,2024-06-25 08:00:00,2024-06-25 08:00:00,218.562416666653,-477.69613227985974,61105.395666666656,0.00253049503413109,0.004304553455593633,61029.60788095239,61442.715340762625,63164.77574147708,61082.42445588762,60784.297916753305,61413.161054695556,136.43196959165653,98.53640236644443,467.4245170915553,53.45873133814166,72.64429033369379,60.87284657719283,62045.68415276916,60782.137956621955,80.29253484783128,78.16153496452806,False,True,60806.137,61206.137,61206.137,61156.137,2024-06-25 08:45:00,True,2024-06-25 08:45:00,2024-06-25 10:29:26,2024-06-25 10:05:33,even,True,18.66,9528.13000000004,,2,0,26,6
2024-06-25 10:00:00,61098.738,61207.938,60924.254,60934.539,860,36422,0,2024-06-25 10:00:00,2024-06-25 10:00:00,53.733000000022,-359.8784863035471,61030.80182142855,0.0009686908814513491,0.001020850394733719,61159.12866666668,60818.23036413006,62053.84004574302,61038.18671582523,60896.19735123259,61060.63943550048,95.60709149501781,107.17013466098743,377.3863025584457,-89.05061231514992,-54.260041279652796,-49.50300653594604,61570.11094395438,60549.66792704658,20.83256800135398,30.817482501279017,False,True,60434.539,60834.539,60834.539,60784.539,2024-06-25 10:45:00,True,2024-06-25 10:45:00,,2024-06-25 11:14:22,even,True,18.66,9546.790000000039,,3,0,26,6
2024-06-25 21:00:00,61326.039,61414.137,61081.84,61298.84,1887,36422,0,2024-06-25 21:00:00,2024-06-25 21:00:00,1.4230119047497283,16.825447140545293,61710.463226190455,0.0004300462052131515,0.0011185705440249758,61461.944273809546,61187.52795206793,62681.937551346186,61494.09346236169,61430.667989564565,61515.659435500565,57.85037305601145,75.4946649649014,288.25644688056343,-84.92725730983511,-73.51251943588431,-28.651458892323717,61904.80563878932,61125.01323221181,23.316464067031347,36.158712846265125,False,True,60798.84,61698.84,61198.84,61148.84,,False,2024-06-26 20:15:00,2024-06-26 22:01:41,2024-06-25 21:24:17,fail,False,-74.66,9472.13000000004,,0,1,26,6
2024-06-26 02:00:00,61863.566,61904.84,61681.84,61687.438,616,36422,0,2024-06-26 02:00:00,2024-06-26 02:00:00,35.42584523813275,173.54805957106873,61904.94152380951,0.0017644915615160966,-0.0003190007685929667,61906.07596428572,62062.74040239152,62217.49112545127,61876.092245636566,61802.05152501977,61875.34468386649,61.37562389039522,74.344697963921,204.07269548436045,-38.41470588239463,-10.853237702001934,-47.06401444791118,62150.84282277038,61598.3465449626,26.41265324565887,40.42828922914941,False,True,61187.438,62087.438,61587.438,61537.438,,False,2024-06-26 09:00:00,2024-06-26 13:25:41,2024-06-26 04:55:32,fail,False,-74.66,9397.47000000004,,0,2,26,6
2024-06-26 03:00:00,61758.461,61799.84,61681.84,61701.84,1149,36422,0,2024-06-26 03:00:00,2024-06-26 03:00:00,-1.134440476213058,171.40929357115238,61831.280095238086,0.0013807916264761233,-0.0013633262768341513,61904.94152380951,61933.51815919067,61613.79012824219,61792.93324457704,61775.971131415994,61760.483491915984,34.528479699431045,54.858290420583174,168.35994279896505,-32.1010237358787,-17.141630202946544,-39.17087719307165,61987.76941469459,61531.69756913738,18.133477157867087,13.68447200287372,False,True,61201.84,62101.84,61601.84,61551.84,,False,2024-06-26 09:00:00,2024-06-26 13:23:43,2024-06-26 04:55:33,fail,False,-74.66,9322.81000000004,,0,3,26,6
2024-06-26 04:00:00,61728.137,61874.938,61676.34,61869.637,1266,36422,0,2024-06-26 04:00:00,2024-06-26 04:00:00,-73.66142857142404,164.7170718496127,61840.895,0.0013808408022413171,-0.0006156303101560354,61831.280095238086,62019.24889473939,61992.881661786574,61777.92073295237,61771.15858524535,61730.70156346746,23.222526223951718,37.17265792320602,119.42491074004033,23.55861403502786,-11.540139662894944,-38.61820777429239,61893.42519296652,61569.4779339684,28.461611007952456,23.43336408298038,True,False,62369.637,61969.637,61969.637,62019.637,2024-06-26 05:00:00,True,2024-06-26 05:00:00,2024-06-26 05:17:00,2024-06-26 05:02:22,even,True,18.66,9341.47000000004,,1,0,26,6
2024-06-26 05:00:00,62047.039,62344.969,61952.863,62302.238,1757,36422,0,2024-06-26 05:00:00,2024-06-26 05:00:00,9.61490476191102,183.44291441136738,61899.167630952354,-0.0005458535995517508,0.00016091928295481996,61840.895,61386.911440604774,62487.471582214064,61929.94525251762,61852.10851688044,61914.13798004817,44.98248860871536,36.13921461075881,155.98727196861728,89.56854798763379,41.72709184728592,21.09238321294106,62126.22079720581,61703.55516289054,81.71465265733735,72.80523759414609,True,False,62802.238,61902.238,62402.238,62452.238,,False,,,2024-06-26 06:20:08,fail,False,-74.66,9266.81000000004,,0,1,26,6
2024-06-26 08:00:00,61674.637,61736.238,61639.637,61716.34,862,36422,0,2024-06-26 08:00:00,2024-06-26 08:00:00,-69.99845238100534,164.85941066077066,61734.664857142874,-0.00022778277674252617,0.0003784483905821522,61841.86945238091,61462.92684749212,62613.223088769715,61815.90553447202,61842.30689905082,61784.481837289284,4.121435003813531,22.432675401818965,173.8332089308899,-59.448656002750795,-55.6188734090174,-56.48607602330594,62019.15666934598,61548.307005232586,4.489559530958753,6.412198644715151,False,True,61216.34,61616.34,61616.34,61566.34,2024-06-26 08:30:00,True,2024-06-26 08:30:00,2024-06-26 13:17:50,2024-06-26 08:45:25,even,True,18.66,9285.47000000004,,1,0,26,6
2024-06-26 11:00:00,61688.84,61723.039,61506.543,61518.738,1128,36422,0,2024-06-26 11:00:00,2024-06-26 11:00:00,-27.69391666661977,100.4474083765308,61517.62604761913,-0.0007998400803454605,-0.0019445773566599757,61628.78489285714,61134.90097477626,61240.62164493962,61617.73107002875,61685.25341737766,61540.807116615106,-32.388758705543296,-26.35658681029883,218.3668869196944,-3.4124203646133537,22.36411867907009,24.166406948745134,61835.602413956694,61244.51181927352,48.10890519687603,44.981414983115876,True,False,62018.738,61618.738,61618.738,61668.738,2024-06-26 17:00:00,True,2024-06-26 17:00:00,2024-06-27 17:00:41,2024-06-26 17:29:20,even,True,18.66,9304.13000000004,,2,0,26,6
2024-06-26 13:00:00,61341.137,61388.539,61224.84,61301.738,1036,36422,0,2024-06-26 13:00:00,2024-06-26 13:00:00,-80.22959523817553,42.32129351853655,61354.047035714284,-0.001263787603400355,-0.0010083929150971722,61437.396452380955,60821.9912149763,61349.17472868543,61447.87723919601,61554.301620157414,61394.66662125903,-54.08895005602972,-43.46833810066965,126.76158574528323,-33.78738734088256,-32.8201231510393,-26.465197798439476,61565.79476201516,61222.038480502895,10.801331875492428,16.382741844237852,True,False,61801.738,61401.738,61401.738,61451.738,2024-06-26 14:15:00,True,2024-06-26 14:15:00,2024-06-26 17:04:03,2024-06-26 14:21:06,even,True,18.66,9322.790000000039,,3,0,26,6
2024-06-26 15:00:00,61407.141,61559.137,61334.137,61352.539,1342,36422,0,2024-06-26 15:00:00,2024-06-26 15:00:00,5.753130952412903,-2.5081643055091263,61354.77738095241,-0.0012318776808441,-0.0006695104462276432,61359.8001666667,60679.90852106308,61392.74581655594,61368.20924145232,61452.11508590464,61286.07631647746,-52.94505159420078,-54.68391776391819,133.071536019496,11.14519298243249,12.72927760580933,-7.6795971791871125,61467.22289010378,61106.42974285114,53.94523711032016,48.81487342590406,True,False,61852.539,61452.539,61452.539,61502.539,2024-06-26 16:45:00,True,2024-06-26 16:45:00,2024-06-26 17:05:36,2024-06-26 18:10:34,success,True,93.28,9416.07000000004,,4,0,26,6
2024-06-27 01:00:00,61022.285,61027.84,60936.414,60950.438,1033,56422,0,2024-06-27 01:00:00,2024-06-27 01:00:00,-12.519988095191366,-137.10574829178222,60914.82664285712,-0.0010660027659545482,-0.0016221976890475147,60934.11022619051,60229.779700278035,60630.71150137381,60951.07168758004,61033.80550620664,60902.001475404206,-61.24851472587761,-71.09915409607575,207.07042422695153,9.104888200949063,34.29336016511661,4.3629958720412105,61183.04654811059,60622.45640269782,67.69056083929789,64.68775731135294,True,False,61450.438,61050.438,61050.438,61100.438,2024-06-27 07:30:00,True,2024-06-27 07:30:00,2024-06-27 13:31:07,2024-06-27 08:07:37,even,True,18.66,9434.73000000004,,5,0,26,6
2024-06-27 03:00:00,60841.84,60881.34,60775.039,60807.238,956,36422,0,2024-06-27 03:00:00,2024-06-27 03:00:00,-26.89365476187959,-166.81192797644326,60905.47684523806,-0.00019876873464403828,-0.0006958363579946745,60887.93298809524,60573.21066560951,60857.91883275729,60870.17421828445,60947.4885779486,60865.56035947712,-54.75588047898782,-58.862272242255315,89.24567630388411,-16.803929824585794,-17.410840041178744,-23.435943928488996,60986.04202248736,60743.57869646687,32.3660600290284,37.38814086995493,True,False,61307.238,60907.238,60907.238,60957.238,2024-06-27 03:45:00,True,2024-06-27 03:45:00,2024-06-27 12:57:41,2024-06-27 03:45:23,even,True,18.66,9453.39000000004,,6,0,26,6
2024-06-27 04:00:00,60959.34,61011.039,60851.621,60987.438,1078,36422,0,2024-06-27 04:00:00,2024-06-27 04:00:00,17.543857142816705,-167.201534489177,60960.39363095242,0.00026578427820446026,-0.00020668066240462423,60905.47684523806,60814.73567820333,61072.57296701167,60904.68801932365,60944.375653024836,60874.04670003431,-38.815924456772336,-50.599669969590366,84.85829349040452,8.616008599783527,0.5004664602965931,3.601027863820491,60990.105396246356,60759.48800382227,77.51257843982103,58.961999574017426,True,False,61487.438,60587.438,61087.438,61137.438,,False,2024-06-27 13:00:00,2024-06-27 15:10:47,2024-06-27 09:47:54,fail,False,-74.66,9378.73000000004,,0,1,26,6
2024-06-27 09:00:00,60770.84,60828.738,60691.637,60733.84,1191,36422,0,2024-06-27 09:00:00,2024-06-27 09:00:00,-62.73477380951226,-148.6430208292877,60877.40917857144,-0.00039218950407495824,0.00032152190426023295,60961.15450000001,60491.595678155965,61426.74654715613,60935.91930974026,60964.426613554824,60932.236348813225,-12.764397863284103,-4.637913181719744,103.26039307293802,-43.11404403163033,-47.324932920550054,-12.058434468490304,61071.63787946169,60791.33481816476,10.599156289604485,17.528119008781527,False,True,60233.84,61133.84,60633.84,60583.84,,False,2024-06-28 22:30:00,2024-06-28 22:17:54,2024-06-27 12:50:45,fail,False,-74.66,9304.07000000004,,0,2,26,6
2024-06-27 12:00:00,60843.039,60919.039,60794.438,60879.137,964,36422,0,2024-06-27 12:00:00,2024-06-27 12:00:00,-18.84639285711455,-161.40216668116773,60930.5977619047,-0.0007156360641538209,0.00010106878416864633,60793.94797619044,60283.44194135573,61349.89461808191,60818.09291353349,60857.61965470183,60754.24279566568,-25.62180923642154,-27.33059427216951,143.55988023505626,33.925773305840266,23.617132094994304,-1.4915978671997436,60949.54863398301,60560.43695734836,61.01410099262506,49.76420184914647,True,False,61379.137,60979.137,60979.137,61029.137,2024-06-27 12:45:00,True,2024-06-27 12:45:00,2024-06-27 13:31:06,2024-06-28 17:36:07,success,True,93.28,9397.35000000004,,1,0,26,6
2024-06-27 19:00:00,61552.34,61755.34,61535.996,61727.539,1555,36422,0,2024-06-27 19:00:00,2024-06-27 19:00:00,25.647309523854346,77.09008301686845,61690.27572619044,0.0016500196836491373,0.003276696259342292,61657.106880952364,61910.68195882279,63604.16717464784,61681.07239116078,61526.43266305015,61864.33045786032,98.3696740707237,104.06445372846093,349.16981470134084,-16.787731682117737,-53.972404884822026,-40.7188562090887,62335.70970770713,61391.45120801351,40.08554923988785,39.78884014548802,False,True,61227.539,61627.539,61627.539,61577.539,2024-06-27 22:30:00,True,2024-06-27 22:30:00,2024-06-28 10:47:21,2024-06-28 01:24:07,even,True,18.66,9416.01000000004,,2,0,26,6
2024-06-27 22:00:00,61849.438,61858.238,61565.137,61621.18,1121,36422,0,2024-06-27 22:00:00,2024-06-27 22:00:00,41.35609523813764,149.58605221393373,61679.75928571436,0.0006039745247454213,-0.001419346749647705,61813.793321428566,61528.17695813413,61565.06848913437,61754.87201513682,61672.61648079174,61798.11993876848,66.60526958203263,79.46225771616453,195.6782263615579,0.9815644995396724,54.27856965933461,40.59438252499967,62063.785544356586,61533.95433318038,51.27473061707147,58.46590545286827,False,True,61121.18,61521.18,61521.18,61471.18,2024-06-27 23:00:00,True,2024-06-27 23:00:00,2024-06-28 17:18:35,2024-06-27 23:17:00,even,True,18.66,9434.67000000004,,3,0,26,6
2024-06-27 23:00:00,61427.738,61498.137,61311.938,61475.738,1253,36422,0,2024-06-27 23:00:00,2024-06-27 23:00:00,-134.03403571420495,132.112494538982,61562.43702380948,5.914888731633236e-05,-0.0016158475344561043,61679.75928571436,61327.11177902404,61357.1781668262,61621.844985316275,61622.93456379405,61609.384414860695,29.68694710155978,56.4922648434965,214.72701355500365,-52.78871620223072,-61.0464771242041,-40.60402373580291,61899.26588315995,61318.00294656144,14.140157737544305,13.33857175348246,False,True,60975.738,61875.738,61375.738,61325.738,,False,2024-06-28 11:00:00,2024-06-28 17:36:07,2024-06-28 04:23:13,fail,False,-74.66,9360.01000000004,,0,1,26,6
2024-06-28 01:00:00,61503.637,61550.238,61475.992,61541.738,647,56422,0,2024-06-28 01:00:00,2024-06-28 01:00:00,-19.01107142848923,111.54915611601609,61552.28830952381,-0.0005940965672176506,-0.0009795970290428226,61543.42595238099,61092.81751878221,61433.153271824216,61537.12515307841,61566.74254290651,61431.31681286546,0.6421563674521167,13.864399596221846,157.41588406527381,1.236646026816743,7.57427932581777,0.9222325420705602,61645.328256353576,61218.80536937734,38.37204615522594,36.208159938427535,True,False,62041.738,61141.738,61641.738,61691.738,,False,2024-06-28 04:30:00,2024-06-28 04:24:50,2024-06-28 17:18:35,success,True,93.28,9453.29000000004,,1,0,26,6
2024-06-28 02:00:00,61612.582,61653.539,61571.848,61586.84,596,36422,0,2024-06-28 02:00:00,2024-06-28 02:00:00,8.862357142817928,113.16559464084276,61561.88979761908,-0.0005086845151967761,-0.000813213683240493,61552.28830952381,61093.13827532183,61475.47683552146,61571.123786779914,61577.53612303691,61541.95460784311,4.286298520193668,7.791977691081744,153.58265017899592,24.906014103871712,30.798889920864895,35.08750051604875,61750.791185584756,61334.61803010146,89.96859933258035,78.03562160605458,True,False,62086.84,61186.84,61686.84,61736.84,,False,2024-06-28 04:30:00,2024-06-28 04:25:15,2024-06-28 10:47:22,success,True,93.28,9546.570000000042,,2,0,26,6
2024-06-28 03:00:00,61663.84,61687.637,61598.828,61640.84,790,36422,0,2024-06-28 03:00:00,2024-06-28 03:00:00,9.601488095271634,117.16370921568159,61535.13159523812,-4.034722683989787e-05,-0.0006744300226554712,61561.88979761908,61292.08721797896,61519.596307860615,61602.51782025295,61592.58714843471,61648.471797729595,8.352660042335629,7.313764147427028,120.51056636633271,15.189102167176316,27.17756037147774,21.532721706244047,61812.66106232414,61485.78253313505,84.52847815193671,84.842027915907,True,False,62140.84,61740.84,61740.84,61790.84,2024-06-28 04:30:00,True,2024-06-28 04:30:00,2024-06-28 04:39:14,2024-06-28 05:28:12,success,True,93.28,9639.850000000042,,3,0,26,6
2024-06-28 07:30:00,61494.215,61622.938,61490.773,61601.438,741,36422,0,2024-06-28 07:00:00,2024-06-28 07:00:00,30.575476190475456,138.78031882798678,61772.60971428569,0.00016819122404177747,0.0013862484622569767,61787.32128571431,61523.589007430564,62794.85771025759,61691.90915492097,61684.89477441202,61728.34326590976,12.957241020507354,21.99780429971494,146.71084756721626,-30.32545510847558,-50.91942930857476,-17.60526556588593,61926.4029101255,61528.78362169402,18.77632557710992,29.510102392075108,True,False,62101.438,61201.438,61701.438,61751.438,,False,2024-07-01 00:15:00,2024-07-01 01:17:03,2024-06-28 10:47:21,fail,False,-74.66,9565.190000000042,,0,1,26,6
2024-06-28 12:00:00,61434.395,61466.938,61392.039,61418.039,906,36422,0,2024-06-28 12:00:00,2024-06-28 12:00:00,-87.88954761909554,52.26577972168161,61448.56929761903,-0.0011833901550781982,-0.0012379990383130219,61432.20638095238,60739.85901005937,61254.92654238141,61434.15620975122,61510.46410529828,61349.91792535257,-36.37529800222546,-27.81113742738258,152.4546109276577,-5.673237358176266,-12.571383556889486,-18.847188510466367,61555.73165010491,61142.60420060023,49.25211359202242,41.08403815476928,True,False,61918.039,61518.039,61518.039,61568.039,2024-06-28 14:30:00,True,2024-06-28 14:30:00,2024-07-01 00:00:02,2024-06-28 15:30:31,even,True,18.66,9583.850000000042,,1,0,26,6
2024-06-28 13:00:00,61502.84,61541.738,61444.406,61463.039,835,36422,0,2024-06-28 13:00:00,2024-06-28 13:00:00,16.362916666650563,44.67258787328319,61442.36102380951,-0.0009087516199853887,-0.0007193572722760299,61448.56929761903,60785.1088363371,61382.75584525765,61438.06569171134,61491.30786767701,61370.24952149983,-31.24117523222958,-31.481162253347083,117.98046249527091,3.913388372879126,19.974169246626843,-3.0148228413963807,61531.02314586844,61210.97589713121,65.05996289446614,56.89011458472177,True,False,61963.039,61563.039,61563.039,61613.039,2024-06-28 14:30:00,True,2024-06-28 14:30:00,2024-07-01 00:00:04,2024-06-28 15:30:29,even,True,18.66,9602.510000000042,,2,0,26,6
2024-06-28 14:00:00,61506.637,61530.539,61438.637,61516.738,668,36422,0,2024-06-28 14:00:00,2024-06-28 14:00:00,-6.208273809519596,37.597379583254224,61511.11292857143,-5.495681644291563e-05,-7.953301082762058e-05,61442.36102380951,61147.43362435382,61739.8401581762,61471.06319373781,61494.86783014358,61461.700123839,-20.44704372844717,-26.91836028416421,98.06388795471541,25.040319573468878,23.259704162410344,28.172751977945154,61595.58637257787,61329.31387510013,87.08271573387914,82.5339924660139,True,False,62016.738,61616.738,61616.738,61666.738,2024-06-28 14:30:00,True,2024-06-28 14:30:00,2024-07-01 01:03:40,2024-06-28 14:44:15,even,True,18.66,9621.170000000042,,3,0,26,6
2024-06-28 22:00:00,60805.539,60826.738,60647.949,60718.133,986,36422,0,2024-06-28 22:00:00,2024-06-28 22:00:00,-75.12883333327045,-154.39321876374743,60553.01997619048,-0.002264407712575972,-0.002684129224386734,60798.80461904768,59516.789461510976,60174.096978369394,60839.50834087373,60984.249841890676,60788.49512762294,-86.98341730159154,-84.25494571894426,249.4173750715162,-29.25234606130107,0.16220089450507658,12.266328861362126,61125.208583969485,60450.281671276396,31.373925672017993,31.378109683268793,True,False,61218.133,60318.133,60818.133,60868.133,,False,2024-07-01 00:15:00,2024-07-01 00:00:02,2024-06-28 22:17:52,fail,False,-74.66,9546.510000000042,,0,1,26,6
2024-06-28 22:45:00,60423.941,60457.938,60058.738,60104.938,2118,36422,0,2024-06-28 22:00:00,2024-06-28 22:00:00,-75.12883333327045,-154.39321876374743,60553.01997619048,-0.002264407712575972,-0.002684129224386734,60798.80461904768,59516.789461510976,60174.096978369394,60626.660976651314,60845.10427188649,60508.12260096318,-116.07339789861726,-94.91559866612803,246.8552018310674,-118.8416666666817,-81.64468696245603,-79.88617303062347,60841.37712343512,60173.368078491236,23.77426296690366,28.01043363249768,False,True,59604.938,60504.938,60004.938,59954.938,,False,,,2024-07-01 00:00:02,fail,False,-74.66,9471.850000000042,,0,2,26,6
2024-07-01 00:00:00,61951.738,61982.438,61847.238,61869.738,857,52422,0,2024-07-01 00:00:00,2024-07-01 00:00:00,-158.80869047620945,-269.23727064174454,60851.34673809524,-0.0007508102003180104,0.0011829050314931247,60394.21128571427,59787.944844846344,62278.95968729793,60651.65319275254,60768.24680617189,60482.46645304439,-90.28597017210268,-111.54398532713225,373.24952097445544,253.3849191606787,-61.0531200550904,-58.63706983139855,60987.85330635991,59978.57959972887,45.41193870190681,29.095617041219565,True,False,62369.738,61969.738,61969.738,62019.738,2024-07-01 01:15:00,True,2024-07-01 01:15:00,2024-07-01 01:26:02,2024-07-02 17:39:31,success,True,93.28,9565.130000000043,,1,0,27,7
2024-07-01 06:00:00,63408.938,63491.738,63361.84,63420.84,1196,36422,0,2024-07-01 06:00:00,2024-07-01 06:00:00,347.91901190477074,429.33940229634027,63591.09848809522,0.007613193353338373,0.004060180783354432,63501.79622619047,65284.223832642354,65294.947756003996,63269.28679387133,62775.67075510516,63556.84938734089,293.13521216832305,285.96806393946457,586.3266726158117,30.96698073616426,45.30800378393178,-22.10983384931751,64349.89039537223,62765.30837930954,68.88562293229369,71.76282475979316,False,True,62920.84,63320.84,63320.84,63270.84,2024-07-01 07:45:00,True,2024-07-01 07:45:00,2024-07-01 11:37:26,2024-07-01 08:09:39,even,True,18.66,9583.790000000043,,2,0,27,7
2024-07-01 07:00:00,63399.84,63435.438,63328.438,63362.238,1017,36422,0,2024-07-01 07:00:00,2024-07-01 07:00:00,89.30226190474787,489.8136003849213,63449.61889285712,0.0034335940910911445,0.0036775105252791593,63591.09848809522,64068.336352721846,65384.15294410113,63322.51481072337,62935.74285747797,63575.51306329548,257.8681621119322,276.2376302175442,402.3578318332204,-12.289473340242694,5.900108015157457,-1.5968964567873627,64118.69613627033,63030.829990320635,62.47253054435571,65.77164397604915,False,True,62862.238,63262.238,63262.238,63212.238,2024-07-01 07:45:00,True,2024-07-01 07:45:00,2024-07-01 11:40:27,2024-07-01 07:47:32,even,True,18.66,9602.450000000043,,3,0,27,7
2024-07-01 08:00:00,63242.785,63331.539,63225.438,63301.539,561,36422,0,2024-07-01 08:00:00,2024-07-01 08:00:00,-141.4795952380955,519.3667344955174,63416.81351190475,0.003040953657407537,0.0011305120054794359,63449.61889285712,64010.413523886615,64291.924811956356,63293.39041524459,63022.166643289354,63316.35878740968,209.13909864463494,244.93594888756613,321.6481675792849,-64.35311627110787,-72.76842621258402,-82.70270657034416,63750.583813641715,62880.63376117764,15.898415331100436,25.963939997157382,False,True,62801.539,63201.539,63201.539,63151.539,2024-07-01 11:30:00,True,2024-07-01 11:30:00,2024-07-01 11:43:02,2024-07-01 19:13:11,success,True,93.28,9695.730000000043,,4,0,27,7
2024-07-01 09:00:00,63388.77,63422.34,63336.738,63336.738,957,36422,0,2024-07-01 09:00:00,2024-07-01 09:00:00,-32.80538095236989,548.1405035622738,63425.974357142906,0.0018752105934232957,0.0002046320706113515,63416.81351190475,63734.40651173536,63886.889304859906,63326.25870185205,63112.0735042891,63287.60336016522,176.43601235681854,210.5033521391246,271.9033840866938,7.585280701874581,3.2546945304056862,9.39833711731626,63656.17292868226,62920.53379164819,49.00062679117337,42.316295930895144,False,True,62836.738,63236.738,63236.738,63186.738,2024-07-01 11:30:00,True,2024-07-01 11:30:00,2024-07-01 11:40:58,2024-07-01 19:13:33,success,True,93.28,9789.010000000044,,5,0,27,7
2024-07-01 10:00:00,63367.438,63400.84,63307.84,63400.84,748,36422,0,2024-07-01 10:00:00,2024-07-01 10:00:00,9.160845238155161,562.3761288588721,63348.18703571435,0.0015237614505629517,-0.0009419917697669001,63425.974357142906,63606.37148337743,63239.77719932923,63343.74822918721,63177.65375244465,63334.71633746129,145.9178347898851,177.29213760129022,107.30906205625752,11.40592019266478,18.341712418259704,3.389760233934794,63481.083571237235,63189.84910368534,68.66261161775782,59.14268891039894,False,True,62900.84,63300.84,63300.84,63250.84,2024-07-01 11:00:00,True,2024-07-01 11:00:00,2024-07-01 11:38:00,2024-07-01 19:13:51,success,True,93.28,9882.290000000045,,6,0,27,7
2024-07-01 11:00:00,63247.238,63284.438,63215.746,63224.137,995,36422,0,2024-07-01 11:00:00,2024-07-01 11:00:00,-77.78732142855733,557.6516856712187,63145.80657142855,-0.00014031940846358053,-0.0011995328356741277,63348.18703571435,62765.76142851559,63016.93825517267,63301.33353186268,63199.239503426885,63300.03566666662,109.4242397093767,143.8364693023746,79.82736260260961,-17.45386962507473,-8.620012727893481,0.08255521148385014,63407.80260618014,63190.768727153096,30.32314061864362,41.45973742221093,False,True,62724.137,63124.137,63124.137,63074.137,2024-07-01 11:45:00,True,2024-07-01 11:45:00,2024-07-01 14:05:49,2024-07-01 19:00:38,success,True,93.28,9975.570000000045,,7,0,27,7
2024-07-01 16:00:00,62847.383,62969.938,62762.273,62796.438,1262,36422,0,2024-07-01 16:00:00,2024-07-01 16:00:00,-44.744797619016026,367.41442896909575,62688.451523809505,-0.0012677659766763773,-0.0009068255689670952,62755.81083333335,62084.98912130896,62824.978116346865,62798.30114774397,62879.86941152686,62740.061358789055,-33.156387360773806,-23.98703409743847,213.8144417141064,4.226883728908433,31.68498039212136,32.76557206737925,63030.2108551031,62451.41186247501,66.05416478520075,56.91041497187704,True,False,63296.438,62896.438,62896.438,62946.438,2024-07-01 18:15:00,True,2024-07-01 18:15:00,2024-07-01 19:13:51,2024-07-01 18:18:53,even,True,18.66,9994.230000000045,,8,0,27,7
2024-07-01 18:00:00,62787.438,63042.438,62782.172,62995.539,1253,36422,0,2024-07-01 18:00:00,2024-07-01 18:00:00,20.168773809549748,300.9330253823282,62849.319035714325,-0.000538145777744483,-0.0003694296051450287,62708.620297619054,62292.110513442945,63026.55940518422,62802.730578240225,62838.67556219218,62802.45369384245,-24.658254734953516,-30.846129149681385,96.01646866632508,50.27701375987817,14.147414860723075,20.477469212266442,62933.57592654199,62672.83146114291,66.57018503798099,54.721302359403985,True,False,63495.539,63095.539,63095.539,63145.539,2024-07-01 19:15:00,True,2024-07-01 19:15:00,2024-07-01 20:41:33,2024-07-01 19:26:44,even,True,18.66,10012.890000000045,,9,0,27,7
2024-07-01 19:00:00,63107.438,63325.938,62928.262,63254.883,1649,36422,0,2024-07-01 19:00:00,2024-07-01 19:00:00,140.69873809527053,302.7060283718456,62943.207511904744,-1.554241114592821e-05,0.0008071818746788755,62849.319035714325,62488.3167723135,63533.60500092347,62931.256465180326,62895.225793191195,62992.376003783975,3.389195732670487,-17.619977959360963,147.10482099689912,78.1004970760041,55.77397454426682,24.549393876834074,63192.46751212979,62793.78449543816,86.68150357447358,81.75592588430209,True,False,63754.883,63354.883,63354.883,63404.883,2024-07-01 20:45:00,True,2024-07-01 20:45:00,2024-07-01 21:19:12,2024-07-01 22:26:43,success,True,93.28,10106.170000000046,,10,0,27,7
2024-07-01 20:15:00,63075.047,63352.301,63054.102,63306.84,1192,36422,0,2024-07-01 20:00:00,2024-07-01 20:00:00,93.88847619041917,299.4729221286252,63219.70100000001,0.001248860610591875,0.0016137404730033377,62943.207511904744,63127.34265289184,64085.53300067315,63062.19503064091,62978.828174226976,63187.27054970762,29.481417143018916,8.441628162800784,204.10355724647883,66.81871241828048,25.43426075000025,24.341293429628422,63464.31035199036,62911.730747424874,78.52935199344256,75.82822118209452,True,False,63806.84,63406.84,63406.84,63456.84,2024-07-01 20:45:00,True,2024-07-01 20:45:00,2024-07-01 21:19:25,2024-07-01 21:27:38,success,True,93.28,10199.450000000046,,11,0,27,7
2024-07-01 21:45:00,63513.207,63702.84,63485.34,63621.84,1153,36422,0,2024-07-01 21:00:00,2024-07-01 21:00:00,276.4934880952642,339.65933835256146,63425.074047619055,0.00203127022148173,0.0022434745001765886,63219.70100000001,63606.4298168993,64414.74720758092,63387.87601030727,63200.65745868952,63601.95980357763,84.21881669300637,55.696455990186735,333.06073653194335,48.513592363364296,24.65138252491306,36.08927622981719,64053.09179789575,63152.32780925951,72.06126160158888,77.82367419733289,True,False,64121.84,63221.84,63721.84,63771.84,,False,,,2024-07-01 22:40:20,fail,False,-74.66,10124.790000000046,,0,1,27,7
2024-07-02 00:00:00,63245.035,63245.035,63180.691,63180.938,296,56422,0,2024-07-02 00:00:00,2024-07-02 00:00:00,3.913785714212281,329.24691855893616,63314.16182142855,0.0009386375196090798,0.001475089431526373,63416.26842857142,63226.312729725,64498.455684698325,63284.033439355146,63232.806295350674,63293.98939972482,43.5443042200568,56.333242758837805,220.2534567163202,-52.42225490193232,-37.352939456439344,-25.523519779890194,63591.331566291854,62995.14723315779,24.492687953669048,28.563309039501465,False,True,62680.938,63080.938,63080.938,63030.938,2024-07-02 01:15:00,True,2024-07-02 01:15:00,2024-07-02 10:05:49,2024-07-02 01:17:36,even,True,18.66,10143.450000000046,,1,0,27,7
2024-07-02 01:00:00,63091.637,63119.137,62970.055,63020.738,582,56422,0,2024-07-02 01:00:00,2024-07-02 01:00:00,-102.10660714287224,301.02927368199744,63159.0602142857,-4.44417306483529e-05,-0.00085863618447575,63314.16182142855,62751.35650034918,63390.908587329366,63184.41564362588,63193.10765302143,63056.6577867217,16.83484993247839,37.882684681291984,195.81088882663607,-40.676985208061524,-56.70382180937304,-65.456158238856,63321.002486637655,62790.81308680574,11.568170025901857,12.14984669629299,False,True,62520.738,62920.738,62920.738,62870.738,2024-07-02 01:30:00,True,2024-07-02 01:30:00,2024-07-02 11:06:28,2024-07-02 01:46:59,even,True,18.66,10162.110000000046,,2,0,27,7
2024-07-02 04:00:00,62897.238,62937.438,62812.406,62901.637,841,36422,0,2024-07-02 04:00:00,2024-07-02 04:00:00,-124.15470238088892,195.94768252282665,62859.603249999986,-0.001438101117119596,-0.00201475660641621,62889.084857142916,62129.801463010044,62425.38535664315,62925.925585288,63007.67075668749,62820.109755074016,-35.781936245955876,-25.18962598772941,194.1887178741692,9.123664602724602,6.108914688673394,-15.856513587845257,63083.76452420415,62557.954985943885,31.271522528634105,29.47435324051405,True,False,63401.637,63001.637,63001.637,63051.637,2024-07-02 06:30:00,True,2024-07-02 06:30:00,,2024-07-02 07:59:22,even,True,18.66,10180.770000000046,,3,0,27,7
2024-07-02 05:00:00,62896.137,63071.137,62882.574,63050.34,377,36422,0,2024-07-02 05:00:00,2024-07-02 05:00:00,-29.481607142930443,170.2653833461518,62892.78016666664,-0.0004380347107661315,-0.0012028137483246668,62859.603249999986,62541.161192638145,62781.65710150724,62922.546426042565,62982.0456631518,62879.09229239766,-32.516266262602585,-31.6741490278348,159.49128610401348,46.71941176472319,10.024709322293347,-1.424152734791278,63095.90552863808,62663.77905615724,57.29168498272602,40.43170310162819,True,False,63550.34,62650.34,63150.34,63200.34,,False,,,2024-07-02 10:06:33,fail,False,-74.66,10106.110000000046,,0,1,27,7
2024-07-02 06:00:00,62965.637,63036.238,62953.129,62996.039,735,36422,0,2024-07-02 06:00:00,2024-07-02 06:00:00,33.176916666656325,153.73154344025534,62947.10730952377,-0.00011069666066500976,-0.00027185222326435286,62892.78016666664,62699.2101456947,63195.93219324718,62947.209515902425,62979.48696956515,62950.19501685585,-23.367104518452834,-28.459070132237013,103.18078567043024,15.498457516310737,7.2918004815946915,16.896288269745128,63090.98907751093,62810.90095620076,63.93333333333436,66.83089227451897,True,False,63496.039,63096.039,63096.039,63146.039,2024-07-02 06:45:00,True,2024-07-02 06:45:00,,2024-07-02 06:51:25,even,True,18.66,10124.770000000046,,1,0,27,7
2024-07-02 08:15:00,62994.938,63048.438,62990.918,63033.84,260,36422,0,2024-07-02 08:00:00,2024-07-02 08:00:00,35.66471428579098,136.80579274851334,63007.245761904785,0.0004910797686986999,0.0004656298884684441,62982.772023809564,63027.03585029901,63444.16931388249,63038.79198024457,63028.32178170295,63104.12744616438,-0.03543114470812725,-4.835866698086232,112.6941738609586,-4.25374131409626,-14.084746818029089,-1.9866202270932263,63256.26458087667,62950.490311452086,41.71799920855494,49.106127627327744,True,False,63533.84,62633.84,63133.84,63183.84,,False,,,2024-07-02 10:08:51,fail,False,-74.66,10050.110000000046,,0,1,27,7
2024-07-02 09:00:00,62996.039,63019.438,62858.539,62909.137,422,36422,0,2024-07-02 09:00:00,2024-07-02 09:00:00,24.47373809522105,124.59972596439184,62966.74042857141,0.00012937103335918475,0.0005729825015461874,63007.245761904785,62829.76319431562,63521.76072029373,63010.21756017548,63016.205145816624,63034.411992776,-4.598535118770087,-3.6721303939800913,105.02101466668054,-40.4212356381322,-20.165183350538427,-9.12903439970978,63176.19036257602,62891.133622975976,21.75555270966557,29.655590045838434,False,True,62409.137,62809.137,62809.137,62759.137,2024-07-02 10:15:00,True,2024-07-02 10:15:00,2024-07-02 11:12:31,2024-07-02 14:34:24,success,True,93.28,10143.390000000047,,1,0,27,7
2024-07-02 13:00:00,62628.621,62649.738,62481.84,62550.84,1094,36422,0,2024-07-02 13:00:00,2024-07-02 13:00:00,-79.32879761897493,12.94130560427584,62636.115904761915,-0.0018686565144377834,-0.001149909366492165,62668.673714285775,61668.0200639555,62482.65870358413,62663.98495817333,62759.174924362174,62564.16107946337,-52.99767947019427,-48.0014860262349,202.71171500495822,-6.985299277519516,3.9608421052689664,-3.4694905401192955,62837.82189472006,62289.000264206676,43.214809511670175,46.26752001254291,True,False,63050.84,62650.84,62650.84,62700.84,2024-07-02 13:45:00,True,2024-07-02 13:45:00,2024-07-02 16:42:11,2024-07-02 14:03:18,even,True,18.66,10162.050000000047,,2,0,27,7
2024-07-02 14:00:00,62697.34,62702.738,62632.539,62669.34,645,36422,0,2024-07-02 14:00:00,2024-07-02 14:00:00,-32.55780952385976,0.2051169530095649,62674.25653571437,-0.001520472187414832,-0.0008316329642889976,62636.115904761915,61703.839787786725,62630.623337263554,62670.401583509534,62737.19505555457,62645.36690161679,-44.19433660678624,-47.4600543164157,158.78904607082177,21.57338080502086,22.037255245857523,24.411559339612722,62861.2321138124,62431.00168942118,79.21577529694245,69.76980433273741,True,False,63169.34,62769.34,62769.34,62819.34,2024-07-02 15:45:00,True,2024-07-02 15:45:00,,2024-07-02 16:33:58,even,True,18.66,10180.710000000046,,3,0,27,7
2024-07-02 15:00:00,62811.539,62836.238,62693.438,62731.137,1063,36422,0,2024-07-02 15:00:00,2024-07-02 15:00:00,38.14063095245365,-1.1843427248022635,62732.163726190454,-0.00013276062722919208,-8.084399430053577e-05,62674.25653571437,62301.711153402364,63010.49578747595,62716.013383290614,62744.473594939045,62743.625479532144,-28.497651982761454,-38.6851934703873,106.71709958052183,6.772699690445734,29.597983832092723,24.501181630526844,62889.19356396585,62599.55739509844,80.1441944770314,84.30106552263847,True,False,63231.137,62831.137,62831.137,62881.137,2024-07-02 15:45:00,True,2024-07-02 15:45:00,,2024-07-02 15:53:17,even,True,18.66,10199.370000000046,,4,0,27,7
2024-07-02 17:00:00,62594.277,62709.738,62316.211,62351.84,2582,36422,0,2024-07-02 17:00:00,2024-07-02 17:00:00,-21.084785714221653,-16.896979343044222,62498.878321428565,-0.0013605060357302563,0.0007993068260442368,62711.07894047623,61523.367055737326,63403.06243146969,62711.45190525548,62741.38430655857,62758.686765393846,-19.687335650109162,-16.990726706919773,131.98048337896697,-81.36412039914285,-35.33363742686197,31.74418988652178,62936.86041795545,62579.01311283224,26.14364164346672,47.33098749778023,False,True,61851.84,62251.84,62251.84,62201.84,2024-07-02 17:45:00,True,2024-07-02 17:45:00,2024-07-02 18:34:19,2024-07-02 21:07:41,success,True,93.28,10292.650000000047,,5,0,27,7
