time,open,high,low,close,tick_volume,spread,real_volume,support_trendline_15,resistance_trendline_15,support_gradient_15,resistance_gradient_15,fixed_resistance_gradient_15,fixed_support_gradient_15,fixed_support_trendline_15,fixed_resistance_trendline_15,hourly_time,time2,prev_hour_lsma_slope,prev_hour_macd_line,hour_lsma,fixed_support_gradient,fixed_resistance_gradient,prev_hour_lsma,fixed_support_trendline,fixed_resistance_trendline,prev_fixed_support_trendline,prev_fixed_resistance_trendline,prev_fixed_resistance_gradient,prev_fixed_support_gradient,ema_50,ema_24,stoch_k,stoch_d,prev_hour_macd_signal,ema_short,ema_long,lsma,macd_line,macd_signal,lsma_stddev,lsma_slope,prev_lsma_slope_1,prev_lsma_slope_2,lsma_upper_band,lsma_lower_band,is_buy2,is_sell2,tp,sl,be,be_condition,time_updated,sl_updated,time_to_trail,time_tp_hit,time_sl_hit,type,success,profit,account_balance,win_streak,losing_streak,Week,Month
2024-01-08 20:45:00,46929.84,46993.34,46599.949,46949.664,4560,25922,0,46599.949,47303.986067087775,-0.00028064332407793475,-0.0009760079319059672,0.01000558891486,0.005391732440348625,48165.23480553099,51397.358049382805,2024-01-08 20:00:00,2024-01-08 20:00:00,205.88636904762097,393.8815407785951,45799.715571428555,0.00357905171554585,0.006982352586148852,45218.45577380951,45631.501511871196,48337.70376778287,45522.57705397071,46007.968194363675,0.002147147987535704,0.003913309725844352,44177.95196944639,44503.466120686164,92.13022538132505,90.3730172324199,239.53960513583075,45803.834602199546,45302.66990115885,46140.87407361545,501.16470104069595,327.24290128560256,598.1230923121146,298.2379287926087,323.2726955624894,156.02264189883135,46949.840248236804,45333.4078989941,True,False,47849.664,47049.664,47049.664,47099.664,2024-01-08 21:15:00,True,2024-01-08 21:15:00,2024-01-09 23:12:06,2024-01-08 21:15:55,even,True,18.38,468.38,1,0,2,1
2024-01-08 21:00:00,46949.637,47258.305,46750.547,47105.164,4248,0,0,46518.01154216809,47258.305,0.0011886918264750797,-0.0009958250650133234,0.004245963037133676,0.008686000558067227,50007.56217872391,49078.211540484896,2024-01-08 21:00:00,2024-01-08 21:00:00,581.2597976190445,548.2871249468735,46298.329583333325,0.0030689797638471066,0.006982444100130335,45799.715571428555,45664.42753154875,48677.66368099425,45631.501511871196,48337.70376778287,0.006982352586148852,0.00357905171554585,44287.853382409274,44701.623871031275,93.95142336870121,91.54366250811442,301.2891090980393,46004.03912493808,45436.1879825545,46442.99773684208,567.8511423835807,375.36454950519817,703.1932603590624,302.12366322663,298.2379287926087,323.2726955624894,47393.80863832682,45493.686835357345,True,False,48005.164,46705.164,47205.164,47255.164,,False,2024-01-09 23:15:00,2024-01-09 23:15:05,2024-01-08 21:28:02,fail,False,-73.53,394.85,0,1,2,1
2024-01-10 09:30:00,45875.137,45901.637,45709.238,45814.238,1203,24523,0,45709.238000000005,45901.18282672625,-0.00013672776950213726,-0.000554136109830959,-0.001137592443403757,-0.001410997304934301,45213.392361259714,45499.09846044057,2024-01-10 09:00:00,2024-01-10 09:00:00,25.147726190436515,-58.56484595275106,45917.66733333336,0.00036698727186022524,-0.00015240410387284064,45981.42910714285,45772.289526971166,46147.24391771335,46043.45795395105,46224.47523594848,4.711121205437901e-06,0.001085230264016693,45855.59173417431,46138.07579307303,15.479564654930448,23.041696867775148,26.458644518019796,45933.015990098975,45988.636156296525,45873.92233505332,-55.620166197550134,-48.532086877889576,106.57536917500238,-23.737876161052554,-30.677718954226293,-38.486477812126395,46017.799083439575,45728.54558666707,False,True,44914.238,45714.238,45714.238,45664.238,2024-01-10 10:45:00,True,2024-01-10 10:45:00,2024-01-10 13:53:13,2024-01-10 10:49:18,even,True,18.38,413.23,1,0,2,1
2024-01-10 09:45:00,45817.738,45845.738,45728.867,45740.137,1419,42762,0,45729.31488474169,45891.551361017526,-0.0008939501799908104,-0.0008984197552100513,-0.0011376166756515958,-0.0012925904141415946,45196.3115493373,45447.41963840246,2024-01-10 09:00:00,2024-01-10 09:00:00,25.147726190436515,-58.56484595275106,45917.66733333336,0.00036698727186022524,-0.00015240410387284064,45981.42910714285,45772.289526971166,46147.24391771335,46043.45795395105,46224.47523594848,4.711121205437901e-06,0.001085230264016693,45855.59173417431,46138.07579307303,14.568643766706925,17.131189229340645,26.458644518019796,45903.342299314514,45970.22881138567,45842.57513347094,-66.88651207115618,-52.2029719165429,107.51861253588328,-31.347201582379057,-23.737876161052554,-30.677718954226293,45987.725260394385,45695.9250065475,False,True,44840.137,45640.137,45640.137,45590.137,2024-01-10 11:00:00,True,2024-01-10 11:00:00,2024-01-10 14:48:27,2024-01-10 11:34:25,even,True,18.38,431.61,2,0,2,1
2024-01-10 10:15:00,45759.746,45807.438,45690.039,45717.586,1317,44023,0,45662.54378632696,45864.54651121754,-0.004153446803466431,-0.0015844324028926216,-0.000554136109830959,-0.00013672776950213726,45642.2299224784,45629.01398779198,2024-01-10 10:00:00,2024-01-10 10:00:00,-63.7617738094923,-83.230410622833,45691.82988095236,-0.0010182931738218764,-0.0012117019820287044,45917.66733333336,45113.937146198004,45742.64323908157,45772.289526971166,46147.24391771335,-0.00015240410387284064,0.00036698727186022524,45833.64068577532,46070.696929627185,9.304799325950126,12.722269335912422,4.520833489849238,45856.994877024,45937.564679171526,45785.606355005184,-80.56980214752548,-61.175226925121336,126.05824648407912,-29.19539938080561,-27.773379084952467,-31.347201582379057,45955.78498775869,45613.927722251676,False,True,44817.586,45617.586,45617.586,45567.586,2024-01-10 11:00:00,True,2024-01-10 11:00:00,2024-01-10 14:48:47,2024-01-10 11:34:01,even,True,18.38,449.99,3,0,2,1
2024-01-10 10:30:00,45717.586,45746.039,45606.84,45625.367,1579,27515,0,45296.98961180104,45746.03900000002,-0.0002691183689855816,-0.0005915279913084796,-0.0008984197552100513,-0.0008939501799908104,45292.86096433013,45451.24517613763,2024-01-10 10:00:00,2024-01-10 10:00:00,-63.7617738094923,-83.230410622833,45691.82988095236,-0.0010182931738218764,-0.0012117019820287044,45917.66733333336,45113.937146198004,45742.64323908157,45772.289526971166,46147.24391771335,-0.00015240410387284064,0.00036698727186022524,45833.64068577532,46070.696929627185,8.3367485676641,10.64497093623148,4.520833489849238,45821.359819020305,45914.43892515882,45751.26257653937,-93.07910613851709,-67.55600276780049,141.35095707890957,-34.343778465816285,-29.19539938080561,-27.773379084952467,45942.0863685959,45558.93878448284,False,True,44725.367,45525.367,45525.367,45475.367,2024-01-10 11:00:00,True,2024-01-10 11:00:00,2024-01-10 14:54:45,2024-01-10 11:18:06,even,True,18.38,468.37,4,0,2,1
2024-01-10 10:45:00,45628.637,45719.438,45284.801,45295.84,2804,0,0,45174.30156757911,45719.43800000001,0.002436083386933274,-0.00033594583242154254,-0.0009564839327480721,-0.003314093318335989,44140.78780485066,45382.64027583469,2024-01-10 10:00:00,2024-01-10 10:00:00,-63.7617738094923,-83.230410622833,45691.82988095236,-0.0010182931738218764,-0.0012117019820287044,45917.66733333336,45113.937146198004,45742.64323908157,45772.289526971166,46147.24391771335,-0.00015240410387284064,0.00036698727186022524,45833.64068577532,46070.696929627185,4.4184475163019,7.353331803305397,4.520833489849238,45740.5106160941,45868.61678255446,45655.99140660483,-128.10616646036215,-79.66603550631282,192.22212801111945,-95.2711699345382,-34.343778465816285,-29.19539938080561,45915.49127941984,45394.99153378982,False,True,44395.84,45695.84,45195.84,45145.84,,False,2024-01-10 14:45:00,2024-01-10 14:57:08,2024-01-10 12:14:48,fail,False,-73.52,394.85,0,1,2,1
2024-01-11 13:00:00,46841.609,46966.438,46678.246,46961.539,3021,15922,0,46678.24600000002,47147.50496899267,0.0013944158921967943,-0.00011685222516587534,0.0029036910777666385,0.0033230948243410208,47896.618543385775,48064.073169006435,2024-01-11 13:00:00,2024-01-11 13:00:00,249.79616666673246,114.52344343710865,46624.93410714286,0.003225569582687043,0.002005574225041328,46334.985000000044,46890.935553084295,47498.56085230551,45917.97723840374,46997.30839376337,0.0008432838781837022,0.0009378751359636978,46062.249380423775,46262.69497279812,98.64613895370883,96.29334046921969,95.71844726735478,46480.08403940784,46346.78564563491,46638.18043962848,133.29839377292956,38.300739228262344,303.3796423449502,106.5029253526227,87.71774234602344,71.84207086339302,47049.24295679416,46228.6179224628,True,False,47861.539,47061.539,47061.539,47111.539,2024-01-11 14:30:00,True,2024-01-11 14:30:00,2024-01-11 16:28:13,2024-01-11 14:31:55,even,True,18.38,413.23,1,0,2,1
2024-01-12 17:30:00,44932.34,44943.438,44482.965,44534.582,5141,34922,0,44483.39034291612,44947.57086486027,-0.005283545097952023,-0.00293934702816435,-0.006166639754500067,-0.006627433774720321,42141.739941392305,42855.77834462193,2024-01-12 17:00:00,2024-01-12 17:00:00,-140.7018333333399,-185.05861460802407,45272.459702380955,-0.004035732193740531,-0.002545418230729828,45711.9683095238,43676.84340665314,45352.74609228117,45044.36701250034,46258.26607879018,1.4536388652896458e-05,-0.0011597467862405533,46068.79381918012,45943.51728735464,8.126374245799814,9.566048732367115,-130.68930071732967,45367.65199928643,45621.17345721454,45136.06191847269,-253.52145792811643,-132.05666922710097,386.1262584212033,-202.9350395596921,-141.00013347090135,-119.14650945991889,45657.33236734131,44613.29146960407,False,True,43634.582,44434.582,44434.582,44384.582,2024-01-12 18:15:00,True,2024-01-12 18:15:00,2024-01-12 18:37:25,,success,True,165.39,578.62,2,0,2,1
2024-01-12 17:45:00,44537.938,44663.738,44333.84,44468.84,4802,36074,0,44334.282127650025,44923.558874312184,-0.007296893263166403,-0.005354170680438634,-0.006032480709963644,-0.004828048097137149,42601.38081447397,42649.88138748419,2024-01-12 17:00:00,2024-01-12 17:00:00,-140.7018333333399,-185.05861460802407,45272.459702380955,-0.004035732193740531,-0.002545418230729828,45711.9683095238,43676.84340665314,45352.74609228117,45044.36701250034,46258.26607879018,1.4536388652896458e-05,-0.0011597467862405533,46068.79381918012,45943.51728735464,10.450774744832252,10.708267054272154,-130.68930071732967,45229.37323016544,45535.8154233468,44962.378108703146,-306.4421931813631,-166.9337740179534,458.91459338861193,-173.6838097695436,-202.9350395596921,-141.00013347090135,45581.91280977777,44341.34340762852,False,True,43568.84,44368.84,44368.84,44318.84,2024-01-12 18:30:00,True,2024-01-12 18:30:00,2024-01-12 18:37:27,,success,True,165.39,744.01,3,0,2,1
2024-01-12 18:00:00,44465.605,44684.113,44300.359,44363.84,4424,37800,0,44187.99595627835,44683.672633323935,-0.009292803293780651,-0.005354163892869969,-0.00399086450692853,-0.003600172627153452,42956.97339282799,43330.18943587287,2024-01-12 18:00:00,2024-01-12 18:00:00,-439.508607142845,-285.7466117677104,44624.876488095266,-0.0074288161263408176,-0.002545624089943377,45272.459702380955,42033.590789052636,45239.37206558907,43676.84340665314,45352.74609228117,-0.002545418230729828,-0.004035732193740531,45973.35245372208,45758.839024366265,5.059837284512142,7.8789954250480845,-161.70076292740583,45096.21427167845,45449.00242902481,44781.55601272787,-352.7881573463601,-204.10465068363476,525.9747992680183,-180.82209597527253,-173.6838097695436,-202.9350395596921,45491.621991739696,44069.99003371605,False,True,43463.84,44263.84,44263.84,44213.84,2024-01-12 18:30:00,True,2024-01-12 18:30:00,2024-01-12 18:38:59,,success,True,165.39,909.4,4,0,2,1
2024-01-15 00:15:00,42518.059,42533.738,42288.938,42295.238,1675,64324,0,42108.0968964076,42533.31515888545,-0.0016628174378776651,-0.001584528649774569,-0.01083614903606396,-0.008401175182080054,39476.33439380548,39146.27972856802,2024-01-15 00:00:00,2024-01-15 00:00:00,-35.46648809522594,-740.8622986027985,43022.09020238095,-0.004529210888572681,-0.006006138311662458,43367.19564285717,41349.8447432027,42637.51975290119,42658.50517878547,42802.88040753253,-0.006538923155859137,-0.001444983695887348,45408.42542849569,44789.61504751553,13.065517366771418,19.512930347685348,-524.4644980080938,43264.69440858737,43696.56656114042,43170.064272789816,-431.8721525530491,-376.1350233327285,383.43338860046254,-207.59455899553723,-202.50598383210308,-40.0362242862393,43687.69934740044,42650.92919817919,False,True,41395.238,42195.238,42195.238,42145.238,2024-01-15 01:15:00,True,2024-01-15 01:15:00,,2024-01-15 02:35:34,even,True,18.38,927.78,5,0,3,1
2024-01-15 00:30:00,42295.238,42336.34,42038.137,42270.371,2029,44922,0,42038.13699999999,42501.63341841453,-0.0016731439357218433,-0.0024239109222795427,-0.008774874452499054,-0.006974053733725567,39690.309908219446,39586.14704886818,2024-01-15 00:00:00,2024-01-15 00:00:00,-35.46648809522594,-740.8622986027985,43022.09020238095,-0.004529210888572681,-0.006006138311662458,43367.19564285717,41349.8447432027,42637.51975290119,42658.50517878547,42802.88040753253,-0.006538923155859137,-0.001444983695887348,45408.42542849569,44789.61504751553,5.647525128888273,11.424450986173584,-524.4644980080938,43111.721576497,43590.922445500386,42970.91194220845,-479.20086900338356,-396.74819246685956,436.6355484520818,-199.152330581368,-207.59455899553723,-202.50598383210308,43560.369932618756,42379.95395179814,False,True,41370.371,42170.371,42170.371,42120.371,2024-01-15 01:15:00,True,2024-01-15 01:15:00,,2024-01-15 02:35:14,even,True,18.38,946.16,6,0,3,1
2024-01-15 00:45:00,42270.402,42398.738,42148.039,42243.738,2123,65410,0,42014.129266744545,42398.331534516445,-0.0027483085824456313,-0.002355831157189844,-0.0017617096680837903,-0.0038242604039158724,40670.43509990116,41830.80092138545,2024-01-15 00:00:00,2024-01-15 00:00:00,-35.46648809522594,-740.8622986027985,43022.09020238095,-0.004529210888572681,-0.006006138311662458,43367.19564285717,41349.8447432027,42637.51975290119,42658.50517878547,42802.88040753253,-0.006538923155859137,-0.001444983695887348,45408.42542849569,44789.61504751553,7.664679243503258,8.792573913054326,-524.4644980080938,42978.185641651304,43491.13100509295,42775.96183900925,-512.9453634416495,-419.98762666181756,496.8353372644648,-194.95010319919675,-199.152330581368,-207.59455899553723,43446.68954431628,42103.73413370222,False,True,41343.738,42143.738,42143.738,42093.738,2024-01-15 01:15:00,True,2024-01-15 01:15:00,,2024-01-15 02:20:55,even,True,18.38,964.54,7,0,3,1
2024-01-18 08:00:00,42750.84,42848.637,42750.84,42832.539,1102,44523,0,42750.83999999998,42880.274550947775,-0.0001938732525856069,-0.0005443739265534524,0.0008870528683302379,0.0009405242848938897,43034.11021786827,43140.55957302638,2024-01-18 08:00:00,2024-01-18 08:00:00,39.049642857164145,-35.94710677999683,42695.86171428569,0.0004453380233984897,0.00033142377486557146,42648.3475,42653.07217436722,42909.035442949236,42661.62524616272,42766.02792951155,-1.1565537805272526e-05,0.000559718190485303,42827.954222347,42682.68713879273,91.26657602878082,88.56385864215777,-59.64155001538136,42691.97892437386,42656.97784722226,42715.66706914345,35.00107715160266,13.235547847047329,70.43247896925504,25.552712762306328,25.19304196765006,19.513157894725737,42812.250915751945,42620.58322253495,True,False,43732.539,42432.539,42932.539,42982.539,,False,,,2024-01-18 12:53:05,fail,False,-73.52,891.02,0,1,3,1
2024-01-18 09:00:00,42782.738,42900.848,42776.676,42886.223,1370,42824,0,42776.67599999996,42907.02222796644,0.0004738612451436725,-0.00010220825976388207,0.00033803245844263806,0.0007275864316620512,43015.86667350705,43011.74502245999,2024-01-18 09:00:00,2024-01-18 09:00:00,47.51421428568574,-22.340605612327636,42782.38190476187,0.0008729900898447648,0.0004384742603661689,42695.86171428569,42812.171916834624,42971.24820082092,42653.07217436722,42909.035442949236,0.00033142377486557146,0.0004453380233984897,42830.46735088241,42699.43528768932,82.46344952285618,80.28305812682197,-52.18136113477062,42750.74567486285,42697.16433252083,42811.0194258686,53.581342342018615,32.60169507182572,95.92450082107347,39.496753009989334,21.456537667676457,16.355973168218043,42942.017501977054,42681.52134976015,True,False,43786.223,42486.223,42986.223,43036.223,,False,,,2024-01-18 12:50:06,fail,False,-73.53,817.49,0,2,3,1
2024-01-18 19:00:00,41927.637,41929.039,41613.84,41674.84,3354,8121,0,41614.24521614188,42221.45605568454,-0.001465803983098605,-0.0015197199064600749,-0.00570751319914241,-0.005078694993897945,39891.9946765271,40176.36960942406,2024-01-18 19:00:00,2024-01-18 19:00:00,-193.5015952381509,-89.68676026554022,42158.10277380953,-0.003224620322107742,0.00015103101951563925,42352.225904761886,40949.26872464056,42831.66534935206,41286.66092741026,42752.34004097405,-0.00021473788301068858,-0.002705596218311377,42689.79233727562,42515.89258822223,16.722086546817327,20.455154300672817,-47.64880013875913,42282.759314892144,42423.861964898264,42250.24525662196,-141.1026500061198,-58.321077995919424,231.0464360203777,-153.14990436875087,-112.71639834880625,-85.52038149294094,42562.15794524947,41936.83256799445,False,True,40774.84,42074.84,41574.84,41524.84,,False,2024-01-18 20:15:00,2024-01-18 22:32:09,2024-01-18 19:26:49,fail,False,-73.52,743.97,0,3,3,1
2024-01-19 05:00:00,41085.438,41117.238,40977.238,41039.137,1481,41941,0,40868.07811625609,41117.23800000003,-0.0019052700000153646,-0.0005622843084304782,-0.0010159367070062065,-0.0009557024279607973,40679.87715898086,40799.58465571181,2024-01-19 05:00:00,2024-01-19 05:00:00,3.078654761920916,-403.2167961238956,41171.835666666666,0.00022258406440362467,0.00017163333256652152,41236.1299047619,40745.81131456356,41391.359053166205,41298.87973776108,41126.12873571792,-0.001023504533730788,0.0016466315028431982,42188.388346749336,41752.24770115671,10.66881421079484,20.991312217372393,-341.4975040320292,41152.432048540606,41237.371898870544,41121.925401444794,-84.93985032993805,-91.90754138634686,104.40497635687689,-28.128476436184428,-29.779276229783136,-30.35105366355856,41262.872119526575,40979.47868336301,False,True,40139.137,41439.137,40939.137,40889.137,,False,2024-01-19 17:30:00,2024-01-22 20:49:21,2024-01-19 08:48:52,fail,False,-73.52,670.45,0,4,3,1
2024-01-19 05:15:00,41041.238,41074.238,40868.496,40915.84,1857,35007,0,40605.963510687034,41074.23799999996,0.002623791834829961,0.00020760484210158043,-0.0010363842073850549,-0.0015229685942609384,40397.07364196684,40751.009572051466,2024-01-19 05:00:00,2024-01-19 05:00:00,3.078654761920916,-403.2167961238956,41171.835666666666,0.00022258406440362467,0.00017163333256652152,41236.1299047619,40745.81131456356,41391.359053166205,41298.87973776108,41126.12873571792,-0.001023504533730788,0.0016466315028431982,42188.388346749336,41752.24770115671,12.738897209023298,13.759381282649926,-341.4975040320292,41116.033271842054,41213.55472117643,41079.11503577573,-97.52144933437376,-93.03032297595225,103.26936681368882,-42.810365669065504,-28.128476436184428,-29.779276229783136,41218.52868097421,40938.20139057725,False,True,40015.84,41315.84,40815.84,40765.84,,False,2024-01-19 18:30:00,2024-01-22 20:49:23,2024-01-19 08:39:44,fail,False,-73.53,596.9200000000001,0,5,3,1
2024-01-19 20:45:00,41391.438,41966.188,41384.137,41784.34,4181,0,0,41384.13700000004,41966.18799999997,0.002103291517086128,-0.0005951992150261397,0.005634738704629326,0.004834941974503021,42939.468183206685,43813.39882996134,2024-01-19 20:00:00,2024-01-19 20:00:00,55.21079761907458,-250.18994557492988,41129.48488095238,-0.0049267543004061715,0.0016335842906022272,40861.50035714286,39185.397179299485,42216.79128461796,39519.07879266438,41007.829828193906,-0.0015427246304204178,-0.004173764967243884,41749.33471900098,41364.033392180936,93.82307535558412,93.47966961235515,-253.95677408542267,41137.22297851305,41077.822338586404,41183.84752149982,59.400639926643635,-63.0804400269041,352.66747708923407,185.1937605778876,135.19486824904743,131.2366945304675,41661.44861557028,40707.74642742935,True,False,42684.34,41884.34,41884.34,41934.34,2024-01-19 22:15:00,True,2024-01-19 22:15:00,,2024-01-19 22:26:47,even,True,18.38,615.3000000000001,1,0,3,1
2024-01-24 09:15:00,39896.563,40161.34,39893.563,40075.34,2674,36422,0,39893.56300000003,40161.340000000004,9.488511541460123e-05,-0.000411761248167373,0.0024298409493384724,0.0007890727013988507,40062.59610177452,40909.94700611192,2024-01-24 09:00:00,2024-01-24 09:00:00,-2.4113333333662013,5.368301147223974,39788.3854404762,-0.0003588582276014287,-0.00023030274976937567,39724.59883333332,39438.44251136079,40127.65222512683,39644.434203897465,39657.92585319562,-0.0014818776458300326,0.0005072681803178954,39937.60553825369,39643.46575397471,92.00877098403107,89.81027781520322,-91.45065988532555,39818.77751290826,39742.74395746001,39873.851287925674,76.03355544825172,51.01076184754301,116.67936954555378,70.8329865840642,45.10507327145024,38.376579635369126,40032.86843681217,39716.33413903918,True,False,40975.34,40175.34,40175.34,40225.34,2024-01-24 12:45:00,True,2024-01-24 12:45:00,,2024-01-24 13:09:23,even,True,18.38,633.6800000000001,2,0,4,1
2024-01-25 07:00:00,39930.137,39941.438,39798.238,39810.34,1353,36422,0,39763.24563336075,39941.43800000003,-3.909080900892076e-05,-0.0005453658962549113,-0.0004242035822758154,-0.0011387623949154612,39455.66500102412,39812.95784066843,2024-01-25 07:00:00,2024-01-25 07:00:00,-40.49497619047179,44.802561296499334,39925.79271428573,0.00015339412335695427,-0.00038277148000997096,39988.63748809526,39782.41561418523,40035.17780743402,40099.25071314041,40145.76837188399,-2.1064525564051914e-05,0.001508499746101991,39941.918053589674,39888.50038950301,18.814889965162003,23.308827413391196,49.382732026872546,39945.40485175287,39954.11991664383,39909.426959752294,-8.715064890959184,12.468569537664752,76.71042054212904,-24.83501238394092,-15.013933264526713,-8.873642930870119,40012.98602748417,39804.36789202042,False,True,38910.34,40210.34,39710.34,39660.34,,False,2024-01-25 19:15:00,,2024-01-25 13:13:11,fail,False,-73.53,560.1500000000001,0,1,4,1
2024-01-25 07:15:00,39810.34,39829.938,39765.738,39793.539,1215,36422,0,39719.8171446654,39829.550394505764,0.0010145918987326777,0.0011211279769873105,-0.0007687463076490452,-0.001539792693565998,39275.253907565246,39678.480009358274,2024-01-25 07:00:00,2024-01-25 07:00:00,-40.49497619047179,44.802561296499334,39925.79271428573,0.00015339412335695427,-0.00038277148000997096,39988.63748809526,39782.41561418523,40035.17780743402,40099.25071314041,40145.76837188399,-2.1064525564051914e-05,0.001508499746101991,39941.918053589674,39888.50038950301,12.65059476633769,19.22301560866148,49.382732026872546,39922.04087456012,39942.22503392948,39887.931178534556,-20.184159369353438,5.9380237562611144,87.4050825324964,-21.495781217738113,-24.83501238394092,-15.013933264526713,40005.928039953425,39768.43431711569,False,True,38893.539,40193.539,39693.539,39643.539,,False,2024-01-25 19:15:00,,2024-01-25 13:13:09,fail,False,-73.53,486.6200000000001,0,2,4,1
2024-01-25 15:30:00,39812.738,39936.637,39763.852,39805.34,2076,36422,0,39615.45054667036,39936.63699999997,0.0020044657805988325,0.0006796202819915511,0.0003799492328254926,-0.0001074527115184356,39725.46988744749,40052.04992439407,2024-01-25 15:00:00,2024-01-25 15:00:00,-74.73034523811657,45.34681165510119,39958.20660714288,-0.0005478202934525447,-0.0005040815693895127,40025.399785714275,39617.349546863246,40167.891092048776,39820.04268945826,40474.73338610639,0.0010383560017378564,0.00014126724309469188,39960.30611464327,39944.44013940603,10.78283768546617,11.565949668257721,51.40098410856931,39943.381577689666,39985.92663684735,39915.070724114186,-42.54505915768095,-3.0650373410893774,118.96072447534647,-37.7778682490607,-41.91651737186476,-40.982613347085135,40075.6677021559,39752.97374607247,False,True,38905.34,39705.34,39705.34,39655.34,2024-01-25 19:15:00,True,2024-01-25 19:15:00,,2024-01-25 19:31:29,even,True,18.38,505.0000000000001,1,0,4,1
2024-01-26 04:15:00,40035.637,40162.637,40021.84,40145.84,1865,36422,0,40021.84000000001,40254.288627222646,0.0005331024467288409,-0.0006000571305294607,0.0021834052131544076,0.0012320339739338984,40329.06388327298,40839.8455891703,2024-01-26 04:00:00,2024-01-26 04:00:00,-0.036428571424039546,-5.487803990763496,39972.8504047619,0.0009552619421528462,0.0009630128923026931,39908.23064285713,39968.47792024712,40369.946969801196,39930.20959209641,39891.79814771624,-0.0002967992737533424,0.0009552623618696503,39930.2886854664,39913.16545247492,84.13427197101628,67.31653475999441,-5.9606418668469745,39941.81052939201,39905.98097281722,39949.6741513588,35.82955657479033,15.562507337508976,79.35527011837301,45.08658754731732,19.043935328510997,1.894755417961278,40058.3037660186,39842.544536698995,True,False,41045.84,40245.84,40245.84,40295.84,2024-01-26 12:45:00,True,2024-01-26 12:45:00,2024-01-26 13:30:38,,success,True,165.38,670.3800000000001,2,0,4,1
2024-01-26 11:00:00,40098.152,40171.84,40079.762,40159.137,857,36422,0,40080.1607473654,40171.44967289721,-0.0006849465709098097,0.0017923802028042043,0.00027888471288457133,5.103497297517313e-05,40080.24858438116,40257.085815197344,2024-01-26 11:00:00,2024-01-26 11:00:00,12.870678571467579,36.88957084296271,40025.47219047621,-0.0002041989406559661,0.0005609882356597247,40039.38845238096,39817.90031475777,40469.83017066262,39917.38007463879,40101.11444208654,-0.000334608359217185,0.0002944108937803435,39957.03720695982,39968.83690414416,89.76026391655836,87.66741556084264,24.116767149152523,40068.052793862764,40043.4990827106,40049.08979738561,24.553711152162577,15.476905028421736,71.67950418781575,28.356212934268115,14.882746818031592,16.697797385641024,40147.35712803916,39952.32246673206,True,False,41059.137,40259.137,40259.137,40309.137,2024-01-26 12:45:00,True,2024-01-26 12:45:00,2024-01-26 13:30:39,,success,True,165.38,835.7600000000001,3,0,4,1
2024-01-26 11:30:00,40145.84,40281.039,40139.77,40277.137,979,36422,0,39985.03749978212,40446.460169079575,0.0003213060889889999,-0.0014454516289920459,0.001204544985262125,0.000743101702157589,40367.10730246547,40651.25869397089,2024-01-26 11:00:00,2024-01-26 11:00:00,12.870678571467579,36.88957084296271,40025.47219047621,-0.0002041989406559661,0.0005609882356597247,40039.38845238096,39817.90031475777,40469.83017066262,39917.38007463879,40101.11444208654,-0.000334608359217185,0.0002944108937803435,39957.03720695982,39968.83690414416,95.47282319529357,91.74678765691537,24.116767149152523,40111.47815418577,40068.421501638026,40119.00657275542,43.05665254774067,23.258006090722652,83.83719669949623,45.61979910561058,24.29697626419511,28.356212934268115,40233.68678829974,40005.826357211095,True,False,41177.137,40377.137,40377.137,40427.137,2024-01-26 12:45:00,True,2024-01-26 12:45:00,2024-01-26 13:30:46,,success,True,165.38,1001.1400000000001,4,0,4,1
2024-01-26 12:45:00,40608.996,40724.453,40491.848,40654.238,2864,36422,0,40477.23637631654,40724.0987150819,0.003236237940554787,0.004897381525710447,0.006241664889936212,0.004050869372936059,41680.33938443543,42925.66945507325,2024-01-26 12:00:00,2024-01-26 12:00:00,-13.916261904749263,38.045030134955596,40236.20259523811,-0.0004680602752582516,0.001989066874423189,40025.47219047621,39740.13046491973,41018.30260715014,39817.90031475777,40469.83017066262,0.0005609882356597247,-0.0002041989406559661,39984.37841453003,40023.66899181263,86.13615196519702,68.9956240138326,26.902419746313136,40268.68483424619,40160.93072694316,40363.79826487789,107.75410730302974,52.80287681551796,177.77917530912893,101.4619109047344,102.5862855177038,36.572490884078434,40605.30015154522,40123.796378210565,True,False,41554.238,40754.238,40754.238,40804.238,2024-01-26 13:30:00,True,2024-01-26 13:30:00,2024-01-26 16:59:57,,success,True,165.38,1166.52,5,0,4,1
2024-01-26 13:00:00,40646.652,40866.238,40645.086,40776.547,2893,36422,0,40565.3169296318,40911.984466196656,0.004298788493351999,0.005044564480588692,0.003397201513111979,0.004070451524244043,41858.45283371666,42029.64247053031,2024-01-26 13:00:00,2024-01-26 13:00:00,210.73040476189635,87.18832125962217,40603.802166666675,0.0014328590996263541,0.003963361604516158,40236.20259523811,40300.61571041326,41925.58525040601,39740.13046491973,41018.30260715014,0.001989066874423189,-0.0004680602752582516,40034.15722180336,40122.07451246762,91.41769238778348,82.50812465103,38.95960004897495,40346.81747513139,40206.531932354774,40476.57231750945,140.28554277661897,70.29941000773817,220.64504522803082,112.77405263156106,101.4619109047344,102.5862855177038,40775.9431285673,40178.70150645161,True,False,41676.547,40876.547,40876.547,40926.547,2024-01-26 13:30:00,True,2024-01-26 13:30:00,2024-01-26 18:19:35,,success,True,165.38,1331.9,6,0,4,1
2024-01-26 13:45:00,41216.738,41301.367,41120.688,41253.738,2426,36422,0,41120.687999999995,41436.919915044,0.000296981695069339,0.0003958438018782072,0.005044564480588692,0.004298788493351999,42460.953559173315,43165.4304377928,2024-01-26 13:00:00,2024-01-26 13:00:00,210.73040476189635,87.18832125962217,40603.802166666675,0.0014328590996263541,0.003963361604516158,40236.20259523811,40300.61571041326,41925.58525040601,39740.13046491973,41018.30260715014,0.001989066874423189,-0.0004680602752582516,40034.15722180336,40122.07451246762,94.29697882487169,93.49700938697156,38.95960004897495,40665.08283086021,40400.09209709107,40904.900693498465,264.9907337691402,147.9502180900982,395.23587365184153,142.93394530443766,159.14655108360603,126.24787960096728,41439.96912292845,40371.33226406848,True,False,42153.738,41353.738,41353.738,41403.738,2024-01-26 14:30:00,True,2024-01-26 14:30:00,2024-01-26 20:45:50,2024-01-26 14:31:52,even,True,18.38,1350.2800000000002,7,0,4,1
2024-01-29 03:15:00,42050.676,42214.723,41993.938,42162.344,1957,36422,0,41993.93800000001,42306.13994346844,0.0007628095393494538,-0.0005300149028078638,0.001448791108082214,0.0014926903198110146,42475.91930696887,42684.82576919829,2024-01-29 03:00:00,2024-01-29 03:00:00,-7.267630952417676,501.3925674192287,41979.26001190478,-0.00048486946305883484,0.0003238007917498553,41929.57858333333,41438.137396769314,42333.75610323408,41398.73646933657,42032.83134993217,-0.0005678708464705312,-0.0007395999779579546,40793.15791388098,41308.53261536587,89.29131154198446,84.82049872859398,471.0284312245752,41975.914965686214,41900.852179514084,41996.41712899895,75.06278617212956,71.0315778840446,102.74797855841402,49.93369246643124,30.927619883033913,12.970985552135971,42136.62690005281,41857.707357945095,True,False,43062.344,42262.344,42262.344,42312.344,2024-01-29 05:30:00,True,2024-01-29 05:30:00,2024-01-29 18:33:52,2024-01-29 06:04:20,even,True,18.38,1368.6600000000003,8,0,5,1
2024-01-29 03:30:00,42161.691,42283.723,42128.703,42188.738,2107,36422,0,42084.30579918288,42283.722999999976,6.453534343185512e-05,-0.00012145336742413679,0.002890321476646208,0.0014927891541860689,42539.6098557671,43283.71914662041,2024-01-29 03:00:00,2024-01-29 03:00:00,-7.267630952417676,501.3925674192287,41979.26001190478,-0.00048486946305883484,0.0003238007917498553,41929.57858333333,41438.137396769314,42333.75610323408,41398.73646933657,42032.83134993217,-0.0005678708464705312,-0.0007395999779579546,40793.15791388098,41308.53261536587,92.69833952526876,89.3849991904168,471.0284312245752,42008.65697096526,41922.17705510564,42043.20606604748,86.47991585962154,74.12124547915998,112.28279092470797,46.78893704852817,49.93369246643124,30.927619883033913,42196.28783379584,41891.624298299124,True,False,43088.738,42288.738,42288.738,42338.738,2024-01-29 05:30:00,True,2024-01-29 05:30:00,2024-01-29 18:34:47,2024-01-29 05:59:53,even,True,18.38,1387.0400000000004,9,0,5,1
2024-01-30 04:00:00,43407.039,43549.066,43407.039,43541.039,1834,36422,0,43394.63142655218,43555.49998667623,0.0008395320631489402,0.002435050130023054,6.538370535859729e-05,0.0013339956806407848,43854.37115537616,43570.51035189656,2024-01-30 04:00:00,2024-01-30 04:00:00,91.0103333333318,426.7723308656714,43384.10825000001,0.0009877717197878636,0.0021204903247496352,43256.17583333335,43313.737298639215,44111.636623290164,43270.69288049392,43782.92632395569,0.0014929771898046758,0.0009878222646368803,42022.89157762984,42682.26246487686,80.72057457080994,79.74313841033673,406.18055683412,43307.19073636636,43171.22793121022,43384.482513931885,135.9628051561449,118.39600124040027,139.7985177573625,61.77482662534749,34.74203921571461,39.112016167870024,43574.71051290433,43195.754514959444,True,False,44441.039,43141.039,43641.039,43691.039,,False,2024-01-31 20:00:00,,2024-01-30 15:17:02,fail,False,-73.53,1313.5100000000004,0,1,5,1
2024-01-31 01:30:00,42855.926,42967.738,42661.938,42747.098,2544,36422,0,42563.36368757479,42967.738000000005,0.0019669948722492417,0.0012038349112782649,-0.0029693051593012625,-0.004982787520323489,41038.77762530255,42109.336351744,2024-01-31 01:00:00,2024-01-31 01:00:00,-52.541190476185875,162.27685199952975,43246.69688095242,-0.0017744127848034843,0.00024100669904713527,43429.903642857134,42371.045900216275,43802.15788188572,43337.9504144862,43887.70806828237,0.000626665166544423,0.00037795740948898965,42784.255904821206,43236.378521622755,3.1983124248350534,3.7444447239894103,212.65176437953627,43229.67493205169,43328.523763657315,43164.996165806675,-98.84883160562458,-14.329863001958483,209.8512864607727,-133.58983625728433,-121.62710010322917,-64.29427966977528,43448.29540252872,42880.19692908463,False,True,41847.098,42647.098,42647.098,42597.098,2024-01-31 13:00:00,True,2024-01-31 13:00:00,,2024-01-31 13:56:22,even,True,18.38,1331.8900000000006,1,0,5,1
2024-01-31 11:15:00,42805.738,42861.738,42745.738,42748.637,1438,36422,0,42739.73676115019,42905.99063876573,-0.0018458424771384144,-0.00042264451144448807,-0.0008394692888786378,-0.0015861129516890591,42200.95415039163,42632.17441692359,2024-01-31 11:00:00,2024-01-31 11:00:00,13.161726190468471,-47.53189318551449,42859.93801190477,-0.0001381126611636029,0.00012782391540707016,42979.096142857175,42561.13665046504,43082.72003121196,43075.06718725826,43115.853081170615,0.0003196651906349036,0.0010893713300746822,42815.31739420916,43032.9931481105,16.605257695764795,27.015699170961494,-2.006774756760896,42899.69994139045,42931.0051975733,42893.23688476094,-31.305256182851736,-18.129546831045786,56.358480720767076,-37.400371173003805,-30.586733746167738,-3.642722050230077,42969.320833733975,42815.652935787904,False,True,41848.637,42648.637,42648.637,42598.637,2024-01-31 13:00:00,True,2024-01-31 13:00:00,2024-02-01 03:38:04,2024-01-31 13:56:22,even,True,18.38,1350.2700000000007,2,0,5,1
2024-01-31 11:45:00,42819.137,42869.738,42582.246,42619.938,1480,36422,0,42551.7328015553,42869.73799999998,0.00045727277682945357,-0.0008051087075752056,-0.000569234510218725,-0.001585185824161883,42068.3704321131,42683.07459086816,2024-01-31 11:00:00,2024-01-31 11:00:00,13.161726190468471,-47.53189318551449,42859.93801190477,-0.0001381126611636029,0.00012782391540707016,42979.096142857175,42561.13665046504,43082.72003121196,43075.06718725826,43115.853081170615,0.0003196651906349036,0.0010893713300746822,42815.31739420916,43032.9931481105,12.993325950838715,14.238453732811593,-2.006774756760896,42846.172159220376,42900.2904670553,42812.93066563466,-54.11830783492769,-28.092655011612443,85.90622614813921,-59.98126762988977,-20.324951496389986,-37.400371173003805,42928.904070934645,42695.457260334675,False,True,41719.938,42519.938,42519.938,42469.938,2024-01-31 13:00:00,True,2024-01-31 13:00:00,,2024-01-31 13:24:52,even,True,18.38,1368.6500000000008,3,0,5,1
2024-02-01 16:45:00,42499.457,42618.438,42437.867,42609.137,2339,36422,0,42437.86699999998,42667.95438948778,0.0015702906677785133,0.0027775300518199787,0.0028226895294386407,0.00258365487910038,43285.64210193422,43582.35659523926,2024-02-01 16:00:00,2024-02-01 16:00:00,11.567250000000058,-199.84937936639471,42290.36472619049,-0.0008485010410050797,0.0011611187224804364,42135.88705952384,41707.94660138711,42799.940830698026,41765.22477859841,42360.16036985889,0.00019468583058156254,-0.0007365855270919586,42543.76873593347,42399.57600064836,94.34709727914178,88.96312348870379,-211.23354345974064,42292.077294940595,42230.38808365967,42317.01884038529,61.68921128092188,12.639752960606598,126.29944645453638,82.21755693153682,62.9857113863618,32.84334124523593,42489.02309309891,42146.51458767166,True,False,43509.137,42709.137,42709.137,42759.137,2024-02-01 17:30:00,True,2024-02-01 17:30:00,,2024-02-01 17:39:27,even,True,18.38,1387.0300000000009,4,0,5,2
2024-02-01 17:00:00,42593.891,42774.938,42530.637,42748.438,2947,36422,0,42530.63700000002,42896.98812384584,-0.000379357746355888,0.00019170020589271363,0.002852630993261156,0.002450398062743815,43336.263818814645,43719.95902194894,2024-02-01 17:00:00,2024-02-01 17:00:00,154.4776666666512,-152.91087057880213,42375.6244642857,0.0008845020344393963,0.002305477344774241,42290.36472619049,42156.241075523205,43277.76811732057,41707.94660138711,42799.940830698026,0.0011611187224804364,-0.0008485010410050797,42541.340158053725,42406.157120596494,97.02847746528938,93.63264381790323,-199.56900888355295,42362.286634180506,42268.76215153673,42413.45688132094,93.52448264377745,28.81669889724077,166.9138870842333,96.43804093565268,82.21755693153682,62.9857113863618,42640.29062888466,42188.123133757224,True,False,43648.438,42348.438,42848.438,42898.438,,False,2024-02-01 19:30:00,,2024-02-01 18:35:49,fail,False,-73.52,1313.510000000001,0,1,5,2
2024-02-02 08:15:00,43075.664,43196.738,43072.438,43175.039,1159,36422,0,43072.43800000001,43200.23427130926,0.00020138317916669365,0.000481313437400793,0.001236304026685453,0.001104441340109702,43438.887851157415,43629.41241811806,2024-02-02 08:00:00,2024-02-02 08:00:00,21.17646428572334,140.81267913907504,43048.831297619065,0.0002729624679621544,-0.000634759237170736,43034.44051190476,42967.00080177463,43140.69505160336,42956.543574515395,42894.182629594994,-0.0013690272647693819,0.0002812854777383509,42750.83884353759,42842.415423429164,82.91710540665201,63.226029279472094,114.86298218869354,43038.589536132575,43023.36223501994,43018.21630546951,15.227301112638088,5.650386895489051,92.53748994882318,36.53926659786521,19.957805641533923,24.608621947023494,43144.64191690042,42893.2906940386,True,False,44075.039,42775.039,43275.039,43325.039,,False,2024-02-02 18:15:00,,2024-02-02 15:30:47,fail,False,-73.52,1239.990000000001,0,2,5,2
2024-02-06 17:45:00,43156.137,43229.738,43107.355,43213.84,1878,36422,0,43089.087439203795,43235.705866341814,0.0005711937328445598,0.0013711977226199307,0.001263343904300747,0.0021379562834509718,43820.621518451844,43741.9956462611,2024-02-06 17:00:00,2024-02-06 17:00:00,5.904000000031374,18.301230815952295,42944.1648214286,-0.00022818727993874268,0.0005984284389735992,42829.94160714289,42548.04520083294,43339.24102180071,42560.60660631433,43037.88010496168,-0.00013707870165205244,-0.0002182083856794707,42816.7783783037,42836.074605929876,91.00864541480432,83.04613263717117,2.331513292088361,42996.060936893846,42919.37861647356,43070.46340350874,76.6823204202883,37.37256351793459,131.35352063438097,54.13150739586854,45.67447609223018,56.64301995182905,43249.29065636515,42893.136150652324,True,False,44113.84,42813.84,43313.84,43363.84,,False,2024-02-07 19:30:00,2024-02-07 22:17:17,2024-02-07 05:37:36,fail,False,-73.52,1166.470000000001,0,3,6,2
2024-02-07 05:45:00,42827.891,42842.938,42745.238,42764.84,1157,36422,0,42723.32032589001,42842.938,0.0007942236938390626,0.0005028136987639476,-0.0015223022877158465,-0.0014938368407451511,42259.12506016027,42365.58449574693,2024-02-07 05:00:00,2024-02-07 05:00:00,-26.56094047620718,66.05773010709527,42939.50265476191,-0.0009676874211523678,-0.0006215890985590939,43027.66032142857,42593.989240866606,43002.43178902045,42846.434924847905,43027.94006735666,-0.0006254762666800041,-0.0004550483117149739,42911.93813020367,42972.81084940439,4.622371562821037,7.988504953975039,77.29698527924755,42954.912357943984,43017.01850848314,42908.65892844858,-62.10615053915535,-31.371668274891462,98.87540859445535,-47.58936635704595,-35.84878947369725,-21.23277089784824,43042.1407300511,42773.677126846065,False,True,41864.84,43164.84,42664.84,42614.84,,False,,,2024-02-07 11:43:29,fail,False,-73.52,1092.950000000001,0,4,6,2
2024-02-08 10:30:00,44584.637,44681.738,44572.668,44665.738,1102,36422,0,44572.66799999996,44715.04430208653,-1.7852254173147703e-05,-9.734027472233138e-05,0.0011628602966627989,0.0011333117014671653,44963.581959547344,45102.30259891815,2024-02-08 10:00:00,2024-02-08 10:00:00,-38.044476190443675,385.686732024551,44526.21554761907,-0.00016047409091934158,-0.00015974079688522037,44462.53747619051,44356.02921738665,44684.233714722985,44443.94068341497,44354.62161128087,-0.00102883495959019,0.00032850347289726443,43596.504169793785,44011.67971518491,87.25140759265004,73.77502014674828,362.88059983307545,44538.83771517165,44487.60479936606,44540.186759545955,51.232915805587254,50.92350188845035,61.44124300580551,32.283536979746714,16.63719711039448,19.03962848298397,44624.632437603796,44457.241081488115,True,False,45565.738,44765.738,44765.738,44815.738,2024-02-08 13:15:00,True,2024-02-08 13:15:00,2024-02-08 22:17:22,2024-02-08 13:27:51,even,True,18.38,1111.330000000001,1,0,6,2
2024-02-08 10:45:00,44665.738,44711.137,44647.785,44677.34,1695,36422,0,44582.32625971304,44710.69804961264,-0.00014005559616253526,0.0003155166919768413,0.0007930000100152626,0.000992144643405526,44953.01521627729,44992.781775556075,2024-02-08 10:00:00,2024-02-08 10:00:00,-38.044476190443675,385.686732024551,44526.21554761907,-0.00016047409091934158,-0.00015974079688522037,44462.53747619051,44356.02921738665,44684.233714722985,44443.94068341497,44354.62161128087,-0.00102883495959019,0.00032850347289726443,43596.504169793785,44011.67971518491,87.08175849892145,81.59526394911067,362.88059983307545,44560.14575899139,44501.65925867228,44574.279415204684,58.48650031910802,52.43610157458188,66.90043245076508,34.0926556587292,32.283536979746714,16.63719711039448,44666.094999013214,44483.963831396155,True,False,45577.34,44777.34,44777.34,44827.34,2024-02-08 13:15:00,True,2024-02-08 13:15:00,2024-02-08 22:17:23,2024-02-08 13:27:03,even,True,18.38,1129.7100000000012,2,0,6,2
2024-02-08 13:00:00,44784.117,44853.938,44731.84,44847.137,1505,36422,0,44731.84,44904.07875320529,-0.0009774591385867037,-0.0012564586590474431,0.00016393242866074556,0.0006894625321347226,44970.208330912516,44910.227014029384,2024-02-08 13:00:00,2024-02-08 13:00:00,90.93225000001985,384.8319968726137,44689.593976190474,0.000980844984722212,0.0009625118265263089,44665.44404761905,44726.31963662274,45034.74619593169,44465.0068568101,44906.22450416354,0.00045181398309715925,0.00025337024612563717,43721.01727011534,44163.47442231391,89.68305687295056,82.47644912087182,373.56902724524014,44699.83558671777,44612.14791652001,44786.41153629167,87.68767019775987,70.93637873124895,116.63656500465206,32.95732370139012,30.90431854139024,27.165366357068706,44945.37089904795,44628.95217353539,True,False,45747.137,44947.137,44947.137,44997.137,2024-02-08 16:15:00,True,2024-02-08 16:15:00,2024-02-09 04:18:57,2024-02-08 16:30:49,even,True,18.38,1148.0900000000013,3,0,6,2
2024-02-09 05:00:00,46252.738,46329.238,46071.961,46264.738,2888,36422,0,46071.96099999997,46351.027359611486,-0.0011731685515670486,-0.0019498470386963879,0.004988416511258857,0.0049631850827511845,47876.21213346821,48433.52506811224,2024-02-09 05:00:00,2024-02-09 05:00:00,313.1271071428346,401.5143981137953,45810.38167857144,0.000746440587908075,0.0028499556170355793,45635.53155952381,45427.23128515686,46997.51482869901,45392.86195274225,46863.84849991273,0.0028498223916177887,0.0007462965670321311,44492.59385144296,45084.63984614144,92.85630428575429,91.40360002230635,372.724238304768,45703.388149808015,45496.11056300414,45853.400584795316,207.27758680387342,104.88989597474443,301.10044509853867,142.43046405229688,162.53827210178133,109.78303336776298,46261.38618567834,45446.91498391229,True,False,47164.738,45864.738,46364.738,46414.738,,False,2024-02-09 10:30:00,2024-02-09 13:50:19,2024-02-09 06:19:07,fail,False,-73.52,1074.5700000000013,0,1,6,2
2024-02-14 08:00:00,49532.84,49643.637,49498.039,49616.738,890,36422,0,49498.03899999997,49643.636999999966,0.00023087898188851462,-0.00010807072835508283,0.0011050391120778714,0.00044280111123220275,49669.50639096522,50115.91292619868,2024-02-14 08:00:00,2024-02-14 08:00:00,20.653154761916085,42.93990125144046,49503.96505952383,-0.0004747659213533166,-0.00033111057838066126,49463.184000000016,49062.253627737184,49580.5149630788,49123.21608604006,49548.23092441099,-0.0004312451191665423,-0.0003154516188738391,49022.87091118063,49423.168930718704,83.14505636966231,75.9893069371468,41.96182212021987,49495.5602297746,49465.425420287575,49501.56354833165,30.13480948702636,22.81348582772622,71.02598443416515,17.670005159925495,8.591318197453802,7.887009631966066,49598.948627317775,49405.67846934553,True,False,50516.738,49716.738,49716.738,49766.738,2024-02-14 09:30:00,True,2024-02-14 09:30:00,2024-02-14 10:57:58,,success,True,165.38,1239.9500000000012,1,0,7,2
2024-02-14 08:45:00,49559.738,49628.039,49531.84,49616.438,1362,36422,0,49519.23785164634,49647.34122147726,0.0009290995457838242,0.0020206099679616414,-0.00010807072835508283,0.00023087898188851462,49621.73483528732,49585.662568518506,2024-02-14 08:00:00,2024-02-14 08:00:00,20.653154761916085,42.93990125144046,49503.96505952383,-0.0004747659213533166,-0.00033111057838066126,49463.184000000016,49062.253627737184,49580.5149630788,49123.21608604006,49548.23092441099,-0.0004312451191665423,-0.0003154516188738391,49022.87091118063,49423.168930718704,86.9622230047098,86.60296066749731,41.96182212021987,49531.81978053254,49490.37037524734,49543.26450773996,41.449405285202374,30.206856028861992,78.81826523999378,19.253641210838396,8.86739903686248,13.579919160605641,49651.169165813946,49436.85984966597,True,False,50516.438,49716.438,49716.438,49766.438,2024-02-14 09:30:00,True,2024-02-14 09:30:00,2024-02-14 10:57:58,,success,True,165.38,1405.3300000000013,2,0,7,2
2024-02-14 09:00:00,49616.438,49717.238,49616.438,49649.637,1330,36422,0,49542.99428367848,49814.16962131534,0.0013785726592653747,0.0006865844618425199,0.000634155760294471,0.00014713108343479542,49596.10119084079,49964.21628817438,2024-02-14 09:00:00,2024-02-14 09:00:00,40.781059523811564,54.243570852908306,49633.41614285712,0.00021947226969788286,0.000517076034982112,49503.96505952383,49271.373615476,49977.80464459805,49062.253627737184,49580.5149630788,-0.00033111057838066126,-0.0004747659213533166,49054.395110742174,49455.45445626121,87.24436715934074,87.06374706014988,44.41817186675756,49549.945506604454,49502.1679030068,49570.12463536292,47.77760359765671,33.72100554262094,85.79884708309184,26.860127622960135,19.253641210838396,8.86739903686248,49687.45307892509,49454.29619180074,True,False,50549.637,49749.637,49749.637,49799.637,2024-02-14 09:30:00,True,2024-02-14 09:30:00,2024-02-14 10:57:59,2024-02-14 09:38:18,even,True,18.38,1423.7100000000014,3,0,7,2
2024-02-14 09:15:00,49649.637,49848.383,49611.34,49833.328,1033,36422,0,49611.33999999998,49867.29828223264,0.0007604847756410313,0.00023947454445418155,0.0015372771746070268,0.000796901529038636,49921.15252463174,50450.51039613745,2024-02-14 09:00:00,2024-02-14 09:00:00,40.781059523811564,54.243570852908306,49633.41614285712,0.00021947226969788286,0.000517076034982112,49503.96505952383,49271.373615476,49977.80464459805,49062.253627737184,49580.5149630788,-0.00033111057838066126,-0.0004747659213533166,49054.395110742174,49455.45445626121,92.85748060469975,89.02135692291682,44.41817186675756,49593.54281328069,49526.69828056185,49627.065802201556,66.84453271883831,40.345710977864414,108.02282182306205,56.94116683863831,26.860127622960135,19.253641210838396,49774.39661166269,49481.23499274042,True,False,50733.328,49433.328,49933.328,49983.328,,False,2024-02-14 11:00:00,2024-02-14 10:58:03,,success,True,165.38,1589.0900000000015,4,0,7,2
2024-02-14 09:45:00,49791.184,49869.738,49758.008,49826.738,1552,36422,0,49715.69293759935,49913.40780243944,0.0001704560392834781,-0.00020579358854906074,0.0006865844618425199,0.0013785726592653747,50287.172576602425,50185.51176121019,2024-02-14 09:00:00,2024-02-14 09:00:00,40.781059523811564,54.243570852908306,49633.41614285712,0.00021947226969788286,0.000517076034982112,49503.96505952383,49271.373615476,49977.80464459805,49062.253627737184,49580.5149630788,-0.00033111057838066126,-0.0004747659213533166,49054.395110742174,49455.45445626121,91.84812370926734,91.60215091274648,44.41817186675756,49653.917777556,49566.41588114013,49726.12789370481,87.50189641587349,55.626563476764275,128.0455562984585,50.37734709318465,48.68474441007129,56.94116683863831,49900.48939470773,49553.266392701895,True,False,50726.738,49426.738,49926.738,49976.738,,False,2024-02-14 11:00:00,2024-02-14 10:58:03,,success,True,165.38,1754.4700000000016,5,0,7,2
2024-02-14 11:00:00,50767.168,51667.438,50631.773,50988.438,4749,36422,0,50631.77300000003,51667.43800000003,0.004645498013344379,0.00025948389558360204,0.011928066474502293,0.003224215686456903,51231.191231912955,56740.820480122784,2024-02-14 11:00:00,2024-02-14 11:00:00,409.9161904761859,174.27026793792902,50623.321761904794,0.0026586162848184895,0.006089949143877549,50043.3323333333,50367.111677256056,52935.932288526594,50230.90220290367,51611.46617227577,0.003834867001536459,0.002658277802352255,49217.410058782,49720.76080857949,83.13925049942587,81.35349042880074,75.96290442623766,50042.773265262666,49793.043654929614,50236.509775369756,249.72961033305182,124.28106002618054,387.40420563985134,213.84403130369174,199.79709838324197,43.343899552797666,50761.005452983554,49713.51409775596,True,False,51888.438,51088.438,51088.438,51138.438,2024-02-14 11:30:00,True,2024-02-14 11:30:00,2024-02-14 16:31:50,2024-02-14 13:06:21,even,True,18.38,1772.8500000000017,6,0,7,2
2024-02-19 08:15:00,52372.738,52481.738,52332.805,52437.637,1883,36422,0,52244.13177799413,52531.514587416146,0.0003386643634978817,-0.0005231673867453898,0.002055325750123486,0.0025380579281660326,53323.72770362743,53344.730085813986,2024-02-19 08:00:00,2024-02-19 08:00:00,-18.595119047589833,42.82612579804845,52219.21784523808,0.00043645478637342825,0.00010193046883848837,52120.571440476226,52116.12429112893,52524.24639662009,52104.52399639608,51962.72447888735,-0.001099291059636729,0.0004922464833712794,51879.84320129514,52094.83782158405,83.75819149447334,61.70732636387399,39.805155483121155,52191.307894832215,52147.69630046695,52191.95722566222,43.611594365262135,16.12873176833577,102.0581317184737,55.384112831139646,39.2641114551152,3.3233298933701008,52331.23570348216,52054.17874784228,True,False,53337.637,52037.637,52537.637,52587.637,,False,2024-02-20 15:45:00,,2024-02-19 16:07:08,fail,False,-73.52,1699.3300000000017,0,1,8,2
2024-02-21 00:00:00,52023.84,52163.039,51999.84,52153.695,968,56422,0,51999.84000000004,52162.52311278416,0.001048424848073853,0.0009655580682702776,-4.0371811260965615e-05,0.0003429675367360357,52140.708604211286,52145.96773531891,2024-02-21 00:00:00,2024-02-21 00:00:00,209.11091666668653,-20.76870554618654,52062.32708333331,0.004623658095053576,0.0005841608154378605,51890.895202380954,52892.80748913359,52431.564948787614,51682.931770178,51772.020233009,-0.001975099843329357,0.002268227312546791,51931.542920691885,51940.2758094464,87.45754279529096,86.9860386531439,-30.705192630986623,51993.00931409962,51893.42117825221,52236.730629859005,99.5881358474071,46.071449188689954,361.7014471065101,15.35964705888182,-1.2497856897753081,45.75409838324413,52726.52758345279,51748.43367626522,True,False,53053.695,52253.695,52253.695,52303.695,2024-02-21 01:15:00,True,2024-02-21 01:15:00,,2024-02-21 01:31:42,even,True,18.38,1717.7100000000019,1,0,8,2
2024-02-21 00:15:00,52155.738,52200.738,52098.988,52157.637,862,56422,0,52095.25862791455,52200.231041261046,0.0004104012082498407,0.0017292599610582474,0.00026818244184729817,-0.00011714964065608378,51945.88950268572,52310.40828854822,2024-02-21 00:00:00,2024-02-21 00:00:00,209.11091666668653,-20.76870554618654,52062.32708333331,0.004623658095053576,0.0005841608154378605,51890.895202380954,52892.80748913359,52431.564948787614,51682.931770178,51772.020233009,-0.001975099843329357,0.002268227312546791,51931.542920691885,51940.2758094464,88.54806360324615,87.78396471757848,-30.705192630986623,52018.33665039199,51912.9927206039,52252.0007901617,105.34392978809046,57.925945308570064,372.3625550709371,15.270160302694421,15.35964705888182,-1.2497856897753081,52756.190239507465,51749.31134081593,True,False,53057.637,52257.637,52257.637,52307.637,2024-02-21 01:15:00,True,2024-02-21 01:15:00,,2024-02-21 01:31:42,even,True,18.38,1736.090000000002,2,0,8,2
2024-02-21 00:30:00,52158.039,52260.738,52116.125,52260.738,500,56422,0,52083.34174714555,52326.86278785507,0.0007299907634463876,0.0013774240508616065,0.00096055600986752,0.000959665762322498,52494.275531257204,52659.103762342376,2024-02-21 00:00:00,2024-02-21 00:00:00,209.11091666668653,-20.76870554618654,52062.32708333331,0.004623658095053576,0.0005841608154378605,51890.895202380954,52892.80748913359,52431.564948787614,51682.931770178,51772.020233009,-0.001975099843329357,0.002268227312546791,51931.542920691885,51940.2758094464,94.08449717339592,90.03003452397773,-30.705192630986623,52055.6291657163,51938.751630188795,52270.587148950806,116.87753552750655,69.71626335235737,387.0878567813655,18.58635878910718,15.270160302694421,15.35964705888182,52794.65575560565,51748.01854229596,True,False,53160.738,51860.738,52360.738,52410.738,,False,,,2024-02-21 06:35:00,fail,False,-73.52,1662.570000000002,0,1,8,2
2024-02-21 20:45:00,50944.531,50986.238,50831.84,50850.105,972,36422,0,50553.210482646806,50986.237999999976,0.0018108954067107756,0.0005879811488036133,-0.001276053651476209,-0.0009951020910174903,50318.21053525332,50479.25183404095,2024-02-21 20:00:00,2024-02-21 20:00:00,-85.86780952385016,-234.02153381092648,51031.71423809521,0.0008074152289318501,-6.556551128267328e-05,51111.71279761901,50970.727864223125,51419.41180788474,51138.260104780595,51422.76739388193,-6.553978433689704e-05,0.0012699540559305668,51658.47026291101,51453.84755445001,10.52754453727915,18.38504174390762,-184.09420231321488,51030.09581824077,51122.14793388745,51013.85276608192,-92.05211564667843,-70.42833545192411,156.90064959963553,-62.07724148604757,-28.926820433378452,-48.33857103547052,51225.668643041434,50800.53688912241,False,True,49950.105,51250.105,50750.105,50700.105,,False,,,2024-02-21 23:27:40,fail,False,-73.52,1589.050000000002,0,2,8,2
2024-02-22 01:00:00,51496.984,51674.438,51484.063,51621.84,1620,56422,0,51484.56595597379,51673.94217080593,0.000882718562081625,0.0018923820756033966,0.0018441118747130187,0.001304422623345453,51928.80941829273,52428.1951131092,2024-02-22 01:00:00,2024-02-22 01:00:00,125.27803571425466,-175.4351023045965,51461.238166666684,0.0018054505426062697,0.0014595365633577233,51220.08546428572,51367.63891011645,52261.1552671324,50619.82515062075,51573.81107078487,0.0002648645224814939,-7.218978986049061e-05,51604.33139534214,51428.22682167476,94.5449778693145,92.22087401388461,-207.7483178686894,51319.668259899976,51223.566183306044,51459.99470966629,96.102076593932,34.63592519570238,213.40939650576178,74.8876859304437,52.79440522880759,59.64741417262849,51749.597394949065,51171.89202438351,True,False,52521.84,51721.84,51721.84,51771.84,2024-02-22 02:00:00,True,2024-02-22 02:00:00,,2024-02-22 02:19:01,even,True,18.38,1607.430000000002,1,0,8,2
2024-02-22 08:30:00,51634.738,51769.738,51634.738,51754.418,1117,36422,0,51635.25081584651,51792.59448197233,0.0003222358576099979,0.000649039214341716,0.0004348718124276886,0.0007279308689512169,51883.928876471124,51946.364825255616,2024-02-22 08:00:00,2024-02-22 08:00:00,-9.258690476141055,-30.459852905376465,51562.11302380952,0.0010232846348531578,-0.00039055348881684196,51478.67557142859,51623.34960395206,51748.273243419135,51349.10949992598,51530.56253098823,-0.0008581640344000377,0.00047523767116744084,51584.14852116126,51473.32402597491,82.76165035408808,72.58549103151815,-90.38790531522565,51594.871722571625,51536.67864452667,51634.93444341245,58.193078044954746,48.87029303574489,104.88232487344975,25.806185758490756,-1.678853801175137,9.40014757480094,51778.025581991606,51493.343304833295,True,False,52654.418,51854.418,51854.418,51904.418,2024-02-22 12:00:00,True,2024-02-22 12:00:00,,2024-02-22 12:21:21,even,True,18.38,1625.8100000000022,2,0,8,2
2024-02-22 08:45:00,51753.215,51826.738,51730.289,51780.84,1569,36422,0,51625.327058679395,51826.73800000004,0.0008366797659956477,0.0006656071458664941,0.0015458220044799913,0.0014636354140790356,52299.55423793811,52483.30118964881,2024-02-22 08:00:00,2024-02-22 08:00:00,-9.258690476141055,-30.459852905376465,51562.11302380952,0.0010232846348531578,-0.00039055348881684196,51478.67557142859,51623.34960395206,51748.273243419135,51349.10949992598,51530.56253098823,-0.0008581640344000377,0.00047523767116744084,51584.14852116126,51473.32402597491,88.69162787764265,80.03632282975938,-90.38790531522565,51623.48222679138,51554.76467085803,51667.79052872377,68.7175559333482,52.83974561526556,116.13371385095805,32.85608531132311,25.806185758490756,-1.678853801175137,51826.07104242257,51511.01001502498,True,False,52680.84,51880.84,51880.84,51930.84,2024-02-22 12:00:00,True,2024-02-22 12:00:00,,2024-02-22 12:12:24,even,True,18.38,1644.1900000000023,3,0,8,2
2024-02-22 09:30:00,51859.84,51930.84,51793.484,51891.637,1527,36422,0,51793.48399999999,51952.283233687675,-0.0005670641954764804,3.036123086742979e-05,0.0006656071458664941,0.0008366797659956477,52096.33296957773,52202.6434901859,2024-02-22 09:00:00,2024-02-22 09:00:00,83.43745238093106,0.05841135123046115,51700.29902380952,0.001307677121919123,0.00010186388254385375,51562.11302380952,51821.333664595266,51950.76600436022,51623.34960395206,51748.273243419135,-0.00039055348881684196,0.0010232846348531578,51594.27367719415,51502.84530389692,89.80047445815842,89.43015542911758,-72.29864198193442,51708.89477827006,51612.72608231249,51767.93322703826,96.16869595757453,69.3141006981418,153.0819829129309,40.35878431382298,36.57430615755584,23.209607843105914,51976.093903970715,51561.2725501058,True,False,52791.637,51491.637,51991.637,52041.637,,False,,,2024-02-22 14:40:15,fail,False,-73.52,1570.6700000000023,0,1,8,2
2024-02-22 22:45:00,51914.637,52051.738,51748.438,52006.539,2200,36422,0,51748.43799999999,52169.80529301386,-0.0013040996919977098,-0.0028902731625291824,0.002994577621889676,0.0017379911122781182,52459.670329225024,53511.84168564341,2024-02-22 22:00:00,2024-02-22 22:00:00,12.772500000013679,19.710917826741934,51791.07146428568,0.0014756795702751094,0.0014981501702390984,51626.69610714286,51772.060496992235,52412.57229456925,51806.0061131567,51794.944306215206,8.400997827259088e-05,0.001693038048712043,51614.34151375413,51597.98556956387,83.07132977011638,73.74443067233562,17.813590338043554,51736.23365003778,51651.37668768647,51799.824559683504,84.85696235131036,43.762297592609585,163.5949388225528,54.55060853109899,63.52024561399594,64.0199549364188,52022.17772709395,51578.97139227306,True,False,52906.539,51606.539,52106.539,52156.539,,False,,,2024-02-22 23:33:45,fail,False,-73.52,1497.1500000000024,0,2,8,2
2024-02-26 00:30:00,51832.238,51876.84,51832.238,51874.137,639,56422,0,51702.0254963184,51923.30251312718,-0.0003517985058912081,-0.0008991434193488964,0.003273054086743254,0.005425553346794668,54089.6567267615,53479.41770092698,2024-02-26 00:00:00,2024-02-26 00:00:00,-24.103833333356306,-90.08715639671573,51301.212988095234,0.0013837608995469898,0.0020509373990895497,51076.619119047595,51329.78962811848,52289.906418738734,51257.93640168789,51035.594436299754,-0.0005737537550915791,0.0013838874515331296,51328.644616358135,51217.350633714974,96.44736561340767,72.84317928755887,-100.95788567951594,51356.75856389693,51217.13019254947,51415.25726762985,139.62837134746223,50.942916117365286,252.42512208646113,121.00476367389638,134.88482318542083,129.15346233228047,51757.531182446575,51074.48335281313,True,False,52774.137,51474.137,51974.137,52024.137,,False,2024-02-26 17:30:00,2024-02-26 17:32:41,2024-02-26 04:10:24,fail,False,-73.52,1423.6300000000024,0,3,9,2
2024-02-26 11:30:00,51064.004,51102.438,50956.844,50969.074,2410,36422,0,50887.41912431269,51102.43799999999,0.0006237225905626867,0.0009691928747282532,-0.0008362205357578209,-0.0019985751607465123,50165.23706726735,50945.99700736242,2024-02-26 11:00:00,2024-02-26 11:00:00,-60.224654761907004,45.26998146349797,51237.893095238076,-0.001448833284584155,-0.0004406696875514896,51403.671821428565,50637.180309230986,51471.224360081935,51152.06608975224,51521.91691066396,-0.000347567027222487,-0.0005673827774124967,51371.662837243864,51341.92687611563,9.918910930959248,10.437975060663796,46.59679478044344,51276.35979789421,51374.48024140605,51176.176671138615,-98.12044351183431,-50.6812172789093,160.53767345665665,-73.40372893023596,-61.922221878150594,-18.673592707280477,51392.9025303051,50957.95081197213,False,True,50069.074,51369.074,50869.074,50819.074,,False,,,2024-02-26 15:11:35,fail,False,-73.52,1350.1100000000024,0,4,9,2
2024-02-26 11:45:00,50968.398,51051.039,50919.539,50966.137,1534,36422,0,50844.4803262736,51086.68738323651,0.0020916012584387177,0.0016127936232161306,-0.0025097990120449974,-0.002056174823747606,50039.694957822125,50071.992789236974,2024-02-26 11:00:00,2024-02-26 11:00:00,-60.224654761907004,45.26998146349797,51237.893095238076,-0.001448833284584155,-0.0004406696875514896,51403.671821428565,50637.180309230986,51471.224360081935,51152.06608975224,51521.91691066396,-0.000347567027222487,-0.0005673827774124967,51371.662837243864,51341.92687611563,3.3477495906316483,7.654782209254577,46.59679478044344,51228.63321360279,51344.23259389449,51104.38163742693,-115.59938029170007,-63.66484988146746,184.27108349097387,-71.79503371168539,-73.40372893023596,-61.922221878150594,51353.147600139746,50854.115674714114,False,True,50066.137,51366.137,50866.137,50816.137,,False,,,2024-02-26 15:11:13,fail,False,-73.52,1276.5900000000024,0,5,9,2
2024-02-26 17:00:00,51703.039,52044.637,51649.859,51960.738,2092,36422,0,51649.859000000026,52159.4179297969,0.005648444182634541,0.005861093230702936,0.004135872933139169,0.002610950574786194,52719.704408342484,53764.270216539066,2024-02-26 17:00:00,2024-02-26 17:00:00,199.4844285713989,9.558738445630297,51897.48338095232,0.002436441518523995,0.003990220215179025,51356.9534642857,51828.51773296678,53689.615098369206,51067.228161710336,51835.58226720021,0.0005117917242426635,0.00032637082888758886,51418.943918731355,51455.97319249864,94.06795410184698,89.36281509283138,4.1859543393022705,51469.62003298997,51374.08680164903,51575.42399931199,95.53323134094535,17.000731977283614,221.9097687121719,121.39721362231649,82.10533195731114,51.855483316147,51876.50218707343,51275.84581155056,True,False,52860.738,52060.738,52060.738,52110.738,2024-02-26 17:30:00,True,2024-02-26 17:30:00,2024-02-26 17:59:58,,success,True,165.38,1441.9700000000025,1,0,9,2
2024-02-26 17:15:00,51960.738,52466.539,51960.738,52389.738,3284,36422,0,51961.2259538024,52466.01732924965,0.005092237752945344,0.007545683724486911,0.005698260626509771,0.003079654392241855,53078.27945152083,54872.3256467483,2024-02-26 17:00:00,2024-02-26 17:00:00,199.4844285713989,9.558738445630297,51897.48338095232,0.002436441518523995,0.003990220215179025,51356.9534642857,51828.51773296678,53689.615098369206,51067.228161710336,51835.58226720021,0.0005117917242426635,0.00032637082888758886,51418.943918731355,51455.97319249864,94.28238684927935,93.20381195483436,4.1859543393022705,51611.17664329921,51449.3202237491,51764.03591262471,161.85641955010942,45.97186949184878,315.97253250864475,188.6119133127213,121.39721362231649,82.10533195731114,52192.09883151139,51337.47299373804,True,False,53289.738,52489.738,52489.738,52539.738,2024-02-26 17:45:00,True,2024-02-26 17:45:00,2024-02-26 18:08:17,,success,True,165.38,1607.3500000000026,2,0,9,2
2024-02-26 17:45:00,52564.84,52865.738,52532.039,52854.039,2829,36422,0,52532.039000000026,53649.54106499072,0.0037454134446436725,0.0003298074229187741,0.005861093230702936,0.005648444182634541,54920.210507777105,55592.43554063605,2024-02-26 17:00:00,2024-02-26 17:00:00,199.4844285713989,9.558738445630297,51897.48338095232,0.002436441518523995,0.003990220215179025,51356.9534642857,51828.51773296678,53689.615098369206,51067.228161710336,51835.58226720021,0.0005117917242426635,0.00032637082888758886,51418.943918731355,51455.97319249864,94.19394690443993,93.43061568051895,4.1859543393022705,51926.53176236216,51629.88373915389,52202.04377502585,296.64802320826857,124.90244343730708,488.6879425880659,236.53872652221617,201.4691358789205,188.6119133127213,52863.27249751974,51542.31505253196,True,False,53754.039,52954.039,52954.039,53004.039,2024-02-26 18:15:00,True,2024-02-26 18:15:00,2024-02-26 21:13:01,,success,True,165.38,1772.7300000000027,3,0,9,2
2024-02-26 18:00:00,52854.039,53667.238,52761.117,53543.738,4749,36422,0,52761.11699999998,53667.23799999998,0.003104906461546591,-0.001207196954854208,0.007545683724486911,0.005092237752945344,54919.49493885571,56959.607558657575,2024-02-26 18:00:00,2024-02-26 18:00:00,540.5299166666155,129.33323192520038,52529.174809523814,0.0024367661876073536,0.006369522650239167,51897.48338095232,51957.74261791212,55013.78111278656,51828.51773296678,53689.615098369206,0.003990220215179025,0.002436441518523995,51497.44564740855,51613.15437709875,94.24752527599496,93.41899515609083,29.215409856481894,52175.332721998755,51771.65072143879,52534.98623942203,403.6820005599657,180.6583548618388,634.0143119532341,332.9424643961829,236.53872652221617,201.4691358789205,53392.4055605589,51679.06691828516,True,False,54443.738,53143.738,53643.738,53693.738,,False,2024-02-26 21:15:00,2024-02-26 21:22:38,2024-02-26 18:23:40,fail,False,-73.53,1699.2000000000028,0,1,9,2
2024-02-27 10:30:00,56384.039,56470.539,56280.836,56431.84,1308,36422,0,56249.608098774166,56496.41766369173,-0.0004048075221148603,5.876901368433889e-05,0.001477669617954868,0.001998535463922811,57181.396362151405,57202.81651086946,2024-02-27 10:00:00,2024-02-27 10:00:00,-31.910107142932247,1156.2269998471165,56189.355988095274,0.00393587401471098,-0.0031960377708569456,56238.59483333326,56927.61877406751,55791.88516433071,56703.14223544155,56021.309732994756,-0.0030951372298374464,0.0039359434025424255,53320.33265873658,54486.09870987051,87.80408807391616,72.849684922201,1034.6895718385774,56226.33395140146,55998.49596286219,56329.0471998624,227.83798853927146,264.75405085130745,250.10775228858168,38.48441898862802,25.483373925017077,86.31731647748529,56668.192665451985,55991.40173427281,True,False,57331.84,56531.84,56531.84,56581.84,2024-02-27 11:45:00,True,2024-02-27 11:45:00,2024-02-27 14:43:44,2024-02-27 12:02:49,even,True,18.38,1717.5800000000029,1,0,9,2
2024-02-27 11:30:00,56471.934,56781.738,56471.934,56701.438,2675,36422,0,56471.93400000005,56781.17561626012,0.000178671564383482,0.0004491559735882944,0.0016563642950362307,0.0008925210105388384,56702.44162269935,57533.54513139003,2024-02-27 11:00:00,2024-02-27 11:00:00,-49.23884523798915,1144.0205039346474,56341.00305952379,0.0010914771247056358,-0.0020281133416867217,56189.355988095274,56195.23082021545,56328.561485575876,56927.61877406751,55791.88516433071,-0.0031960377708569456,0.00393587401471098,53450.603456433186,54658.58985308087,85.01759318281186,79.620618753607,1056.5557582577915,56343.14411100693,56117.92455117509,56431.45428723773,225.2195598318358,234.62454773270423,248.62467096758616,62.825323357428715,20.002771585830487,6.124114207079401,56768.59759304397,56095.81098143149,True,False,57601.438,56801.438,56801.438,56851.438,2024-02-27 14:30:00,True,2024-02-27 14:30:00,2024-02-27 21:54:12,2024-02-27 14:58:59,even,True,18.38,1735.960000000003,2,0,9,2
2024-03-01 22:30:00,62533.348,62662.34,62446.57,62616.938,1485,36422,0,62366.72709964658,63220.4151116764,-0.00032746204561770264,-0.0007132377752319544,0.0015002457201228874,0.0018119584745122045,63363.19686689617,63422.65611612594,2024-03-01 22:00:00,2024-03-01 22:00:00,83.33190476191521,138.58728183739004,62335.487130952424,0.0018395980611068206,0.0010054698248015295,61998.855226190484,62207.67895053715,63432.83557907672,61444.214053121425,62342.19985403085,-0.0006203154846089478,0.0005325720586807181,61303.93454103835,61926.7902611886,92.33246379874755,86.60396947938928,111.53265516220964,62289.23285877913,62148.32020289737,62541.4849501204,140.91265588175884,80.6860460077084,364.96898494268106,61.31831682151096,49.0359838321383,53.36823426208866,63035.69307979302,62048.77682044778,True,False,63516.938,62716.938,62716.938,62766.938,2024-03-01 23:00:00,True,2024-03-01 23:00:00,2024-03-04 02:21:19,2024-03-01 23:00:18,even,True,18.38,1754.340000000003,3,0,9,3
2024-03-01 22:45:00,62618.238,63175.34,62453.84,62917.438,2796,36422,0,62237.50966234442,63175.339999999946,0.0014191222972504396,-0.0017574559401617683,0.0040301273512071654,0.0010744890336401804,62995.856936455464,65259.48163866434,2024-03-01 22:00:00,2024-03-01 22:00:00,83.33190476191521,138.58728183739004,62335.487130952424,0.0018395980611068206,0.0010054698248015295,61998.855226190484,62207.67895053715,63432.83557907672,61444.214053121425,62342.19985403085,-0.0006203154846089478,0.0005325720586807181,61303.93454103835,61926.7902611886,92.2225953741264,90.21430198756791,111.53265516220964,62385.87980358234,62205.291891571644,62648.85730546953,180.58791201069835,100.6664192083064,408.4211836906751,107.37235534912907,61.31831682151096,49.0359838321383,63201.725903451945,62097.488707487115,True,False,63817.438,62517.438,63017.438,63067.438,,False,2024-03-04 00:30:00,2024-03-04 02:29:23,2024-03-01 23:03:04,fail,False,-73.53,1680.8100000000031,0,1,9,3
2024-03-04 09:15:00,63629.637,63807.039,63629.637,63793.738,901,36422,0,63568.39409101769,63806.48021669119,0.0025774894229008017,0.006022278755516631,0.0005597773189484441,0.00037270457344998613,63740.73032285729,64096.80486413895,2024-03-04 09:00:00,2024-03-04 09:00:00,20.93572619050974,505.8633985003835,63769.23471428575,0.0027806649604432037,-0.00010996000030940399,63632.42590476194,64247.529046583404,64331.52628449925,64081.63334272401,63283.95410362619,-0.0017525943702252033,0.002800809937797976,62078.889248738735,62885.885560361254,82.47852249052124,73.9373454985715,425.833933200869,63613.48480719521,63517.66959269604,63593.17848400418,95.81521449916909,106.79761709318447,148.81281856142087,50.79901754394086,31.229656002717093,24.112269349840062,63795.575789062095,63392.281178946265,True,False,64693.738,63893.738,63893.738,63943.738,2024-03-04 09:45:00,True,2024-03-04 09:45:00,2024-03-04 10:07:52,2024-03-05 19:09:40,success,True,165.38,1846.1900000000032,1,0,10,3
2024-03-04 09:30:00,63793.738,64181.738,63731.84,64177.539,1927,36422,0,63602.43147998221,64192.25101905694,0.0035985832040025534,0.006019544740299645,0.002315923068180214,0.0016137815648506904,64566.47395460827,65391.82045858191,2024-03-04 09:00:00,2024-03-04 09:00:00,20.93572619050974,505.8633985003835,63769.23471428575,0.0027806649604432037,-0.00010996000030940399,63632.42590476194,64247.529046583404,64331.52628449925,64081.63334272401,63283.95410362619,-0.0017525943702252033,0.002800809937797976,62078.889248738735,62885.885560361254,87.46154174105327,80.03369458876439,425.833933200869,63700.26237531902,63566.548808051884,63705.52860749908,133.71356726713566,112.18080712797472,178.87977611658735,112.35012349489989,50.79901754394086,31.229656002717093,63948.516305256475,63464.040909741685,True,False,65077.539,64277.539,64277.539,64327.539,2024-03-04 10:15:00,True,2024-03-04 10:15:00,2024-03-04 10:26:49,2024-03-05 19:07:51,success,True,165.38,2011.5700000000033,2,0,10,3
2024-03-04 10:00:00,64102.34,64969.738,64061.84,64855.84,4232,36422,0,64061.84000000004,65043.80119044437,0.005791228414376067,0.004752103715489413,0.006022278755516631,0.0025774894229008017,65407.89901362245,68210.03557274042,2024-03-04 10:00:00,2024-03-04 10:00:00,136.8088095238054,538.2443847635877,64305.24580952386,0.0026502345635542237,0.0038644788465138444,63769.23471428575,64384.76854891037,66711.66334946311,64247.529046583404,64331.52628449925,-0.00010996000030940399,0.0027806649604432037,62205.722493886235,63080.06567553236,90.04107118805616,89.45644036060763,448.3160235134128,63930.38501428167,63698.80022638193,64033.616446508466,231.58478789973742,143.0540224508595,313.9500553660352,224.02225937399635,104.06557963538944,112.35012349489989,64458.949021252614,63609.78387176432,True,False,65755.84,64955.84,64955.84,65005.84,2024-03-04 10:45:00,True,2024-03-04 10:45:00,2024-03-04 16:35:24,2024-03-04 11:05:54,even,True,18.38,2029.9500000000035,3,0,10,3
2024-03-04 10:30:00,64947.309,65664.938,64827.461,65586.734,5222,36421,0,64827.46099999995,65751.43668945569,-0.0011195129174325124,-0.0024379075524669836,0.00549944382263693,0.0059355288130442056,68012.07805997485,68677.64467836726,2024-03-04 10:00:00,2024-03-04 10:00:00,136.8088095238054,538.2443847635877,64305.24580952386,0.0026502345635542237,0.0038644788465138444,63769.23471428575,64384.76854891037,66711.66334946311,64247.529046583404,64331.52628449925,-0.00010996000030940399,0.0027806649604432037,62205.722493886235,63080.06567553236,93.79279471519733,90.35646509319379,448.3160235134128,64318.17840667504,63924.589543880254,64563.31904643963,393.5888627947861,217.6185785708262,534.5255711802425,316.27039559684636,213.43220433431998,224.02225937399635,65286.42856753296,63841.709525346305,True,False,66486.734,65186.734,65686.734,65736.734,,False,2024-03-04 16:45:00,2024-03-04 17:44:23,2024-03-04 10:49:07,fail,False,-73.53,1956.4200000000035,0,1,10,3
2024-03-04 16:45:00,66177.336,66461.734,65831.836,66205.133,5355,36421,0,65768.71659568002,66461.73399999998,0.0014816341969683682,0.0005991904096575966,0.007759824152651346,0.006169976178415396,69121.43006878618,71212.16269455703,2024-03-04 16:00:00,2024-03-04 16:00:00,-30.37133333318343,826.432646481022,65622.20673809528,0.0022790854178384398,0.0020085438391795954,65359.245321428636,65150.33519657152,67011.2293996398,66164.80815468931,66039.02142100669,0.0006247124211865972,0.004036527253336508,62888.25237688204,64001.44152438365,82.48763895460719,71.26690794232026,704.3748335927223,65514.201030502125,65175.5933065633,65677.02444960442,338.6077239388251,290.77736642646613,314.3682483505821,173.16729790160025,179.4683883729158,54.1448661850809,66102.92158487771,65252.627314331134,True,False,67105.133,66305.133,66305.133,66355.133,2024-03-04 17:45:00,True,2024-03-04 17:45:00,2024-03-04 19:25:44,2024-03-04 17:46:03,even,True,18.38,1974.8000000000036,1,0,10,3
2024-03-04 17:00:00,66205.133,66391.438,65866.234,66351.734,4437,36421,0,65866.23399999994,66448.63091824642,0.0014816553304044505,0.0009972885955955861,0.0027245416336453684,0.004245031828974191,68169.07925542936,68206.65582947792,2024-03-04 17:00:00,2024-03-04 17:00:00,262.96141666664334,897.9622709014584,65885.55390476191,0.001258671315296835,0.002121066574990802,65622.20673809528,64963.34640716974,67230.30917924932,65150.33519657152,67011.2293996398,0.0020085438391795954,0.0022790854178384398,63029.42047974941,64200.36932243296,90.34130182400948,82.27580477424982,743.0923210544696,65643.05225657873,65262.71483941046,65849.55108737528,380.33741716826626,308.68937657482616,380.3697568523502,172.52663777086127,173.16729790160025,179.4683883729158,66364.55025912596,65336.05191562461,True,False,67251.734,66451.734,66451.734,66501.734,2024-03-04 18:15:00,True,2024-03-04 18:15:00,2024-03-04 19:26:09,2024-03-04 18:27:08,even,True,18.38,1993.1800000000037,2,0,10,3
2024-03-05 18:00:00,66826.336,67066.898,64581.84,65444.941,7833,36421,0,64581.83999999999,67066.89800000006,0.0019291835241388154,-0.007342114780468419,-0.007139889995990773,-0.013159012768842071,58070.92847558392,63292.16132789194,2024-03-05 18:00:00,2024-03-05 18:00:00,-246.51736904760764,472.3050671862293,67066.12035714286,-0.0033884491287748566,0.005784764548930021,67650.9545238095,63696.07816723519,71404.86958060616,66995.47473726737,70756.72438324087,0.004934615860210079,0.0019190689071320159,65717.92262159412,66844.47900889932,15.379182206574912,22.320569669607448,591.5642480426901,67204.76471637476,67274.36435232034,67378.59077949775,-69.59963594557485,137.40572297262094,702.6828572373357,-470.55961197119905,-183.81908943918825,-176.41303130380402,68327.21263676816,66428.46892222734,False,True,64544.941,65844.94099999999,65344.941,65294.941,,False,2024-03-05 18:45:00,2024-03-05 19:07:48,2024-03-05 18:24:58,fail,False,-73.52,1919.6600000000037,0,1,10,3
2024-03-05 19:00:00,65603.734,65606.734,63481.938,64278.738,6904,36421,0,63451.84841171316,65606.73399999998,0.006516633963925433,0.00039513202731759987,-0.003580557595804263,-0.0071790951245800485,59913.54518892956,63733.25602834646,2024-03-05 19:00:00,2024-03-05 19:00:00,-584.8341666666383,299.05707719697966,66509.30538095241,-0.0066253674316923954,0.004561729807324649,67066.12035714286,61797.70944974564,71277.37178721577,63696.07816723519,71404.86958060616,0.005784764548930021,-0.0033884491287748566,65714.78655800219,66747.95692818737,16.007763913104586,18.79047393344558,533.0628138735481,66202.85669109775,66724.82243707792,65688.60992466466,-521.9657459801674,-162.68331095182998,1073.000780739809,-552.7748052975076,-343.39990264875814,-439.75122325416305,67137.1609786634,64238.55887066592,False,True,63378.738,64678.738,64178.738,64128.738,,False,2024-03-05 21:00:00,2024-03-05 21:11:10,2024-03-05 19:20:35,fail,False,-73.52,1846.1400000000037,0,2,10,3
2024-03-06 04:45:00,63444.938,63475.238,62810.84,62833.238,3241,36422,0,62740.625425168546,63475.23799999998,0.0007160369230428225,-0.00038410646938851677,-0.0005091358990588401,-0.0010612671362433112,62277.2748010079,63215.34382563944,2024-03-06 04:00:00,2024-03-06 04:00:00,244.19124999994528,-912.5220793936824,63396.909749999984,0.008712420922477792,0.0002657779501694581,63332.72703571425,65065.8557227297,64495.93902326585,65983.18353999332,62948.16624851838,-0.003788189669145854,0.010967577200736735,64910.71882439901,64807.20808156149,15.269783817433016,24.227106271522135,-587.8672343268379,63333.85018621745,63564.880919888106,63276.953177846626,-231.03073367065372,-239.3829250109663,455.7126014159981,-156.53250257992477,-36.45517199860478,-76.23686446512875,63892.16518975823,62660.241165935025,False,True,61933.238,63233.238,62733.238,62683.238,,False,,,2024-03-06 05:22:35,fail,False,-73.52,1772.6200000000038,0,3,10,3
2024-03-06 05:00:00,62834.84,63099.738,62814.938,62830.34,2047,36422,0,62698.64644338151,63218.10290881164,0.002101385501500424,0.001453212004551938,-0.001401288342211886,-0.0027065632198250366,61291.35628663224,62675.13222624109,2024-03-06 05:00:00,2024-03-06 05:00:00,64.18271428573644,-948.3863143721974,63322.75507142854,0.003658198051346919,-0.0009485475896240035,63396.909749999984,63752.628652295265,63885.50886389856,65065.8557227297,64495.93902326585,0.0002657779501694581,0.008712420922477792,64847.7666352069,64687.06647503657,11.479472607295465,18.91136844428939,-659.9710503359098,63256.38708064554,63510.47048137787,63107.01505228754,-254.08340073233558,-242.32302015524016,359.4327782567773,-169.93812555908517,-156.53250257992477,-36.45517199860478,63592.24930293419,62620.28080164089,False,True,61930.34,63230.34,62730.34,62680.34,,False,,,2024-03-06 05:22:34,fail,False,-73.52,1699.1000000000038,0,4,10,3
2024-03-08 16:45:00,68399.234,68713.734,68301.438,68487.734,4247,36421,0,68302.10111082703,69261.22619881121,-0.005395726861873511,0.004917805801950954,0.002999179312988104,0.0036714179112573788,70269.62871586588,70410.75877176813,2024-03-08 16:00:00,2024-03-08 16:00:00,87.95326190479682,210.76148792752065,67963.2696428571,0.0009173150928020563,0.0021243109061709732,67609.03769047624,67650.94667110272,69319.79030446232,67609.7271390978,68091.00014836834,0.0005698601038356332,0.0009905649386635635,66915.58172318303,67338.11807513915,86.48513746816643,80.58588919625835,186.7358026558919,67884.94174876911,67652.65950717016,68037.24883866525,232.28224159895035,145.4419769057339,331.9755245268658,130.16168455446314,126.69476848990598,52.03862951499468,68486.91579677652,67589.08188055399,True,False,69387.734,68587.734,68587.734,68637.734,2024-03-08 17:15:00,True,2024-03-08 17:15:00,2024-03-08 17:28:00,2024-03-08 17:32:05,success,True,165.38,1864.4800000000037,1,0,10,3
2024-03-08 17:00:00,68478.531,68901.641,68394.5,68856.438,4019,36421,0,68326.17017348901,69850.27293607875,-0.008269754879280448,0.003142333676783982,0.003603487436901587,0.0033801688025727437,70300.8216217931,71024.17879281972,2024-03-08 17:00:00,2024-03-08 17:00:00,354.2319523808692,280.3690708904178,67944.84183333332,0.0002931939066792741,0.005900827367143029,67963.2696428571,67286.52478597991,72037.61599216246,67650.94667110272,69319.79030446232,0.0021243109061709732,0.0009173150928020563,66944.91585168566,67364.15678912803,91.42446783787256,85.75773828785539,205.46245630279708,68034.40271049694,67741.82828441681,68229.19970794632,292.57442608012934,174.868466740613,412.8157427182954,191.9508692810632,130.16168455446314,126.69476848990598,68788.00096061602,67671.89845527662,True,False,69756.438,68456.438,68956.438,69006.438,,False,2024-03-08 17:30:00,2024-03-08 17:28:15,2024-03-08 17:32:05,success,True,165.38,2029.8600000000038,2,0,10,3
2024-03-11 09:00:00,69375.039,70817.547,69329.258,70759.813,6056,36421,0,69329.25800000006,70882.18043626157,0.007215748199915041,0.004433531506453252,0.009665246587963363,0.008602401693297004,74362.18361224206,76634.14261123263,2024-03-11 09:00:00,2024-03-11 09:00:00,278.3088571428525,373.2495762960607,69712.24565476194,0.003692671595689862,0.005121773977967373,68803.81589285712,69797.0466891563,73060.14940025429,69538.02651596259,69586.95770070293,0.0007139498874955451,0.0036955796630196757,67822.28096166349,68489.18594748742,91.0749889580017,78.62213049875315,354.4211239649728,69056.72290141773,68798.09144051865,69210.48978500172,258.6314608990797,93.26569650472003,521.7640221397759,372.682804609547,136.12675885800854,30.472158582677366,69916.37121489042,68506.10835511301,True,False,71659.813,70359.813,70859.813,70909.813,,False,2024-03-11 10:00:00,2024-03-11 10:01:32,2024-03-11 09:16:12,fail,False,-73.52,1956.3400000000038,0,1,11,3
2024-03-13 22:00:00,73376.836,73443.336,73073.25,73435.734,2285,36421,0,73073.24999999999,73534.20508670807,-0.0007806502530714576,-0.0012137388777954657,0.0011852121382918681,0.0031230028938881147,74968.53882041934,74206.44470132476,2024-03-13 22:00:00,2024-03-13 22:00:00,242.98505952383857,339.81614267070836,73231.47734523809,0.002560444788810502,0.0006902955697449179,73128.59741666669,73737.15555141275,73665.48990081507,73637.5752035822,73487.64943724163,0.00027956273301768525,0.0026794934937270577,71996.5248972141,72621.42169758416,82.11966360841491,69.1694437296267,321.7745213949159,73077.15847419783,72973.81054338244,73216.57525730995,103.34793081539101,52.59090768815669,259.01562247637276,82.41745476442156,75.74355865150574,-14.770839353339397,73567.74634765305,72866.90416696684,True,False,74335.734,73035.734,73535.734,73585.734,,False,2024-03-14 06:15:00,,2024-03-13 22:33:25,fail,False,-73.52,1882.8200000000038,0,2,11,3
2024-03-15 20:45:00,69276.758,70506.641,69212.109,70253.102,6345,36421,0,69212.10899999994,70890.93116759812,0.0009788134777002078,-0.0029201779301970517,0.00971608226927751,0.0028203166117987434,70158.18438833578,76326.77347121492,2024-03-15 20:00:00,2024-03-15 20:00:00,53.40101190477435,-842.6717891930166,68926.07551190478,0.0021287670602829637,0.005246251017461863,68305.47821428571,68383.75181596537,72063.62949107739,68238.53737482378,69027.93762244178,0.000618259628268708,0.0021318325230275607,70132.48324605414,69146.6853651299,85.70413130224881,76.50302413286592,-975.0815835496634,68670.04395424003,68375.61739540487,68746.21644478843,294.42655883515545,121.60689520048189,519.0804553567111,347.92686068105104,178.08919263852295,53.31284932914423,69448.47505951999,68045.45783005687,True,False,71153.102,69853.102,70353.102,70403.102,,False,,,2024-03-15 21:22:27,fail,False,-73.52,1809.3000000000038,0,3,11,3
2024-03-15 21:00:00,70257.734,70684.219,70104.836,70301.336,5445,36421,0,70105.49779519427,70786.04882302784,-0.007436307513659848,-0.0048728565305434235,0.0129556233304126,0.010459916717583704,76036.23908494679,79396.78350453694,2024-03-15 21:00:00,2024-03-15 21:00:00,620.5972976190678,-626.4585540675762,69022.76651190475,0.0013613240574992052,0.0052466201223402694,68926.07551190478,68208.26354484083,72443.78096400664,68383.75181596537,72063.62949107739,0.005246251017461863,0.0021287670602829637,70087.78782464025,69134.37053591952,91.8891848370695,85.33010801598375,-905.356977653246,68921.01196128002,68518.26321796747,69072.75672136218,402.7487433125498,177.83526482289545,647.8456463940681,326.54027657375264,347.92686068105104,178.08919263852295,69948.84834399418,68198.16509873018,True,False,71201.336,69901.336,70401.336,70451.336,,False,,,2024-03-15 21:20:16,fail,False,-73.52,1735.7800000000038,0,4,11,3
2024-03-18 17:00:00,67024.68,67171.336,66699.836,66775.336,4762,36421,0,66416.04271587693,67171.33600000002,0.003365433019107152,0.001929718628971593,-0.0033851967350577872,-0.002666631856968516,65083.89792253772,65350.57875595328,2024-03-18 17:00:00,2024-03-18 17:00:00,-332.0967500000261,-334.68351214514405,67595.66663095242,-0.0016133305889050897,0.0003202882128470384,67721.99554761905,66136.73701709467,68801.76926967484,66242.04862545908,68779.85268851598,0.00032029529160279525,-0.0016163287005421312,68974.32828898031,68202.15649234368,8.981628993648128,13.587103947556422,-329.7890131869374,67529.48268148716,67817.661247671,67261.7995847953,-288.17856618383667,-134.37048616070192,481.9355079492577,-222.18414619885152,-205.26446026835765,-238.8767963535647,67912.41252052679,66609.6866490638,False,True,65875.336,67175.336,66675.336,66625.336,,False,2024-03-19 03:30:00,2024-03-19 03:38:51,2024-03-18 17:34:09,fail,False,-73.52,1662.2600000000039,0,5,12,3
2024-03-20 21:00:00,65437.238,65769.359,65111.859,65605.578,5541,36421,0,65111.859,65768.72724460432,0.001684727816147201,0.0013672442612627609,0.005372394523081161,0.00685369918077437,68560.77575868793,68785.74856507867,2024-03-20 21:00:00,2024-03-20 21:00:00,505.60042857150984,62.12298696777725,64859.428857142884,0.0005811553396470584,0.0036739537944627592,64322.33177380954,62295.569733370954,67040.22891101465,60895.83713987873,66298.90698673397,0.0029397848444219507,-0.0030680969376599117,64521.486068934304,63831.300961576504,93.35193879246042,91.0815799547466,-263.6120332972291,64481.7459991268,64057.40842139331,64697.43365187473,424.3375777334877,250.94872896677674,663.6713781173341,313.92026487786643,311.6115438596389,111.40149294800358,65594.89001233313,63801.477291416326,True,False,66505.578,65705.578,65705.578,65755.578,2024-03-20 22:00:00,True,2024-03-20 22:00:00,2024-03-20 22:24:37,2024-03-20 22:00:45,even,True,18.38,1680.640000000004,1,0,12,3
2024-03-22 12:00:00,65516.34,65631.734,65154.641,65184.238,2997,36421,0,64806.55823085891,65631.73400000003,-0.0020206665958146628,-0.003180976310829292,-0.0027060409129753197,-0.0028631840184190588,63556.17833748684,64210.230243694496,2024-03-22 12:00:00,2024-03-22 12:00:00,-271.98833333334187,-36.073306155754835,65487.84692857143,-0.0023347967216035366,-0.0019787024856076033,65995.5106547619,63931.17366420018,65599.22339583546,65493.06904517122,67230.67382398849,0.0012037164071699979,0.00048314282469343853,65844.04108110612,65887.98649557315,6.574242007622385,10.548796777834964,-18.897018442621572,65824.74126444593,65943.7052127031,65620.63782180945,-118.96394825718016,11.761404955343838,335.262996993261,-174.22890918471967,-128.90272686618846,-164.12320502228977,66073.24286775035,65166.532775868545,False,True,64284.238,65084.238,65084.238,65034.238,2024-03-22 12:30:00,True,2024-03-22 12:30:00,2024-03-22 13:50:43,2024-03-25 00:00:03,success,True,165.39,1846.0300000000038,2,0,12,3
2024-03-22 12:15:00,65184.238,65307.332,64675.738,64866.637,3934,36422,0,64659.428732524044,65307.33200000005,-0.000910120822687129,-0.0020284624156349834,-0.0027059341678229718,-0.003807149250915701,62717.17013536213,64037.63037219784,2024-03-22 12:00:00,2024-03-22 12:00:00,-271.98833333334187,-36.073306155754835,65487.84692857143,-0.0023347967216035366,-0.0019787024856076033,65995.5106547619,63931.17366420018,65599.22339583546,65493.06904517122,67230.67382398849,0.0012037164071699979,0.00048314282469343853,65844.04108110612,65887.98649557315,8.612550999883846,8.901051505041158,-18.897018442621572,65677.34060837733,65863.9223821325,65418.57385276923,-186.5817737551697,-27.90723078675887,415.8718949513244,-202.06396904021676,-174.22890918471967,-128.90272686618846,65980.00091095352,64855.64679458494,False,True,63966.637,64766.637,64766.637,64716.637,2024-03-22 13:00:00,True,2024-03-22 13:00:00,2024-03-22 14:04:00,2024-03-22 13:00:18,even,True,18.38,1864.410000000004,3,0,12,3
2024-03-25 01:00:00,66972.742,67643.734,66951.336,67588.336,4284,36421,0,66951.33599999994,67810.93174162762,0.0012358368869469334,-0.00190708153947251,0.002978926909925804,0.0017749770812771155,67922.28245826424,69300.3253296292,2024-03-25 01:00:00,2024-03-25 01:00:00,1108.8604642857608,-368.11708836243633,65761.11897619045,0.00414743169376704,0.007133390869019047,64837.8689761905,64978.21986569597,69701.36158191256,64097.739319984845,68961.2677954298,0.006790398182222478,0.0022928511217313995,65266.33986770958,64991.138018216865,98.11516981676878,97.62871044982565,-526.6713119416698,65606.80975685337,64807.22528800803,66334.93375060198,799.5844688453435,336.50975630083036,1440.4108584240141,537.8122229102592,452.4284888200127,509.1158875129622,68280.9884094744,64390.37909172956,True,False,68488.336,67188.336,67688.336,67738.336,,False,2024-03-25 16:00:00,2024-03-25 16:08:59,2024-03-25 02:01:55,fail,False,-73.53,1790.880000000004,0,1,13,3
2024-03-25 16:00:00,68028.336,68839.836,67711.75,68616.242,6416,36421,0,67711.75000000006,69429.71205701036,0.006293924051554543,0.0011806693372689815,0.008964802252959909,0.0031804663964204627,69103.58953912693,74050.84385697248,2024-03-25 16:00:00,2024-03-25 16:00:00,369.8497500000085,560.0450332160253,68104.33670238098,0.0009108516150209138,0.00461678467636732,67338.23538095239,67177.5297033623,70856.15036339697,67115.54967427837,68457.69864490331,0.0013575536831523741,0.0009106716941868153,66192.31464882629,66711.70458059583,86.62974125668238,66.32397592657841,468.98979202050026,67411.35312544805,67203.34441357196,67488.78552872376,208.00871187608573,70.68230829019039,390.49198693913047,275.2617313381779,176.11364017885353,22.77724355008104,68017.44971109158,66961.62134635594,True,False,69516.242,68716.242,68716.242,68766.242,2024-03-25 16:30:00,True,2024-03-25 16:30:00,2024-03-25 17:00:09,2024-03-27 16:12:12,success,True,165.4,1956.280000000004,1,0,13,3
2024-03-25 16:15:00,68610.352,69511.734,68610.281,69217.273,6499,36421,0,68610.281,69511.04053673356,0.0028503250695042326,0.001608821348048835,0.009722387844560105,0.008658782916148185,73285.888770448,75243.21626600475,2024-03-25 16:00:00,2024-03-25 16:00:00,369.8497500000085,560.0450332160253,68104.33670238098,0.0009108516150209138,0.00461678467636732,67338.23538095239,67177.5297033623,70856.15036339697,67115.54967427837,68457.69864490331,0.0013575536831523741,0.0009106716941868153,66192.31464882629,66711.70458059583,91.4874395467178,81.5987066171283,468.98979202050026,67689.18695230219,67352.52430886292,67862.31006707944,336.6626434392674,123.8783753200058,572.34263577896,373.52453835567576,275.2617313381779,176.11364017885353,68636.47262538104,67089.64750877784,True,False,70117.273,69317.273,69317.273,69367.273,2024-03-25 17:00:00,True,2024-03-25 17:00:00,2024-03-25 18:35:59,2024-03-25 17:13:58,even,True,18.38,1974.6600000000042,2,0,13,3
2024-03-25 16:45:00,69140.352,69480.641,69001.836,69416.438,4738,36421,0,68993.59792551889,69805.08604421488,0.0011838022159618843,0.0006051875654648118,0.0011806693372689815,0.006293924051554543,72630.57119309403,70349.66023356582,2024-03-25 16:00:00,2024-03-25 16:00:00,369.8497500000085,560.0450332160253,68104.33670238098,0.0009108516150209138,0.00461678467636732,67338.23538095239,67177.5297033623,70856.15036339697,67115.54967427837,68457.69864490331,0.0013575536831523741,0.0009106716941868153,66192.31464882629,66711.70458059583,90.7229922992301,90.15720688492831,468.98979202050026,68144.11164040571,67628.17873119249,68563.53791537667,515.9329092132248,250.894595701376,808.5846803647986,352.36520123844093,348.8626470587915,373.52453835567576,69656.62723386915,67471.94859688419,True,False,70316.438,69516.438,69516.438,69566.438,2024-03-25 17:45:00,True,2024-03-25 17:45:00,2024-03-25 18:38:38,2024-03-25 18:10:12,even,True,18.38,1993.0400000000043,3,0,13,3
2024-03-28 08:15:00,70022.086,70161.438,69916.336,70106.836,2821,36421,0,69916.33599999997,70355.5546478316,0.0016573683615787418,0.0010765399979856924,0.0014698522171206255,0.0007019430329670742,70115.74397214364,71007.19043977991,2024-03-28 08:00:00,2024-03-28 08:00:00,36.25367857146193,-93.19772430657758,69858.91369047621,0.0013536321391076842,0.0009501906265654782,69575.5482142857,69688.45664977313,70729.65023435507,69103.44737017647,69901.91695810086,-0.00023103501298989316,0.00036414292667284547,69516.82240440877,69618.46366043566,90.5294310585203,86.6610394452685,-168.81026928366228,69758.88464317277,69601.42650080626,69916.81066563471,157.45814236650767,103.33726424031845,266.47286650813993,101.45294461651065,95.31182146536594,43.13055108363915,70278.0490354207,69557.07229584872,True,False,71006.836,70206.836,70206.836,70256.836,2024-03-28 08:45:00,True,2024-03-28 08:45:00,2024-03-28 13:10:43,2024-03-29 08:06:05,success,True,165.4,2158.440000000004,4,0,13,3
2024-03-28 08:30:00,70113.836,70431.336,70046.0,70406.734,3158,36421,0,70045.99999999999,70448.39454711074,0.0008527901239963277,0.0004635249073088644,0.0028064551878647223,0.002710627939527693,71611.98944600462,72062.6551911027,2024-03-28 08:00:00,2024-03-28 08:00:00,36.25367857146193,-93.19772430657758,69858.91369047621,0.0013536321391076842,0.0009501906265654782,69575.5482142857,69688.45664977313,70729.65023435507,69103.44737017647,69901.91695810086,-0.00023103501298989316,0.00036414292667284547,69516.82240440877,69618.46366043566,97.24433450641283,91.45056798585942,-168.81026928366228,69858.55377499234,69661.07890815396,70075.6823856209,197.4748668383836,122.16478475993148,309.19153897396137,158.87171998618578,101.45294461651065,95.31182146536594,70494.59096323574,69658.27380800605,True,False,71306.734,70506.734,70506.734,70556.734,2024-03-28 10:45:00,True,2024-03-28 10:45:00,2024-03-28 15:35:07,2024-03-28 12:15:56,even,True,18.38,2176.8200000000043,5,0,13,3
2024-03-29 17:45:00,69406.734,69491.734,69162.141,69216.336,3704,36421,0,69133.42005669007,69501.5171776312,0.0009292912575619416,0.0008327399247955974,-0.0024554048075402972,-0.005854063152668427,65393.81824694393,68402.52709962758,2024-03-29 17:00:00,2024-03-29 17:00:00,39.62123809523473,-75.20400090204203,69925.38521428574,-0.0014604966764248052,0.0015403536447328565,70249.88730952378,68573.73220360781,71360.29325938404,70244.16171014325,70801.4542707323,0.00031634953271723307,0.0011385138296533715,70173.7008826678,70238.63768413599,18.45145354401845,21.332036093352812,-34.88665309411004,69950.26793864637,70073.09062904687,69935.69526934988,-122.82269040049869,-18.85148254807547,310.87986849450726,-172.294195046401,-157.27115445476375,-60.5467602340068,70355.38309181746,69514.50744688229,False,True,68316.336,69616.336,69116.336,69066.336,,False,2024-04-01 17:45:00,2024-04-01 18:12:55,2024-03-29 18:21:34,fail,False,-73.52,2103.3000000000043,0,1,13,3
2024-04-01 01:00:00,70901.734,71078.438,70881.68,71002.141,1736,56421,0,70881.68000000005,71094.79741088995,0.00041419535225639204,0.00032790934494999514,0.0002467233666844394,0.0006662123765498778,71164.01752614255,71221.17620045875,2024-04-01 01:00:00,2024-04-01 01:00:00,526.4584523809026,-126.62169088951487,70485.92577380955,0.0024068032988194517,0.0020280195460505093,69997.5893571428,70579.38613205879,71773.38683244163,70187.24151539007,71312.13970116875,0.0009689322341123693,0.001858455212086363,70125.09779132955,70145.5770912984,93.17960383630678,92.57964705495107,-166.4933594988781,70355.05292673846,70065.90775486267,70681.73571964225,289.14517187578895,107.44635294542903,594.3322850796432,173.68719470244832,174.2579814241617,192.61188716893957,71485.58430449977,69879.38713478473,True,False,71902.141,71102.141,71102.141,71152.141,2024-04-01 02:45:00,True,2024-04-01 02:45:00,,2024-04-01 03:36:06,even,True,18.38,2121.6800000000044,1,0,14,4
2024-04-01 17:30:00,69426.141,69486.836,69036.852,69066.141,3899,36421,0,68854.14680848457,69486.83600000001,-0.004832801014714583,-0.002769582336313269,-0.002642474337779679,-0.0037177382079792392,66978.99449716772,68124.41212333838,2024-04-01 17:00:00,2024-04-01 17:00:00,77.51122619042872,-163.82201061054366,69502.12460714283,-0.0013751814619648627,0.0007399656016360663,69731.39346428568,68246.51502981567,70394.78747114197,69932.39081037657,70342.83146982631,0.0007399580432697697,0.001363259987327757,70032.8813362229,69911.79877917083,14.93102470643518,39.69791931716223,-123.44566013234993,69634.02836317591,69699.81924073439,69717.36548503608,-65.79087755848013,-36.33492240127946,222.77601682565702,-131.8692019264272,-72.95053560375527,-11.819185414453386,70018.11310775072,69415.11786232144,False,True,68166.141,68966.141,68966.141,68916.141,2024-04-01 18:15:00,True,2024-04-01 18:15:00,2024-04-01 19:00:08,2024-04-01 21:52:23,success,True,165.39,2287.0700000000043,2,0,14,4
2024-04-01 17:45:00,69046.328,69246.141,68635.844,68931.836,4376,36421,0,68115.76140339194,69246.14099999996,0.0011162195791869806,-0.0019027822457057745,-0.003769003928002326,-0.004895626926112931,65955.56735912497,67173.1221484954,2024-04-01 17:00:00,2024-04-01 17:00:00,77.51122619042872,-163.82201061054366,69502.12460714283,-0.0013751814619648627,0.0007399656016360663,69731.39346428568,68246.51502981567,70394.78747114197,69932.39081037657,70342.83146982631,0.0007399580432697697,0.001363259987327757,70032.8813362229,69911.79877917083,8.3205490012032,20.554413711400112,-123.44566013234993,69525.99876884115,69642.93159327257,69552.96952872376,-116.9328244314238,-52.45450280730833,261.7686408174634,-164.39595631232078,-131.8692019264272,-72.95053560375527,69906.35719382734,69198.08186362017,False,True,68031.836,68831.836,68831.836,68781.836,2024-04-01 18:15:00,True,2024-04-01 18:15:00,2024-04-02 05:36:01,2024-04-01 18:28:13,even,True,18.38,2305.4500000000044,3,0,14,4
2024-04-08 10:15:00,69911.734,70157.234,69856.445,70092.039,2577,36421,0,69805.72948054573,70587.7025158793,0.004036826276712971,0.0039875154642334525,0.0016973277521100702,0.001555883186952978,70748.35812848595,71134.82244556032,2024-04-08 10:00:00,2024-04-08 10:00:00,104.70779761907761,609.962503300645,70013.9359404762,0.0018259249386731481,0.0024314824916463807,69611.31723809529,70170.41594457731,71591.71352021591,69459.55853882803,69816.67121412039,-4.2656761121921314e-05,0.0006593243318919926,68074.97961334753,68742.9632626789,92.36963824656254,88.51470579259215,490.63449584236344,69733.39546676776,69520.74409045292,69888.01099277605,212.65137631483958,191.16025612981986,231.30746798988474,76.27826281389571,58.827920536641614,41.492159270797856,70201.7760745624,69575.7459109897,True,False,70992.039,70192.039,70192.039,70242.039,2024-04-08 10:45:00,True,2024-04-08 10:45:00,2024-04-08 11:04:45,2024-04-09 10:46:14,success,True,165.38,2470.8300000000045,4,0,15,4
2024-04-08 10:30:00,70092.039,70869.734,70087.398,70675.836,4062,36421,0,70087.39800000002,70869.73400000005,0.004046415480339334,0.0034543109931161023,0.005060419897634973,0.0032906836004692056,71994.28579820029,73860.63443289453,2024-04-08 10:00:00,2024-04-08 10:00:00,104.70779761907761,609.962503300645,70013.9359404762,0.0018259249386731481,0.0024314824916463807,69611.31723809529,70170.41594457731,71591.71352021591,69459.55853882803,69816.67121412039,-4.2656761121921314e-05,0.0006593243318919926,68074.97961334753,68742.9632626789,91.19903369320343,89.97018421768524,490.63449584236344,69878.38631803426,69606.30645412307,70063.72077880974,272.079863911189,207.3441776860937,322.7844739883305,175.7097860336944,76.27826281389571,58.827920536641614,70500.97981869399,69627.9617389255,True,False,71575.836,70775.836,70775.836,70825.836,2024-04-08 11:15:00,True,2024-04-08 11:15:00,2024-04-08 11:53:48,2024-04-09 09:40:00,success,True,165.38,2636.2100000000046,5,0,15,4
2024-04-08 11:00:00,70720.336,71361.734,70656.25,71357.938,3424,36421,0,70656.95252963154,71361.08419270639,0.002185964681329592,0.0045492561601767345,0.0039875154642334525,0.004036826276712971,73024.10592935933,73804.41038405146,2024-04-08 11:00:00,2024-04-08 11:00:00,402.61870238091797,692.9762708567869,70772.61248809518,0.002894968735062643,0.005020461961060853,70013.9359404762,70841.5356070556,73879.24580542414,70170.41594457731,71591.71352021591,0.0024314824916463807,0.0018259249386731481,68230.43292262802,69006.64932166459,92.7645930423497,91.4434070262231,531.1028508452481,70215.61257090027,69812.46500113432,70502.15356965942,403.147569765948,264.3841680101463,523.6125648767351,273.1042665978457,165.32852425183228,175.7097860336944,71210.53053224302,69795.27660707582,True,False,72257.938,70957.938,71457.938,71507.938,,False,2024-04-08 12:00:00,2024-04-08 11:55:14,2024-04-09 04:10:33,success,True,165.38,2801.5900000000047,6,0,15,4
2024-04-10 16:00:00,67992.938,68000.039,67599.641,67633.977,3863,36421,0,67600.31545672183,68000.03900000006,-0.00034597400894430643,0.0016987158035237006,-0.0071423401366702026,-0.0019018685621562557,66242.70454280458,64184.96162800893,2024-04-10 16:00:00,2024-04-10 16:00:00,-397.8090952381608,-345.4613714641746,68471.86391666664,-0.004184210465971702,-0.0008450829723934453,68687.99535714283,66098.78019709393,68952.1219632668,66600.56562267446,69009.67598557615,-0.0008449949920309803,-0.003364235504006304,69498.75007586315,69216.00571794994,19.698105857531406,35.42191139709104,-325.27121509532026,68575.16554156737,68838.58667091712,68416.68745854832,-263.4211293497501,-122.97506193917255,444.3313190345104,-231.8332088063471,-171.69560440313944,-196.4691506708332,69016.5347392449,67815.34017785173,False,True,66733.977,68033.977,67533.977,67483.977,,False,,,2024-04-10 16:51:50,fail,False,-73.52,2728.0700000000047,0,1,15,4
2024-04-12 02:15:00,70074.492,70105.039,69781.844,69999.039,1430,36421,0,69781.84400000003,70104.34169093134,0.0011586540233681666,0.0011041222934204328,-0.0008481920904903225,-0.0013325748731265951,69027.7920123515,69691.49925738068,2024-04-12 02:00:00,2024-04-12 02:00:00,-63.9089999999851,51.96613754464488,70216.02610714285,0.0003890094808106999,0.0004279499857552915,70303.22179761909,69895.34614194765,70978.97930166955,70358.22079890686,71369.38416467678,0.001387748537728747,0.0010770285550967332,70075.5073723333,70220.22355314945,15.396796748685198,18.52996200163955,103.62202968887853,70204.9126192354,70246.74066922514,70141.21768868247,-41.82804998973734,-0.6464655089865516,175.69365451738437,-79.34463020296243,-56.36351152390125,-45.817475748219294,70378.40412228095,69902.531255084,False,True,69099.039,70399.039,69899.039,69849.039,,False,2024-04-12 16:45:00,2024-04-12 19:17:02,2024-04-12 04:06:14,fail,False,-73.52,2654.5500000000047,0,2,15,4
2024-04-12 17:00:00,69908.141,70118.938,69640.141,69793.641,3627,36421,0,69640.14100000005,70171.7245404355,-0.0018749404622391396,-0.0015249130567872755,-0.001385672602726271,-0.0021360227721939897,68301.12353616863,69330.75959840098,2024-04-12 17:00:00,2024-04-12 17:00:00,-278.826869047567,73.94904921529815,70013.01730952383,-0.00279272457469639,-0.000358967467973441,70449.7302619048,68451.75590199702,70852.54300425263,69010.35502116695,70969.32133027622,-0.00010915172993013485,-0.002220210429648298,70299.81079163612,70435.63856557905,10.882285966887672,13.024482488176163,143.9739423392376,70306.44518230302,70522.75930554175,70134.27183694532,-216.31412323872792,-100.88407412867011,349.4840528975152,-150.76655280351406,-135.8772851738031,-158.6099570002698,70606.07530835697,69660.96836553367,False,True,68893.641,69693.641,69693.641,69643.641,2024-04-12 18:00:00,True,2024-04-12 18:00:00,2024-04-12 19:19:33,2024-04-12 18:27:44,even,True,18.38,2672.930000000005,1,0,15,4
2024-04-15 07:30:00,64897.844,64939.438,64731.867,64853.836,2621,36422,0,64727.83982641617,64938.79843817207,0.0007656329405176564,0.0010758896142087763,-0.0016713759843752657,-0.0007214774155317416,64195.91781536375,64067.59401987326,2024-04-15 07:00:00,2024-04-15 07:00:00,42.217392857135565,-1414.4446050602564,65202.2004880953,0.0030377715220137997,0.0006116479705383242,65093.34097619043,65437.015787736666,66148.35408236209,66172.41411718621,64039.99759169042,-0.004694764335137202,0.00444593483494115,68463.6302881549,67257.85717813502,18.2121776955625,21.189030023380695,-1160.3031344631631,65066.1780170447,65368.64095424992,64912.819563123485,-302.462937205215,-338.1256128437062,253.25588731574,-32.65671310629841,-41.70734502923733,-76.59980116964289,65254.71501099973,64569.42411524724,False,True,63953.836,65253.836,64753.836,64703.836,,False,2024-04-15 18:00:00,2024-04-15 18:01:36,2024-04-15 08:42:45,fail,False,-73.52,2599.410000000005,0,1,16,4
2024-04-18 14:15:00,62344.176,62981.738,62344.176,62876.438,4739,36422,0,62344.17599999996,63189.3991559906,-0.0002895187192245669,-0.0024997772629409736,0.006744877105424674,0.003529330498793626,63772.72096039255,66495.6361776544,2024-04-18 14:00:00,2024-04-18 14:00:00,148.7533452380885,-260.1630342388089,61864.46640476193,0.0005713476361958852,0.0022879486403168123,61422.717999999986,61049.37130925061,63618.15799327834,60812.07208956732,61718.434871723155,-0.0006690982114273679,0.00013153733892418585,62412.04935738212,61748.057625585665,93.44594468092073,90.2866904318874,-366.32279622917537,61805.707309512814,61588.099324965835,62035.79730994147,217.60798454697942,61.47942079629904,444.34551199896856,254.2612404540123,157.751493636104,81.2066738905778,62637.16375114008,61435.93086874286,True,False,63776.438,62476.438,62976.438,63026.438,,False,2024-04-18 17:15:00,2024-04-18 17:25:49,2024-04-18 15:06:00,fail,False,-73.52,2525.890000000005,0,2,16,4
2024-04-19 05:00:00,60981.637,61140.039,60577.172,60661.34,5619,36422,0,59717.41525018972,61140.038999999946,-0.0014241931975324407,0.001354539384797454,-0.007869736214673365,-0.004990660038634136,57895.85963251058,57427.52241929442,2024-04-19 05:00:00,2024-04-19 05:00:00,-806.1264880952876,157.2515848825933,61893.46236904765,-0.008135503448781715,-0.0029952712437029587,62438.25847619046,57643.51705397741,62296.89391383045,59614.47511483477,62479.73084059486,-0.002995148776345488,-0.0039305167102336004,62605.14833774388,62468.7544527228,7.0501718762311185,7.616553632698232,280.3963953255577,62055.524394755295,62589.807352402975,61552.925291021675,-534.2829576476797,-237.27670248672308,878.8119450950626,-355.4865916753042,-353.47769074630196,-372.0197120743833,62739.321416900006,60365.02916514334,False,True,59761.34,61061.34,60561.34,60511.34,,False,2024-04-19 05:30:00,2024-04-19 05:29:29,2024-04-19 05:55:25,success,True,165.38,2691.270000000005,1,0,16,4
2024-04-29 00:30:00,63612.406,63637.738,63538.613,63604.039,957,56422,0,63511.99889779508,63682.398762055214,-0.0017245263564564803,-0.0001512558888446236,-0.0014763414205620723,-0.0007037639716433436,63110.762549814615,62884.89093591686,2024-04-29 00:00:00,2024-04-29 00:00:00,40.49149999998917,-149.71418569031812,63800.37174999993,0.0008386391673416846,-0.0018083937973502342,63803.72994047621,63755.89444533684,63481.27500137788,63716.97540681995,63595.57380808646,-0.0018082708608720892,0.0008666434875826363,64329.1765946681,64052.671676324186,10.912730367321709,24.756828394518607,-125.7355624708604,63766.57484355883,63828.982290467684,63732.86606879942,-62.40744690885185,-44.71156729278509,179.65721369469983,-62.74271276232321,-64.67527003774012,-66.47678740978881,63975.40330728726,63488.82883031158,False,True,62704.039,63504.039,63504.039,63454.039,2024-04-29 01:15:00,True,2024-04-29 01:15:00,2024-04-29 02:08:17,2024-04-29 01:17:04,even,True,18.38,2709.650000000005,2,0,18,4
2024-04-30 01:30:00,63463.738,63857.738,63455.84,63702.383,3076,36422,0,63455.84000000003,63904.94190718111,0.002205371003584742,0.002161009434353798,0.0038336008580837676,0.002207528379102397,64392.197204544405,65862.78127674198,2024-04-30 01:00:00,2024-04-30 01:00:00,-25.396904761924816,-114.74511991792679,63250.87239285719,0.00012381697023491255,0.001893728325766378,62955.28125000002,62547.51726607458,64401.62243058796,63304.03343154756,63148.21071306983,-0.00010547608467584443,0.00213910307674493,63331.4918250564,62966.13386511983,94.58681204570917,91.12504428940849,-236.7410576197341,63124.36031165288,62962.11692101892,63235.131148606764,162.24339063396474,96.68416295736606,238.84407091847228,143.37994152039755,118.22296250428917,55.598775369813666,63559.0706443467,62912.69165286683,True,False,64602.383,63802.383,63802.383,63852.383,2024-04-30 02:15:00,True,2024-04-30 02:15:00,2024-04-30 03:53:20,2024-04-30 02:50:02,even,True,18.38,2728.030000000005,3,0,18,4
2024-04-30 01:45:00,63701.371,63907.738,63696.422,63837.75,2509,36422,0,63696.421999999955,64197.03322690109,0.0006492034676956512,-0.00023828280684196952,0.004878463462457545,0.004291483307953503,65902.53172435294,66745.1737681063,2024-04-30 01:00:00,2024-04-30 01:00:00,-25.396904761924816,-114.74511991792679,63250.87239285719,0.00012381697023491255,0.001893728325766378,62955.28125000002,62547.51726607458,64401.62243058796,63304.03343154756,63148.21071306983,-0.00010547608467584443,0.00213910307674493,63331.4918250564,62966.13386511983,94.40314544059623,94.17839535208721,-236.7410576197341,63234.1125713986,63026.97863057307,63394.9250299278,207.13394082552986,118.77411853099882,296.57789860224466,159.79388132103486,143.37994152039755,118.22296250428917,63796.80519304083,62994.544866814766,True,False,64737.75,63937.75,63937.75,63987.75,2024-04-30 03:45:00,True,2024-04-30 03:45:00,,2024-04-30 04:54:50,even,True,18.38,2746.4100000000053,4,0,18,4
2024-05-01 11:00:00,57459.238,57552.34,56903.887,57315.539,6246,36422,0,56456.108499831695,57552.33999999995,0.0011054957738944288,-0.0024288920934725875,-0.0060546391371316755,-0.001008453946856955,56450.11231769095,54843.74286107394,2024-05-01 11:00:00,2024-05-01 11:00:00,-801.8433809524722,-785.1409032275842,58265.97010714291,-0.008098775745034772,-0.0036274695627845606,59048.00489285712,54742.53383783377,58790.56615417423,55380.71767160557,58997.03875223047,-0.003627214537935917,-0.0073798926694545195,61255.40335442572,60177.47658271106,15.198839587879233,19.452738113906424,-675.5612696105799,58639.71824050239,59284.60504071143,58060.33945958035,-644.8868002090385,-358.14589174097046,932.7668190874281,-362.8553914688455,-390.41926659786986,-381.4430309597301,59319.57466534837,56799.60425381232,False,True,56415.539,57215.539,57215.539,57165.539,2024-05-01 11:30:00,True,2024-05-01 11:30:00,,2024-05-01 12:03:41,even,True,18.38,2764.7900000000054,5,0,18,5
2024-05-01 18:30:00,57052.707,57115.738,56896.238,56938.938,3462,36422,0,56691.29016920873,57115.73800000005,0.00017570009557131333,0.0015851441696654253,-0.0031465862575548215,-0.00379472450484986,54742.80554989955,55703.63789855593,2024-05-01 18:00:00,2024-05-01 18:00:00,150.75486904761783,-1066.148376589983,57360.78172619045,0.0002919691809240827,0.0008113432692887172,57576.56323809523,56699.444141862405,58569.20156271356,57375.36332857151,56730.05516361369,-0.004403921646662909,0.0015119510185505683,60321.77394387574,58957.74720600932,16.62653778584134,20.587168920307253,-976.0089825499748,57314.170939330834,57596.13066436086,57134.317023047835,-281.9597250300285,-260.72578841897996,353.25030963700465,-119.88510767114349,-94.88738183687383,-138.0070024079978,57611.20494105779,56655.92910503788,False,True,56038.938,57338.938,56838.938,56788.938,,False,2024-05-01 20:15:00,,2024-05-01 19:25:49,fail,False,-73.52,2691.2700000000054,0,1,18,5
2024-05-03 16:00:00,60583.898,61219.852,60464.137,61105.871,5076,36422,0,60464.13699999997,61241.093862653,0.005163611053623965,0.004642415524029356,0.008681965600451745,0.011514575360930403,66278.01454499528,65936.41377787916,2024-05-03 16:00:00,2024-05-03 16:00:00,475.787892857159,287.9950438228552,60391.74866666672,0.0023889232680241955,0.00540119906817123,59638.58669047622,59662.12292849385,63173.198331873544,58865.15183220915,61374.38429587299,0.00270406181080077,0.00018429573438297398,59220.73119994085,59365.16370485992,95.4379144467793,77.65819182582489,249.7794982908525,59777.709087521325,59527.89111073823,59897.49890780871,249.81797678309522,45.27208448447662,521.5703327988392,328.8955569314785,249.67877158589545,225.10080632951576,60603.118857087145,59193.37895853027,True,False,62005.871,61205.871,61205.871,61255.871,2024-05-03 16:45:00,True,2024-05-03 16:45:00,2024-05-03 17:02:23,,success,True,165.38,2856.6500000000055,1,0,18,5
2024-05-03 23:30:00,62707.039,62923.207,62640.309,62877.738,3227,56422,0,62249.69332828692,62967.257409294914,0.0070941959386764605,0.0056587562249775765,0.006152699301608933,0.003906960878589981,64346.26805021349,66425.31193167093,2024-05-03 23:00:00,2024-05-03 23:00:00,-22.19461904761556,814.3636601664839,62193.302869047664,0.002935177627831447,0.002605052605718329,61909.61219047619,62454.305354164564,63823.0040953977,63077.159510542544,62247.71876761725,0.0001314822045859661,0.006132847496503674,59879.76806866837,60507.978588150145,93.84973950314462,85.96169527574278,619.7083202520504,62086.684420014775,61687.29665039142,62196.34734399722,399.38776962335396,359.51756747922224,338.72269161635506,183.13305297556508,158.99438562097203,43.502102511127305,62655.122977679304,61739.07171031514,True,False,63777.738,62977.738,62977.738,63027.738,2024-05-06 00:15:00,True,2024-05-06 00:15:00,2024-05-06 00:26:18,2024-05-06 18:01:35,success,True,165.38,3022.0300000000057,2,0,18,5
2024-05-06 11:30:00,65334.238,65431.738,65199.215,65392.402,3387,36422,0,65011.54147824307,65551.47562981343,0.0001291459852995801,-0.001196747317845292,0.006962673775385519,0.0025750326725052643,65927.16741197594,69733.68721036534,2024-05-06 11:00:00,2024-05-06 11:00:00,146.65923809533706,1164.3763381231402,64557.023202380915,0.00196721848003677,0.0023064149524938764,64213.606797619104,64736.03297288138,66093.52696866823,64024.573584117825,64601.958935352166,0.0002721984833029619,0.0007314718043584524,61509.993443544256,62841.488254423275,89.92767981457114,89.14620785423796,1152.9059120546437,64581.804647257406,64271.58935112832,64783.29908771932,310.2152961290849,214.28270680679626,423.4472593275172,174.09615101476084,189.34961713112716,33.41895596838731,65356.45288781147,64211.64528762717,True,False,66292.402,64992.402,65492.402,65542.402,,False,,,2024-05-06 13:18:26,fail,False,-73.52,2948.5100000000057,0,1,19,5
2024-05-09 00:00:00,61512.121,61602.039,61412.414,61453.738,1748,56422,0,61281.59752288492,61715.362205757156,0.0003795113759548838,-8.000435713793445e-05,-0.002535176381625052,-0.0008326450997634338,60912.96902762487,60360.30664041737,2024-05-09 00:00:00,2024-05-09 00:00:00,-306.3799880952647,-242.38225589258946,61799.38317857142,-0.0014734456638922748,-0.0012332839052201859,62062.336047619036,60919.82079131591,62182.65353930384,61166.478640062945,62638.215018601,-0.00022702334860785572,-0.0008350436309035918,62577.279534802765,62385.092552096634,8.987097893892521,11.606766629093473,-221.2906815624284,61917.314149654405,62106.92904845672,61710.683372548985,-189.61489880231238,-81.26277286352197,336.3970989601819,-149.74157000340347,-146.52563880293746,-141.2778716890607,62164.81945614523,61255.04728895274,False,True,60553.738,61353.738,61353.738,61303.738,2024-05-09 01:15:00,True,2024-05-09 01:15:00,2024-05-09 14:03:38,2024-05-09 01:31:03,even,True,18.38,2966.890000000006,1,0,19,5
2024-05-09 18:15:00,61820.34,62235.637,61618.941,62147.688,3031,36422,0,61618.940999999955,62235.63700000004,0.0021506282046811712,0.001184165913387757,0.004195364882348786,0.003249374166597343,63247.62878266958,64369.707366173454,2024-05-09 18:00:00,2024-05-09 18:00:00,139.84609523806284,-271.95881590295903,61566.59748809526,0.001371691811764004,0.0019146559282501624,61264.52819047617,61193.08866891025,62718.75127062072,60193.570519077606,61568.269559999084,-4.736957063454229e-05,-0.0007778157542094413,61961.22940297426,61609.233651809045,89.27126787142079,80.95811841927421,-316.145370920412,61475.03896431118,61356.30444888124,61615.48049466801,118.73451542994007,19.839534147250543,298.25219217561846,131.6376900584437,107.11636773305509,46.7759356724855,62019.62095410509,61212.840035230925,True,False,63047.688,62247.688,62247.688,62297.688,2024-05-09 19:15:00,True,2024-05-09 19:15:00,2024-05-10 01:47:21,2024-05-09 19:44:27,even,True,18.38,2985.270000000006,2,0,19,5
2024-05-09 18:45:00,62055.82,62149.438,61883.938,62104.34,3041,36422,0,61883.93800000003,62295.62663775764,0.0018888771549916386,0.002589072173660499,0.00020560184375462186,0.002520173159161935,63150.148091898795,62364.20447723645,2024-05-09 18:00:00,2024-05-09 18:00:00,139.84609523806284,-271.95881590295903,61566.59748809526,0.001371691811764004,0.0019146559282501624,61264.52819047617,61193.08866891025,62718.75127062072,60193.570519077606,61568.269559999084,-4.736957063454229e-05,-0.0007778157542094413,61961.22940297426,61609.233651809045,90.65821996762111,89.92252473714831,-316.145370920412,61648.073447820425,61460.0158992466,61822.4901895425,188.05754857382271,75.37215903978154,374.28896324200826,98.60069625044707,108.4089986240433,131.6376900584437,62329.28028991921,61317.20008916579,True,False,63004.34,62204.34,62204.34,62254.34,2024-05-09 19:15:00,True,2024-05-09 19:15:00,2024-05-10 01:47:10,2024-05-09 19:46:02,even,True,18.38,3003.650000000006,3,0,19,5
2024-05-09 19:00:00,62104.34,62457.738,62042.738,62395.707,3409,36422,0,62042.738000000034,62746.152611042635,-0.001546485272761368,-0.002037854465371594,0.001184165913387757,0.0021506282046811712,63098.861964405034,63054.7646172921,2024-05-09 19:00:00,2024-05-09 19:00:00,302.06929761909123,-190.42420927721105,61725.56057142862,0.0025215065012673277,0.002989440977416621,61566.59748809526,61917.15840756948,63380.809971973846,61193.08866891025,62718.75127062072,0.0019146559282501624,0.001371691811764004,61955.147347955666,61624.98591966433,91.47252934926149,90.65627856309521,-291.00113859177185,61763.09399430959,61529.32635115426,61974.49103611969,233.76764315532637,107.05125586289051,432.5794320247881,152.0008465771898,98.60069625044707,108.4089986240433,62559.973269353155,61390.50880288622,True,False,63295.707,61995.707,62495.707,62545.707,,False,2024-05-10 00:00:00,2024-05-10 01:52:06,2024-05-09 19:53:59,fail,False,-73.52,2930.130000000006,0,1,19,5
2024-05-10 01:45:00,62928.895,63403.242,62881.84,63234.539,2898,36422,0,62881.840000000004,63474.869915473064,-0.0003564590299193837,-0.002793741769783814,0.004208285184376067,0.0019381078190558836,63719.724703167565,65589.93713861665,2024-05-10 01:00:00,2024-05-10 01:00:00,59.4138452380721,115.91037397990294,62733.67330952378,0.0023868222613137656,0.0020727250886451282,62451.591190476174,63030.08854404837,63938.093467802624,63111.906019274735,62876.40333270826,0.00045335830533394493,0.0029613032484020504,62068.65431676062,61975.24400612121,90.94164637769661,84.93051764092827,-62.224711225428585,62645.18703446537,62378.367189896206,62822.26447884423,266.8198445691669,221.55356166378027,338.06410565688435,120.32653594776639,79.9498145854086,33.47793429654848,63280.15102148102,62365.877936207435,True,False,64134.539,62834.539,63334.539,63384.539,,False,,,2024-05-10 02:35:54,fail,False,-73.52,2856.610000000006,0,2,19,5
2024-05-10 17:15:00,62515.637,62584.34,62164.039,62171.738,3390,36422,0,62003.97772356348,62778.29274099553,-0.011188377935968559,-0.008058320111123719,-0.0009163164251010956,-0.0032290432773783486,60571.980004111494,62535.42958766197,2024-05-10 17:00:00,2024-05-10 17:00:00,-68.29349999999249,271.07890046465764,62357.498678571406,-0.005345024571776764,0.0002657026437335487,63027.03661904762,59345.39105165797,63529.81012467162,62796.29772580902,63512.94817422516,0.00026574160300352786,0.00016077855890432965,62418.83457210145,62560.449097369885,13.401723354493411,16.68456282829936,286.67080049692885,62792.271561089685,62883.28771937748,62745.76903061581,-91.01615828779177,-4.115671282435796,223.17117189771187,-141.6823360852286,-81.97803680774814,-24.26128723767033,63047.05011267772,62442.9879485539,False,True,61271.738,62071.738,62071.738,62021.738,2024-05-10 17:45:00,True,2024-05-10 17:45:00,2024-05-10 17:50:51,2024-05-13 10:53:30,success,True,165.37,3021.980000000006,1,0,19,5
2024-05-10 17:30:00,62168.238,62274.438,61684.609,61779.34,4290,36422,0,60752.12780773649,62274.43799999995,-0.0019803233021658535,-0.00542534978156662,-0.005440510815130316,-0.005928993805590503,58817.26983425197,59704.16171488278,2024-05-10 17:00:00,2024-05-10 17:00:00,-68.29349999999249,271.07890046465764,62357.498678571406,-0.005345024571776764,0.0002657026437335487,63027.03661904762,59345.39105165797,63529.81012467162,62796.29772580902,63512.94817422516,0.00026574160300352786,0.00016077855890432965,62418.83457210145,62560.449097369885,5.147447066670598,12.577805046234602,286.67080049692885,62636.435936306654,62801.5138142384,62527.403540419706,-165.07787793174793,-36.30811261229823,322.5376959517261,-218.36549019610538,-141.6823360852286,-81.97803680774814,62962.82942995454,62090.47765088487,False,True,60879.34,62179.34,61679.34,61629.34,,False,2024-05-10 18:00:00,2024-05-10 17:52:47,2024-05-13 10:53:44,success,True,165.37,3187.350000000006,2,0,19,5
2024-05-10 17:45:00,61764.98,61775.238,60631.938,61016.539,5746,36422,0,60550.76491443531,61775.238000000034,0.0013296204991351643,-0.0029080199990888043,-0.006325480261986247,-0.009696699526149224,56099.462520192545,58816.59206853286,2024-05-10 17:00:00,2024-05-10 17:00:00,-68.29349999999249,271.07890046465764,62357.498678571406,-0.005345024571776764,0.0002657026437335487,63027.03661904762,59345.39105165797,63529.81012467162,62796.29772580902,63512.94817422516,0.00026574160300352786,0.00016077855890432965,62418.83457210145,62560.449097369885,6.6000551020396445,8.383075174401307,286.67080049692885,62387.22102302871,62669.29345762815,62196.0228403853,-282.07243459943857,-85.46097700972629,495.4811377105078,-331.38070003440225,-218.36549019610538,-141.6823360852286,62864.92237629449,61525.62330447612,False,True,60116.539,60916.539,60916.539,60866.539,2024-05-10 18:15:00,True,2024-05-10 18:15:00,,2024-05-10 18:15:22,even,True,18.37,3205.7200000000057,3,0,19,5
2024-05-13 05:30:00,61082.191,61270.738,60903.238,61010.238,2758,36422,0,60903.237999999976,61270.738,-0.0009361496919961845,-0.001649441638558859,-0.00160412716572868,-0.0012744406118469723,60284.735143120175,60487.23596431656,2024-05-13 05:00:00,2024-05-13 05:00:00,60.33004761906341,-319.36081501384615,61347.787226190514,0.0013792162450330155,0.002629940077336549,61427.44283333336,61241.600877630066,62756.10532325018,61736.8384527173,62613.21233006937,0.0026993144107260976,0.0024254285176201675,61883.85268301787,61604.93311683655,14.083661877815493,19.540239033683292,-310.02816175288984,61267.616269033904,61257.25535109149,61275.75202270378,10.360917942416563,55.9181597937079,271.06079409001893,-78.12325249403511,-73.64592191253905,-34.67018197460857,61641.68409472531,60908.31995068226,False,True,60110.238,60910.238,60910.238,60860.238,2024-05-13 06:15:00,True,2024-05-13 06:15:00,,2024-05-13 06:23:19,even,True,18.37,3224.0900000000056,4,0,20,5
2024-05-13 05:45:00,61010.238,61141.738,60931.84,61005.039,2204,36422,0,60885.13498286102,61141.73800000004,-0.0012604742394510733,-0.001095398382937348,-0.001613960434557343,-0.002376409888152321,59612.008566406636,60384.54585249429,2024-05-13 05:00:00,2024-05-13 05:00:00,60.33004761906341,-319.36081501384615,61347.787226190514,0.0013792162450330155,0.002629940077336549,61427.44283333336,61241.600877630066,62756.10532325018,61736.8384527173,62613.21233006937,0.0026993144107260976,0.0024254285176201675,61883.85268301787,61604.93311683655,9.855520043044882,15.496851398373579,-310.02816175288984,61227.21976610561,61238.572658418045,61203.80805400756,-11.352892312432232,42.463949372479874,239.37177477096722,-71.94396869622142,-78.12325249403511,-73.64592191253905,61526.95994994837,60879.156158066755,False,True,60105.039,60905.039,60905.039,60855.039,2024-05-13 06:15:00,True,2024-05-13 06:15:00,,2024-05-13 06:23:18,even,True,18.37,3242.4600000000055,5,0,20,5
2024-05-13 06:00:00,61005.039,61069.539,60831.84,60831.84,2447,36422,0,60607.77336863052,61069.538999999975,0.0013565370206130747,0.0004287510232830724,-0.001633072079484587,-0.0007072121457834489,60473.36368964157,60276.32265902487,2024-05-13 06:00:00,2024-05-13 06:00:00,-79.65560714284948,-324.8368434181393,61286.764011904794,0.0007823357295675432,0.0011891877166149934,61347.787226190514,60923.4491364913,62287.23371586571,61241.600877630066,62756.10532325018,0.002629940077336549,0.0013792162450330155,61853.95406799756,61566.25350748964,8.036043483715975,10.658408468192212,-312.9898980859397,61166.39210978167,61208.44431335004,61103.44312693496,-42.052203568367986,25.5607187843103,194.75585931368593,-100.36492707260186,-71.94396869622142,-78.12325249403511,61366.36353700844,60839.02271686148,False,True,59931.84,61231.84,60731.84,60681.84,,False,,,2024-05-13 09:40:14,fail,False,-73.52,3168.9400000000055,0,1,20,5
2024-05-13 06:15:00,60836.34,60925.738,60731.84,60800.438,2097,36422,0,60689.5371105021,60941.49999783609,0.0013607283075043628,0.0016974182751689256,-0.001649441638558859,-0.0009361496919961845,60278.49343132461,60167.34692494927,2024-05-13 06:00:00,2024-05-13 06:00:00,-79.65560714284948,-324.8368434181393,61286.764011904794,0.0007823357295675432,0.0011891877166149934,61347.787226190514,60923.4491364913,62287.23371586571,61241.600877630066,62756.10532325018,0.002629940077336549,0.0013792162450330155,61853.95406799756,61566.25350748964,6.121927596070013,8.004497040943717,-312.9898980859397,61110.091477507565,61178.22162347226,61003.28733470935,-68.13014596469293,6.822545834509656,217.60758188666466,-100.15579222561064,-100.36492707260186,-71.94396869622142,61297.057570256344,60708.01709916235,False,True,59900.438,61200.438,60700.438,60650.438,,False,,,2024-05-13 09:22:20,fail,False,-73.52,3095.4200000000055,0,2,20,5
2024-05-13 10:45:00,61692.848,62407.738,61603.969,62278.34,3076,36422,0,61603.96899999999,62421.86264960011,0.005195659132055493,0.0037853878548986426,0.0036661088046669793,0.0016355609740207624,62418.22945628584,64274.35407374859,2024-05-13 10:00:00,2024-05-13 10:00:00,108.55994047618151,-281.6443301676554,61467.99639285717,8.458062161234234e-05,0.0014702326338301768,61076.181833333336,60773.67808599969,62779.660132187935,59961.85418261919,61359.845795512665,-0.0006623595714837264,-0.0018190226984060344,61786.50708711366,61525.80935636841,93.78490479515534,89.39901531672585,-310.6066024174794,61471.25320847236,61296.2718164436,61635.31021052626,174.9813920287561,48.762306845620664,349.7461008420989,186.18476883383846,94.03476264186611,109.49662469901523,62108.96744666309,61163.15297438943,True,False,63178.34,62378.34,62378.34,62428.34,2024-05-13 11:15:00,True,2024-05-13 11:15:00,2024-05-13 12:26:59,2024-05-13 13:37:11,success,True,165.38,3260.8000000000056,1,0,20,5
2024-05-13 11:00:00,62278.184,62635.539,62278.184,62621.637,3796,36422,0,62278.183999999994,62745.9725626616,0.002351428841682735,0.00267797155161426,0.005573393697664825,0.0027935411854648293,63179.39015318067,65633.82229501364,2024-05-13 11:00:00,2024-05-13 11:00:00,391.8145595238311,-175.7946992372963,61964.986559523764,0.0002644468828900547,0.0036158683971669043,61467.99639285717,60844.94940246845,64014.049263561894,60773.67808599969,62779.660132187935,0.0014702326338301768,8.458062161234234e-05,61823.555358207246,61622.243647858944,96.28467841770208,92.72844652959162,-283.64422178144275,61648.235330245836,61394.44701522555,61872.5732077743,253.78831502028333,89.7675084805532,454.1866656439561,237.26299724804267,186.18476883383846,94.03476264186611,62487.22520639364,61259.42120915496,True,False,63521.637,62721.637,62721.637,62771.637,2024-05-13 11:45:00,True,2024-05-13 11:45:00,,2024-05-13 13:14:41,even,True,18.38,3279.1800000000057,2,0,20,5
2024-05-17 18:00:00,66758.109,66901.734,66499.633,66844.734,3318,36421,0,66499.63299999996,67322.97646155945,0.0023618536578989564,0.00043600476388758105,0.003360546350872677,0.0017437924378150777,67317.85933451566,68890.97189482131,2024-05-17 18:00:00,2024-05-17 18:00:00,151.0316428571823,284.1524632077635,66637.82895238097,-0.0007250219219081884,0.002044015546616939,66345.04140476194,65474.38938141424,67951.72625380747,65648.24769154508,67023.49234440179,0.0007630611086164795,-0.00034823300016879487,65372.2978204778,65962.61808838196,87.16072895358955,75.65761717827685,225.90398707845722,66354.4246857148,66225.84721453617,66360.14848366014,128.57747117862164,81.94102796286441,205.45405865405587,123.78570863434288,117.24818163053715,18.833136566943722,66639.01146284312,66082.78550447717,True,False,67744.734,66944.734,66944.734,66994.734,2024-05-17 18:30:00,True,2024-05-17 18:30:00,2024-05-20 19:04:10,2024-05-17 19:46:19,even,True,18.38,3297.560000000006,3,0,20,5
2024-05-20 19:30:00,67772.57,68206.102,67605.766,68200.438,2859,36421,0,67605.76600000003,68205.43082851544,0.0028079832171100747,0.0018291524035401485,0.002281229885035519,0.004139265625868544,69917.08976327785,69504.88505062049,2024-05-20 19:00:00,2024-05-20 19:00:00,135.00941666669678,230.85586932563456,67476.37504761906,7.511550924103373e-05,0.0022117465356473577,67122.85822619048,66729.19429169102,68832.02980284704,66695.25076921667,67580.49364244472,0.0004438009432589365,-9.647747424619833e-06,66326.39615605057,66842.63149374482,83.88077524584675,80.42832409521765,215.4491490729109,67380.76890472458,67163.00484948931,67545.29106295147,217.76405523526773,101.70565407484236,330.0220732924911,213.58189026487526,141.37875404195802,96.83652975573204,67992.32086189633,67099.7612640066,True,False,69100.438,68300.438,68300.438,68350.438,2024-05-20 21:15:00,True,2024-05-20 21:15:00,2024-05-20 22:22:58,2024-05-20 21:18:13,even,True,18.38,3315.940000000006,4,0,21,5
2024-05-20 20:00:00,68143.68,68410.961,67985.836,68343.938,2557,36421,0,67985.836,68675.48838254789,0.00043790636512225795,-0.0013806936538942318,0.0020110133740379047,0.003255082488593762,69809.04157232793,69610.27678247818,2024-05-20 20:00:00,2024-05-20 20:00:00,353.51682142858044,311.2217744536465,67804.25804761903,0.0021675744641120945,0.0026759419098587012,67476.37504761906,67737.60331026786,69343.39610295955,66729.19429169102,68832.02980284704,0.0022117465356473577,7.511550924103373e-05,66402.66403228388,66956.91913424522,97.2973608853484,92.02052051590266,234.60367414905804,67628.89516847144,67318.07631403404,67896.63110767114,310.81885443739884,169.31618977762392,457.3771216312635,180.3950853113056,170.94495940837078,213.58189026487526,68515.59022187335,67279.17199346893,True,False,69243.938,68443.938,68443.938,68493.938,2024-05-20 21:45:00,True,2024-05-20 21:45:00,2024-05-20 22:23:19,,success,True,165.38,3481.320000000006,5,0,21,5
2024-05-22 19:00:00,70469.836,70684.336,70309.445,70684.336,2188,36421,0,70309.44500000007,70841.53936244678,-0.0007208357911194775,-0.0020559969357125552,0.0011011434815552154,0.0017754669740583594,71335.57331025472,71417.84371500515,2024-05-22 19:00:00,2024-05-22 19:00:00,169.76929761901556,33.07823478709906,70131.3014285714,8.545338318756898e-05,0.0010212046982153017,70035.46334523805,69490.0337403092,70997.45508615534,69484.08125635158,70848.32012283494,0.0007595420253620787,8.547707267386311e-05,69574.75627502396,69997.81202691066,92.62838452189145,88.0669238715286,18.94931410248344,70167.82176743653,70039.50796242061,70255.43848538009,128.31380501591775,26.56818543498279,302.3893845635651,155.09721947029175,124.29514275879774,151.3829074647074,70665.16415454091,69847.21281621927,True,False,71584.336,70284.336,70784.336,70834.336,,False,,,2024-05-22 19:36:17,fail,False,-73.52,3407.800000000006,0,1,21,5
2024-05-27 04:15:00,68745.648,68816.938,68741.234,68786.734,797,36421,0,68653.07633620435,69210.84924072793,0.001740629954415492,0.0007349434865968987,6.445851677031069e-05,0.0009184646075838521,69257.6489684502,68878.33729006248,2024-05-27 04:00:00,2024-05-27 04:00:00,-9.661059523830772,184.31502471222484,68750.03817857141,7.293064769551893e-05,0.00015813919032269235,68631.77021428567,68166.18780329615,69358.80015530527,67673.90021129203,68460.77781976345,-0.0013087212905743839,-0.0009327716721305582,68435.294751516,68350.42139902232,91.10591171133369,90.72475290303059,66.5468198021798,68669.54892678437,68614.52419408041,68687.12041038868,55.024732703954214,48.0368913465243,202.344000483926,56.75162263496895,59.74186446508975,68.41951943591994,68961.78481104199,68413.95600973538,True,False,69686.734,68886.734,68886.734,68936.734,2024-05-27 04:45:00,True,2024-05-27 04:45:00,2024-05-27 18:00:35,2024-05-27 06:50:56,even,True,18.38,3426.180000000006,1,0,22,5
2024-05-27 18:00:00,69530.336,69931.734,69524.016,69907.234,2480,36421,0,69447.60334875432,69976.41907498581,0.00246367904807136,0.003881315529032561,0.003399789426348783,0.0016325193947531133,70128.0041365973,71897.11923873208,2024-05-27 18:00:00,2024-05-27 18:00:00,276.5807738095318,173.5321194704884,69511.25061904767,0.00179211151271568,0.003343135550074994,68976.48598809521,69264.64105053352,71555.9304476418,68406.20761302706,69942.95338025295,0.0014310541377739272,0.0003002322836664539,68636.42455648308,68769.46449572229,93.91458323703789,89.60424092834869,135.96753651148015,69106.70660826164,68885.2612065583,69321.67588235295,221.4454017033422,99.3151884281896,362.75939098145403,193.78796525626967,135.74607430344622,85.88820571034739,69812.90106017792,68831.95070452799,True,False,70807.234,70007.234,70007.234,70057.234,2024-05-27 18:45:00,True,2024-05-27 18:45:00,,2024-05-27 21:46:11,even,True,18.38,3444.5600000000063,2,0,22,5
2024-05-27 19:00:00,70403.234,70671.539,70393.852,70583.438,2379,36421,0,70393.85200000003,70867.4156831783,-0.0009128325755990816,-0.001991297306989399,0.0017883827222180296,0.004056481268195767,72727.6263614215,71815.56848909632,2024-05-27 19:00:00,2024-05-27 19:00:00,534.7646309524571,289.373166233112,69875.93079761903,0.0034616216325448965,0.0045442475325270515,69511.25061904767,70325.33791134928,72243.02049715805,69264.64105053352,71555.9304476418,0.003343135550074994,0.00179211151271568,68698.00167191512,68884.43861606451,93.1550390145665,90.68491203590769,166.64866245580652,69702.52355749304,69260.95981900125,70154.09980976951,441.56373849179363,259.88432356556524,674.6945880691044,210.5120381837187,216.92288923282467,247.72475679397758,71066.4375036628,69243.26211587622,True,False,71483.438,70183.438,70683.438,70733.438,,False,,,2024-05-27 20:23:03,fail,False,-73.52,3371.0400000000063,0,1,22,5
2024-05-29 18:45:00,67462.227,67600.438,67302.961,67402.836,2341,36421,0,67041.3728074017,67600.43800000001,0.0010414140167524409,0.00015740033694915275,-0.0013840867910434238,-0.0006394622236883367,66943.18493773906,66947.27940818475,2024-05-29 18:00:00,2024-05-29 18:00:00,-38.624940476205666,-173.403627055377,67665.25895238093,-0.0006658421644137982,0.0006857491304327204,67814.34455952374,67119.36867369454,68598.69727893661,67473.77950851744,68093.93012824249,-0.0006193641929044939,-0.00021103271595074562,68325.11387417345,68133.7207113563,17.868930510731364,18.47666551714225,-106.84454685282059,67680.76922119208,67832.56590873316,67594.64634124523,-151.79668754107843,-122.08713726837601,182.80421366989293,-67.61672170623206,-66.6059453044727,-17.320156518777367,67841.43202969959,67346.36065279087,False,True,66502.836,67302.836,67302.836,67252.836,2024-05-29 19:15:00,True,2024-05-29 19:15:00,,2024-05-29 19:17:28,even,True,18.38,3389.4200000000064,1,0,22,5
2024-05-29 19:00:00,67402.836,67421.938,67111.227,67231.836,2629,36421,0,67081.45850329306,67462.52182028563,0.002090455760551336,0.0014473441336326945,-0.0021547485126062168,-0.001317454112098496,66398.29388123837,66284.50977896198,2024-05-29 19:00:00,2024-05-29 19:00:00,-149.0856071428134,-211.54859644392855,67597.58432142861,-0.0012572962481391713,-0.00010129722620550954,67665.25895238093,66764.98033480952,68261.86571891126,67119.36867369454,68598.69727893661,0.0006857491304327204,-0.0006658421644137982,68295.86031048038,68089.35489444781,10.065077706893122,15.281952124139154,-127.78535677104219,67611.70257177792,67788.06739697515,67500.1406040591,-176.36482519723359,-132.94267485414753,218.3113315402034,-94.50573718613305,-67.61672170623206,-66.6059453044727,67794.86090163837,67203.92030647982,False,True,66331.836,67631.836,67131.836,67081.836,,False,2024-05-31 19:15:00,,2024-05-29 19:44:01,fail,False,-73.52,3315.9000000000065,0,1,22,5
2024-05-30 14:15:00,67988.039,68135.836,67870.0,68109.109,1711,36421,0,67870.00000000004,68179.63028162165,-0.0004673675901454873,-0.0007434563487847476,0.0006102205264358137,0.0007775684983976261,68300.84225284203,68473.9910516958,2024-05-30 14:00:00,2024-05-30 14:00:00,15.88260714293574,-42.98247553000692,67777.10351190479,-0.001431264423805146,-0.0006690666776385765,67775.8368452381,66467.56461835415,67947.20107097218,66200.2930202713,67728.56272305982,-0.0010534727448335984,-0.0023243477468007766,68027.9384695795,67871.38059678362,91.77897929704233,86.0730459233137,-73.23717098481173,67848.38235669854,67827.48258487259,67860.53134778123,20.899771825948847,-31.924574615506042,238.41676760244522,84.51013381492521,73.53179738561448,63.87539972482773,68183.89398404454,67538.66871151792,True,False,69009.109,68209.109,68209.109,68259.109,2024-05-30 17:00:00,True,2024-05-30 17:00:00,2024-05-30 20:23:23,2024-05-30 18:05:42,even,True,18.38,3334.2800000000066,1,0,22,5
2024-05-30 15:30:00,68046.336,68303.039,67881.914,68245.234,3022,36421,0,67881.91400000006,68339.48529659558,0.0013511774693711707,0.00027767736682907427,0.001488482329499003,0.0007887842073743838,68318.38582490826,69134.10848441113,2024-05-30 15:00:00,2024-05-30 15:00:00,1.26666666669189,-40.18621803437418,67911.45511904759,0.0005499097297059743,0.0002921528725332511,67777.10351190479,67449.48994796928,68441.7229298167,66467.56461835415,67947.20107097218,-0.0006690666776385765,-0.001431264423805146,68033.04503939992,67894.32262904094,85.15661141425251,77.71833621253164,-66.62698039472421,67960.3867545541,67892.91777068697,68099.0059325766,67.46898386713292,19.545927490523606,234.26137658708356,38.703976608259836,44.33066838658124,67.8449786722922,68416.75879096916,67782.75307418405,True,False,69145.234,68345.234,68345.234,68395.234,2024-05-30 17:00:00,True,2024-05-30 17:00:00,2024-05-30 20:25:02,2024-05-30 17:53:24,even,True,18.38,3352.6600000000067,2,0,22,5
2024-05-31 17:15:00,67836.039,67981.438,67691.836,67784.688,2951,36421,0,67445.96024935959,68037.16074551709,-0.0012450486717072804,-0.0023002813194740106,-0.0039943451523226136,-0.0026401356850583365,66170.78441162327,65809.45955131375,2024-05-31 17:00:00,2024-05-31 17:00:00,-46.08166666665056,2.0504431128210854,68076.4267380952,-0.00174475689280866,0.001782451915294794,68319.0125,66798.09041604321,69820.31323538185,68088.53977737311,69549.37931539363,0.0013689925150260115,0.00035895391804201325,68267.72506589738,68276.9643801446,5.67241815801728,19.013724284545948,36.396598620026985,68273.41797092685,68327.15066101613,68328.54305366357,-53.73269008928037,18.256187786687654,277.699884308388,-149.05846130021382,-137.7020856554591,-91.01336016507412,68703.43789747989,67952.14820984725,False,True,66884.688,67684.688,67684.688,67634.688,2024-05-31 17:45:00,True,2024-05-31 17:45:00,2024-05-31 19:09:17,2024-05-31 22:40:25,success,True,165.38,3518.040000000007,3,0,22,5
2024-05-31 17:30:00,67781.836,67880.836,67362.039,67365.141,2802,36421,0,67287.6802506961,67880.83600000005,-0.0001102030741358277,-0.0017831540505721527,-0.0028678889584964383,-0.0031115363910840573,65682.49181342946,66317.29338154993,2024-05-31 17:00:00,2024-05-31 17:00:00,-46.08166666665056,2.0504431128210854,68076.4267380952,-0.00174475689280866,0.001782451915294794,68319.0125,66798.09041604321,69820.31323538185,68088.53977737311,69549.37931539363,0.0013689925150260115,0.00035895391804201325,68267.72506589738,68276.9643801446,3.6976938245468696,8.056094844306637,36.396598620026985,68133.68305232273,68255.89068612605,68127.66096800825,-122.2076338033221,-9.836576531314297,334.52722511134493,-200.88208565532113,-149.05846130021382,-137.7020856554591,68579.27272190856,67674.54921410793,False,True,66465.141,67265.141,67265.141,67215.141,2024-05-31 19:15:00,True,2024-05-31 19:15:00,,2024-05-31 20:01:26,even,True,18.38,3536.420000000007,4,0,22,5
2024-06-03 04:45:00,68188.172,68601.438,68175.453,68503.234,1878,36421,0,68175.45300000005,68700.73797799344,0.0012816443189923221,0.0009379453002598135,0.001560293156860845,0.0016741839568398592,69110.39303660438,69477.8605820359,2024-06-03 04:00:00,2024-06-03 04:00:00,15.993392857097206,-140.14830569901096,68101.16863095232,0.0010580701220644579,0.0013912548430004238,67883.06966666666,67990.94413128657,68996.69204517569,67918.84325392796,68104.7157137939,0.00011941369812639525,0.0010581574625881456,68076.53035564342,67975.44535691295,83.17441925821548,79.2474843782057,-157.80114979003912,68048.71938023056,67914.37149233505,68101.4970732714,134.34788789550657,78.59247655089581,199.35556487471197,104.10298039217014,54.90372205020685,57.3344341244665,68372.12708585226,67832.36706069054,True,False,69403.234,68603.234,68603.234,68653.234,2024-06-03 05:15:00,True,2024-06-03 05:15:00,2024-06-03 15:21:23,2024-06-03 05:32:46,even,True,18.38,3554.800000000007,5,0,23,6
2024-06-03 05:00:00,68503.234,68762.438,68503.234,68715.734,2066,36421,0,68503.23399999997,68937.78206159128,-0.00047550817099078807,-0.0015685567517410024,0.0019088638960949996,0.0008395636914441222,68700.30798712134,69838.34974217527,2024-06-03 05:00:00,2024-06-03 05:00:00,218.09896428565844,-74.08571457100334,68241.78445238093,0.0007626130357396273,0.0016697370945050146,68101.16863095232,67940.31116554354,69307.11196551699,67990.94413128657,68996.69204517569,0.0013912548430004238,0.0010580701220644579,68090.86802797114,68012.78100835992,87.36759141846797,83.73024259958727,-141.05806274623197,68151.33701404124,67973.731678088,68238.44342414863,177.60533595323795,98.39504843136424,253.3099179714866,136.94635087723145,104.10298039217014,54.90372205020685,68581.91181341014,67896.47503488712,True,False,69615.734,68315.734,68815.734,68865.734,,False,2024-06-03 09:30:00,2024-06-03 15:39:10,2024-06-03 06:03:08,fail,False,-73.53,3481.270000000007,0,1,23,6
2024-06-06 23:00:00,70507.555,70518.641,70074.133,70424.641,2021,36421,0,70074.13300000003,70600.41950550224,0.0026348533687722176,0.0009275881441615293,-0.0024635541907043184,-0.003642553053270637,68022.61978089249,69202.41868908108,2024-06-06 23:00:00,2024-06-06 23:00:00,-227.42748809524346,5.959604744159151,70802.3150714286,-0.0018901297540171698,-0.0020541606937807973,70909.6387142857,69525.6584710593,70358.48945991026,70120.89842997723,70950.81539976594,-0.0012784165037178137,-0.0012060176575562512,70789.90055016705,71018.98747630615,19.909722382355937,20.402672738922288,65.1689253166971,70854.20959334553,70995.03116863167,70748.5306105951,-140.82157528614334,-70.24481322821259,282.43158450975494,-72.34180839352484,-62.72189955275098,-44.87598658417119,71129.81324968327,70365.74797150693,False,True,69524.641,70824.641,70324.641,70274.641,,False,2024-06-07 21:00:00,2024-06-07 21:01:15,2024-06-07 00:18:27,fail,False,-73.53,3407.7400000000066,0,2,23,6
2024-06-07 14:45:00,71557.938,71749.305,71557.938,71731.734,1487,36421,0,71558.59930181318,71967.23535576426,-0.004260298954801109,0.0003110087021445941,0.0014706777242785136,0.0015406650166728574,72439.36374093534,72617.0522281288,2024-06-07 14:00:00,2024-06-07 14:00:00,31.836678571475204,76.08530614216579,71434.63255952376,0.00019707394001980242,0.0006803155309827209,71296.1431666667,71168.08240366814,71953.67593351926,71363.79608052173,71454.60977095892,-4.764415268983897e-06,0.0007641914883663439,70952.16757257626,71143.08396692012,91.17960238124897,85.8838289468445,33.80228234908719,71406.11034980514,71292.75179164273,71500.32611592706,113.35855816240655,77.49805734701808,142.63281702387962,89.80949432410125,55.55494530434953,38.086945304399705,71694.3804189093,71307.77181294482,True,False,72631.734,71831.734,71831.734,71881.734,2024-06-07 15:15:00,True,2024-06-07 15:15:00,,2024-06-07 15:22:12,even,True,18.38,3426.1200000000067,1,0,23,6
2024-06-07 15:00:00,71731.734,71981.734,71726.641,71905.938,2289,36421,0,71629.16291252403,72211.18723277452,-0.006883253231520897,-0.001225502336013115,0.00236515246826603,0.001888293337559781,72809.25979803156,73388.64304593208,2024-06-07 15:00:00,2024-06-07 15:00:00,138.48939285705274,116.09843426286534,71401.08713095236,-0.0010616003953520207,0.001149665451842367,71434.63255952376,70338.10603774799,72381.82349263105,71168.08240366814,71953.67593351926,0.0006803155309827209,0.00019707394001980242,70963.84880502426,71151.6403695665,91.27971930323294,88.72974135090776,50.26151273184283,71483.00691137358,71338.1729922618,71602.15821121431,144.83391911178478,90.96522969997142,189.77724024902312,101.83209528724547,89.80949432410125,55.55494530434953,71859.85748555048,71345.95893687813,True,False,72805.938,71505.938,72005.938,72055.938,,False,,,2024-06-07 15:30:08,fail,False,-73.53,3352.5900000000065,0,1,23,6
2024-06-07 20:30:00,70465.539,70555.641,70261.938,70286.836,1768,36421,0,70071.0149486365,70864.39076127124,-0.012177803870382743,-0.006348431821369725,-0.0023977530514603445,-0.002899221953996843,68530.98849675599,69187.90059423917,2024-06-07 20:00:00,2024-06-07 20:00:00,-187.9939285715227,64.33774154269486,70689.42297619041,-0.002400979660956522,-0.0024409425356683085,71200.01963095235,69114.08016629821,70440.1256475887,70595.16167651738,71535.66127304579,-0.0008500240826298222,-9.478719961393528e-05,70959.33576045292,71066.96448147712,4.151619654406401,8.189966270161761,83.62861717756745,70889.16169964884,71089.09148442691,70679.3634183007,-199.929784778069,-93.3846708158921,397.2394338948517,-165.88655658751668,-140.92082628136268,-124.99773856210231,71215.63665405875,70141.59018254264,False,True,69386.836,70186.836,70186.836,70136.836,2024-06-07 21:00:00,True,2024-06-07 21:00:00,2024-06-07 21:04:24,2024-06-10 18:54:35,success,True,165.39,3517.9800000000064,1,0,23,6
2024-06-07 20:45:00,70281.938,70415.938,69806.141,69819.438,2038,36421,0,68431.84155117474,70415.93799999998,-0.0006846167435894872,-0.005471136356793935,-0.002259151113863383,-0.0040174371343454154,67556.60935432783,69129.39532897912,2024-06-07 20:00:00,2024-06-07 20:00:00,-187.9939285715227,64.33774154269486,70689.42297619041,-0.002400979660956522,-0.0024409425356683085,71200.01963095235,69114.08016629821,70440.1256475887,70595.16167651738,71535.66127304579,-0.0008500240826298222,-9.478719961393528e-05,70959.33576045292,71066.96448147712,3.4132123614608614,5.06215259708176,83.62861717756745,70724.5888227798,70995.04307817307,70456.76288269692,-270.4542553932697,-128.7985877313676,482.85580995891064,-222.60053560377855,-165.88655658751668,-140.92082628136268,71108.61822614145,69803.40753925238,False,True,68919.438,70219.438,69719.438,69669.438,,False,2024-06-07 21:15:00,2024-06-07 21:05:05,,success,True,165.39,3683.3700000000063,2,0,23,6
2024-06-07 21:00:00,69814.359,69906.539,68385.008,68530.594,6368,36421,0,68235.74241888717,69906.53899999998,0.0038409430477426456,-0.002718503665125151,-0.007250588992521425,-0.009566026771550235,63266.37548622286,65892.93709641744,2024-06-07 21:00:00,2024-06-07 21:00:00,-510.59665476193186,-52.975920847500674,70061.13339285717,-0.005431412620531923,-0.0029204422151777295,70689.42297619041,66867.03436137701,69967.39760936674,69114.08016629821,70440.1256475887,-0.0024409425356683085,-0.002400979660956522,70889.10047572928,70915.07420295896,2.4013478413290574,3.3220599523988583,56.307709572553826,70387.05115773674,70812.4912946047,70033.14157619535,-425.4401368679537,-188.12689755868485,703.0407955553924,-423.6213065015618,-222.60053560377855,-165.88655658751668,70982.24665019513,69082.53650219558,False,True,67630.594,68930.594,68430.594,68380.594,,False,2024-06-11 05:30:00,2024-06-11 07:26:34,2024-06-07 21:15:41,fail,False,-73.53,3609.840000000006,0,1,23,6
2024-06-11 05:00:00,68721.836,68956.242,68521.422,68551.836,2442,36421,0,67892.05085215835,68956.24199999998,-0.00043270466424655377,-0.002989485772339185,-0.0017689196016445789,-0.006551848868060803,64503.407174931795,68339.40053656859,2024-06-11 05:00:00,2024-06-11 05:00:00,-247.19578571428428,-189.59995654628437,68870.62501190482,-0.003198029014858077,-0.0007361664303004536,69217.31329761907,66973.27167290478,69285.50541258785,67856.86483453083,69195.66725862249,-0.0012247113307703268,-0.0022175293524732804,69873.66815201082,69526.65414404558,9.722957484135174,19.37942706002811,-154.55196305261515,69245.05692239209,69417.3231986804,69151.7280894393,-172.26627628831193,-87.15334023397119,257.9140994481272,-157.7262996215868,-142.61662229101057,-11.539972824219149,69499.91212369427,68802.04405518433,False,True,67651.836,68451.836,68451.836,68401.836,2024-06-11 05:30:00,True,2024-06-11 05:30:00,2024-06-11 07:26:34,2024-06-11 06:27:25,even,True,18.38,3628.220000000006,1,0,24,6
2024-06-12 16:00:00,69316.203,69641.039,69314.758,69361.539,2264,36421,0,69038.54913919253,69641.03900000002,0.0003227655355385187,-0.0007666148078823945,0.0043932525691769905,0.009434741879010245,74833.1243626557,72637.95364993087,2024-06-12 16:00:00,2024-06-12 16:00:00,587.3636428571481,107.71944958395034,68774.16185714286,0.0019461681690745877,0.005097564121653589,68336.28533333335,68403.31163923128,71318.03820877602,68267.67316528289,70668.55062597597,0.004124108894412777,0.0019460162441316629,68117.83485975498,67806.41860604023,92.1976230602247,89.7968133752254,-119.06172408444503,68400.92833876997,68000.86259240091,68710.14643412453,400.0657463690586,225.3998671600619,612.617887607086,229.62223907806037,247.97597110428615,305.1081974544795,69538.6805823941,67883.11228585496,True,False,70261.539,69461.539,69461.539,69511.539,2024-06-12 17:15:00,True,2024-06-12 17:15:00,,2024-06-12 19:27:14,even,True,18.38,3646.6000000000063,2,0,24,6
2024-06-13 05:00:00,67963.734,67987.039,67826.914,67898.234,1735,36421,0,67826.91400000002,68122.4230323985,-0.0007695542257516461,0.0003471290684074901,-0.0010348989377615804,-0.0013783476772745331,67021.58056334837,67524.40391265413,2024-06-13 05:00:00,2024-06-13 05:00:00,28.830595238134265,104.02969800635765,68091.87236904757,0.0010023386880995805,-0.0020651030907267525,68171.65545238099,67950.65455223265,67631.28874803388,68337.25042675856,67519.83357941495,-0.002962739364574353,0.0016613402393698116,68296.99347106724,68241.56712269303,19.395007563988685,24.675871333778996,213.45621416517923,68131.9834806573,68282.4942050624,68044.41103921572,-150.5107244050887,-144.3339763276341,187.98164187453008,-37.0598290333146,-45.87491159274941,-37.92871138625196,68298.18625574633,67789.1358226851,False,True,66998.234,67798.234,67798.234,67748.234,2024-06-13 06:00:00,True,2024-06-13 06:00:00,2024-06-13 06:38:11,2024-06-13 06:13:18,even,True,18.38,3664.9800000000064,3,0,24,6
2024-06-13 06:15:00,67823.539,67837.734,67401.859,67419.141,2362,36421,0,66816.46347311325,67837.73399999995,0.001829797570822756,-0.0008672793719586439,-0.0016240324514446205,-0.0017575495385644426,66447.60897530956,66948.49081945048,2024-06-13 06:00:00,2024-06-13 06:00:00,-79.78308333341556,44.29508035678009,67799.63284523813,-0.0009417316379855204,-0.001066225404567347,68091.87236904757,66680.7783155914,67907.22196081674,67950.65455223265,67631.28874803388,-0.0020651030907267525,0.0010023386880995805,68263.89325651558,68178.4767928776,12.176444547089405,17.76909891673081,179.62398740349943,67908.01294869372,68115.92648072948,67789.79382524939,-207.91353203576,-166.1585697827286,256.360747815563,-106.22973099420778,-43.33565015481145,-67.94781286544458,68135.8808348004,67442.20681569839,False,True,66519.141,67319.141,67319.141,67269.141,2024-06-13 06:45:00,True,2024-06-13 06:45:00,2024-06-13 18:42:58,2024-06-13 06:49:58,even,True,18.38,3683.3600000000065,4,0,24,6
2024-06-13 17:15:00,67414.219,67608.734,67121.836,67254.875,2488,36421,0,67121.83600000004,67773.61137428747,0.00048278275219125136,-0.000860223346780684,-0.0033348394388131508,-0.003276942763162353,65281.89358925513,65802.20198217765,2024-06-13 17:00:00,2024-06-13 17:00:00,-25.8170833333279,-149.8449111613736,67551.42866666667,-8.192344401007054e-05,0.002537866907845472,67663.16413095238,67099.86370431301,69647.76384556113,67503.66274894099,69422.51507651142,0.002397316067335226,0.0006469734578002233,68015.31237548598,67811.5323287733,11.359677589831742,29.082787582354204,-121.15670615362146,67643.19712452685,67657.44905269949,67717.15594496038,-14.251928172641783,26.430237265124106,238.2615317457972,-109.03711695913807,-96.50539422080328,-48.318559683539206,68038.8090128172,67394.00287710356,False,True,66354.875,67654.875,67154.875,67104.875,,False,2024-06-13 18:30:00,2024-06-13 18:57:19,2024-06-13 17:39:29,fail,False,-73.53,3609.8300000000063,0,1,24,6
2024-06-13 18:30:00,66957.039,67025.641,66496.039,66587.141,2874,36421,0,66338.9982912464,67025.64099999999,-0.0008000208553998873,-0.0010812479379810726,-0.003340020938276594,-0.0039832814742045645,64383.558213804594,65276.17951157422,2024-06-13 18:00:00,2024-06-13 18:00:00,-111.7354642857099,-168.9254327795934,67180.57990476192,-0.002031092857486006,0.001034451927676432,67551.42866666667,65786.80939870636,69080.77937448217,67099.86370431301,69647.76384556113,0.002537866907845472,-8.192344401007054e-05,67953.62518429046,67701.99286247145,6.233828652041336,11.195091214899755,-130.71045147881586,67312.86236078292,67479.60521714167,67150.01988132099,-166.74285635874548,-56.505783091445586,344.27228267559803,-180.77707911928883,-126.14027382187487,-91.34011799101427,67614.78746293305,66683.75229970893,False,True,65687.141,66987.141,66487.141,66437.141,,False,2024-06-14 19:00:00,2024-06-14 19:09:24,2024-06-13 19:59:02,fail,False,-73.53,3536.300000000006,0,2,24,6
2024-06-13 18:45:00,66586.039,66666.641,66337.273,66442.289,3263,36421,0,66093.98201404675,66848.25237650446,0.0021001930221638053,-0.00011247563043479818,-0.004006037944109792,-0.005014438790055936,63529.122115674174,64624.29459752285,2024-06-13 18:00:00,2024-06-13 18:00:00,-111.7354642857099,-168.9254327795934,67180.57990476192,-0.002031092857486006,0.001034451927676432,67551.42866666667,65786.80939870636,69080.77937448217,67099.86370431301,69647.76384556113,0.002537866907845472,-8.192344401007054e-05,67953.62518429046,67701.99286247145,4.125690021448296,6.701557830558454,-130.71045147881586,67178.92799758555,67402.76697883487,66969.29433677325,-223.83898124932603,-89.97242272302168,403.4179013384668,-180.7255445477349,-180.77707911928883,-126.14027382187487,67513.90850358018,66423.18016996632,False,True,65542.289,66842.289,66342.289,66292.289,,False,2024-06-14 19:15:00,2024-06-14 19:09:26,2024-06-13 19:50:21,fail,False,-73.53,3462.770000000006,0,3,24,6
2024-06-17 21:00:00,66566.891,66966.938,66504.117,66833.336,2402,36421,0,66504.11700000001,67057.9777573263,0.0010871483754960464,0.001521425871007415,0.0035055383619063945,0.003726069903093876,68454.0520418329,68912.59182452667,2024-06-17 21:00:00,2024-06-17 21:00:00,344.2999285714104,-190.06636525513022,66313.07646428568,0.0002527967872746784,0.0026871782291680527,65837.84051190478,65211.205737300945,68009.96315344443,65194.5237800746,66973.72242992175,0.0014291926261306214,0.00025269471562855276,66438.4446777406,66109.98779738284,95.05833178622787,91.79368335731515,-238.61919953949706,66080.48265561943,65896.1203431563,66319.15792948059,184.36231246312673,31.207983177766284,399.44693890833713,189.4974447884888,181.47553147572035,165.19604334364703,66859.91129700684,65779.90456195433,True,False,67733.336,66933.336,66933.336,66983.336,2024-06-17 22:00:00,True,2024-06-17 22:00:00,,2024-06-17 22:02:03,even,True,18.38,3481.150000000006,1,0,25,6
2024-06-18 14:15:00,65265.32,65305.637,65146.535,65148.738,1741,36422,0,65049.31412621069,65308.690526896724,0.0002847568260903912,0.0008693383757120405,-0.0010107958373183517,-0.001479351189902061,64345.913929178874,64847.47647556019,2024-06-18 14:00:00,2024-06-18 14:00:00,-55.28438095240563,-193.67742860343424,65434.28278571432,-0.0005023796502550515,-0.0006135770523052831,65507.336499999976,64934.50253297322,65436.1532431538,65354.93745720101,65591.3469485401,-0.00036448247844357047,0.00019176443934352283,66078.12966427696,65755.53085143314,10.018324030611184,20.707509244083713,-165.20583711031895,65417.203893826256,65509.443223805654,65347.21196663223,-92.23932997939846,-57.89139743190029,145.46269323162926,-80.328596491192,-56.39167973860458,-34.04445132440742,65543.58660249494,65149.33733076953,False,True,64248.738,65048.738,65048.738,64998.738,2024-06-18 15:30:00,True,2024-06-18 15:30:00,2024-06-18 18:11:25,2024-06-18 15:30:10,even,True,18.38,3499.530000000006,2,0,25,6
2024-06-21 02:15:00,64939.398,64975.84,64911.84,64917.34,816,36422,0,64912.486667437006,64975.19038808314,-0.001311944714360929,-0.00044381018361479995,5.896259488832542e-05,-3.908139173953941e-05,64891.992392358334,65053.063599796056,2024-06-21 02:00:00,2024-06-21 02:00:00,-5.547821428568568,-77.01201691084862,64951.8187857143,0.000675338511626545,-0.00016204997338232038,65017.88352380952,64992.243496559466,65074.99568574595,65198.85375167143,65239.470187589206,0.00013019714815010517,0.0010570717545611528,65238.5104879498,65145.06425281085,19.491592255163443,33.10785188774651,-21.179363637410887,64980.687484801274,65013.87534415538,64975.60426418982,-33.18785935410415,-32.15191446765128,99.74593662792442,-13.288905056760996,-15.001312349508225,-6.37329824565677,65110.26127863752,64839.447249742116,False,True,64017.34,64817.34,64817.34,64767.34,2024-06-21 03:15:00,True,2024-06-21 03:15:00,2024-06-21 11:49:44,2024-06-21 03:27:33,even,True,18.38,3517.910000000006,3,0,25,6
2024-06-21 02:30:00,64916.438,64926.34,64883.801,64893.84,906,36422,0,64810.83883170769,64973.07678075554,-0.001179360373865771,-0.0006544501840625996,-0.000495586745792007,-0.00017007938730148614,64795.33848023706,64694.216037390885,2024-06-21 02:00:00,2024-06-21 02:00:00,-5.547821428568568,-77.01201691084862,64951.8187857143,0.000675338511626545,-0.00016204997338232038,65017.88352380952,64992.243496559466,65074.99568574595,65198.85375167143,65239.470187589206,0.00013019714815010517,0.0010570717545611528,65238.5104879498,65145.06425281085,11.000538096205416,21.60467883606634,-21.179363637410887,64967.326333293386,65004.98383718091,64954.634144822805,-37.65750388752349,-33.25303235162573,85.83775222543613,-20.970119367011648,-13.288905056760996,-15.001312349508225,65070.51511032714,64837.25317931847,False,True,63993.84,64793.84,64793.84,64743.84,2024-06-21 03:15:00,True,2024-06-21 03:15:00,2024-06-21 11:49:47,2024-06-21 03:27:16,even,True,18.38,3536.2900000000063,4,0,25,6
2024-06-21 02:45:00,64889.262,64909.438,64812.84,64829.676,734,36422,0,64715.092763534834,64909.43799999999,-0.0010298365694977316,-3.5680967451266244e-05,-0.0005615490664857938,-0.0006236485378991305,64487.094196750375,64614.92564786195,2024-06-21 02:00:00,2024-06-21 02:00:00,-5.547821428568568,-77.01201691084862,64951.8187857143,0.000675338511626545,-0.00016204997338232038,65017.88352380952,64992.243496559466,65074.99568574595,65198.85375167143,65239.470187589206,0.00013019714815010517,0.0010570717545611528,65238.5104879498,65145.06425281085,3.914192254613107,11.468774201994082,-21.179363637410887,64946.14935894056,64991.99807146381,64926.60275748194,-45.84871252324956,-35.77216838595049,69.22936258762404,-28.031387340866786,-20.970119367011648,-13.288905056760996,65020.062396975234,64831.64311798864,False,True,63929.676,64729.676,64729.676,64679.676,2024-06-21 04:15:00,True,2024-06-21 04:15:00,2024-06-21 11:49:48,2024-06-21 04:20:16,even,True,18.38,3554.6700000000064,5,0,25,6
2024-06-21 03:00:00,64829.664,64888.738,64657.504,64679.84,1108,36422,0,64531.73748981932,64888.73800000004,0.0007776172821348681,0.00010596485720448698,-0.00044381018361479995,-0.001311944714360929,63975.984872406516,64656.4522685665,2024-06-21 03:00:00,2024-06-21 03:00:00,-66.0647380952214,-92.92473818815051,64879.98277380954,-0.0001313110392260117,-0.0001880944090479085,64951.8187857143,64547.99365808959,65046.749014334695,64992.243496559466,65074.99568574595,-0.00016204997338232038,0.000675338511626545,65221.005645285106,65116.83007258599,4.655321068305562,6.523350473041456,-35.528438547558814,64905.17868833432,64968.87525135538,64868.78217371862,-63.69656302105432,-41.35704731297126,93.27867447533264,-57.82058376332134,-28.031387340866786,-20.970119367011648,64994.70838426032,64741.35596317692,False,True,63779.84,64579.84,64579.84,64529.84,2024-06-21 07:00:00,True,2024-06-21 07:00:00,2024-06-21 11:49:48,2024-06-21 07:23:43,even,True,18.38,3573.0500000000065,6,0,25,6
2024-06-24 19:45:00,60502.172,60511.738,59950.973,60126.238,4153,36422,0,59787.025019461646,60511.73799999995,5.204974740177659e-05,3.8852188428943184e-05,-0.00149608826594092,-0.003643667276534244,58228.91832794166,60092.96239496265,2024-06-24 19:00:00,2024-06-24 19:00:00,-147.4487142857397,-764.9904178184006,60785.006142857135,-0.0012581799634865873,-0.0037739451598897194,61023.307345238136,59650.442191180504,60272.53967001085,60733.27433146887,60499.12034663147,-0.0037741364371244243,0.0004143359518076562,63141.34486883869,62208.15916939837,15.487987697386144,18.719721813269278,-663.376339808468,60851.828245776145,61151.2893952448,60735.13215514273,-299.4611494686542,-242.1173315815783,294.43971868792073,-168.73359236329998,-105.53147058819013,-63.297373925066495,61132.62577537142,60336.13853491404,False,True,59226.238,60026.238,60026.238,59976.238,2024-06-24 20:30:00,True,2024-06-24 20:30:00,2024-06-24 22:55:37,2024-06-24 20:31:46,even,True,18.38,3591.4300000000067,7,0,26,6
2024-06-26 05:00:00,62047.039,62344.969,61952.863,62302.238,1757,36422,0,61952.86300000003,62592.1856445672,0.00015918544120128883,-0.002324805544200224,0.001638544893354133,0.0010675992119340907,62486.532379389006,63171.144473119646,2024-06-26 05:00:00,2024-06-26 05:00:00,9.61490476191102,183.44291441136738,61899.167630952354,-0.0005458535995506741,0.00016091928295589665,61840.895,61386.9114406051,62487.47158221428,62019.248894740376,61992.881661787455,-0.0006156303101545963,0.001380840802242756,61790.50121182306,61574.93028794137,81.71465265733735,72.80523759414609,117.04679886097985,61929.94525251762,61852.10851688044,61914.13798004817,77.83673563717457,40.52252252110939,155.98727196861728,89.56854798763379,41.72709184728592,21.09238321294106,62126.22079720581,61703.55516289054,True,False,63202.238,61902.238,62402.238,62452.238,,False,,,2024-06-26 06:20:08,fail,False,-73.53,3517.9000000000065,0,1,26,6
2024-06-27 08:45:00,60970.137,60978.438,60766.938,60771.938,908,36422,0,60737.84861532127,60978.438,-0.0009468515561430416,-0.0009344403418380985,-0.0007993012863159982,-0.0008676648046456168,60344.29202061783,60588.8757820112,2024-06-27 08:00:00,2024-06-27 08:00:00,36.85977380951954,-135.43190282095748,60961.15450000001,0.00011336932863770324,0.000853890552907307,61023.889273809524,60795.206080212134,61604.2349551699,60974.25439440987,61493.6342608999,0.000665958173730931,0.0004942152724447612,61382.86294937568,61150.18745552546,14.921286093254944,26.476574381722454,-133.72310988442882,60972.66100242031,60982.873542639216,60975.350392844855,-10.212540218904905,9.861186063710164,94.67281055074821,-47.324932920550054,-12.058434468490304,-25.458908496744698,61103.15868708836,60846.04209860135,False,True,59871.938,61171.938,60671.938,60621.938,,False,2024-06-28 22:30:00,,2024-06-27 12:51:07,fail,False,-73.53,3444.3700000000063,0,2,26,6
2024-06-27 09:00:00,60770.84,60828.738,60691.637,60733.84,1191,36422,0,60641.89164946462,60829.547042857994,-0.00030269859224438847,-0.00017434570419140165,-0.0004924995672123283,-0.0009800016380869104,60217.4720905967,60708.27651963427,2024-06-27 09:00:00,2024-06-27 09:00:00,-62.73477380951226,-148.6430208292877,60877.40917857144,-0.0003921895040738194,0.0003215219042613718,60961.15450000001,60491.59567815629,61426.746547156676,60795.206080212134,61604.2349551699,0.000853890552907307,0.00011336932863770324,61356.81102979232,61115.655579083425,10.599156289604485,17.528119008781527,-136.70709207340062,60935.91930974026,60964.426613554824,60932.236348813225,-28.507303814563784,2.1874880880553746,103.26039307293802,-43.11404403163033,-47.324932920550054,-12.058434468490304,61071.63787946169,60791.33481816476,False,True,59833.84,61133.84,60633.84,60583.84,,False,2024-06-28 22:30:00,,2024-06-27 12:50:45,fail,False,-73.53,3370.840000000006,0,3,26,6
2024-06-27 17:00:00,61945.137,62329.738,61938.156,62329.738,2462,36422,0,61938.15599999997,62473.5035977442,-0.0014925978688284207,-0.0018374584505169863,0.0027784906695702163,0.0014897056331817367,62447.41452116211,63737.19859478618,2024-06-27 17:00:00,2024-06-27 17:00:00,289.4360714285067,21.76622657944972,61631.45957142851,0.0017761235687731587,0.0033473011823083564,61504.65278571427,61777.88757340283,63208.600292410534,61667.59518001828,62631.79893582561,0.0026256539192557435,0.0017761275149726242,61339.66544739174,61218.863752059944,91.5673240846224,81.38127593474137,-84.6056124047679,61593.67627090903,61344.92802595338,61753.47552356383,248.74824495565554,153.61925977079807,367.02919456774094,165.58260061922192,103.6520880632961,52.48944272445078,62250.46493623028,61257.98611089738,True,False,63229.738,61929.738,62429.738,62479.738,,False,,,2024-06-27 17:49:00,fail,False,-73.53,3297.310000000006,0,4,26,6
2024-06-28 02:15:00,61592.137,61656.738,61583.801,61624.137,408,36422,0,61577.08433388797,61672.79086736945,9.367570075439308e-06,8.186634470906234e-05,6.188456847749704e-05,0.00018213047931265407,61673.79037060452,61687.38235915504,2024-06-28 02:00:00,2024-06-28 02:00:00,8.862357142817928,113.16559464084276,61561.88979761908,-0.0005086845151952747,-0.0008132136832389916,61552.28830952381,61093.13827532237,61475.476835522335,61092.81751878265,61433.15327182487,-0.0009795970290415337,-0.0005940965672163617,61422.25847133337,61425.076192693145,86.90750618712876,85.62831145582221,88.95059515506706,61579.279665736845,61580.98803984899,61584.5724134847,-1.7083741121459752,-10.906689963483327,147.45207226378045,42.61780564158835,24.906014103871712,30.798889920864895,61785.1327110408,61385.51211592859,True,False,62524.137,61724.137,61724.137,61774.137,2024-06-28 04:30:00,True,2024-06-28 04:30:00,2024-07-01 01:26:05,2024-06-28 05:29:53,even,True,18.38,3315.690000000006,1,0,26,6
2024-06-28 02:45:00,61606.637,61667.438,61578.238,61663.75,299,36422,0,61578.238000000034,61730.03180682108,-0.0007954041701798109,-0.000697008862433168,0.00019204811810179852,3.1260301139310884e-05,61593.69359493933,61784.271744733756,2024-06-28 02:00:00,2024-06-28 02:00:00,8.862357142817928,113.16559464084276,61561.88979761908,-0.0005086845151952747,-0.0008132136832389916,61552.28830952381,61093.13827532237,61475.476835522335,61092.81751878265,61433.15327182487,-0.0009795970290415337,-0.0005940965672163617,61422.25847133337,61425.076192693145,87.43934532731932,85.63503726097103,88.95059515506706,61595.55015120804,61588.726920309484,61633.28269556242,6.823230898553447,-5.547618634333029,127.47905695682542,27.17756037147774,21.532721706244047,42.61780564158835,61806.879422454134,61461.1859686707,True,False,62563.75,61763.75,61763.75,61813.75,2024-06-28 04:30:00,True,2024-06-28 04:30:00,2024-07-01 01:26:06,2024-06-28 05:28:05,even,True,18.38,3334.070000000006,2,0,26,6
2024-06-28 10:45:00,61371.738,61376.34,61174.41,61299.738,1403,36422,0,61104.0590930591,61376.34000000001,0.0010857360290114047,0.00023771602715160644,-0.0011879364763949817,-0.001788919144861518,60302.83865027136,60831.86039655946,2024-06-28 10:00:00,2024-06-28 10:00:00,-47.99313095240359,102.78135543187818,61520.09592857148,-0.000617433504919956,-0.0014389189843900805,61655.08909523807,61023.2982435626,61294.861359857656,61458.40701201134,61421.961215942254,-0.0013687371646371332,2.9908957141923267e-05,61480.77489448678,61521.55960348911,13.907917316761427,17.307178085330985,116.0454221560461,61506.83568907462,61575.18607182493,61436.159234606166,-68.3503827503082,-36.89760158044925,161.47791057657534,-36.12654901957285,-36.46249329204147,-26.617849673173623,61654.15441388454,61216.66405532779,False,True,60399.738,61699.738,61199.738,61149.738,,False,2024-06-28 17:30:00,2024-06-28 22:17:52,2024-06-28 14:20:04,fail,False,-73.53,3260.540000000006,0,1,26,6
2024-06-28 17:30:00,61043.137,61144.34,60831.84,60860.238,2251,36422,0,60665.23201347996,61144.34000000002,0.0003148421561635715,-0.0008062194131523695,-0.003251066176535153,-0.0019684097909721857,59880.132883296064,59591.85080310675,2024-06-28 17:00:00,2024-06-28 17:00:00,-65.1363571428883,0.3682388560337131,61241.99024999998,-0.0010146826071251297,-0.00016805713228027386,61409.08985714286,60495.07689773227,61761.54528056847,61140.73864334965,61771.88052225723,-0.0001680070225471823,-5.493705120271765e-05,61451.07713237243,61442.93560952929,8.783497059383787,19.117985834861344,48.256285153173565,61314.95758306187,61416.41336818141,61247.78860577916,-101.45578511954227,-36.521982345337186,203.25451257368394,-120.3111658066482,-88.86701547988196,-54.94295493645768,61522.18219775364,60971.895013804686,False,True,59960.238,60760.238,60760.238,60710.238,2024-06-28 22:30:00,True,2024-06-28 22:30:00,,2024-07-01 00:00:02,even,True,18.38,3278.920000000006,1,0,26,6
2024-06-28 18:00:00,60887.055,60944.738,60702.84,60779.84,1969,36422,0,60640.20793078787,60944.1303086438,0.0013571062020723763,0.0011831891764564127,-0.0022996510896830034,-0.0014879176920621112,59932.78046835188,59830.744633333605,2024-06-28 18:00:00,2024-06-28 18:00:00,-167.09960714288172,-47.23814374720678,61118.92072619043,-0.0011698610645915664,-0.00016804140176853306,61241.99024999998,60387.340056496105,61751.225169977835,60495.07689773227,61761.54528056847,-0.00016805713228027386,-0.0010146826071251297,61434.240303651946,61409.23980076695,7.823448218379428,8.188886035142739,29.157399373097498,61177.421228109386,61333.212229236466,61031.90672067424,-155.79100112707965,-74.97599427780867,264.7733075633981,-112.33971379431023,-103.5421713106116,-120.3111658066482,61389.35068588483,60672.96275546365,False,True,59879.84,60679.84,60679.84,60629.84,2024-06-28 22:30:00,True,2024-06-28 22:30:00,,2024-07-01 00:00:02,even,True,18.38,3297.300000000006,2,0,26,6
2024-07-02 11:00:00,62591.84,62671.738,62368.297,62449.621,1167,36422,0,62368.296999999984,62671.73800000004,0.0010409862662621536,0.000886353118225394,-0.00022585367470798282,-0.0010786674443809324,61829.69327925748,62557.957885935124,2024-07-02 11:00:00,2024-07-02 11:00:00,-126.05884523809073,63.13429895584704,62748.00251190475,-0.0009361724284408231,-0.0009096454786417724,62840.68158333332,62132.80984132141,62747.14995507562,62432.417005785646,63062.259431488455,-0.0004000571308068009,-0.00045677624708746447,62584.2447817464,62865.37865449032,8.585317065961233,8.894400981499972,149.21319233612857,62738.42148575826,62856.55476618111,62604.880920880605,-118.13328042284411,-65.57877818246095,195.28653099375995,-65.34152528379491,-50.25481492947438,-71.73042174061993,62868.517737722184,62339.744104039026,False,True,61549.621,62849.621,62349.621,62299.621,,False,2024-07-02 17:45:00,2024-07-03 04:55:10,2024-07-02 15:41:46,fail,False,-73.53,3223.770000000006,0,1,27,7
2024-07-02 17:15:00,62345.41,62421.637,62194.344,62341.238,2335,36422,0,61890.94062626671,62524.0132488977,-0.00034099052000930927,-0.0021081835042552257,-0.003939189876557742,-0.0029263273831986337,60690.2652320419,60514.93256730595,2024-07-02 17:00:00,2024-07-02 17:00:00,-21.084785714221653,-16.896979343044222,62498.878321428565,-0.0013605060357291794,0.0007993068260453134,62711.07894047623,61523.36705573765,63403.062431470134,62619.119866220324,63222.67340478243,0.0002921986015220348,0.0004438312173042715,62585.07405842701,62750.946934236505,11.13262149953023,28.678205247006662,39.251779170938335,62654.49591983156,62711.74383940608,62679.05462882697,-57.247919574518164,-20.270697091558695,141.93027455476786,-79.6321365668773,-81.36412039914285,-35.33363742686197,62870.6604994759,62485.948758178034,False,True,61441.238,62241.238,62241.238,62191.238,2024-07-02 17:45:00,True,2024-07-02 17:45:00,2024-07-03 04:55:10,2024-07-02 21:07:33,even,True,18.38,3242.150000000006,1,0,27,7
2024-07-02 17:30:00,62316.438,62392.34,61869.84,61878.137,2350,36422,0,61860.90856157724,62392.33999999998,2.4949871355721973e-05,-0.0017312584348740151,-0.002997957617057818,-0.0034080529546965323,60199.615766440846,60906.222260624534,2024-07-02 17:00:00,2024-07-02 17:00:00,-21.084785714221653,-16.896979343044222,62498.878321428565,-0.0013605060357291794,0.0007993068260453134,62711.07894047623,61523.36705573765,63403.062431470134,62619.119866220324,63222.67340478243,0.0002921986015220348,0.0004438312173042715,62585.07405842701,62750.946934236505,6.779764170097645,14.685342437698312,39.251779170938335,62535.05608601132,62649.995184635256,62509.710421052594,-114.93909862393775,-39.20437739803451,216.51361323279502,-169.3442077743748,-79.6321365668773,-81.36412039914285,62802.00379891687,62215.91704318832,False,True,60978.137,62278.137,61778.137,61728.137,,False,2024-07-03 05:00:00,2024-07-03 06:12:42,2024-07-02 21:12:33,fail,False,-73.53,3168.620000000006,0,1,27,7
2024-07-02 18:00:00,62012.848,62130.438,61972.469,62005.277,1601,36422,0,61910.50286313085,62130.43800000002,-0.0007165699465033119,-0.00034737122367872075,-0.0021081835042552257,-0.00034099052000930927,61658.50477664116,61085.999059340385,2024-07-02 18:00:00,2024-07-02 18:00:00,-212.20061904766771,-77.46377480283263,62272.186642857145,-0.0013573987609684442,0.0007843424950983707,62498.878321428565,61441.29990846201,63447.55840145332,61523.36705573765,63403.062431470134,0.0007993068260453134,-0.0013605060357291794,62559.260958096536,62685.01837949759,7.88968215143102,7.992165085098872,15.90866837618414,62385.77884264716,62558.64725431692,62271.99764981084,-172.86841166976228,-83.33742447774104,282.109919000997,-111.70030718948692,-126.01246405226993,-169.3442077743748,62652.84604046218,61889.649259159494,False,True,61105.277,62405.277,61905.277,61855.277,,False,2024-07-03 05:00:00,2024-07-03 04:55:15,,success,True,165.39,3334.0100000000057,1,0,27,7
2024-07-04 11:15:00,58292.438,58305.137,58039.863,58039.863,1499,36422,0,57458.50602857904,58348.50253123798,-0.008330432433691592,-0.003171592706044196,-0.0014654891541109882,-0.0007568918365571144,57630.99625407643,57702.41184622363,2024-07-04 11:00:00,2024-07-04 11:00:00,-199.54482142858615,-659.8297960794152,58287.01905952379,-0.0019056711102220258,-0.004623636163442313,58526.75483333333,56555.02702139519,57487.83079502451,58411.7205536748,57752.72380036891,-0.0046234369670037825,0.00148729800460321,60458.687527262315,59598.3730789146,11.92174716377536,12.88972512146645,-570.8630233894243,58510.127626065325,58825.18078110221,58340.00599896799,-315.05315503688325,-279.40422932400816,279.18742561969003,-101.9365706913959,-73.48431475752295,-109.9082063983733,58716.90902355457,57961.60297438141,False,True,57139.863,58439.863,57939.863,57889.863,,False,2024-07-04 11:45:00,2024-07-04 11:40:22,,success,True,165.39,3499.4000000000055,2,0,27,7
