time,open,high,low,close,tick_volume,spread,real_volume,bb_lower,bb_middle,bb_upper,ema_50,lsma,lsma_long,long_smooth,long_smooth_grad,lsma2,lsma2_grad,lsma2_smooth,lsma2_smooth_grad,lsma3,lsma3_grad,lsma3_smooth,lsma3_smooth_grad,lsma_grad,lsma_long_grad,support_trendline_15,resistance_trendline_15,support_gradient_15,resistance_gradient_15,supertrend_dir,Span_A,Span_B,fixed_resistance_gradient_15,fixed_support_gradient_15,fixed_support_trendline_15,fixed_resistance_trendline_15,fixed_support_grad,fixed_resistance_grad,ema_short,ema_long,macd_line,macd_signal,lsma_stddev,lsma_slope,prev_lsma_slope_1,prev_lsma_slope_2,lsma_upper_band,lsma_lower_band,stoch_k,stoch_d,is_doji,is_doji_star,3whitesoldiers,3blackcrows,engulfing,inverted_hammer,two_crows,three_inside,three_line_strike,three_outside,three_stars_in_south,abandoned_baby,advance_block,belt_hold,breakaway,closing_marubozu,conceal_baby_swallow,counterattack,dark_cloud_cover,doji,doji_star,dragonfly_doji,evening_doji_star,evening_star,gap_side_side_white,gravestone_doji,hammer,hanging_man,harami,harami_cross,high_wave,hikkake,hikkake_mod,homing_pigeon,identical_three_crows,in_neck,kicking,kicking_by_length,ladder_bottom,long_legged_doji,long_line,matching_low,mat_hold,morning_doji_star,morning_star,on_neck,piercing,rickshaw_man,rise_fall_3_methods,separating_lines,shooting_star,short_line,spinning_top,stalled_pattern,stick_sandwich,takuri,tasuki_gap,thrusting,tristar,unique_3_river,upside_gap_two_crows,xside_gap_3_methods,be_increment,be_condition_increment,ticket,in_session,is_buy2,is_sell2,signal,tp,sl,be,be_condition,conditions_arr,order_type,lot,first_time_to_trail,last_time_to_trail,sl_updated,time_to_trail,time_tp_hit,time_sl_hit,entry_time,entry_price,exit_time,exit,exit_price,lot_size,profit,type,duration,account_balance,success,win_streak,losing_streak,Week,Month
2024-06-04 13:45:00,2331.33,2331.33,2328.81,2329.48,898,27,0,2328.591270067094,2332.3813333333333,2336.1713965995727,2339.990466615199,2331.112303299962,2331.112303299962,2331.233442837719,-0.014390804597951501,2333.635279720281,-0.5284498834462283,2334.066693861699,-0.17419968919966777,2331.5167715617704,-0.7354662004686361,2332.100944055948,-0.32858974359078275,-0.16368112717964323,-0.16368112717964323,2312.8685851334117,2337.2500688937685,2.6544180969846427e-05,8.83093928114584e-06,,7.755137607804633,7.755878115704839,-8.654566838716861e-06,3.7932840916571703e-06,2324.2484885579743,2356.5102010270202,0.009065849063517817,-0.02040391239506789,2331.9866391743594,2333.0684157874734,-0.8667581404060911,-1.089397703149627,1.5175897243831582,-0.16368112717964323,-0.03605635891608472,0.1565650723023282,2334.1474827487286,2328.0771238511957,36.59228604795225,56.37790727924334,0,0,0,0,0,0,0,0,0,0,0,0,0,-100,0,0,0,0,0,0,0,0,0,0,0,0,0,0,0,0,0,0,0,0,0,0,0,0,0,0,0,0,0,0,0,0,0,0,0,0,0,0,0,0,0,0,0,0,0,0,0,0,4,5,,True,False,True,1.0,2229.48,2296.48,2292.48,2284.48,"5,4,2299.48",1,0.01,2024-06-07 22:15:00,2024-06-07 23:00:00,True,,,2024-06-10 01:46:31,2024-06-04 13:50:00,2329.48,2024-06-05 14:30:00,manual,2333.85,0.01,-77.26,fail,1 days 00:40:00,622.74,False,0,1,23,6
2024-06-04 16:55:00,2326.73,2327.54,2322.07,2324.12,1700,27,0,2323.459237084233,2330.706666666667,2337.954096249101,2335.133628490094,2332.1961416388585,2332.1961416388585,2333.172729946854,-0.8528666419474575,2329.7900000000022,-1.6363636363612386,2331.5181196581284,-1.8056371406355538,2325.8979137529154,-2.183916083911299,2327.9015423465457,-1.8922766122755093,-1.1154134223202163,-1.1154134223202163,2315.226021289771,2332.22360599519,2.6458845855525633e-05,3.5966397192736594e-05,,7.75360920019725,7.75360920019725,-8.51988945383075e-06,-5.06713922384807e-06,2325.5222295554863,2355.6955861141987,-0.06193985465370133,-0.021414172498680273,2329.7453063999483,2330.7542415031003,-0.948595453836333,0.17884962112130104,5.003362976195343,-1.1154134223202163,-0.6989380793493183,-0.7442484241732927,2342.2028675912493,2322.189415686468,8.979357688009168,5.442197023268737,0,0,0,0,0,0,0,0,0,0,0,0,0,0,0,0,0,0,0,0,0,0,0,0,0,0,0,0,0,0,0,0,0,0,0,0,0,0,0,0,0,0,0,0,0,0,0,0,0,0,0,0,0,0,0,0,0,0,0,0,0,0,4,5,,True,False,True,1.0,2224.12,2384.12,2299.12,2294.12,"5,4,2294.12",1,0.01,2024-06-07 22:40:00,2024-06-07 22:40:00,False,2024-06-07 22:40:00,,2024-06-07 07:29:04,2024-06-04 17:00:00,2324.12,2024-06-05 14:30:00,manual,2333.85,0.01,-172.02,fail,0 days 21:30:00,450.72,False,0,2,23,6
2024-06-04 17:05:00,2328.78,2328.87,2323.68,2323.96,2150,27,0,2323.135509854299,2330.634666666667,2338.1338234790346,2334.8143466528986,2330.755160548757,2330.755160548757,2331.571000865158,-0.8521315041402886,2328.8654662004647,-0.8876456876464545,2329.4695260295334,-0.8536324786327896,2323.4480885780868,-1.3050466200520532,2324.6997125097178,-1.544580419580143,-1.0065398591054873,-1.0065398591054873,2315.3460264837936,2328.850800593864,2.6463588208634222e-05,4.1116076320118334e-05,,7.75360920019725,7.75360920019725,-8.522651611209063e-06,-5.068751512232652e-06,2325.498633934841,2355.6567307444307,-0.011797361848493892,-0.01970585746175857,2328.7308998484837,2330.116242715278,-1.2841626805598025,-0.2932893419399719,2.7884068032023817,-1.0065398591054873,-0.4344412309960717,-1.1154134223202163,2336.331974155162,2325.178346942352,22.461019806151665,17.72019583375199,0,0,0,0,0,0,0,0,0,0,0,0,0,-100,0,-100,0,0,0,0,0,0,0,0,0,0,0,0,0,0,0,0,0,0,0,0,0,0,0,0,-100,0,0,0,0,0,0,0,0,0,0,0,0,0,100,0,0,0,0,0,0,0,4,5,,True,False,True,1.0,2223.96,2383.96,2298.96,2293.96,"5,4,2293.96",1,0.01,2024-06-07 22:40:00,2024-06-07 22:40:00,False,2024-06-07 22:40:00,,2024-06-07 07:29:04,2024-06-04 17:10:00,2323.96,2024-06-05 14:30:00,manual,2333.85,0.01,-174.86,fail,0 days 21:20:00,275.86,False,0,3,23,6
2024-06-04 18:55:00,2326.39,2326.74,2325.68,2326.02,850,27,0,2316.11558612177,2324.009000000001,2331.902413878232,2330.913602546956,2323.9590545050037,2323.9590545050037,2323.0034129279434,0.9217817327885314,2328.4202564102598,-0.6318298368273645,2328.9144599844703,-0.16532245532062007,2326.569393939397,-0.14141025640628868,2326.6009401709434,0.10408702408722093,0.9623826473803092,0.9623826473803092,2314.2506426333944,2329.3540565608455,3.161022539299004e-05,4.363798385262167e-05,,7.751952800112078,7.752194668399351,-1.2073141691371253e-05,-2.9568321737061535e-05,2334.244903869812,2356.6809825517093,2.817513163433887,0.42247409114315815,2325.5285565906756,2325.3162573219192,0.28086335762691306,-0.364995382031554,0.8814719832732153,0.9623826473803092,0.94215943641575,0.8608031145708992,2325.7219984715503,2322.196110538457,79.60562143170976,84.67846260115357,0,0,0,0,0,0,0,0,0,0,0,0,0,0,0,0,0,0,0,0,0,0,0,0,0,0,0,0,0,0,0,100,0,0,0,0,0,0,0,0,0,0,0,0,0,0,0,0,0,0,0,-100,0,0,0,0,0,0,0,0,0,0,4,5,,True,False,True,1.0,2226.02,2386.02,2301.02,2296.02,"5,4,2296.02",1,0.01,2024-06-07 22:20:00,2024-06-07 22:20:00,False,2024-06-07 22:20:00,,2024-06-07 07:33:19,2024-06-04 19:00:00,2326.02,2024-06-05 14:30:00,manual,2333.85,0.01,-138.43,fail,0 days 19:30:00,137.43,False,0,4,23,6
2024-06-05 13:05:00,2332.39,2332.55,2329.71,2330.01,763,27,0,2330.49217499582,2332.520333333333,2334.548491670846,2332.6173718560067,2332.2979362254355,2332.2979362254355,2332.595867012727,-0.24601878630619467,2332.6364685314684,-0.07564102564219866,2332.6722649572716,-0.048931623932276125,2331.230594405599,-0.4906876456852842,2331.5268686868753,-0.1260450660429342,-0.3711798294402797,-0.3711798294402797,2328.824039935589,2348.5617952976245,4.266107938916877e-05,6.025130264419801e-05,,7.754440200189901,7.7545021606226285,8.214991366428862e-06,2.72143716544095e-05,2311.3392357084804,2337.126734981071,0.5049243121902691,-0.8524656958293235,2331.9913058047496,2332.373192002233,-0.3378678953790768,-0.17806374504192607,0.7745367279605981,-0.3711798294402797,-0.1514327030026834,-0.21544382647653038,2333.8470096813567,2330.7488627695143,32.944158236964974,35.17041334201817,0,0,0,0,-100,0,0,0,0,0,0,0,0,0,0,0,0,0,0,0,0,0,0,0,0,0,0,0,0,0,0,0,0,0,0,0,0,0,0,0,-100,0,0,0,0,0,0,0,0,0,0,0,0,0,0,0,0,0,0,0,0,0,4,5,,True,False,True,1.0,2230.01,2297.01,2293.01,2285.01,"5,4,2300.01",1,0.01,2024-06-07 22:10:00,2024-06-07 23:00:00,True,,,2024-06-10 01:54:40,2024-06-05 13:10:00,2330.01,2024-06-05 14:30:00,manual,2333.85,0.01,-67.89,fail,0 days 01:20:00,69.54,False,0,5,23,6
2024-06-05 14:25:00,2334.31,2334.83,2333.83,2333.86,514,27,0,2330.4799885664115,2332.7166666666653,2334.953344766919,2332.780151245458,2333.6247556544304,2333.6247556544304,2333.463300210108,0.1874937584975669,2334.675850815848,-0.10272727272740667,2334.6912354312394,-0.008131313131798379,2333.6319580419586,0.0050699300713858975,2333.600038850043,0.03713286713355046,0.13452354467881378,0.13452354467881378,2330.5510211703104,2358.511744780243,3.29750365510119e-05,3.940029988946413e-05,,7.755033992434232,7.754677934237902,8.827943123949118e-06,2.654195079827593e-05,2312.424110381873,2337.1008096119817,0.061713534303180495,0.020790736380604358,2333.542118509835,2333.1345965942023,0.3747582289852289,0.2717288482893425,0.29421809226328804,0.13452354467881378,0.2153192436039717,0.2126384872090057,2334.213191838957,2333.036319469904,70.89471134365081,70.32073940441151,0,0,0,0,0,0,0,0,0,0,0,0,0,0,0,0,0,0,0,0,0,0,0,0,0,0,0,0,0,0,0,0,0,0,0,0,0,0,0,0,0,0,0,0,0,0,0,0,0,0,0,0,0,0,0,0,0,0,0,0,0,0,4,5,,True,True,False,0.0,2433.86,2366.86,2370.86,2378.86,"5,4,2363.86",0,0.01,2024-06-06 04:20:00,2024-06-06 06:00:00,True,2024-06-07 06:40:00,,2024-06-06 07:13:56,2024-06-05 14:30:00,2333.86,2024-06-06 07:13:56,auto,2366.85,0.01,583.17,even,0 days 16:43:56,652.7099999999999,True,1,0,23,6
2024-06-05 15:20:00,2334.49,2336.94,2334.48,2335.94,1451,27,0,2330.6823862024407,2333.237666666666,2335.792947130891,2332.9709190599447,2334.482700037078,2334.482700037078,2334.259507601036,0.18485181065261713,2335.6080536130526,0.6769114219127914,2334.865233100238,0.6141375291381337,2332.708916083916,0.5076689976694979,2332.4290132090177,0.11463480963539041,0.27244493882108145,0.27244493882108145,2332.2583039670635,2359.730612858086,3.171166992241905e-05,3.8892625299566256e-05,,7.755340670734178,7.755172230612022,8.829062990151054e-06,2.6545000964300126e-05,2313.0991254786545,2337.3277174254727,0.06150306440758868,0.02059897590243054,2334.009891667566,2333.5799565004245,0.3868105038632166,0.23649366282416953,1.2082070541988446,0.27244493882108145,0.12468743047702446,0.15742306266110973,2336.8991141454753,2332.0662859286804,69.45624268205107,63.858605672583565,0,0,0,0,0,0,0,0,0,0,0,0,0,100,0,0,0,0,0,0,0,0,0,0,0,0,0,0,0,0,0,0,0,0,0,0,0,0,0,0,0,0,0,0,0,0,0,0,0,0,0,0,0,0,0,0,0,0,0,0,0,0,4,5,,True,True,False,0.0,2435.94,2364.94,2368.94,2375.94,"5,4,2365.94",0,0.01,2024-06-06 04:30:00,2024-06-06 05:45:00,True,2024-06-06 18:45:00,,2024-06-06 09:28:13,2024-06-05 15:25:00,2335.94,2024-06-06 09:28:13,auto,2365.1,0.01,515.47,even,0 days 18:03:13,1168.1799999999998,True,2,0,23,6
2024-06-05 15:35:00,2335.29,2337.78,2335.29,2337.77,953,27,0,2330.846181600056,2333.718333333333,2336.5904850666097,2333.1530477988927,2335.229942899519,2335.229942899519,2334.9669714497577,0.24908095414684794,2336.9555477855483,0.5951048951037592,2336.4587839937917,0.44916472416571196,2334.133624708625,0.6262121212139391,2333.6105516705557,0.4749028749029094,0.312906933630984,0.312906933630984,2332.4802357730046,2361.4443488573097,3.171077313390983e-05,3.5108148541957295e-05,,7.755340670734178,7.755172230612022,8.831385991050292e-06,2.654563307587409e-05,2313.283331559775,2337.3895120133175,0.06126699234573607,0.0206118991236508,2334.965309881443,2334.156555419353,0.7319371762414448,0.4164638010218602,1.5748560025200673,0.312906933630984,0.16310048201557947,0.2712354467944351,2338.379654904559,2332.0802308944785,78.29912023460436,71.06549364613913,0,0,0,0,0,0,0,0,0,0,0,0,0,100,0,100,0,0,0,0,0,0,0,0,0,0,0,0,0,0,0,200,0,0,0,0,0,0,0,0,100,0,0,0,0,0,0,0,0,0,0,0,0,0,0,0,0,0,0,0,0,0,4,5,,True,True,False,0.0,2437.77,2366.77,2370.77,2377.77,"5,4,2367.77",0,0.01,2024-06-06 04:35:00,2024-06-06 06:00:00,True,2024-06-07 03:20:00,,2024-06-06 08:51:21,2024-06-05 15:40:00,2337.77,2024-06-06 08:51:21,auto,2366.78,0.01,512.82,even,0 days 17:11:21,1681.0,True,3,0,23,6
2024-06-05 17:15:00,2336.22,2340.63,2333.96,2340.59,1865,27,0,2331.5777087520787,2338.8660000000013,2346.154291247924,2335.5683239570953,2342.6425161290317,2342.6425161290317,2342.8787961932994,-0.3409902360644992,2340.9436596736623,-0.3944172494157101,2341.6556759906844,-0.9794599844594813,2336.0168648018644,-1.173578088580598,2337.117113442118,-1.0994405594410637,-0.0699799777548833,-0.0699799777548833,2333.9600000000005,2369.6104423150373,3.17131275056006e-05,1.5604855828310382e-05,,7.757548313044483,7.757229981615284,1.2009466501764357e-05,2.654372446442278e-05,2314.511954866111,2337.7709056434496,0.0614923807120249,0.02811949069109687,2340.0440511758793,2339.2960475451932,0.5904292178461219,1.198861196863894,2.887722780541448,-0.0699799777548833,-0.5688802372987993,-0.3841104931393602,2348.4179616901147,2336.8670705679488,25.584474924763303,25.26413479435125,0,0,0,0,0,0,0,0,0,0,0,0,0,0,0,100,0,0,0,0,0,0,0,0,0,0,0,0,0,0,0,0,0,0,0,0,0,0,0,0,0,0,0,0,0,0,0,0,0,0,0,0,0,0,0,0,0,0,0,0,0,0,4,5,,True,True,False,0.0,2440.59,2365.59,2369.59,2375.59,"5,4,2370.59",0,0.01,2024-06-06 04:35:00,2024-06-06 04:35:00,True,2024-06-06 18:45:00,,2024-06-06 05:02:35,2024-06-05 17:20:00,2340.59,2024-06-06 05:02:35,auto,2365.85,0.01,446.53,even,0 days 11:42:35,2127.5299999999997,True,4,0,23,6
2024-06-05 17:25:00,2345.49,2346.0,2343.84,2345.78,1414,27,0,2332.5276130340853,2339.7360000000012,2346.944386965917,2335.935303508525,2343.4543715239165,2343.4543715239165,2343.0595985663062,0.2472918057096649,2343.2588811188803,0.9502331002317987,2342.1703962704046,0.6402680652672643,2338.5223310023316,1.6831118881118527,2337.1261383061424,0.44396270396237014,0.3724634779396183,0.3724634779396183,2343.862093740079,2370.245249149379,1.563578444121739e-05,1.3902341944659554e-05,,7.757710273621285,7.757391942192086,1.2925467414394864e-05,2.6544708761997835e-05,2314.634933304293,2337.8223232194287,0.061388098712996,0.030216803080293175,2341.6419538004816,2340.2045949461535,1.2342641752024974,1.1659719310838175,3.8484904276277843,0.3724634779396183,0.4393919169451692,-0.0699799777548833,2351.1513523791723,2335.7573906686607,80.11858207802972,52.121659770821594,100,0,0,0,0,0,0,0,0,0,0,0,-100,0,0,0,0,0,0,100,0,100,0,0,0,0,0,0,0,0,0,0,0,0,0,0,0,0,0,100,0,0,0,0,0,0,0,0,0,0,0,0,0,0,0,100,0,0,0,0,0,0,4,5,,True,True,False,0.0,2445.78,2370.78,2374.78,2380.78,"5,4,2375.78",0,0.01,2024-06-06 18:45:00,2024-06-06 18:45:00,True,2024-06-07 07:15:00,,2024-06-06 19:23:36,2024-06-05 17:30:00,2345.78,2024-06-06 19:23:36,auto,2370.9,0.01,444.05,even,1 days 01:53:36,2571.58,True,5,0,23,6
2024-06-05 19:10:00,2353.51,2354.02,2352.81,2353.31,651,27,0,2337.3133267233943,2348.574000000002,2359.8346732766095,2341.0944236183905,2356.3436929922136,2356.3436929922136,2356.107545668025,0.3358618217775984,2355.310011655011,-0.360442890442755,2355.6305477855553,-0.2350777000783637,2352.897202797206,0.04451048951341363,2352.8150777000815,0.0892696192704534,0.21901965146344082,0.21901965146344082,2351.22023797442,2372.0903115353203,3.894964919936813e-06,9.782216640437213e-06,,7.7620432108880255,7.7602926828490535,4.36360718205166e-05,2.6462929342278248e-05,2315.944675819972,2328.111846629147,0.06015209099314234,0.10170349719737715,2352.9498434940883,2350.1638628274836,2.386624312659933,2.7101074727159102,1.712862578954377,0.21901965146344082,0.27040266963513204,0.5181631442342223,2359.7694181501224,2352.917967834305,58.53242031478385,62.51016946089984,100,0,0,0,0,0,0,0,0,-100,0,0,0,0,0,0,0,0,0,100,0,0,0,0,0,0,0,0,0,0,-100,0,0,0,0,0,0,0,0,100,0,0,0,0,0,0,0,100,0,0,0,-100,-100,0,0,0,0,0,0,0,0,0,4,5,,True,True,False,0.0,2453.31,2378.31,2382.31,2388.31,"5,4,2383.31",0,0.01,2024-06-07 07:30:00,2024-06-07 07:30:00,True,,,2024-06-07 08:48:12,2024-06-05 19:15:00,2353.31,2024-06-07 08:48:12,auto,2378.5,0.01,445.29,even,1 days 13:33:12,3016.87,True,6,0,23,6
2024-06-05 19:45:00,2353.22,2353.61,2352.07,2352.49,694,27,0,2345.8229987863447,2351.625333333335,2357.4276678803258,2342.5533174078682,2355.013998516869,2355.013998516869,2355.5231365714976,-0.4650290446188592,2353.4395687645697,0.1012121212143029,2353.352202797211,-0.0272027972032447,2352.482121212123,0.1788927738939492,2352.254584304587,0.16440559440616198,-0.4839718205439567,-0.4839718205439567,2351.283603813753,2372.252962709683,3.89632235326521e-06,9.781398230474946e-06,,7.761915091879981,7.7602926828490535,4.363408236277356e-05,2.397167008888692e-05,2317.5987768596606,2328.8243365206054,0.3169086659772802,0.10460670987777121,2352.9848648020247,2351.3675550399216,1.3222395619386589,1.865417379496283,0.7970794906300323,-0.4839718205439567,-0.5594705228022576,-0.3516447905099085,2356.608157498129,2353.419839535609,38.872832369938116,38.05297409311435,0,0,0,0,0,0,0,0,0,0,0,0,0,0,0,0,0,0,0,0,0,0,0,0,0,0,0,0,0,0,0,0,0,0,0,0,0,0,0,0,0,0,0,0,0,0,0,0,0,0,0,0,0,0,0,0,0,0,0,0,0,0,4,5,,True,True,False,0.0,2452.49,2377.49,2381.49,2387.49,"5,4,2382.49",0,0.01,2024-06-07 07:30:00,2024-06-07 07:30:00,True,,,2024-06-07 08:51:54,2024-06-05 19:50:00,2352.49,2024-06-07 08:51:54,auto,2377.53,0.01,442.64,even,1 days 13:01:54,3459.5099999999998,True,7,0,23,6
2024-06-05 20:10:00,2353.26,2354.32,2353.05,2353.67,622,27,0,2348.2898863891573,2352.512333333335,2356.7347802775125,2343.4517691027518,2354.0275469039666,2354.0275469039666,2354.0601188975384,-0.134518848103653,2353.3666200466214,0.21444055944175489,2353.179549339557,0.07243978243923266,2351.979242424244,0.3217832167833876,2351.784273504278,0.043341103341845155,-0.02310863922957651,-0.02310863922957651,2352.1385505194303,2372.368896095105,2.3806360127923353e-06,9.781752968533439e-06,,7.7618269307028775,7.7602926828490535,4.363833882015578e-05,3.1607766151528034e-05,2314.2346576378527,2329.3298144265214,-7.932000325453828,0.09956519450452106,2352.8983197669518,2351.8119839111605,0.8601835835893326,1.2347820100097713,0.6759754856801736,-0.02310863922957651,-0.05149870226114217,-0.3289492028188761,2355.379497875327,2352.675595932606,51.676929442398794,41.29020642710871,0,0,0,0,0,0,0,0,0,100,0,0,0,0,0,0,0,0,0,0,0,0,0,0,0,0,0,0,0,0,0,0,0,0,0,0,0,0,0,0,0,0,0,0,0,0,0,0,0,0,0,0,0,0,0,0,0,0,0,0,0,0,4,5,,True,True,False,0.0,2453.67,2378.67,2382.67,2388.67,"5,4,2383.67",0,0.01,2024-06-07 07:30:00,2024-06-07 07:30:00,True,,,2024-06-07 08:48:08,2024-06-05 20:15:00,2353.67,2024-06-07 08:48:08,auto,2378.66,0.01,441.76,even,1 days 12:33:08,3901.2699999999995,True,8,0,23,6
2024-06-05 21:25:00,2355.04,2355.95,2354.93,2355.53,476,27,0,2351.701845325368,2353.760333333334,2355.8188213413,2346.117921719089,2354.6279073044116,2354.6279073044116,2354.468522308736,0.17631912000979355,2355.3769463869494,0.3330303030320465,2355.1732323232413,0.12490287490345509,2354.16374125874,0.37487179487288813,2353.9000893550924,0.11946386946328857,0.21674378939633243,0.21674378939633243,2352.5206125666286,2372.717303319399,1.782951827239253e-06,9.780396945541957e-06,,7.763808930964887,7.763725659614492,4.578707017587337e-05,3.160991722963907e-05,2315.3311304008143,2329.5621321308336,0.07222361380081566,0.10727426813446073,2354.520521264213,2353.674012162477,0.6961338191458708,0.7324219256889529,0.5816709306189147,0.21674378939633243,0.04466740823181681,0.2675461624021409,2355.7912491656493,2353.464565443174,82.26070875194303,72.16894766602725,0,0,0,0,0,0,0,0,0,0,0,0,0,0,0,0,0,0,0,0,0,0,0,0,0,0,0,0,0,0,0,-100,0,0,0,0,0,0,0,0,0,0,0,0,0,0,0,0,0,0,0,0,0,0,0,0,0,0,0,0,0,0,4,5,,True,True,False,0.0,2455.53,2380.53,2384.53,2390.53,"5,4,2385.53",0,0.01,2024-06-07 07:35:00,2024-06-07 07:35:00,True,,,2024-06-07 08:21:25,2024-06-05 21:30:00,2355.53,2024-06-07 08:21:25,auto,2380.52,0.01,441.75,even,1 days 10:51:25,4343.0199999999995,True,9,0,23,6
2024-06-05 22:00:00,2355.71,2355.74,2354.9,2355.13,462,27,0,2351.8629791330027,2354.259000000001,2356.655020866999,2347.2636147388666,2355.75054727475,2355.75054727475,2355.7056109257196,0.0838415523421645,2356.222051282049,-0.04001165501358628,2356.230846930853,-0.01174436674637036,2355.2122144522154,0.0742424242416746,2355.0897474747526,0.053146853147154616,0.02469632925476617,0.02469632925476617,2352.549891235103,2372.879296542339,1.7831229570104446e-06,9.782680474541051e-06,,7.76405960724491,7.763793738926997,4.578293306561409e-05,3.1613051798065806e-05,2315.8419895311017,2330.31130255083,0.07106872574786394,0.10853327939685187,2355.1735625127976,2354.438756840012,0.6052699306101204,0.6925395192398304,0.5856482977610571,0.02469632925476617,0.08541638857877842,0.14141193919203943,2356.921843870272,2354.5792506792277,64.60085426374145,64.81450735782956,0,0,0,0,0,0,0,0,0,0,0,0,0,0,0,0,0,0,0,0,0,0,0,0,0,0,0,0,0,0,0,0,0,0,0,0,0,0,0,0,0,0,0,0,0,0,0,0,0,0,0,-100,0,0,0,0,0,0,0,0,0,0,4,5,,True,True,False,0.0,2455.13,2380.13,2384.13,2390.13,"5,4,2385.13",0,0.01,2024-06-07 07:35:00,2024-06-07 07:35:00,True,,,2024-06-07 08:21:56,2024-06-05 22:05:00,2355.13,2024-06-07 08:21:56,auto,2380.17,0.01,442.63,even,1 days 10:16:56,4785.65,True,10,0,23,6
2024-06-06 16:25:00,2359.01,2361.09,2358.73,2360.87,1585,27,0,2355.540665633555,2359.146333333333,2362.7520010331114,2361.1151664343347,2357.2707793845016,2357.2707793845016,2357.039289828204,0.030906686441085185,2358.085442890444,0.6302913752920176,2357.629906759919,0.07050116550090024,2355.0817016317005,0.847004662002746,2354.476002331007,0.21997280497180327,0.31705672970110754,0.31705672970110754,2358.746113642002,2409.8033765107975,-8.18434852510631e-05,-5.2831615292115085e-05,,7.765664355857807,7.766079074219558,3.940224998198476e-05,3.30421303674061e-05,2331.2031099806054,2359.3257835922823,0.05519610425199062,0.09226556987368895,2358.0609134803644,2358.708119850755,-0.549260437122939,-0.7690938353675373,1.863912455828858,0.31705672970110754,0.06035520949126294,-0.2846918798691149,2360.998604296159,2353.542954472844,45.3160919540214,32.499999999999126,0,0,0,0,0,0,0,0,0,0,0,0,0,100,0,100,0,0,0,0,0,0,0,0,0,0,0,0,0,0,0,0,0,0,0,0,0,0,0,0,100,0,0,0,0,0,0,0,0,0,0,0,0,0,0,0,0,0,0,0,0,0,4,5,,True,True,False,0.0,2460.87,2300.87,2385.87,2390.87,"5,4,2390.87",0,0.01,,,False,,,2024-06-07 21:37:08,2024-06-06 16:30:00,2360.87,2024-06-07 11:15:00,manual,2351.2,0.01,-170.96,fail,0 days 18:45:00,4614.69,False,0,1,23,6
2024-06-06 17:30:00,2363.21,2365.06,2362.28,2363.6,1360,27,0,2354.279230239026,2360.3233333333337,2366.367436427641,2361.5280925028983,2363.057751575825,2363.057751575825,2362.7112725250286,0.4556087010259944,2364.0429254079236,0.21120046619898858,2363.892253302264,0.02637917637866849,2361.2336713286722,0.33879953379846484,2360.8425330225373,0.2679292929301482,0.3372302558377669,0.3372302558377669,2362.28,2414.132196365885,-9.133228642265321e-05,-6.805576794562385e-05,,7.766963639688855,7.766495389578173,3.5108148541957295e-05,3.171077313390983e-05,2333.0548603812686,2362.0884451373686,0.07401390764880489,0.5525546562416821,2362.437168061949,2361.4165298020625,0.9294832157879682,0.7170514210648384,1.6307092015791282,0.3372302558377669,0.3649766407147581,0.6646192065254581,2366.319169978983,2359.796333172667,70.94930902404049,69.36448042059614,0,0,0,0,0,0,0,0,0,0,0,0,0,0,0,0,0,0,0,0,0,0,0,0,0,0,0,0,0,0,100,0,0,0,0,0,0,0,0,0,0,0,0,0,0,0,0,0,0,0,0,0,100,0,0,0,0,0,0,0,0,0,4,5,,True,True,False,0.0,2463.6,2303.6,2388.6,2393.6,"5,4,2393.6",0,0.01,,,False,,,2024-06-07 19:05:25,2024-06-06 17:35:00,2363.6,2024-06-07 11:15:00,manual,2351.2,0.01,-219.23,fail,0 days 17:40:00,4395.46,False,0,2,23,6
2024-06-06 18:00:00,2364.11,2367.17,2364.02,2366.67,1543,27,0,2354.425665063415,2361.317333333334,2368.2090016032525,2361.866842182209,2365.575044123101,2365.575044123101,2365.00215399827,0.4314250401694153,2366.0259906759925,0.4706876456880309,2365.7844794094913,0.13592851592920852,2364.0157342657362,0.17955710956175608,2363.8503030303054,0.27353535353586267,0.6753044123120162,0.6753044123120162,2364.0200000000004,2419.539214334152,-9.621054844600941e-05,-8.490650551680359e-05,,7.767063984156499,7.766535523498751,2.8121655584312904e-05,3.171064409608694e-05,2333.498898379342,2365.0176460079947,0.07404406919840767,0.445692579111892,2363.9969780094866,2362.670410675122,1.1879849783877034,0.9878404209198882,1.0783022370353081,0.6753044123120162,0.36806154987061745,0.25090915832606697,2367.731648597172,2363.4184396490305,79.24417374287997,75.1912337501562,0,0,0,0,0,0,0,0,0,0,0,0,0,100,0,0,0,0,0,0,0,0,0,0,0,0,0,0,0,0,0,200,0,0,0,0,0,0,0,0,100,0,0,0,0,0,0,0,0,0,0,0,0,0,0,0,0,0,0,0,0,0,4,5,,True,True,False,0.0,2466.67,2306.67,2391.67,2396.67,"5,4,2396.67",0,0.01,,,False,,,2024-06-07 16:56:17,2024-06-06 18:05:00,2366.67,2024-06-07 11:15:00,manual,2351.2,0.01,-273.51,fail,0 days 17:10:00,4121.95,False,0,3,23,6
2024-06-06 19:40:00,2374.55,2375.78,2373.84,2374.85,812,27,0,2360.6935431724396,2370.5330000000004,2380.372456827561,2365.5508131793995,2376.975248053393,2376.975248053393,2376.9139137313064,0.09361488073182045,2374.651794871794,0.1277972027942269,2374.652789432801,-0.06989121989181513,2372.0517832167825,0.32622377622328713,2371.8165578865614,0.06192307692253962,0.001042639971274184,0.001042639971274184,2372.236119054769,2431.6805905352035,-0.00011844737961683918,-0.0001338381458190539,,7.771056262110715,7.769960969002743,1.1113120956878115e-05,1.3031211258077498e-05,2345.809717689911,2371.474618331476,0.03247686923350557,0.2176612551729704,2373.732768850335,2371.5461256824815,1.8563703404893204,2.270409213040602,1.460620587313808,0.001042639971274184,0.18191768631731975,0.09788431590686741,2379.8964892280205,2374.0540068787654,48.89705882352933,44.98759833035364,0,0,0,0,0,0,0,0,0,0,0,0,0,0,0,0,0,0,0,0,0,0,0,0,0,0,0,0,0,0,100,-100,0,0,0,0,0,0,0,0,0,0,0,0,0,0,0,0,0,0,0,0,100,0,0,0,0,0,0,0,0,0,4,5,,True,True,False,0.0,2474.85,2314.85,2399.85,2404.85,"5,4,2404.85",0,0.01,,,False,,,2024-06-07 15:31:00,2024-06-06 19:45:00,2374.85,2024-06-07 11:15:00,manual,2351.2,0.01,-418.13,fail,0 days 15:30:00,3703.8199999999997,False,0,4,23,6
2024-06-06 20:15:00,2371.36,2372.4,2370.61,2372.33,626,27,0,2365.902209131681,2372.5040000000004,2379.1057908683197,2366.3800381443843,2374.6212925472737,2374.6212925472737,2375.0873236929915,-0.47801705598794797,2372.9022144522137,-0.15790209790611698,2373.1083605283716,-0.40973581973594264,2371.3580885780884,-0.2786480186496192,2371.6052292152317,-0.2458391608392958,-0.4141505376378518,-0.4141505376378518,2370.610000000001,2429.402099716204,-0.00011902815526127062,-0.0001338337246543056,,7.77097640164658,7.769960969002743,9.78064614886459e-06,5.71765759059762e-06,2350.166270311283,2372.0390521634067,0.011860474463901483,0.02376244745664735,2372.6846933550632,2371.862118629168,0.621977566082478,1.2438098532327087,1.2074412142226991,-0.4141505376378518,-0.5697923618795357,-0.4501082684469111,2377.036174975719,2372.2064101188284,23.267577137075275,23.353087146777256,0,0,0,0,0,0,0,0,0,0,0,0,0,0,0,0,0,0,0,0,0,0,0,0,0,0,0,0,0,0,0,0,0,0,0,0,0,0,0,0,0,0,0,0,0,0,0,0,0,0,0,0,0,0,0,0,0,0,0,0,0,0,4,5,,True,True,False,0.0,2472.33,2312.33,2397.33,2402.33,"5,4,2402.33",0,0.01,,,False,,,2024-06-07 16:49:01,2024-06-06 20:20:00,2372.33,2024-06-07 11:15:00,manual,2351.2,0.01,-373.58,fail,0 days 14:55:00,3330.24,False,0,5,23,6
2024-06-06 20:30:00,2371.53,2373.35,2371.16,2372.45,793,27,0,2368.9567974524816,2373.2236666666668,2377.490535880852,2366.691696872048,2372.9922595476464,2372.9922595476464,2373.511723149178,-0.5430109998760599,2372.5356410256427,0.07362470862562986,2372.5185586635703,-0.1221911421898767,2370.632703962704,-0.09001165501103969,2370.7606216006247,-0.2417948717948093,-0.4501675936221545,-0.4501675936221545,2370.898636096734,2428.426226657174,-0.00012108051773088885,-0.00013383158123781938,,7.770900625572716,7.769960969002743,9.784330370785894e-06,5.318714886012662e-06,2350.429956632452,2372.107630079912,0.012045638316521945,0.022826815278222057,2372.474723193259,2371.9211605741375,0.3929783609687547,0.8546986941227643,0.5378644944386611,-0.4501675936221545,-0.6580556173530567,-0.5208097886520591,2374.067988536524,2371.916530558769,30.815532130681806,28.863740058094894,0,0,0,0,100,0,0,0,0,0,0,0,0,0,0,0,0,0,0,0,0,0,0,0,0,0,0,0,0,0,0,0,0,0,0,0,0,0,0,0,0,0,0,0,0,0,0,0,0,0,0,0,0,0,0,0,0,0,0,0,0,0,4,5,,True,True,False,0.0,2472.45,2312.45,2397.45,2402.45,"5,4,2402.45",0,0.01,,,False,,,2024-06-07 16:48:52,2024-06-06 20:35:00,2372.45,2024-06-07 11:15:00,manual,2351.2,0.01,-375.7,fail,0 days 14:40:00,2954.54,False,0,6,23,6
2024-06-06 20:40:00,2371.54,2372.69,2371.54,2372.51,509,27,0,2369.816896950377,2373.4306666666666,2377.044436382956,2366.8856020106114,2372.1635587690025,2372.1635587690025,2372.535595600049,-0.42628945742217184,2372.554568764568,0.0954195804201845,2372.516452991464,0.030850815850499202,2371.0270046620017,0.25990675990215095,2370.8089355089387,0.10142968142872633,-0.2874097144976986,-0.2874097144976986,2370.324432697757,2427.7766584007277,-0.00012106924148970705,-0.00013383271809509209,,7.771183139501452,7.770785004760482,9.78184151531314e-06,5.317924888256903e-06,2350.4553982567218,2372.154730392565,0.013100736172418692,0.0230031402907116,2372.3571686768305,2371.937949737772,0.28177185078038747,0.6500456812458315,0.5021791798389277,-0.2874097144976986,-0.5412910641462076,-0.4501675936221545,2373.1679171286805,2371.1592004093245,30.045132172790247,28.910930067509643,0,0,0,0,0,0,0,0,0,0,0,0,0,100,0,0,0,0,0,0,0,0,0,0,0,0,0,0,0,0,0,-100,0,0,0,0,0,0,0,0,100,0,0,0,0,0,0,0,0,0,0,0,0,0,0,0,0,0,0,0,0,0,4,5,,True,True,False,0.0,2472.51,2312.51,2397.51,2402.51,"5,4,2402.51",0,0.01,,,False,,,2024-06-07 16:48:51,2024-06-06 20:45:00,2372.51,2024-06-07 11:15:00,manual,2351.2,0.01,-376.76,fail,0 days 14:30:00,2577.7799999999997,False,0,7,23,6
2024-06-06 21:40:00,2372.29,2372.86,2372.26,2372.7,341,27,0,2369.756399518138,2372.2686666666664,2374.7809338151947,2367.8266080085173,2371.2234453096044,2371.2234453096044,2371.0237718452613,0.08268644172585482,2371.9356993006995,0.184883449879635,2371.702311577325,0.18421522921471478,2370.7811305361324,0.4250349650374119,2370.416013986019,0.22727272727297532,0.27557582499139244,0.27557582499139244,2372.26,2431.4472916547224,-0.00013143898299266323,-0.00015618537702185613,,7.771674968028362,7.772182123084442,9.781398230474946e-06,3.89632235326521e-06,2351.35480499243,2372.433305654887,0.008701889070380275,0.023047084843256016,2371.7659903344397,2371.7415541822143,-0.017995280858940532,-0.040089648851078956,1.1383125042087707,0.27557582499139244,0.04786874304727462,-0.0753852428611026,2373.5000703180217,2368.946820301187,66.33399866932668,57.529385673097714,0,0,0,0,0,0,0,0,0,0,0,0,0,0,0,0,0,0,0,0,0,0,0,0,0,0,0,0,0,0,0,0,0,0,0,0,0,0,0,0,0,0,0,0,0,0,0,0,0,0,0,100,0,0,0,0,0,0,0,0,0,0,4,5,,True,True,False,0.0,2472.7,2312.7,2397.7,2402.7,"5,4,2402.7",0,0.01,,,False,,,2024-06-07 16:48:21,2024-06-06 21:45:00,2372.7,2024-06-07 11:15:00,manual,2351.2,0.01,-380.12,fail,0 days 13:30:00,2197.66,False,0,8,23,6
2024-06-06 22:05:00,2371.59,2373.34,2371.59,2373.01,566,27,0,2369.90088676135,2372.091,2374.2811132386496,2368.2186084089326,2371.5670077864297,2371.5670077864297,2371.4068028673832,0.10931454702767951,2373.1485664335673,0.16213286713082198,2373.0226301476428,0.16214063714096483,2372.0981118881127,-0.08653846153993072,2372.147707847714,0.11326728826770704,0.2446362625146321,0.2446362625146321,2371.590000000001,2433.139202427749,-0.0001331916238366204,-0.00016720425787131423,,7.771761732336952,7.77203704714984,9.781752968533439e-06,2.3806360127923353e-06,2352.1820704234783,2372.5492574267214,0.507714271999248,0.0234046964060326,2372.055057998271,2371.9084854951448,0.10713207370145028,0.02977950280138967,0.5068794588524574,0.2446362625146321,-0.008657767890781543,0.09196514645827847,2372.5807667041345,2370.553248868725,68.3350705213968,65.57469978998957,0,0,0,0,0,0,0,0,0,0,0,0,0,100,0,0,0,0,0,0,0,0,0,0,0,0,0,0,0,0,0,0,0,0,0,0,0,0,0,0,0,0,0,0,0,0,0,0,0,0,0,0,0,0,0,0,0,0,0,0,0,0,4,5,,True,True,False,0.0,2473.01,2313.01,2398.01,2403.01,"5,4,2403.01",0,0.01,,,False,,,2024-06-07 16:48:13,2024-06-06 22:10:00,2373.01,2024-06-07 11:15:00,manual,2351.2,0.01,-385.6,fail,0 days 13:05:00,1812.06,False,0,9,23,6
2024-06-06 23:00:00,2372.57,2373.24,2372.2,2373.24,196,27,0,2369.9595969678735,2372.3500000000004,2374.7404030321272,2369.140202495011,2373.1875706340384,2373.1875706340384,2373.1163695464097,0.036119144728672836,2373.0085431235425,-0.2955477855484787,2373.320687645697,-0.3503923853932065,2372.1540792540773,-0.27305361305434417,2372.427591297595,-0.2905555555553292,0.11790507971772968,0.11790507971772968,2372.2,2434.4027474775185,-0.00014167025962171244,-0.00018637839252779348,,7.7718432084516955,7.771553156462943,9.782809845284063e-06,1.782517198079601e-06,2352.5366469702067,2372.804339262071,0.004300854343455285,0.022674809024465503,2372.825726565719,2372.59502787863,0.18648718862323221,0.2575395748043719,0.6496029007484142,0.11790507971772968,-0.022206896548595978,0.012659251017339557,2374.4867764355354,2371.8883648325414,36.65123456789973,30.632716049382225,0,0,0,0,0,0,0,0,0,0,0,0,0,0,0,100,0,0,0,0,0,0,0,0,0,0,0,0,0,0,0,0,0,0,0,0,0,0,0,0,0,0,0,0,0,0,0,0,0,0,0,0,0,0,0,0,0,0,0,0,0,0,4,5,,False,True,False,0.0,2473.24,2313.24,2398.24,2403.24,"5,4,2403.24",0,0.01,,,False,,,2024-06-07 15:31:03,2024-06-06 23:05:00,2373.24,2024-06-07 11:15:00,manual,2351.2,0.01,-389.66,fail,0 days 12:10:00,1422.3999999999999,False,0,10,23,6
2024-06-06 23:25:00,2372.6,2373.47,2372.47,2373.07,138,33,0,2370.0231192594656,2372.364000000001,2374.7048807405363,2369.4560211020944,2373.460998887653,2373.460998887653,2373.3463774564348,0.08606154987046466,2372.860745920746,0.23505827505732668,2372.685951825963,0.08376068376128387,2372.207867132865,0.16495337995183945,2372.0503885003914,0.09086247086270305,0.12614608824605966,0.12614608824605966,2372.4700000000007,2433.7109044634853,-0.00014582306570567387,-0.0001918670147659853,,7.771649483447265,7.771553156462943,9.782756220543419e-06,1.7817284436650993e-06,2352.5579910564365,2372.9204143693196,0.0047802303192838735,0.022752248192318802,2372.7770423065763,2372.635611504573,0.10914386791046127,0.16102399276268997,0.30291146764823607,0.12614608824605966,0.09157211716774327,0.0404664441962268,2374.06682182295,2372.8551759523566,30.887547507266987,28.728899225650963,0,0,0,0,0,0,0,0,0,0,0,0,0,0,0,0,0,0,0,0,0,0,0,0,0,0,0,0,0,0,0,0,0,0,0,0,0,0,0,0,0,0,0,0,0,0,0,0,0,0,0,0,0,0,0,0,0,0,0,0,0,0,4,5,,False,True,False,0.0,2473.07,2313.07,2398.07,2403.07,"5,4,2403.07",0,0.01,,,False,,,2024-06-07 16:48:12,2024-06-06 23:30:00,2373.07,2024-06-07 11:15:00,manual,2351.2,0.01,-386.66,fail,0 days 11:45:00,1035.7399999999998,False,0,11,23,6
2024-06-06 23:35:00,2372.79,2373.46,2372.69,2373.35,141,33,0,2370.6695925681615,2372.5760000000014,2374.4824074318412,2369.5877018431006,2373.324791991101,2373.324791991101,2373.4009427759247,-0.0033536027690388437,2373.1364801864806,0.1618298368298383,2372.990625485636,0.17026418026352985,2372.5573076923056,0.15100233100065452,2372.3904933954955,0.1714646464638463,-0.0922454579163059,-0.0922454579163059,2372.6900000000005,2431.665784372315,-0.00014778434084925616,-0.0001879277978159354,,7.7716378973042906,7.771553156462943,9.78082808340128e-06,1.7825941695079125e-06,2352.5659649685044,2372.967212041688,0.003788780197737651,0.02339311066452865,2372.8681782195013,2372.6998041019997,0.13598898101417944,0.14659038290499438,0.31020442582862745,-0.0922454579163059,-0.0439614386359608,0.12614608824605966,2373.9452008427584,2372.7043831394435,50.35220137776728,38.702659632159225,0,0,0,0,100,0,0,0,0,0,0,0,0,0,0,0,0,0,0,0,0,0,0,0,0,0,0,0,0,0,0,0,0,0,0,0,0,0,0,0,100,0,0,0,0,0,0,0,0,0,0,0,0,0,0,0,0,0,0,0,0,0,4,5,,False,True,False,0.0,2473.35,2313.35,2398.35,2403.35,"5,4,2403.35",0,0.01,,,False,,,2024-06-07 15:31:03,2024-06-06 23:40:00,2373.35,2024-06-07 11:15:00,manual,2351.2,0.01,-391.61,fail,0 days 11:35:00,644.1299999999998,False,0,12,23,6
2024-06-07 04:15:00,2373.72,2375.17,2373.51,2374.4,892,27,0,2375.0268591435974,2376.921666666667,2378.8164741897367,2373.497850789416,2376.8096121616627,2376.8096121616627,2377.198298603389,-0.3176361389196245,2377.6615384615393,-0.8393939393927212,2378.4044755244845,-0.48792929292903864,2375.3689860139857,-0.7690675990720592,2376.2397280497335,-0.6984226884233067,-0.3544048943249436,-0.3544048943249436,2360.1870204993,2405.7073844318184,-0.00015585891215847097,-0.00015370951563821038,,7.7733409006770895,7.7733409006770895,9.78303222225037e-06,9.169873210823664e-06,2350.0194012435472,2373.9884742355484,-0.20320158741196792,0.02328487569684512,2376.477196660717,2376.5880319411654,-0.13965068976494877,0.2559527876950155,1.822092596068542,-0.3544048943249436,-0.4572495365227951,-0.1412539859111348,2380.4537973538,2373.1654269695255,14.815627432944419,26.863207069337715,0,0,0,0,0,0,0,0,0,0,0,0,0,0,0,0,0,0,0,0,0,0,0,0,0,0,0,0,0,0,0,0,0,0,0,0,0,0,0,0,0,0,0,0,0,0,0,0,0,0,0,0,0,0,0,0,0,0,0,0,0,0,4,5,,False,True,False,0.0,2474.4,2314.4,2399.4,2404.4,"5,4,2404.4",0,0.01,,,False,,,2024-06-07 15:31:01,2024-06-07 04:20:00,2374.4,2024-06-07 11:15:00,manual,2351.2,0.01,-410.17,fail,0 days 06:55:00,233.95999999999975,False,0,13,23,6
2024-06-07 05:40:00,2373.05,2375.01,2372.75,2374.93,700,29,0,2368.050927495462,2373.984,2379.917072504538,2373.0088993310114,2370.274157953283,2370.274157953283,2370.0690980101376,0.0640677295759815,2373.1058041958013,0.814580419581489,2372.3597358197417,0.5654778554776385,2370.8483333333343,0.6967715617734029,2370.291099456103,0.33980186480221164,0.2908995179864178,0.2908995179864178,2344.8319512903236,2398.511767984996,-0.00012713651513838878,-0.00014687354242048123,,7.772085498990481,7.772604956754302,9.7815480753427e-06,1.8189223352852948e-05,2347.4149817862526,2374.3834017066697,-0.14940374423895264,0.023176077793323202,2372.2963308326844,2373.0757869561503,-0.6627357451561693,-1.0909006361035016,1.5843830480497247,0.2908995179864178,0.033380793471224024,-0.13207712273015204,2373.4429240493823,2367.105391857184,84.01169875860586,59.681409880953844,0,0,0,0,0,0,0,0,0,0,0,0,0,0,0,100,0,0,0,0,0,0,0,0,0,0,0,0,0,0,0,0,0,0,0,0,0,0,0,0,100,0,0,0,0,0,0,0,0,0,0,0,0,0,0,0,0,0,0,0,0,0,4,5,,False,True,False,0.0,2474.93,2314.93,2399.93,2404.93,"5,4,2404.93",0,0.01,,,False,,,2024-06-07 15:31:00,2024-06-07 05:45:00,2374.93,2024-06-07 11:15:00,manual,2351.2,0.01,-419.54,fail,0 days 05:30:00,-185.58000000000027,False,0,14,23,6
2024-06-07 11:10:00,2357.25,2358.93,2350.8,2351.14,1551,27,0,2360.901916927505,2373.3033333333337,2385.7047497391623,2375.2564745677723,2367.6795246570273,2367.6795246570273,2369.924154987026,-2.0190114942524815,2366.9665268065296,-3.52319347319235,2370.38811965813,-2.4585508935497273,2359.237832167832,-4.5747552447546695,2363.954339549345,-4.576651126651086,-2.4551279199113196,-2.4551279199113196,2307.6052364438096,2358.9300000000007,-6.344130497411799e-05,-8.89268918110684e-05,,7.769145085434964,7.7702879361724815,2.634438164565588e-05,-5.158020461644487e-06,2354.334044764272,2371.762714424418,0.6889651660717391,0.06300740771030178,2366.927461577122,2371.565297597603,-4.2098754974076655,-2.113671079981284,9.558778967901416,-2.4551279199113196,-1.823635150166865,-1.7782714126792598,2386.79708259283,2348.5619667212245,6.078641704937105,9.210540827861776,0,0,0,0,0,0,0,0,0,0,0,0,0,0,0,-100,0,0,0,0,0,0,0,0,0,0,0,0,0,0,0,0,0,0,0,0,0,0,0,0,0,0,0,0,0,0,0,0,0,0,0,0,0,0,0,0,0,0,0,0,0,0,4,5,,False,False,True,1.0,2251.14,2326.14,2322.14,2316.14,"5,4,2321.14",1,0.01,2024-06-07 15:35:00,2024-06-07 15:35:00,True,2024-06-07 16:50:00,,2024-06-07 16:06:29,2024-06-07 11:15:00,2351.14,2024-06-07 16:06:29,auto,2325.97,0.01,444.93,even,0 days 04:51:29,259.34999999999974,True,1,0,23,6
2024-06-07 11:25:00,2356.76,2357.18,2352.39,2352.39,1056,27,0,2354.862075716985,2371.098,2387.3339242830148,2374.160964189935,2362.1341802002235,2362.1341802002235,2364.087042145596,-1.8484481522682472,2358.4650233100233,-2.250023310024062,2360.852917637925,-2.8338344988355857,2351.4839627039623,-2.0364685314698363,2353.5316860916914,-2.584623154622932,-2.109895439375123,-2.109895439375123,2305.0510692946677,2357.1800000000003,-5.693678993770349e-05,-8.622377543701709e-05,,7.768693602264756,7.769843787797729,2.6480905048796243e-05,-5.11220202879971e-06,2354.2885658311952,2371.893360906462,-0.012614793125976576,0.0628773272219405,2362.1491722162723,2368.132647206348,-5.396365075619087,-3.5520264223263167,8.934267497357178,-2.109895439375123,-1.6387949573609149,-1.7966540600677945,2380.002715194938,2344.265645205509,14.893132771926192,13.335382621224626,0,0,0,0,-100,0,0,0,0,0,0,0,0,-100,0,-100,0,0,0,0,0,0,0,0,0,0,0,0,0,0,0,0,0,0,0,0,0,0,0,0,-100,0,0,0,0,0,0,0,0,0,0,0,0,0,0,0,0,0,0,0,0,0,4,5,,False,False,True,1.0,2252.39,2323.39,2319.39,2312.39,"5,4,2322.39",1,0.01,2024-06-07 15:35:00,2024-06-07 15:50:00,True,2024-06-07 16:50:00,,2024-06-07 16:04:03,2024-06-07 11:30:00,2352.39,2024-06-07 16:04:03,auto,2322.64,0.01,525.89,even,0 days 04:34:03,785.2399999999998,True,2,0,23,6
2024-06-07 13:00:00,2339.25,2339.25,2335.25,2335.73,830,27,0,2326.479227281432,2350.351666666668,2374.2241060519036,2364.721287728085,2333.29604597701,2333.29604597701,2333.7668612038083,-0.4347910023489021,2339.225466200465,-0.21331002330998672,2339.5096464646535,-0.4322610722610989,2336.9192890442896,-0.678881118881236,2337.3270318570376,-0.29915306915381734,-0.549881349649695,-0.549881349649695,2292.5829141030817,2342.2474320738306,-2.1347109376840376e-05,-5.335601352130216e-05,,7.761517424122406,7.765203207829892,2.644267109981623e-05,-3.2451119438155585e-05,2357.425521826733,2373.0947658528116,23.51622952688558,0.06147734275145922,2340.8980100102144,2347.492606606256,-5.673369557348906,-6.126460958833976,1.6110045668196342,-0.549881349649695,-0.3126829810885283,-0.44180867630939247,2336.5180551106496,2330.074036843371,12.871108219945349,15.727315985975112,0,0,0,0,-100,0,0,0,0,0,0,0,0,-100,0,0,0,0,0,0,0,0,0,0,0,0,0,0,0,0,0,0,0,0,0,0,0,0,0,0,-100,0,0,0,0,0,0,0,0,-100,0,0,0,0,0,0,0,0,0,0,0,0,4,5,,True,False,True,1.0,2235.73,2310.73,2306.73,2300.73,"5,4,2305.73",1,0.01,2024-06-07 18:55:00,2024-06-07 18:55:00,True,2024-06-07 21:40:00,,2024-06-07 19:23:57,2024-06-07 13:05:00,2335.73,2024-06-07 19:23:57,auto,2310.69,0.01,442.63,even,0 days 06:18:57,1227.87,True,3,0,23,6
2024-06-07 15:20:00,2335.63,2336.13,2334.32,2335.15,1074,27,0,2332.0044163286675,2335.196666666667,2338.388917004667,2352.7125815701565,2334.75607712273,2334.75607712273,2334.5391941663606,0.26182375478856557,2337.7891375291383,-0.353438228441064,2338.0992229992335,-0.0830769230765327,2334.6291841491834,-0.2474708624718005,2334.7759829059873,0.01847707847764468,0.21202076381177903,0.21202076381177903,2285.7365146634565,2336.1299999999997,4.111131869452095e-06,-4.243815219994902e-05,,7.756689693101373,7.757165737604588,2.64368946569819e-05,-3.145315880183945e-05,2351.331577170623,2374.85521601297,-0.07696276857177509,0.06623600932834961,2335.531811710162,2336.602760465156,-0.7660016847571569,-1.3810091360018484,1.2882740391767342,0.21202076381177903,0.2266073414903076,0.3468431590636101,2337.3326252010834,2332.1795290443765,56.52173913043253,64.51233842537926,0,0,0,0,0,0,0,0,0,0,0,0,0,0,0,0,0,0,0,0,0,0,0,0,0,0,0,0,0,0,0,100,0,0,0,0,0,0,0,0,0,0,0,0,0,0,0,0,0,0,0,-100,-100,0,0,0,0,0,0,0,0,0,4,5,,True,False,True,1.0,2235.15,2310.15,2306.15,2300.15,"5,4,2305.15",1,0.01,2024-06-07 19:00:00,2024-06-07 19:00:00,True,2024-06-07 22:10:00,,2024-06-07 19:22:55,2024-06-07 15:25:00,2335.15,2024-06-07 19:22:55,auto,2310.13,0.01,442.28,even,0 days 03:57:55,1670.1499999999999,True,4,0,23,6
2024-06-07 16:45:00,2316.87,2317.53,2311.57,2312.26,1700,27,0,2311.777674924656,2327.4656666666665,2343.153658408677,2344.2228787319323,2317.6338524286257,2317.6338524286257,2319.1281436163667,-1.1866051167958176,2323.3938461538473,-2.137902097900678,2325.0752719502807,-1.1284926184916912,2318.759335664335,-2.5942307692316717,2320.7658313908364,-1.1982400932402015,-1.6787741935477243,-1.6787741935477243,2285.8956404514124,2321.5810811893875,4.114700826935035e-06,-1.884025758923419e-05,,7.750435154183589,7.751640347516297,9.253248852376385e-06,-4.678859212626112e-05,2343.286222763405,2383.538537147276,-11.390137869330829,0.8065860544606949,2320.9319630324035,2325.086190584318,-3.599034090329951,-3.2232194938218925,4.79440149697809,-1.6787741935477243,-1.1253251761208958,-0.7557159807188327,2327.2226554225817,2308.0450494346696,20.70564558300433,30.900507249018094,0,0,0,0,0,0,0,0,0,0,0,0,0,0,0,0,0,0,0,0,0,0,0,0,0,0,0,0,0,0,0,0,0,0,0,0,0,0,0,0,-100,0,0,0,0,0,0,0,0,0,0,0,0,0,0,0,0,0,0,0,0,0,4,5,,True,False,True,1.0,2212.26,2372.26,2287.26,2282.26,"5,4,2282.26",1,0.01,,,False,,,,2024-06-07 16:50:00,2312.26,2024-06-10 15:00:00,manual,2304.96,0.01,129.04,success,2 days 22:10:00,1799.1899999999998,True,5,0,23,6
2024-06-07 17:55:00,2311.84,2313.48,2310.09,2313.29,1358,27,0,2308.201112802529,2317.7023333333327,2327.203553864136,2337.4289450166852,2313.9492732665917,2313.9492732665917,2313.7138358670145,0.22801878630434658,2318.1903962703936,-1.6291491841520838,2319.541254856264,-0.5957070707081584,2314.8149417249415,-1.5141258741259662,2316.0401631701675,-0.515419580418893,0.3161868743040941,0.3161868743040941,2286.0276027462614,2315.5290819179822,4.112773115814152e-06,-2.746959900567547e-06,,7.7487943435697915,7.750202027451557,-5.2830800338053366e-05,-7.280516311362872e-05,2352.2713875114946,2409.4534037291087,-0.17536144235054962,-0.12918936418145677,2315.511852539804,2318.277997756431,-2.3070192858740484,-2.6953737536598683,2.6839439929043896,0.3161868743040941,0.07393845012893507,0.29393103448092006,2319.3171612524006,2308.581385280783,50.6292690444477,58.8094707433793,0,0,0,0,0,0,0,0,0,0,0,0,0,0,0,0,0,0,0,0,0,0,0,0,0,0,100,0,0,0,0,0,0,0,0,0,0,0,0,0,0,0,0,0,0,0,0,0,0,0,0,0,0,0,0,0,0,0,0,0,0,0,4,5,,True,False,True,1.0,2213.29,2373.29,2288.29,2283.29,"5,4,2283.29",1,0.01,,,False,,,,2024-06-07 18:00:00,2313.29,2024-06-10 15:00:00,manual,2304.96,0.01,147.25,success,2 days 21:00:00,1946.4399999999998,True,6,0,23,6
2024-06-07 20:05:00,2309.38,2310.31,2309.36,2309.49,900,27,0,2304.224494382404,2310.4146666666657,2316.6048389509274,2326.8514603865838,2308.421171672229,2308.421171672229,2308.119525645782,0.3346817451492825,2312.7734965034965,-0.8508624708651951,2313.408601398612,-0.3659052059060741,2310.04846153846,-0.4140093240130227,2310.3784848484897,-0.18564102564232599,0.3624071190210998,0.3624071190210998,2282.1092002361315,2310.9601000497105,1.604013445503662e-05,4.305540500015529e-06,,7.7456442686235984,7.74588002393619,-9.048447864132651e-05,-0.0001027707877692256,2365.7084792712208,2419.5246735806377,1.681484296517283,0.7871866290493017,2310.132507800252,2310.937957865143,-0.5905099289893769,-1.0592272239004488,1.7296903108045616,0.3624071190210998,0.1801238413045212,0.46151427512222654,2311.880552293838,2304.96179105062,62.81714785651737,68.40897839631978,100,0,0,0,0,0,0,0,0,0,0,0,0,0,0,0,0,0,0,100,0,0,0,0,0,100,0,0,0,0,0,0,0,0,0,0,0,0,0,100,0,0,0,0,0,0,0,0,0,0,0,0,0,0,0,0,0,0,0,0,0,0,4,5,,True,False,True,1.0,2209.49,2369.49,2284.49,2279.49,"5,4,2279.49",1,0.01,,,False,,,,2024-06-07 20:10:00,2309.49,2024-06-10 15:00:00,manual,2304.96,0.01,80.08,success,2 days 18:50:00,2026.5199999999998,True,7,0,23,6
2024-06-10 14:55:00,2302.08,2305.2,2301.9,2304.98,941,27,0,2293.523528831471,2298.0986666666668,2302.6738045018624,2297.157242121784,2301.194987022619,2301.194987022619,2300.5299799777567,0.4569803485360353,2302.4249650349648,0.9809673659692635,2301.687649572659,0.37092851592933584,2300.191060606065,0.6331351981370972,2299.783294483303,0.14739316239410982,0.7728134964777382,0.7728134964777382,2300.687050277076,2312.142397349048,-6.615119154698321e-06,1.162581938349143e-05,,7.740736469854898,7.74000122166085,-5.335601352130216e-05,-2.1347109376840376e-05,2292.204011309682,2341.2799876835725,-0.5051581595062089,-0.33112989858818764,2300.563522652953,2298.993706060418,1.397461665497758,1.0597599734956502,1.9142356736113393,0.7728134964777382,0.4493941416403686,0.14873340749045383,2305.0234583698416,2297.3665156753964,87.89111661839894,80.44346236271247,0,0,0,0,0,0,0,0,0,0,0,0,0,0,0,0,0,0,0,0,0,0,0,0,0,0,0,0,0,0,0,0,0,0,0,0,0,0,0,0,100,0,0,0,0,0,0,0,0,0,0,0,0,0,0,0,0,0,0,0,0,0,4,5,,True,True,False,0.0,2404.98,2333.98,2337.98,2344.98,"5,4,2334.98",0,0.01,2024-06-12 15:55:00,2024-06-12 16:15:00,True,,,2024-06-12 16:32:47,2024-06-10 15:00:00,2304.98,2024-06-11 19:20:00,manual,2308.93,0.01,69.82,success,1 days 04:20:00,2096.3399999999997,True,8,0,24,6
2024-06-10 16:15:00,2306.98,2307.74,2306.43,2306.58,842,27,0,2296.763299927008,2303.2820000000006,2309.800700072993,2299.439511864637,2307.785263626251,2307.785263626251,2307.659496724759,0.0872522555928299,2306.9274009324026,0.3049533799562596,2306.779184149195,0.03969696969670622,2305.397529137532,0.37751748251957906,2305.204619269627,0.033414918415928696,0.09537560252147159,0.09537560252147159,2300.4430009648486,2312.572188156776,-6.61381953466307e-06,1.1626358701195859e-05,,7.742418879204951,7.7414967408806135,-4.6632677961432365e-05,2.9064185507696645e-06,2285.96709297606,2339.2779782847992,-0.29000951463194724,-0.11032573785496425,2305.7825809677606,2304.0310419179655,1.4997796387824565,1.709452854107757,0.6641374641805499,0.09537560252147159,0.18654949944175314,-0.020168335184735042,2309.113538554612,2306.4569886978898,55.41591861160933,57.89919513984722,0,0,0,0,0,0,0,0,0,0,0,0,0,0,0,0,0,0,0,0,0,0,0,0,0,0,0,0,0,0,0,-100,0,0,0,0,0,0,0,0,0,0,0,0,0,0,0,0,0,0,0,0,0,0,0,0,0,0,0,0,0,0,4,5,,True,True,False,0.0,2406.58,2331.58,2335.58,2341.58,"5,4,2336.58",0,0.01,2024-06-12 16:05:00,2024-06-12 16:05:00,True,,,2024-06-12 16:36:55,2024-06-10 16:20:00,2306.58,2024-06-11 19:20:00,manual,2308.93,0.01,41.54,success,1 days 03:00:00,2137.8799999999997,True,9,0,24,6
2024-06-10 17:05:00,2303.46,2303.92,2302.6,2303.18,955,27,0,2300.545460921031,2304.718666666667,2308.891872412303,2300.185696452078,2304.905414163886,2304.905414163886,2305.3098509454962,-0.3125361512793461,2304.5963053613063,-0.3600699300659471,2304.7459945610044,-0.04008158508031556,2301.9687645687645,-0.03410256410097645,2301.926429681435,0.04932400932375458,-0.4353325917663824,-0.4353325917663824,2301.527236236476,2312.8403415491966,-9.684351083349395e-06,1.1627568299564206e-05,,7.74214141544774,7.7418604113110785,-4.4881157228717357e-05,4.11175464492157e-06,2285.7903474635123,2337.1677585692187,0.009883896089831978,-0.10009681557312433,2304.121452033599,2303.90584298106,0.1159523572150647,0.5183585162702236,1.0673565476775506,-0.4353325917663824,-0.34264516128996547,-0.15963070078123565,2307.0401272592408,2302.770701068531,50.53763440860252,49.447431302271035,0,0,0,0,0,0,0,0,0,0,0,0,0,0,0,0,0,0,0,0,0,0,0,0,0,0,0,0,0,0,0,0,0,0,0,0,0,0,0,0,0,0,0,0,0,0,0,0,0,0,0,-100,-100,0,0,0,0,0,0,0,0,0,4,5,,True,True,False,0.0,2403.18,2332.18,2336.18,2343.18,"5,4,2333.18",0,0.01,2024-06-12 15:55:00,2024-06-12 16:10:00,True,,,2024-06-12 16:36:55,2024-06-10 17:10:00,2303.18,2024-06-11 19:20:00,manual,2308.93,0.01,101.64,success,1 days 02:10:00,2239.5199999999995,True,10,0,24,6
2024-06-10 17:15:00,2303.74,2305.91,2303.64,2304.87,1093,27,0,2301.8617479208265,2305.0343333333335,2308.2069187458405,2300.335486800761,2304.164056358917,2304.164056358917,2304.5178207885333,-0.3922301322450039,2304.6272727272726,0.38136363636294845,2304.4898290598403,-0.10970085469989499,2302.3933449883443,0.5915034965005361,2302.0546503496566,0.13015928515960695,-0.319935483871177,-0.319935483871177,2301.4835838210647,2312.895003822081,-9.686673658188879e-06,1.1626105576107273e-05,,7.742107179084286,7.742067171726588,-4.243815219994902e-05,4.111131869452095e-06,2285.8092744440005,2335.36249888181,0.010078569807774329,-0.5863291523332919,2304.1856550063044,2303.9652014583844,0.1312720802129661,0.37044689710214557,0.974033403586856,-0.319935483871177,-0.42142232109745237,-0.4353325917663824,2306.112123166091,2302.2159895517434,48.34229390680937,46.99820788530453,0,0,0,0,0,0,0,0,0,100,0,0,0,0,0,0,0,0,0,0,0,0,0,0,0,0,0,0,0,0,0,0,0,0,0,0,0,0,0,0,0,0,0,0,0,0,0,0,0,0,0,0,0,0,0,0,0,0,0,0,0,0,4,5,,True,True,False,0.0,2404.87,2333.87,2337.87,2344.87,"5,4,2334.87",0,0.01,2024-06-12 15:55:00,2024-06-12 16:10:00,True,,,2024-06-12 16:32:47,2024-06-10 17:20:00,2304.87,2024-06-11 19:20:00,manual,2308.93,0.01,71.77,success,1 days 02:00:00,2311.2899999999995,True,11,0,24,6
2024-06-10 20:45:00,2312.12,2313.0,2311.92,2312.83,387,27,0,2304.533504518079,2309.896333333332,2315.2591621485853,2304.969384687104,2313.2550552465696,2313.2550552465696,2313.16186305772,0.018434062538290164,2311.915000000003,0.12371794872160535,2311.8440714840835,0.01332556332636159,2310.488671328672,0.21839160839454053,2310.3412548562605,0.05910256410288639,0.11950760103809444,0.11950760103809444,2293.015276167529,2313.2580502420155,1.5347259145986727e-05,1.3153029619598514e-05,,7.744689829169459,7.74390118269365,-1.2188466032569752e-06,3.944611023389642e-06,2286.2433440170444,2314.431999596555,0.009441823259294324,-0.0028132331444794545,2311.498036440838,2310.313930734364,1.0018975050129484,1.184062338217881,1.0661646884260496,0.11950760103809444,0.040561364479344775,-0.10476677790302347,2315.3873846234214,2311.1227258697177,66.5821591892206,51.662431244626966,0,0,0,0,0,0,0,0,0,0,0,0,0,0,0,0,0,0,0,0,0,0,0,0,0,0,0,0,0,0,0,0,0,0,0,0,0,0,0,0,100,0,0,0,0,0,0,0,0,0,0,0,0,0,0,0,0,0,0,0,0,0,4,5,,True,True,False,0.0,2412.83,2252.83,2337.83,2342.83,"5,4,2342.83",0,0.01,,,False,,,,2024-06-10 20:50:00,2312.83,2024-06-11 19:20:00,manual,2308.93,0.01,-68.95,fail,0 days 22:30:00,2242.3399999999997,False,0,1,24,6
2024-06-10 21:55:00,2310.29,2310.95,2310.13,2310.88,427,27,0,2309.604651746859,2311.4329999999995,2313.26134825314,2306.3464530505844,2310.6936685205783,2310.6936685205783,2310.758582622668,-0.15870943023128348,2311.111328671326,0.01951048950877521,2311.1282905983007,0.009937839936810633,2310.219743589743,0.07178321678384236,2310.179052059057,0.002579642579803476,-0.0093281423796725,-0.0093281423796725,2290.8601838992554,2312.0415630067064,2.5220373473534904e-05,1.6651339398518418e-05,,7.745053843312623,7.744771686307626,2.14950466407551e-06,1.474035090018698e-05,2282.7870791638356,2312.3384971981563,-0.39698241974610937,0.00496974736051925,2310.890235990527,2310.7131632891596,0.10807785165434325,0.31038195335882585,0.4533348651690384,-0.0093281423796725,-0.1760860215035791,-0.2907141268101441,2311.600338250916,2309.7869987902404,16.015647604832253,23.526057997088216,0,0,0,0,0,0,0,0,0,0,0,0,0,0,0,100,0,0,0,0,0,0,0,0,0,0,0,0,0,0,0,0,0,0,0,0,0,0,0,0,100,0,0,0,0,0,0,0,0,0,0,0,0,0,0,0,0,0,0,0,0,0,4,5,,True,True,False,0.0,2410.88,2250.88,2335.88,2340.88,"5,4,2340.88",0,0.01,,,False,,,,2024-06-10 22:00:00,2310.88,2024-06-11 19:20:00,manual,2308.93,0.01,-34.48,fail,0 days 21:20:00,2207.8599999999997,False,0,2,24,6
2024-06-10 22:00:00,2310.9,2311.69,2310.76,2311.32,401,27,0,2309.6727827315367,2311.3676666666665,2313.0625506017964,2306.4377107927753,2310.790455320725,2310.790455320725,2310.7290401680893,-0.02954245457885918,2311.2697552447557,0.15842657342955135,2311.157634032644,0.02934343434344555,2310.365326340326,0.14558275058334402,2310.2443434343495,0.0652913752924178,0.09678680014667407,0.09678680014667407,2290.7516332605746,2312.0802399695767,2.5846284878809303e-05,1.665095816029159e-05,,7.745093965544546,7.744851930771473,4.305540500015529e-06,1.604013445503662e-05,2282.3927472097052,2311.037169272437,-0.39433195413039357,-1.3013279257193062,2310.956353530446,2310.7581141566293,0.13116804268338456,0.2745391712237376,0.48908077040367276,0.09678680014667407,-0.0093281423796725,-0.1760860215035791,2311.7686168615323,2309.8122937799176,30.85366634646263,23.18707812357683,0,0,0,0,0,0,0,0,0,0,0,0,0,0,0,0,0,0,0,0,0,0,0,0,0,0,0,0,0,0,0,0,0,0,0,0,0,0,0,0,0,0,0,0,0,0,0,0,0,0,0,0,0,0,0,0,0,0,0,0,0,0,4,5,,True,True,False,0.0,2411.32,2251.32,2336.32,2341.32,"5,4,2341.32",0,0.01,,,False,,,,2024-06-10 22:05:00,2311.32,2024-06-11 19:20:00,manual,2308.93,0.01,-42.25,fail,0 days 21:15:00,2165.6099999999997,False,0,3,24,6
2024-06-11 05:15:00,2299.66,2300.55,2298.72,2300.34,653,27,0,2300.837277226076,2307.454333333334,2314.071389440592,2307.8960955966886,2303.3391909529105,2303.3391909529105,2304.164894821408,-0.8170685947352467,2301.8826573426577,-1.3747319347326084,2303.267296037306,-1.2778593628599992,2299.9051165501196,-1.3425524475478596,2301.268562548571,-1.2986596736582214,-0.7787786429371408,-0.7787786429371408,2295.401685783091,2317.078293928828,2.3665907498092533e-05,9.481209981576436e-06,,7.742704527541335,7.74295986255005,3.09130674775215e-05,2.1641007492075433e-05,2284.276408638122,2300.315419614346,0.3105300957363397,0.07186501890237196,2303.7058243614433,2305.999380730113,-2.0703770406821604,-1.3609319390514396,2.543348467743731,-0.7787786429371408,-0.9195543196137805,-0.7528728216557283,2308.425887888398,2298.252494017423,6.760144306254638,6.153275504994135,0,0,0,0,0,0,0,0,0,0,0,0,0,0,0,0,0,0,0,0,0,0,0,0,0,0,0,0,100,0,0,0,0,0,0,0,0,0,0,0,0,0,0,0,0,0,0,0,0,0,0,0,0,0,0,0,0,0,0,0,0,0,4,5,,False,True,False,0.0,2400.34,2333.34,2337.34,2345.34,"5,4,2330.34",0,0.01,2024-06-12 15:50:00,2024-06-12 16:15:00,True,,,2024-06-12 16:32:54,2024-06-11 05:20:00,2300.34,2024-06-11 19:20:00,manual,2308.93,0.01,151.85,success,0 days 14:00:00,2317.4599999999996,True,1,0,24,6
2024-06-11 07:50:00,2301.57,2303.55,2301.44,2303.54,273,27,0,2301.030789598804,2302.6233333333334,2304.215877067863,2305.6001067124025,2302.8629996292175,2302.8629996292175,2302.87186454085,-0.13625163762253578,2302.3633916083904,0.1634149184137641,2302.3642579642674,-0.17070318570404197,2301.3999533799542,-0.18491841491641026,2301.608811188819,-0.23114996114964015,0.11034482758486774,0.11034482758486774,2297.093317349804,2320.9437856335076,2.336082569372335e-05,-4.8203904452831136e-06,,7.74203173482679,7.742297622263483,3.0138561243654753e-05,2.1643283902888546e-05,2285.8080926524453,2302.7996531501617,0.050384630182179535,0.3068404544246732,2302.53197831249,2302.943663963591,-0.3337661993864458,-0.3759571320341606,0.7238772092536739,0.11034482758486774,-0.24728439006230474,-0.2718153503897156,2304.310754047725,2301.41524521071,28.56751044641658,15.276592551550218,0,0,0,0,100,0,0,0,0,0,0,0,0,0,0,100,0,0,0,0,0,0,0,0,0,0,0,0,0,0,0,200,0,0,0,0,0,0,0,0,100,0,0,0,0,0,0,0,0,0,0,0,0,0,0,0,0,0,0,0,0,0,4,5,,False,True,False,0.0,2403.54,2332.54,2336.54,2343.54,"5,4,2333.54",0,0.01,2024-06-12 15:55:00,2024-06-12 16:10:00,True,,,2024-06-12 16:36:51,2024-06-11 07:55:00,2303.54,2024-06-11 19:20:00,manual,2308.93,0.01,95.28,success,0 days 11:25:00,2412.74,True,2,0,24,6
2024-06-11 14:30:00,2306.96,2307.09,2305.67,2305.68,654,27,0,2302.8749755838085,2305.832333333334,2308.78969108286,2305.1044718372377,2307.2427905079726,2307.2427905079726,2307.1835486342875,0.07776517117781623,2307.067867132864,0.036445221443955234,2307.0338267288357,-0.011297591297989129,2305.8598484848485,0.011620046621374058,2305.818865578873,0.025574980574674555,0.02147423062751841,0.02147423062751841,2304.2228825880175,2318.613644759663,1.117558337067395e-05,3.325561856915755e-05,,7.743258074496341,7.74289326499532,-3.5784228475406157e-06,5.908017557472392e-06,2294.65074445427,2314.301438851677,0.013548957628245262,-0.008317676225487958,2306.4264688699195,2306.1538528980104,0.21964592588210508,0.3634723174623064,0.7405548112415632,0.02147423062751841,0.13477715980616267,0.07704412309885811,2308.7239001304556,2305.7616808854896,30.456349206354034,31.98762516944878,0,0,0,0,-100,0,0,0,100,0,0,0,0,0,0,-100,0,0,0,0,0,0,0,0,0,0,0,0,0,0,0,-200,0,0,0,0,0,0,0,0,-100,0,0,0,0,0,0,0,0,0,0,0,0,0,0,0,0,0,0,0,0,0,4,5,,True,True,False,0.0,2405.68,2330.68,2334.68,2340.68,"5,4,2335.68",0,0.01,2024-06-12 15:55:00,2024-06-12 15:55:00,True,,,2024-06-12 16:36:56,2024-06-11 14:35:00,2305.68,2024-06-11 19:20:00,manual,2308.93,0.01,57.45,success,0 days 04:45:00,2470.1899999999996,True,3,0,24,6
2024-06-11 14:50:00,2306.15,2306.89,2306.0,2306.76,636,27,0,2303.184844942347,2306.058333333334,2308.931821724321,2305.2069736060166,2307.3025858361148,2307.3025858361148,2307.3292707947126,0.01663156593713211,2306.969067599068,-0.09536130536116616,2307.0041530691637,0.035283605284348596,2305.865372960374,0.027039627042540815,2305.8443900543975,0.012245532245742652,-0.016570263254834572,-0.016570263254834572,2304.3260922087206,2318.922113197828,1.1174063151362776e-05,3.325558873800048e-05,,7.743201747208564,7.74289326499532,-3.5790296082790247e-06,5.9065090779102105e-06,2294.7049519867833,2314.268410476948,0.013552615965181758,-0.008333129691891372,2306.491083320769,2306.2582703409885,0.18728586929410085,0.26093293776774934,0.5321586765473458,-0.016570263254834572,-0.046914349279632006,0.11337931034631765,2308.3669031892096,2306.23826848302,46.329723225040084,37.514683972273296,0,0,0,0,0,0,0,0,0,0,0,0,0,0,0,0,0,0,0,0,0,0,0,0,0,0,0,0,100,0,0,0,0,0,0,0,0,0,0,0,0,0,0,0,0,0,0,0,0,0,0,100,0,0,0,0,0,0,0,0,0,0,4,5,,True,True,False,0.0,2406.76,2331.76,2335.76,2341.76,"5,4,2336.76",0,0.01,2024-06-12 16:05:00,2024-06-12 16:05:00,True,,,2024-06-12 16:36:55,2024-06-11 14:55:00,2306.76,2024-06-11 19:20:00,manual,2308.93,0.01,38.36,success,0 days 04:25:00,2508.5499999999997,True,4,0,24,6
2024-06-11 15:20:00,2313.55,2314.96,2312.65,2313.82,1244,27,0,2303.290394277985,2307.4730000000013,2311.6556057220178,2305.8127680800367,2309.421595105674,2309.421595105674,2308.712675318256,0.58990483253001,2312.515909090908,1.4569813519769923,2311.1231779331897,1.2943201243197109,2310.1735897435924,1.3293123543162437,2308.9469658119756,0.9982439782452275,0.6964189840582549,0.6964189840582549,2304.4801378307393,2319.3867794401176,1.1177832302969873e-05,3.325269829925865e-05,,7.744672649854374,7.7442276804940455,2.5200213159888563e-06,4.318916207473005e-06,2295.556973460498,2313.2615246095565,0.009915841814745363,-0.4091521112723058,2309.6689012220754,2308.0802071581916,1.434441742727813,0.7621835598196913,2.9256256961934137,0.6964189840582549,0.7339213941413618,0.33937411939086815,2315.272846498061,2303.570343713287,90.35755354521753,89.94684309095923,0,0,0,0,0,0,0,0,0,0,0,0,0,0,0,0,0,0,0,0,0,0,0,0,0,0,0,0,0,0,100,0,0,0,0,0,0,0,0,0,0,0,0,0,0,0,0,0,0,0,0,0,100,-100,0,0,0,0,0,0,0,0,4,5,,True,True,False,0.0,2413.82,2253.82,2338.82,2343.82,"5,4,2343.82",0,0.01,,,False,,,,2024-06-11 15:25:00,2313.82,2024-06-11 19:20:00,manual,2308.93,0.01,-86.45,fail,0 days 03:55:00,2422.1,False,0,1,24,6
2024-06-11 16:40:00,2310.76,2314.85,2309.9,2314.71,1448,27,0,2303.452371720804,2312.1070000000004,2320.761628279197,2308.2304726863495,2316.893868743049,2316.893868743049,2317.0479777530613,-0.20154937584902655,2314.092004662008,-0.3511305361275845,2314.7345066045186,-0.9054351204335944,2309.7829720279765,-0.6529370629327786,2310.6052758352866,-0.8616006215997913,0.004007415646356094,0.004007415646356094,2304.919902521446,2316.7243338363824,1.1092365952155779e-05,3.9477186460093576e-05,,7.746520591429402,7.746144458808013,1.1627447263886953e-05,-2.9418494991258306e-06,2298.950148868246,2312.295827421078,-0.007139512003504933,0.026477383349174488,2313.8397870936565,2312.829727874111,0.8146432208877741,1.4619249295979793,2.1809888812230684,0.004007415646356094,-0.4703418613253234,-0.13831368186902182,2321.2558465054954,2312.531890980603,29.226693719963425,23.937142907143368,0,0,0,0,0,0,0,0,0,0,0,0,0,0,0,100,0,0,0,0,0,0,0,0,0,0,0,0,0,0,0,0,0,0,0,0,0,0,0,0,100,0,0,0,0,0,0,0,0,0,0,0,0,0,0,0,0,0,0,0,0,0,4,5,,True,True,False,0.0,2414.71,2254.71,2339.71,2344.71,"5,4,2344.71",0,0.01,,,False,,,,2024-06-11 16:45:00,2314.71,2024-06-11 19:20:00,manual,2308.93,0.01,-102.19,fail,0 days 02:35:00,2319.91,False,0,2,24,6
2024-06-11 16:55:00,2313.51,2314.92,2312.89,2314.59,1205,27,0,2304.9294703882274,2312.8160000000003,2320.702529611773,2308.5281446756044,2316.378017797555,2316.378017797555,2316.4859315288613,-0.1719503151648496,2313.9407226107214,0.11061771561435307,2313.848492618503,-0.05042735042889035,2310.9029603729596,0.7450349650334829,2310.3036829836906,0.373329448327695,-0.09376566555329191,-0.09376566555329191,2304.9993868689994,2316.995932386626,1.1087614165355028e-05,3.948169793828245e-05,,7.74651089133477,7.746144458808013,1.1626791513143426e-05,-6.616080114972519e-06,2300.5543559519692,2312.3769076542553,-0.014797741449910973,0.026265184387284535,2313.837194638897,2313.024854851038,0.6449306068984697,1.0629137034027019,1.2824752852013122,-0.09376566555329191,-0.13620986280830039,-0.28587541713250175,2318.9429683679577,2313.8130672271523,42.63927793339756,39.58916900093562,0,0,0,0,0,0,0,0,0,0,0,0,0,0,0,0,0,0,0,0,0,0,0,0,0,0,0,0,0,0,0,0,0,0,0,0,0,0,0,0,0,0,0,0,0,0,0,0,0,0,0,100,0,0,0,0,0,0,0,0,0,0,4,5,,True,True,False,0.0,2414.59,2254.59,2339.59,2344.59,"5,4,2344.59",0,0.01,,,False,,,,2024-06-11 17:00:00,2314.59,2024-06-11 19:20:00,manual,2308.93,0.01,-100.07,fail,0 days 02:20:00,2219.8399999999997,False,0,3,24,6
2024-06-11 17:50:00,2316.86,2317.39,2315.05,2315.68,1269,27,0,2311.2545732175936,2315.118333333332,2318.9820934490704,2309.746453347383,2314.254363366704,2314.254363366704,2314.2057350142136,-0.008329501915795845,2316.5672377622395,0.25773892773941043,2316.2701709401817,0.20049728049798432,2314.171923076927,0.20569930070450937,2313.959300699309,0.11842657342776874,0.001212458288136986,0.001212458288136986,2305.279951210069,2317.368937165231,1.1088648087347654e-05,4.054937472786097e-05,,7.746683601845133,7.746176989641833,1.1627221672235134e-05,-6.615397500295809e-06,2300.3866430906046,2312.6724141254786,-0.01479089878648665,0.026460185713858664,2315.0961358709183,2314.27385254029,0.6863329937505114,0.6754906415562155,0.9130551149305416,0.001212458288136986,0.14346014089733217,-0.16966110493240194,2316.0804735965653,2312.428253136843,77.25052167961611,76.73182651232399,0,0,0,0,0,0,0,0,0,0,0,0,0,0,0,0,0,0,0,0,0,0,0,0,0,0,0,0,0,0,0,0,0,0,0,0,0,0,0,0,-100,0,0,0,0,0,0,0,0,0,0,0,0,0,0,0,0,0,0,0,0,0,4,5,,True,True,False,0.0,2415.68,2255.68,2340.68,2345.68,"5,4,2345.68",0,0.01,,,False,,,,2024-06-11 17:55:00,2315.68,2024-06-11 19:20:00,manual,2308.93,0.01,-119.34,fail,0 days 01:25:00,2100.4999999999995,False,0,4,24,6
2024-06-11 19:15:00,2310.07,2310.32,2308.88,2308.94,701,27,0,2309.2368413449326,2313.2313333333313,2317.22582532173,2310.293088962751,2310.6474423433456,2310.6474423433456,2311.1454297367463,-0.4420086515874573,2311.2343939393936,-0.5070163170189517,2311.594930069941,-0.1579642579645224,2309.660314685314,-0.39089743589920545,2309.9706604506696,-0.08858974358872729,-0.5738368557667854,-0.5738368557667854,2305.7146695314595,2312.4630808998263,1.1088425646944226e-05,5.230074471034842e-05,,7.746254521886941,7.746816692078273,1.162475376695199e-05,-9.685045601821818e-06,2301.2880282584047,2313.1309387485776,-0.02289672639381024,0.02766225690675128,2311.199441658957,2312.187103289671,-0.9129289000502467,-0.6301891163276805,1.0225877538164356,-0.5738368557667854,-0.34628846866417007,-0.40590063033187107,2312.6926178509784,2308.6022668357127,10.421483371842324,18.112602801516463,0,0,0,0,0,0,0,0,0,0,0,0,0,0,0,-100,0,0,0,0,0,0,0,0,0,0,0,0,0,0,0,0,0,0,0,0,0,0,0,0,-100,0,0,0,0,0,0,0,0,0,0,0,0,0,0,0,0,0,0,0,0,0,4,5,,True,False,True,1.0,2208.94,2368.94,2283.94,2278.94,"5,4,2278.94",1,0.01,,,False,,,,2024-06-11 19:20:00,2308.94,2024-06-11 21:20:00,manual,2313.9,0.01,-87.69,fail,0 days 02:00:00,2012.8099999999995,False,0,5,24,6
2024-06-11 21:15:00,2313.38,2314.11,2313.08,2314.01,458,27,0,2305.847073637892,2310.0356666666657,2314.2242596954393,2310.2505668985546,2311.828388579904,2311.828388579904,2311.2938089234963,0.5296329254724697,2314.079603729606,0.32488344988678364,2313.7036557886645,0.44659673659771215,2312.9882634032638,0.33508158508084307,2312.6183100233193,0.47398212898178826,0.5371434927710652,0.5371434927710652,2301.865614263355,2315.365294173808,2.0724918373581928e-05,5.230527300927207e-05,,7.745526075996336,7.7453575370606185,1.1627724366275689e-05,1.707175040519756e-06,2297.07992852173,2313.7748825331573,-0.24574901772075464,0.025544597732732655,2312.0147051821305,2311.199846553012,0.7771074203719763,0.2690598342472606,1.0298092749924284,0.5371434927710652,0.5294519836852487,0.5223032999615498,2313.888007129889,2309.7687700299193,94.16054474672114,93.09222958843463,0,0,0,0,0,0,0,0,0,0,0,0,0,0,0,0,0,0,0,0,0,0,0,0,0,0,0,0,0,0,0,0,0,0,0,0,0,0,0,0,0,0,0,0,0,0,0,0,0,0,0,0,0,0,0,0,0,0,0,0,0,0,4,5,,True,True,False,0.0,2414.01,2254.01,2339.01,2344.01,"5,4,2344.01",0,0.01,,,False,,,,2024-06-11 21:20:00,2314.01,2024-06-13 04:40:00,manual,2309.54,0.01,-79.03,fail,1 days 07:20:00,1933.7799999999995,False,0,6,24,6
2024-06-11 21:25:00,2313.68,2315.63,2313.55,2314.79,510,27,0,2305.597569986016,2310.2859999999996,2314.9744300139832,2310.3958101524745,2312.878180200223,2312.878180200223,2312.342834507479,0.5289783710300071,2314.7837296037283,0.4523193473169158,2314.3982478632574,0.3430031080029039,2313.551829836827,0.2434498834468286,2313.282824397832,0.2995493395478661,0.5562454579171572,0.5562454579171572,2301.963056542751,2315.6076385182223,2.0721869450447585e-05,5.2305029616266736e-05,,7.745851546212894,7.745314354133393,1.162608675280151e-05,3.3400256327118838e-06,2296.569272188656,2313.829549829083,-0.26048114826926394,0.02713768625199009,2312.6597593315846,2311.63657626287,0.9574725860320541,0.49787727602068266,0.7812809993953341,0.5562454579171572,0.49354616240179894,0.5371434927710652,2314.4407421990136,2311.3156182014327,91.68858526691372,93.09451335907352,0,0,0,0,100,0,0,0,0,0,0,0,0,0,0,0,0,0,0,0,0,0,0,0,0,0,0,0,0,0,0,0,0,0,0,0,0,0,0,0,0,0,0,0,0,0,0,0,0,0,0,0,0,0,0,0,0,0,0,0,0,0,4,5,,True,True,False,0.0,2414.79,2254.79,2339.79,2344.79,"5,4,2344.79",0,0.01,,,False,,,,2024-06-11 21:30:00,2314.79,2024-06-13 04:40:00,manual,2309.54,0.01,-92.82,fail,1 days 07:10:00,1840.9599999999996,False,0,7,24,6
2024-06-11 21:45:00,2313.24,2314.7,2313.23,2314.21,382,27,0,2305.4202986795576,2310.755666666666,2316.0910346537744,2310.662710924933,2314.7097701149423,2314.7097701149423,2314.381669509333,0.3773147942160904,2315.2156410256393,-0.07590909091004505,2315.2989199689287,0.049254079253842065,2313.771480186481,-0.11369463869414176,2313.8802836052914,-0.03585081585151784,0.33913830181563753,0.33913830181563753,2302.1518390315478,2314.6790050083973,2.0724962407082776e-05,5.522528261229864e-05,,7.745991070535929,7.745314354133393,1.1848688746969963e-05,6.669807921252113e-06,2295.5735243975364,2313.82370194999,-0.23917460943175683,0.028070857141756278,2313.3486599339567,2312.291532762214,0.9647458343415565,0.7952940540594827,0.6818030193319894,0.33913830181563753,0.30602521320042797,0.48678086763129613,2316.073376153606,2313.3461640762785,67.9322915722426,76.40759226963739,0,0,0,0,0,0,0,0,0,0,0,0,0,100,0,0,0,0,0,0,0,0,0,0,0,0,0,0,0,0,0,0,0,0,0,0,0,0,0,0,0,0,0,0,0,0,0,0,0,0,0,0,0,0,0,0,0,0,0,0,0,0,4,5,,True,True,False,0.0,2414.21,2254.21,2339.21,2344.21,"5,4,2344.21",0,0.01,,,False,,,,2024-06-11 21:50:00,2314.21,2024-06-13 04:40:00,manual,2309.54,0.01,-82.56,fail,1 days 06:50:00,1758.3999999999996,False,0,8,24,6
2024-06-11 21:55:00,2313.5,2313.81,2313.39,2313.73,521,27,0,2305.924406571793,2311.1523333333325,2316.380260094872,2310.7697363336047,2314.994292176491,2314.994292176491,2314.8650495612414,0.2078867877880839,2314.808158508158,-0.25910256410406873,2315.030353535363,-0.1611305361302584,2313.599277389279,-0.02355477855553545,2313.66452991454,-0.09529914529866801,0.10320578420396487,0.10320578420396487,2302.248929813262,2314.479030888923,2.072240724075636e-05,5.617624003123372e-05,,7.746048371922008,7.745314354133393,1.2935467430686667e-05,8.374392889172666e-06,2295.0866874141284,2313.329757471812,-0.24375405222735935,-0.5200016782700914,2313.424425159815,2312.4795994189076,0.852152265901168,0.8229810679891036,0.6777009454438713,0.10320578420396487,0.18131627734464928,0.33913830181563753,2316.3496940673786,2313.6388902856033,60.4039280104233,63.395509794950904,0,0,0,0,0,0,0,0,0,0,0,0,0,0,0,0,0,0,0,0,0,0,0,0,0,0,0,0,100,0,0,0,0,0,0,0,0,0,0,0,0,0,0,0,0,0,0,0,0,0,0,100,0,0,0,0,0,0,0,0,0,0,4,5,,True,True,False,0.0,2413.73,2253.73,2338.73,2343.73,"5,4,2343.73",0,0.01,,,False,,,,2024-06-11 22:00:00,2313.73,2024-06-13 04:40:00,manual,2309.54,0.01,-74.08,fail,1 days 06:40:00,1684.3199999999997,False,0,9,24,6
2024-06-11 22:10:00,2314.08,2314.66,2314.07,2314.28,341,27,0,2307.1783525732053,2311.8706666666662,2316.562980760127,2310.954070887469,2315.212900259547,2315.212900259547,2315.159823754789,0.07286936101854735,2314.4661538461523,-0.09375291375272354,2314.588714063721,-0.11400155400224321,2313.647727272727,0.06538461538411866,2313.587187257196,0.016149961149039882,0.04330218761742799,0.04330218761742799,2302.3918186681244,2314.6381348294212,2.072277954570001e-05,5.666539791718099e-05,,7.746094852077277,7.745314354133393,1.3154040858785342e-05,1.0876064233961365e-05,2294.402340167665,2313.3106976997788,-0.22741872694996346,-0.07816293701125687,2313.724820158268,2312.8307666981877,0.7960390830517099,0.8179861116828065,0.37837764585362554,0.04330218761742799,0.07262513904152001,0.1026807563971488,2315.969655551254,2314.45614496784,57.533115554439654,56.99969573099228,0,0,0,0,100,0,0,0,0,0,0,0,0,0,0,0,0,0,0,0,0,0,0,0,0,0,0,0,0,0,0,-100,0,0,0,0,0,0,0,0,0,0,0,0,0,0,0,0,0,0,0,0,0,0,0,0,0,0,0,0,0,0,4,5,,True,True,False,0.0,2414.28,2254.28,2339.28,2344.28,"5,4,2344.28",0,0.01,,,False,,,,2024-06-11 22:15:00,2314.28,2024-06-13 04:40:00,manual,2309.54,0.01,-83.8,fail,1 days 06:25:00,1600.5199999999998,False,0,10,24,6
2024-06-11 22:35:00,2312.58,2314.02,2312.47,2313.84,401,27,0,2308.8895450515583,2312.6606666666653,2316.4317882817722,2311.1820069342934,2314.952993696701,2314.952993696701,2314.972660239774,-0.06632529971511758,2313.9891025641036,0.05396270396431646,2314.0220318570414,-0.04931623931588547,2313.1180069930056,-0.18854312354233116,2313.3113170163247,-0.15750971251009105,0.03509677419515356,0.03509677419515356,2302.6299762218664,2315.2661269855553,2.0723434284986056e-05,5.672595303650037e-05,,7.745923086365171,7.745314354133393,1.3153780975927489e-05,1.4587510072199597e-05,2293.469210062314,2313.4629702446314,-0.174448912772732,0.030982260035216314,2313.59775522649,2313.050272325062,0.4685795872446761,0.6498655515209715,0.5303839579774878,0.03509677419515356,-0.1291931776072488,-0.10487949573371225,2316.013761612656,2313.8922257807462,21.845466428745834,23.722886539208485,0,0,0,0,100,0,0,0,0,0,0,0,0,0,0,0,0,0,0,0,0,0,0,0,0,0,0,0,0,0,0,0,0,0,0,0,0,0,0,0,100,0,0,0,0,0,0,0,0,0,0,0,0,0,0,0,0,0,0,0,0,0,4,5,,True,True,False,0.0,2413.84,2253.84,2338.84,2343.84,"5,4,2343.84",0,0.01,,,False,,,,2024-06-11 22:40:00,2313.84,2024-06-13 04:40:00,manual,2309.54,0.01,-76.02,fail,1 days 06:00:00,1524.4999999999998,False,0,11,24,6
2024-06-11 22:50:00,2314.86,2315.33,2314.84,2314.93,289,28,0,2310.4118141519207,2313.2443333333313,2316.076852514742,2311.362788077184,2314.8126459028545,2314.8126459028545,2314.832716104314,-0.04678259794900441,2314.5245687645665,0.2926340326348509,2314.247346542354,0.17848873348748384,2313.613216783215,0.33938228437818907,2313.3532595182674,0.16506993006987614,-0.02419948090619073,-0.02419948090619073,2302.77300807778,2315.659549949248,2.0723638318339058e-05,5.672731377308681e-05,,7.745995440733612,7.745314354133393,1.41617548663703e-05,1.6918523705532743e-05,2292.921428349656,2313.071015054018,-0.1854935995120286,-0.45169915551741724,2313.986204918734,2313.3593936431994,0.5421242785614595,0.5778272261243094,0.7422937424124334,-0.02419948090619073,-0.011811642564225622,-0.10433667037614214,2316.297233387679,2313.3280584180297,75.17537009278652,56.43903279999114,100,0,0,0,0,0,0,0,0,0,0,0,0,0,0,0,0,0,0,100,0,0,0,0,0,100,0,0,0,0,0,0,0,0,0,0,0,0,0,100,0,0,0,0,0,0,0,0,0,0,0,0,0,0,0,0,0,0,0,0,0,0,4,5,,True,True,False,0.0,2414.93,2254.93,2339.93,2344.93,"5,4,2344.93",0,0.01,,,False,,,,2024-06-11 22:55:00,2314.93,2024-06-13 04:40:00,manual,2309.54,0.01,-95.29,fail,1 days 05:45:00,1429.2099999999998,False,0,12,24,6
2024-06-12 04:45:00,2311.38,2312.0,2310.97,2311.92,540,32,0,2310.970107615779,2313.8843333333343,2316.7985590508897,2313.4602804648302,2311.881257693733,2311.881257693733,2312.0821846496133,-0.23983463107197167,2312.132424242424,-0.17688811188872933,2312.319118104127,-0.20321289821367827,2310.803764568766,0.009708624712857272,2310.834875679882,-0.09249417249429825,-0.16795179829705376,-0.16795179829705376,2310.759847922257,2342.1645235634805,-4.282469892043593e-06,-1.915391495032279e-06,,7.746373415280779,7.746770708588383,2.3255341773812058e-05,2.520675972507652e-05,2294.0273271367073,2311.8855530687856,0.05748048036139153,0.2149751896649832,2312.3434980221714,2313.303656952857,-0.8576942227546169,-0.7399318861687486,0.36059227071428235,-0.16795179829705376,-0.2668772710394478,-0.28467482387850396,2312.6024422351616,2311.1600731523044,17.149257321544567,18.76970510053547,0,0,0,0,0,0,0,0,0,0,0,0,0,0,0,100,0,0,0,0,0,0,0,0,0,0,0,0,0,0,0,0,0,0,0,0,0,0,0,0,100,0,0,0,0,0,0,0,0,0,0,0,0,0,0,0,0,0,0,0,0,0,4,5,,False,True,False,0.0,2411.92,2251.92,2336.92,2341.92,"5,4,2341.92",0,0.01,,,False,,,,2024-06-12 04:50:00,2311.92,2024-06-13 04:40:00,manual,2309.54,0.01,-42.08,fail,0 days 23:50:00,1387.1299999999999,False,0,13,24,6
2024-06-12 05:10:00,2312.31,2313.42,2311.86,2313.3,490,29,0,2310.939751703122,2313.6236666666673,2316.3075816302126,2313.4690997274297,2312.1671983685565,2312.1671983685565,2312.215395377582,-0.014752440984011628,2313.956258741259,0.0313286713276284,2313.9033838383934,0.17149184149184293,2312.311212121211,-0.008298368295982073,2312.359906759912,0.15327117327160522,-0.011012977382961253,-0.011012977382961253,2310.71118570623,2344.454043282163,-4.283782756124227e-06,-9.389804408384986e-06,,7.74652575511417,7.746762078561932,2.110823635553343e-05,2.520622826020561e-05,2294.316574657652,2312.8657022586376,0.05776558147454125,0.20660192901823393,2312.971441745384,2313.3716493549123,-0.335650136321874,-0.5234500616008164,1.255021343017784,-0.011012977382961253,-0.12256507230176794,0.08932072673223956,2314.677241054592,2309.657155682521,54.928517682471266,65.49895534872768,0,0,0,0,0,0,0,0,0,0,0,0,0,0,0,100,0,0,0,0,0,0,0,0,0,0,0,0,0,0,0,0,0,0,0,0,0,0,0,0,0,0,0,0,0,0,0,0,0,0,0,0,0,0,0,0,0,0,0,0,0,0,4,5,,False,True,False,0.0,2413.3,2253.3,2338.3,2343.3,"5,4,2343.3",0,0.01,,,False,,,,2024-06-12 05:15:00,2313.3,2024-06-13 04:40:00,manual,2309.54,0.01,-66.47,fail,0 days 23:25:00,1320.6599999999999,False,0,14,24,6
2024-06-12 06:05:00,2314.14,2315.26,2314.09,2315.16,522,32,0,2310.9935040741702,2313.264666666668,2315.5358292591654,2313.561680110147,2313.7951160548773,2313.7951160548773,2313.503130391796,0.20912075145270137,2314.4109790209795,0.17347319347163648,2314.2855011655115,0.09851204351161869,2313.2500349650327,0.19357808857830605,2313.0330341880394,0.23939393939326692,0.34691583240874024,0.34691583240874024,2311.720113411288,2346.59803962611,-6.158422788851142e-06,-1.7797796282816095e-05,,7.746334692298753,7.746343329667466,1.6257209350652984e-05,2.366512037217409e-05,2295.11644231258,2314.8874964758743,0.054511198460659216,0.18618889352319457,2313.8233950523572,2313.7082776900775,0.1235934162104968,-0.038077387773655665,0.8047537334144731,0.34691583240874024,0.18212532443567397,0.09832109751414464,2315.404623521706,2312.1856085880486,74.44903581267253,66.75849403122213,0,0,0,0,0,0,0,0,0,100,0,0,0,100,0,100,0,0,0,0,0,0,0,0,0,0,0,0,0,0,0,0,0,0,0,0,0,0,0,0,100,0,0,0,0,0,0,0,0,0,0,0,0,0,0,0,0,0,0,0,0,0,4,5,,False,True,False,0.0,2415.16,2255.16,2340.16,2345.16,"5,4,2345.16",0,0.01,,,False,,,,2024-06-12 06:10:00,2315.16,2024-06-13 04:40:00,manual,2309.54,0.01,-99.36,fail,0 days 22:30:00,1221.3,False,0,15,24,6
2024-06-12 06:30:00,2315.55,2316.19,2314.94,2315.86,251,27,0,2310.8048179923794,2313.497000000001,2316.189182007623,2313.713688096834,2315.1430989988867,2315.1430989988867,2314.8692134470416,0.2782185143978495,2316.0580652680696,0.389335664340706,2315.651787101798,0.475668220668922,2315.111095571095,0.4300116550102757,2314.6314529914603,0.4638073038067887,0.2634475342974838,0.2634475342974838,2311.647270200698,2346.3905381398667,-6.1555817766537315e-06,-1.780261142742997e-05,,7.746739805693865,7.746574321923619,1.3951195816835275e-05,2.3666056284701587e-05,2295.387957214181,2315.755132716061,0.05427869979712341,0.16007450304232407,2314.696105384635,2314.221081880116,0.44484615420151385,0.21416417933360168,0.775868177339667,0.2634475342974838,0.29476158694751575,0.2764464219499132,2316.694835353566,2313.5913626442075,82.24819143016163,82.51144776034799,0,0,0,0,0,0,0,0,0,0,0,0,0,0,0,0,0,0,0,0,0,0,0,0,0,0,0,0,0,0,0,0,0,0,0,0,0,0,0,0,0,0,0,0,0,0,0,0,0,0,0,0,100,0,0,0,0,0,0,0,0,0,4,5,,False,True,False,0.0,2415.86,2255.86,2340.86,2345.86,"5,4,2345.86",0,0.01,,,False,,,,2024-06-12 06:35:00,2315.86,2024-06-13 04:40:00,manual,2309.54,0.01,-111.73,fail,0 days 22:05:00,1109.57,False,0,16,24,6
2024-06-12 13:30:00,2313.74,2314.13,2313.54,2313.55,231,27,0,2311.7745562203086,2313.5693333333325,2315.3641104463563,2313.7967482794725,2313.6782944011866,2313.6782944011866,2313.593627734524,0.02380002472000342,2313.8893006993026,0.08498834499187069,2313.837968142979,-0.027719502718355216,2313.0514685314656,0.27803030302857223,2312.8261655011725,0.09926184926052883,0.09974193548214316,0.09974193548214316,2312.031117442055,2347.8462134457664,-1.2091861823693785e-05,-4.348104993368007e-05,,7.746459152653906,7.746388715399098,-4.8029832646781344e-06,1.505796072576163e-05,2301.3672521134904,2320.3519929701915,0.03466894411349131,-0.011220369218790438,2313.567006138848,2313.636631856762,-0.060940183518596314,-0.024801952976678938,0.4839126249500963,0.09974193548214316,0.0545161290328906,-0.08285799035638775,2314.646119651087,2312.7104691512864,41.71842650103856,35.507246376814855,0,0,0,0,0,0,0,0,0,0,0,0,0,0,0,0,0,0,0,0,0,0,0,0,0,0,0,0,0,0,0,0,0,0,0,0,0,0,0,0,0,0,0,0,0,0,0,0,0,0,0,0,0,0,0,0,0,0,0,0,0,0,4,5,,True,True,False,0.0,2413.55,2338.55,2342.55,2348.55,"5,4,2343.55",0,0.01,2024-06-20 09:25:00,2024-06-20 09:25:00,True,,,2024-06-20 10:59:35,2024-06-12 13:35:00,2313.55,2024-06-13 04:40:00,manual,2309.54,0.01,-70.89,fail,0 days 15:05:00,1038.6799999999998,False,0,17,24,6
2024-06-12 15:30:00,2315.19,2328.42,2315.17,2324.9,2571,27,0,2309.4219719754515,2313.735333333333,2318.0486946912147,2313.8496122195747,2314.7616937337766,2314.7616937337766,2313.718174762084,0.6197364973418189,2318.4287296037314,3.826340326340869,2315.706973581984,1.673127428126918,2313.3497902097906,0.7682867132880347,2312.7642501942582,0.4000155400158292,1.4425205784195896,1.4425205784195896,2315.170000000001,2342.889866150301,-2.1175158050862684e-05,-2.5188370166222368e-05,,7.7492985741891935,7.7492985741891935,1.3560058471973546e-05,1.117776549411825e-05,2304.1389020620545,2319.2423947485636,0.025712836913044157,-0.8533042283297618,2315.3189369604343,2314.2943921625533,0.9556551730729552,0.12699239733955658,4.1600334820132545,1.4425205784195896,0.24551575824898464,0.17117315535779198,2323.081760697803,2306.44162676975,73.92421223602338,68.8428615105663,0,0,0,0,0,0,0,0,0,0,0,0,0,100,0,0,0,0,0,0,0,0,0,0,0,0,0,0,0,0,0,-100,0,0,0,0,0,0,0,0,0,0,0,0,0,0,0,0,0,0,0,0,0,0,0,0,0,0,0,0,0,0,4,5,,True,True,False,0.0,2424.9,2264.9,2349.9,2354.9,"5,4,2354.9",0,0.01,,,False,,,,2024-06-12 15:35:00,2324.9,2024-06-13 04:40:00,manual,2309.54,0.01,-271.55,fail,0 days 13:05:00,767.1299999999999,False,0,18,24,6
2024-06-12 17:20:00,2327.65,2329.25,2326.63,2328.52,1098,27,0,2309.1881933779246,2327.392333333334,2345.5964732887437,2319.7700612092226,2334.0049306637,2334.0049306637,2334.648134223215,-0.6799859102702612,2326.207797202798,0.03910256410108559,2326.264254079264,-0.4033527583524119,2322.7548251748253,0.8802564102552424,2322.0430536130625,0.17271950271970127,-0.6306651835352568,-0.6306651835352568,2316.8407039656013,2341.5922033184693,-3.090634074383429e-05,-2.5188832748855106e-05,,7.752572567892373,7.7521101628284494,3.325480451972008e-05,1.1089806674911324e-05,2304.7361841570473,2320.0606047260876,0.05633724958715902,0.07582075114532927,2328.282292644465,2327.317799300998,0.682071808382716,1.8755280734757371,2.141984643861692,-0.6306651835352568,-0.6682803114595117,-0.7410122358173794,2338.2888999514234,2329.720961375977,35.05108188850585,25.579068730278504,0,0,0,0,0,0,0,0,0,0,0,0,0,0,0,0,0,0,0,0,0,0,0,0,0,0,0,0,0,0,0,0,0,0,0,0,0,0,0,0,0,0,0,0,0,0,0,0,0,0,0,0,0,0,0,0,0,0,0,0,0,0,4,5,,True,True,False,0.0,2428.52,2268.52,2353.52,2358.52,"5,4,2358.52",0,0.01,,,False,,,,2024-06-12 17:25:00,2328.52,2024-06-13 04:40:00,manual,2309.54,0.01,-335.55,fail,0 days 11:15:00,431.57999999999987,False,0,19,24,6
2024-06-12 20:15:00,2337.8,2338.94,2337.46,2338.69,626,27,0,2324.756879382776,2333.349333333332,2341.9417872838885,2326.0109523051287,2339.380935113088,2339.380935113088,2339.2191637622086,0.12464491410219125,2338.4737995337973,0.3725174825171962,2338.1234071484164,0.14548562548498012,2336.708892773894,0.3624242424257318,2336.4068181818266,0.11549339549446813,0.19626028921038596,0.19626028921038596,2314.336705749784,2339.5279380755032,-3.091038749552451e-05,-2.5187267056794808e-05,,7.755027843637082,7.753417751778027,4.741360258357797e-05,1.1090061573676514e-05,2305.63090224993,2314.809758323717,0.026820021725598053,0.10927066401245611,2336.711824065646,2334.578309960981,1.8393097084217516,1.9168211330859097,0.8629641611049749,0.19626028921038596,0.09279347423080253,0.08488097886538526,2341.1068634352982,2337.655006790878,84.25783475204055,77.09568571357221,0,0,0,0,0,0,0,0,0,0,0,0,0,0,0,0,0,0,0,0,0,0,0,0,0,0,0,0,0,0,0,0,0,0,0,0,0,0,0,0,0,0,0,0,0,0,0,0,0,0,0,100,0,0,0,0,0,0,0,0,0,0,4,5,,True,True,False,0.0,2438.69,2278.69,2363.69,2368.69,"5,4,2368.69",0,0.01,,,False,,,,2024-06-12 20:20:00,2338.69,2024-06-13 04:40:00,manual,2309.54,0.01,-515.35,fail,0 days 08:20:00,-83.77000000000015,False,0,20,24,6
2024-06-13 03:25:00,2320.43,2321.68,2320.3,2321.51,252,29,0,2318.7279414676177,2321.487,2324.2460585323824,2323.517557794887,2319.647005561736,2319.647005561736,2319.541126683976,0.012687183290381654,2320.120582750583,0.288857808857756,2319.9325135975246,0.02280497280480631,2318.8394522144526,0.24008158508468114,2318.6546076146155,-0.00743589743569828,0.17027363737452106,0.17027363737452106,2307.128027128674,2335.713114127844,-2.6454387516385816e-05,-2.6775837607205336e-05,,7.749560656484601,7.74990709574749,5.141298253260557e-05,1.946666480031495e-05,2304.547335433707,2321.3823936423473,0.04458111833309886,0.46271454127554534,2320.381835873549,2321.0490101199107,-0.5691018929678648,-0.6459854788199881,1.1881069877937738,0.17027363737452106,-0.022910641453108838,-0.10930144605117675,2322.0232195373237,2317.2707915861483,65.76011157601351,47.90448469728256,0,0,0,0,0,0,0,0,0,0,0,0,0,0,0,0,0,0,0,0,0,0,0,0,0,0,0,0,0,0,0,0,0,0,0,0,0,0,0,0,100,0,0,0,0,0,0,0,0,0,0,0,0,0,0,0,0,0,0,0,0,0,4,5,,False,True,False,0.0,2421.51,2354.51,2358.51,2366.51,"5,4,2351.51",0,0.01,2024-06-20 17:05:00,2024-06-20 17:50:00,True,,,2024-06-20 18:23:28,2024-06-13 03:30:00,2321.51,2024-06-13 04:40:00,manual,2309.54,0.01,-211.62,fail,0 days 01:10:00,-295.39000000000016,False,0,21,24,6
2024-06-13 04:35:00,2311.26,2311.39,2308.05,2309.53,1185,27,0,2312.0385452676,2318.8750000000005,2325.711454732401,2321.9581976835643,2314.9309877641813,2314.9309877641813,2315.9291350883755,-0.9337275985662927,2313.536841491841,-1.3602564102607175,2314.8864491064633,-1.347793317794185,2310.3384965034957,-1.5626456876429984,2311.728045843052,-1.447828282829505,-1.0603151649988831,-1.0603151649988831,2306.274702357542,2337.8592239658624,-2.645680842677366e-05,-3.6573292990811385e-05,,7.747240095374431,7.747420949011447,3.604908724632917e-05,-4.057474020065504e-06,2310.779174411746,2328.5653400672886,0.0693757833169002,0.6017902750904796,2314.9977655255852,2317.5616142326776,-2.3092283234291244,-1.3981880673303646,3.60234447469153,-1.0603151649988831,-0.8738116425661246,-0.8670559881343252,2322.1356767135644,2307.726298814798,10.195302190552512,10.966730318414191,0,0,0,0,0,0,0,0,0,0,0,0,0,-100,0,0,0,0,0,0,0,0,0,0,0,0,0,0,0,0,0,100,0,0,0,0,0,0,0,0,0,0,0,0,0,0,0,0,0,0,0,0,0,0,0,0,0,0,0,0,0,0,4,5,,False,False,True,1.0,2209.53,2369.53,2284.53,2279.53,"5,4,2279.53",1,0.01,,,False,,,,2024-06-13 04:40:00,2309.53,2024-06-13 16:45:00,manual,2319.47,0.01,-175.73,fail,0 days 12:05:00,-471.1200000000001,False,0,22,24,6
2024-06-13 07:35:00,2311.81,2312.12,2310.65,2311.05,333,28,0,2311.5465546659193,2313.848000000001,2316.1494453340824,2317.8955984981285,2312.924413793103,2312.924413793103,2313.2521295266397,-0.29753503893198285,2312.9096503496517,-0.4233682983658582,2313.30033799535,-0.3726728826732142,2311.9613403263434,-0.5964102564080349,2312.475470085479,-0.488368298367277,-0.37140452354378795,-0.37140452354378795,2298.931195672958,2333.5387902301413,-1.0593139639064888e-05,-3.102015693766266e-05,,7.746051048208959,7.745927217043635,-1.7799743485059573e-05,-6.1575016170305645e-06,2311.680484349728,2346.4839207133923,1.096750744514793,0.3064400906037008,2312.91989336729,2313.643716706735,-0.6261572775615605,-0.417807053318887,1.166811895733599,-0.37140452354378795,-0.2403381535036715,-0.2808624397493986,2315.2580375845705,2310.590790001636,10.804235745221737,11.392941473744884,0,0,0,0,0,0,0,0,0,0,0,0,0,0,0,0,0,0,0,0,0,0,0,0,0,0,0,0,0,0,0,0,0,0,0,0,0,0,0,0,0,0,0,0,0,0,0,0,0,0,0,0,0,0,0,0,0,0,0,0,0,0,4,5,,False,False,True,1.0,2211.05,2371.05,2286.05,2281.05,"5,4,2281.05",1,0.01,,,False,,,,2024-06-13 07:40:00,2311.05,2024-06-13 16:45:00,manual,2319.47,0.01,-148.86,fail,0 days 09:05:00,-619.9800000000001,False,0,23,24,6
2024-06-13 08:05:00,2311.77,2311.77,2311.0,2311.11,284,27,0,2310.363424410075,2313.1970000000015,2316.030575589928,2317.1919215592393,2311.5832769744175,2311.5832769744175,2311.8526785317076,-0.17743418613190443,2311.5109090909077,-0.008379953378607752,2311.5046969697087,-0.019766899766636925,2310.374277389281,0.1343006993029121,2310.243679098689,0.10010489510614207,-0.34597033740874394,-0.34597033740874394,2297.1261409899666,2332.386241506093,-5.245577997498072e-06,-2.7598967677831195e-05,,7.745870666118751,7.746189274394711,-1.7802397629584847e-05,-6.159745271202055e-06,2311.596373238857,2346.234031175483,-0.013469902979522885,-0.04053470196640774,2311.8938560969887,2312.7569572092125,-0.7484447062051913,-0.6836250102906111,0.7578812100598916,-0.34597033740874394,-0.11626399703482093,-0.0700682239530579,2313.099039394537,2310.0675145542978,41.258318209313515,42.95220810646966,0,0,0,0,0,0,0,0,0,0,0,0,0,0,0,0,0,0,0,0,0,0,0,0,0,0,0,0,0,0,0,0,0,0,0,0,0,0,0,0,0,0,0,0,0,0,0,0,0,0,0,-100,0,0,0,0,0,0,0,0,0,0,4,5,,False,False,True,1.0,2211.11,2371.11,2286.11,2281.11,"5,4,2281.11",1,0.01,,,False,,,,2024-06-13 08:10:00,2311.11,2024-06-13 16:45:00,manual,2319.47,0.01,-147.8,fail,0 days 08:35:00,-767.7800000000002,False,0,24,24,6
2024-06-13 14:20:00,2312.44,2312.7,2310.05,2310.49,833,27,0,2312.1287081669325,2316.246666666667,2320.3646251664013,2315.8289796169793,2315.64557879125,2315.64557879125,2316.36120726734,-0.6018151032008063,2314.003310023308,-1.084906759911064,2315.0591880342013,-1.1083605283611178,2311.9053613053616,-1.4543589743598204,2313.2093045843117,-1.2133333333322298,-0.7981053021858315,-0.7981053021858315,2291.904897596203,2326.0412657635006,2.628457036150593e-05,1.6011958434549746e-05,,7.747116340424882,7.747143283157591,-4.3483639125305275e-05,-9.846653258192496e-06,2312.0347355980657,2348.3832495722013,-0.022775978373829275,5.238106859100299,2314.8158031007915,2315.6862679710493,-0.831635473861752,-0.05112487611933314,2.7250163826613387,-0.7981053021858315,-0.5506748238808541,-0.4566651835357334,2321.0956115565727,2310.1955460259273,7.816912135161629,10.397053211291633,0,0,0,0,0,0,0,0,0,0,0,0,0,0,0,0,0,0,0,0,0,0,0,0,0,0,0,0,0,0,0,0,0,0,0,0,0,0,0,0,0,0,0,0,0,0,0,0,0,0,0,0,0,0,0,0,0,0,0,0,0,0,4,5,,True,False,True,1.0,2210.49,2370.49,2285.49,2280.49,"5,4,2280.49",1,0.01,,,False,,,,2024-06-13 14:25:00,2310.49,2024-06-13 16:45:00,manual,2319.47,0.01,-158.76,fail,0 days 02:20:00,-926.5400000000002,False,0,25,24,6
2024-06-13 16:40:00,2323.09,2324.66,2319.78,2319.78,1500,27,0,2301.578535455689,2314.1520000000005,2326.725464544312,2315.5415733851014,2321.7096573971066,2321.7096573971066,2320.8745423309915,1.004534915338354,2322.025734265734,0.5706410256407253,2321.301200466213,0.541021756022019,2318.571538461539,0.23821678321564832,2318.0847202797268,0.031429681430381606,0.6829840563573271,0.6829840563573271,2289.759278854318,2324.659999999999,3.654579201660784e-05,2.012576689498945e-05,,7.74826477084051,7.747258765501578,-2.518293480621215e-05,-1.2087717656825332e-05,2311.3952461066388,2342.9601363852435,-0.02790163260033296,-0.06001753254622599,2319.2553988931827,2317.1101974086905,1.9381071383268136,1.664017358540527,2.2818190582108193,0.6829840563573271,1.1393770856498122,1.1912436040083776,2326.2732955135284,2317.146019280685,68.31384704768168,70.02076792116621,0,0,0,0,-100,0,0,0,0,0,0,0,0,0,0,-100,0,0,0,0,0,0,0,0,0,0,0,0,0,0,0,0,0,0,0,0,0,0,0,0,0,0,0,0,0,0,0,0,0,0,0,0,0,0,0,0,0,0,0,0,0,0,4,5,,True,True,False,0.0,2419.78,2352.78,2356.78,2364.78,"5,4,2349.78",0,0.01,2024-06-20 17:05:00,2024-06-20 17:45:00,True,2024-06-21 11:25:00,,2024-06-20 18:29:28,2024-06-13 16:45:00,2319.78,2024-06-13 16:55:00,manual,2311.08,0.01,-153.81,fail,0 days 00:10:00,-1080.3500000000001,False,0,26,24,6
2024-06-13 16:50:00,2315.57,2315.58,2311.01,2311.02,1575,27,0,2301.7259810720134,2314.2730000000006,2326.820018927988,2315.4587605156157,2321.16160400445,2321.16160400445,2321.549183784458,0.044976887900247675,2319.851550116551,-1.4983682983670406,2321.075734265748,-0.5345143745139467,2315.5507575757597,-1.8484382284382264,2317.173830613838,-0.927521367520967,-0.6146859473469704,-0.6146859473469704,2289.0837923648955,2315.580000000001,3.883236582068314e-05,4.308130317733942e-05,,7.747821634791999,7.747258765501578,-2.518755607002849e-05,-1.208730037351618e-05,2311.3394790400444,2342.8453483298617,-0.02786548951689838,-0.05866512684406189,2317.5060548288466,2316.552062250249,0.8226190875366228,1.4710035846585972,3.933122169486545,-0.6146859473469704,0.06663255469038631,0.6829840563573271,2329.027848343423,2313.295359665477,15.108209403453584,42.05422512459712,0,0,0,0,0,0,0,0,0,0,0,0,0,-100,0,-100,0,0,0,0,0,0,0,0,0,0,0,0,0,0,0,0,0,0,0,0,0,0,0,0,-100,0,0,0,0,0,0,0,0,0,0,0,0,0,0,0,0,0,0,0,0,0,4,5,,True,False,True,1.0,2211.02,2371.02,2286.02,2281.02,"5,4,2281.02",1,0.01,,,False,,,,2024-06-13 16:55:00,2311.02,2024-06-14 13:25:00,manual,2329.3,0.01,-323.18,fail,0 days 20:30:00,-1403.5300000000002,False,0,27,24,6
2024-06-13 17:05:00,2313.4,2313.64,2305.71,2308.11,1778,27,0,2301.9153626867096,2314.369333333334,2326.8233039799584,2315.203430454709,2319.0746614757145,2319.0746614757145,2319.9534260289283,-0.6956475095785208,2315.6629487179493,-1.2370629370639108,2316.852738927753,-1.3962004662002983,2310.2692424242423,-2.1442657342636267,2312.1135159285213,-1.7605050505057989,-1.1639547645540915,-1.1639547645540915,2288.4129610108184,2316.0975926672318,4.1424750327978015e-05,3.5413469994227945e-05,,7.747247633950677,7.747258765501578,-2.5184102505274584e-05,-1.3173359736441376e-05,2311.9141335971494,2342.6661869281083,0.6305712423854857,-0.06038664194466037,2314.782311778423,2315.3418357293167,-0.5716173521063865,0.6728507100403223,5.722349043137299,-1.1639547645540915,-0.30838413051287716,-0.6146036336685938,2330.519359561989,2307.62996338944,19.615649323123126,13.806726821325134,0,0,0,0,0,0,0,0,0,0,0,0,0,-100,0,0,0,0,0,0,0,0,0,0,0,0,0,0,0,0,0,0,0,0,0,0,0,0,0,0,0,0,0,0,0,0,0,0,0,0,0,0,0,0,0,0,0,0,0,0,0,0,4,5,,True,False,True,1.0,2208.11,2368.11,2283.11,2278.11,"5,4,2278.11",1,0.01,,,False,,,2024-06-21 14:38:06,2024-06-13 17:10:00,2308.11,2024-06-14 13:25:00,manual,2329.3,0.01,-374.64,fail,0 days 20:15:00,-1778.17,False,0,28,24,6
2024-06-13 18:05:00,2315.01,2315.89,2310.31,2310.49,1416,27,0,2305.637670716753,2315.2983333333336,2324.9589959499144,2314.4774807829194,2309.794207638115,2309.794207638115,2310.007108144859,-0.322694598938142,2315.680850815851,0.9145804195804885,2314.612521367536,0.8859013209016666,2312.3369813519803,-0.22652680652709023,2312.142898212904,0.5438189588185196,-0.40463477938556025,-0.40463477938556025,2286.9734133728307,2315.8900000000003,4.920798932061099e-05,3.759238444994068e-05,,7.746810621278229,7.747553831400959,-2.5187363295161466e-05,-2.2013168167697555e-05,2314.6264631544423,2341.9602528731803,-0.3114907553112971,-0.05753368189198227,2312.5099277963513,2313.2267448873476,-0.6351119902551545,-0.7696808106370956,1.4395677674783065,-0.40463477938556025,0.17056803856030456,-0.7340170559900798,2312.6733431730718,2306.9150721031583,68.53921814551605,65.54610913224745,0,0,0,0,0,0,0,0,0,0,0,0,0,0,0,-100,0,0,0,0,0,0,0,0,0,0,0,0,0,0,0,-200,0,0,0,0,0,0,0,0,0,0,0,0,0,0,0,0,0,0,0,0,0,0,0,0,0,0,0,0,0,0,4,5,,True,False,True,1.0,2210.49,2370.49,2285.49,2280.49,"5,4,2280.49",1,0.01,,,False,,,,2024-06-13 18:10:00,2310.49,2024-06-14 13:25:00,manual,2329.3,0.01,-332.55,fail,0 days 19:15:00,-2110.7200000000003,False,0,29,24,6
2024-06-13 18:15:00,2309.65,2310.07,2304.68,2308.71,1860,27,0,2304.760098981484,2314.619000000001,2324.477901018518,2314.2832621398575,2308.8475773081186,2308.8475773081186,2309.3160837968167,-0.45042170312717644,2313.5374941724967,-1.245594405592783,2314.6671445221596,-0.40959207459127356,2309.457983682985,-1.8958741258720693,2311.0496076146133,-1.035174825174181,-0.4588891360767775,-0.4588891360767775,2286.7622009092975,2310.338699149045,5.046308682830818e-05,4.8173962594634225e-05,,7.746396503033639,7.747430185271211,-2.5185612332630368e-05,-2.0468609979262167e-05,2314.069716680169,2341.841262625085,-0.2547904240173011,-0.05738018658666988,2311.54261102579,2312.6413656441596,-0.9845026495936509,-0.8177211113473898,2.151502797051745,-0.4588891360767775,-0.4877411939196463,-0.40463477938556025,2313.150582902222,2304.544571714015,36.91709464347212,53.106804369926685,0,0,0,0,0,0,0,0,0,0,0,0,0,0,0,0,0,0,0,0,0,0,0,0,0,0,0,0,0,0,0,0,0,0,0,0,0,0,0,0,0,0,0,0,0,0,0,0,0,0,0,0,0,0,0,0,0,0,0,0,0,0,4,5,,True,False,True,1.0,2208.71,2368.71,2283.71,2278.71,"5,4,2278.71",1,0.01,,,False,,,,2024-06-13 18:20:00,2308.71,2024-06-14 13:25:00,manual,2329.3,0.01,-364.02,fail,0 days 19:05:00,-2474.7400000000002,False,0,30,24,6
2024-06-13 20:40:00,2301.4,2302.96,2301.38,2301.78,717,27,0,2293.579351077716,2301.4080000000017,2309.2366489222873,2308.780425832003,2299.371016685205,2299.371016685205,2298.900711654931,0.5165628476074744,2303.7715384615394,-0.043624708627248765,2303.879529914545,-0.0335003884993057,2302.3449417249385,-0.01876456877016608,2302.347610722618,0.07876068376026524,0.485851687059494,0.485851687059494,2286.115145382479,2302.939132193492,6.466167728026277e-05,7.067947199693893e-05,,7.7423414067286345,7.743367244060826,-2.5186942534476163e-05,-3.091047572682403e-05,2315.0707093896135,2340.132340569449,-0.07076023615491067,-0.05810747990335585,2301.4937150982128,2302.2659192132273,-0.5686075030753273,-1.1653339253481312,0.8181588650359445,0.485851687059494,0.43921171672127457,0.6246251390407451,2301.007334415277,2297.7346989551334,61.09600779425125,66.64934010146898,0,0,0,0,0,0,0,0,0,0,0,0,0,0,0,0,0,0,0,0,0,0,0,0,0,0,0,0,0,0,0,0,0,0,0,0,0,0,0,0,0,0,0,0,0,0,0,0,0,0,-100,0,0,0,0,0,0,0,0,0,0,0,4,5,,True,False,True,1.0,2201.78,2361.78,2276.78,2271.78,"5,4,2271.78",1,0.01,,,False,,,2024-06-20 17:48:38,2024-06-13 20:45:00,2301.78,2024-06-14 13:25:00,manual,2329.3,0.01,-486.54,fail,0 days 16:40:00,-2961.28,False,0,31,24,6
2024-06-14 06:00:00,2306.57,2307.58,2305.78,2306.11,471,30,0,2303.30697208628,2305.2313333333336,2307.1556945803873,2304.884016532128,2305.866479050797,2305.866479050797,2305.800974910399,0.06395698924688986,2306.581013986016,0.38733100233275763,2306.2356721056894,0.24048951049053358,2305.469883449885,0.12958041957972455,2305.2860256410327,0.13597125097157914,0.05672302558377851,0.05672302558377851,2302.426766299374,2337.0555738762223,2.9331684085604103e-05,-2.0605030698559404e-06,,7.7429177594147385,7.7426268092342525,-3.22986072853813e-05,-2.645674718103413e-05,2306.1683086377307,2336.4088798650287,-0.061620587224751944,0.1156694341034381,2305.7376828576876,2305.251267437759,0.4221196957610118,0.39752711011908975,0.5819410254091556,0.05672302558377851,0.08306637004079676,0.05208157211609432,2307.030361101615,2304.7025969999786,76.14266362858436,76.93669486891648,0,0,0,0,0,0,0,0,0,0,0,0,0,0,0,0,0,0,0,0,0,0,0,0,0,0,0,0,0,0,0,0,0,0,0,0,0,0,0,0,0,0,0,0,0,0,0,0,0,0,0,0,0,0,0,0,0,0,0,0,0,100,4,5,,False,False,True,1.0,2206.11,2366.11,2281.11,2276.11,"5,4,2276.11",1,0.01,,,False,,,2024-06-21 11:16:16,2024-06-14 06:05:00,2306.11,2024-06-14 13:25:00,manual,2329.3,0.01,-409.99,fail,0 days 07:20:00,-3371.2700000000004,False,0,32,24,6
2024-06-14 06:35:00,2306.88,2307.0,2304.92,2305.09,489,27,0,2303.3093940139684,2305.7006666666657,2308.091939319363,2305.1158218840906,2306.709547645534,2306.709547645534,2306.744846125331,0.0338034853548379,2307.8169930069907,-0.18534965035087225,2307.9556293706446,-0.05700466200414667,2306.2851048951043,-0.3886247086261392,2306.5387801087877,-0.05318181818074663,-0.09445087133690322,-0.09445087133690322,2303.026720085071,2337.843036475131,2.3491458911543954e-05,-5.645331909323072e-06,,7.7433243513421255,7.743054130907122,-3.737864236692229e-05,-2.6456654664769005e-05,2305.7412432956635,2337.343804619923,-0.06101539763221808,0.14659431661311828,2306.355518377136,2305.8686370830987,0.41595618582505267,0.5057071424369051,0.98695780771635,-0.09445087133690322,0.08300630329949854,0.11285502410055415,2308.6834632609666,2304.735632030101,48.123123123124635,59.7097097097113,0,0,0,0,0,0,0,0,0,0,0,0,0,0,0,0,0,0,0,0,0,0,0,0,0,0,0,0,0,0,0,0,0,0,0,0,0,0,0,0,-100,0,0,0,0,0,0,0,0,0,0,0,0,0,0,0,0,0,0,0,0,0,4,5,,False,False,True,1.0,2205.09,2365.09,2280.09,2275.09,"5,4,2275.09",1,0.01,,,False,,,2024-06-20 18:08:33,2024-06-14 06:40:00,2305.09,2024-06-14 13:25:00,manual,2329.3,0.01,-428.02,fail,0 days 06:45:00,-3799.2900000000004,False,0,33,24,6
2024-06-14 07:35:00,2305.5,2305.5,2304.66,2304.77,237,28,0,2303.507919792378,2305.5823333333333,2307.6567468742887,2305.0432791519806,2304.914601408971,2304.914601408971,2304.953922630088,-0.07010208874089585,2305.018543123541,0.2258741258738155,2304.747249417264,0.17748251748071198,2303.8622144522114,0.13630536130176552,2303.7636596736656,0.07794483294355814,-0.06950092695888088,-0.06950092695888088,2304.20036019255,2337.685097036674,1.8404819094429854e-05,-5.647470757230369e-06,,7.742950443560265,7.743177897852426,-4.555525745677373e-05,-2.6457724616658198e-05,2305.0097269231323,2338.421964421841,-0.059907183615450776,0.045560036909137125,2304.911563814848,2305.173448327596,-0.252007912199133,-0.15646286070059517,0.6597618617158642,-0.06950092695888088,0.021038190583567484,-0.16184352984828365,2306.234125132403,2303.5950776855393,33.91076571799618,25.736980339860583,0,0,0,0,0,0,0,0,0,0,0,0,0,-100,0,0,0,0,0,0,0,0,0,0,0,0,0,0,0,0,0,0,0,0,0,0,0,0,0,0,-100,0,0,0,0,0,0,0,0,0,0,0,0,0,0,0,0,0,0,0,0,0,4,5,,False,False,True,1.0,2204.77,2364.77,2279.77,2274.77,"5,4,2274.77",1,0.01,,,False,,,2024-06-20 17:58:44,2024-06-14 07:40:00,2304.77,2024-06-14 13:25:00,manual,2329.3,0.01,-433.68,fail,0 days 05:45:00,-4232.97,False,0,34,24,6
2024-06-14 13:20:00,2325.83,2329.53,2325.64,2329.29,1051,27,0,2313.098340964988,2319.397333333334,2325.6963257016796,2312.8760002338427,2322.5211041898415,2322.5211041898415,2321.5724743542282,0.6937733283903071,2326.4430069930095,1.532354312354073,2325.08652292154,1.1441414141418136,2323.838554778556,1.1186946386965246,2322.7837334887404,0.9786208236218954,1.0928757879132718,1.0928757879132718,2325.6400000000003,2343.9110448619945,-1.9041111587595842e-05,-3.2785662066999936e-05,,7.749974948889523,7.7490564380466225,5.0919566561568316e-06,2.6433116531196255e-05,2290.212213711228,2326.0778313982423,0.0608036774874563,-0.6393697516627981,2322.7750496611834,2320.039679329288,2.42126106029491,1.719436843519056,2.7428605376061963,1.0928757879132718,0.6601379310345692,0.32830626622126147,2328.006825265054,2317.035383114629,95.56899139285497,91.12528781597507,0,0,0,0,0,0,0,0,0,0,0,0,0,100,0,0,0,0,0,0,0,0,0,0,0,0,0,0,0,0,0,0,0,0,0,0,0,0,0,0,100,0,0,0,0,0,0,0,0,0,0,0,0,0,0,0,0,0,0,0,0,0,4,5,,True,True,False,0.0,2429.29,2358.29,2362.29,2369.29,"5,4,2359.29",0,0.01,2024-06-20 17:45:00,2024-06-20 18:05:00,True,,,2024-06-20 18:14:34,2024-06-14 13:25:00,2329.29,2024-06-17 14:45:00,manual,2319.49,0.01,-173.26,fail,3 days 01:20:00,-4406.2300000000005,False,0,35,24,6
2024-06-14 14:30:00,2328.96,2331.83,2328.93,2331.74,889,27,0,2314.438549619393,2324.493333333334,2334.5481170472744,2316.543883289342,2331.735880608084,2331.735880608084,2331.30233963664,0.34636386108059014,2330.5011072261073,0.35193473193658065,2330.263803418819,0.08915695415544178,2328.0360606060594,0.1294638694630521,2327.888041958048,0.038554778554498625,0.5155283648523437,0.5155283648523437,2325.1462866312977,2339.7627771891325,-1.929154263446706e-05,-1.9494003996376404e-05,,7.752152116541226,7.750986457567782,1.0008907612283415e-05,2.6430591588130157e-05,2291.060382173903,2325.9423447649383,0.06085296308447141,0.04831505943730008,2328.5968634113124,2325.982695579096,2.2442835092115274,2.421033995056321,1.4173617343452614,0.5155283648523437,0.26956618464646454,0.25399703374296223,2334.570604076774,2328.9011571393935,62.63219435404337,57.866018993945495,0,0,0,0,0,0,0,0,0,0,0,0,0,100,0,100,0,0,0,0,0,0,0,0,0,0,0,0,0,0,0,0,0,0,0,0,0,0,0,0,100,0,0,0,0,0,0,0,0,0,0,0,0,0,0,0,0,0,0,0,0,0,4,5,,True,True,False,0.0,2431.74,2356.74,2360.74,2366.74,"5,4,2361.74",0,0.01,2024-06-20 17:50:00,2024-06-20 17:50:00,True,2024-06-21 11:30:00,,2024-06-20 18:19:25,2024-06-14 14:35:00,2331.74,2024-06-17 14:45:00,manual,2319.49,0.01,-216.57,fail,3 days 00:10:00,-4622.8,False,0,36,24,6
2024-06-14 15:50:00,2332.35,2333.29,2329.82,2330.0,1252,27,0,2325.676157138043,2330.1156666666675,2334.555176195292,2320.266755038156,2331.1928134964805,2331.1928134964805,2331.214224941301,-0.15996391051658065,2331.5070979021007,0.6224825174822399,2330.9560839161018,0.13530691530741024,2327.967855477853,0.5918881118846002,2327.4483061383107,0.1518337218317356,-0.05901520207316935,-0.05901520207316935,2324.4287249814556,2338.272568508707,-1.9292518046741122e-05,-1.552779037366612e-05,,7.753061806705244,7.7523979357157895,1.6008683720897163e-05,2.643429747261984e-05,2292.028920891147,2326.143918576947,0.06041954608326705,0.037161837865824054,2330.25166294855,2329.3423116377494,0.7003032310653907,1.140083879780001,1.6171226652836788,-0.05901520207316935,0.05379606970700479,-0.4746725991835774,2334.427058827048,2327.958568165913,34.04406538734811,26.010302293604695,0,0,0,0,0,0,0,0,0,0,0,0,0,0,0,-100,0,0,0,0,0,0,0,0,0,0,0,0,0,0,0,0,0,0,0,0,0,0,0,0,0,0,0,0,0,0,0,0,0,0,0,0,0,0,0,0,0,0,0,0,0,0,4,5,,True,True,False,0.0,2430.0,2355.0,2359.0,2365.0,"5,4,2360.0",0,0.01,2024-06-20 17:45:00,2024-06-20 17:45:00,True,2024-06-21 11:25:00,,2024-06-20 18:20:51,2024-06-14 15:55:00,2330.0,2024-06-17 14:45:00,manual,2319.49,0.01,-185.81,fail,2 days 22:50:00,-4808.610000000001,False,0,37,24,6
2024-06-14 20:10:00,2331.22,2332.01,2330.9,2331.34,734,27,0,2325.8367243389707,2328.9193333333324,2332.001942327694,2325.9315974452,2329.61604746014,2329.61604746014,2329.2908646644487,0.3134556915083522,2330.7742540792547,0.5337529137541424,2330.303135198153,0.20254856254859988,2329.5474475524466,0.6251282051252929,2329.0563947164005,0.15297202797182763,0.29319391916897075,0.29319391916897075,2323.9746886042767,2336.3856622179023,-2.4779663998392827e-05,-1.5528419062868937e-05,,7.753592917481943,7.753474609452169,4.8173962594634225e-05,5.046308682830818e-05,2287.657187861873,2311.2018884635577,-0.18204225898807636,-1.3614624642191302,2329.7942234574293,2329.421951989231,0.34998059188956177,0.08989894584031938,0.9806557574269062,0.29319391916897075,0.3891605487556262,0.2580126066009143,2331.577358974994,2327.6547359452866,81.87815817402605,73.75974399238804,100,0,0,0,0,0,0,0,0,0,0,0,-100,0,0,0,0,0,0,100,0,0,0,0,0,0,0,0,0,0,100,0,0,0,0,0,0,0,0,100,0,0,0,0,0,0,0,100,0,0,0,0,100,-100,0,0,0,0,0,0,0,0,4,5,,True,True,False,0.0,2431.34,2356.34,2360.34,2366.34,"5,4,2361.34",0,0.01,2024-06-20 17:50:00,2024-06-20 17:50:00,True,2024-06-21 11:30:00,,2024-06-20 18:19:55,2024-06-14 20:15:00,2331.34,2024-06-17 14:45:00,manual,2319.49,0.01,-209.5,fail,2 days 18:30:00,-5018.110000000001,False,0,38,24,6
2024-06-14 21:10:00,2333.3,2333.95,2333.29,2333.76,478,27,0,2325.8321440439636,2330.7133333333322,2335.594522622701,2327.383401856438,2334.130650352244,2334.130650352244,2333.9404276356504,0.21637251266929525,2334.1905944055957,-0.11368298368097385,2334.3004312354497,-0.10641025641007218,2333.257983682982,0.07596736596451592,2333.2116860916917,0.026414141413624748,0.20976269929769842,0.20976269929769842,2322.2004800837353,2335.951497803964,-2.1375483642368492e-05,-1.5530558657658466e-05,,7.754389448403433,7.753496018877458,6.63384109328678e-05,5.8947464560165344e-05,2286.476134922243,2303.576292881559,-0.0183245801645171,0.15197708071309535,2332.8882013411608,2331.7497761732075,1.0122408736692705,0.9285595401846114,0.6067889727652593,0.20976269929769842,0.15114275120458842,0.2882120875046894,2335.344228297775,2332.9170724067135,71.86529360878461,72.86284578724404,0,0,0,0,0,0,0,0,0,0,0,0,0,0,0,0,0,0,0,0,0,0,0,0,0,0,0,0,0,0,0,0,0,0,0,0,0,0,0,0,0,0,0,0,0,0,0,0,0,0,0,100,0,0,0,0,0,0,0,0,0,0,4,5,,True,True,False,0.0,2433.76,2358.76,2362.76,2368.76,"5,4,2363.76",0,0.01,2024-06-20 18:00:00,2024-06-20 18:00:00,True,,,2024-06-20 18:13:17,2024-06-14 21:15:00,2333.76,2024-06-17 14:45:00,manual,2319.49,0.01,-252.28,fail,2 days 17:30:00,-5270.39,False,0,39,24,6
2024-06-14 21:30:00,2333.91,2334.01,2333.3,2333.56,501,27,0,2327.817303411576,2331.641999999999,2335.4666965884217,2327.820710213592,2334.214898776418,2334.214898776418,2334.1683747373677,0.027481646273372462,2333.968811188809,-0.007447552447501948,2333.9503574203727,0.0004778554771291965,2333.0236829836804,0.13538461538291813,2332.861317016321,0.044630924629927904,0.06282832777378644,0.06282832777378644,2322.078256564434,2335.8050425701344,-2.1550620403907544e-05,-1.5528032736130976e-05,,7.754258805953885,7.753496018877458,6.633838898815422e-05,6.087310740121642e-05,2286.450597480445,2304.1876338828642,-0.01240330292193903,0.1535245565578407,2333.210591220053,2332.220308138926,0.8662729783040959,0.9106802610704217,0.4206436398643852,0.06282832777378644,0.013915461622218572,0.0057011494250218675,2335.056186056147,2333.373611496689,58.35285828077392,59.925875269573005,0,0,0,0,-100,0,0,0,0,0,0,0,0,0,0,0,0,0,0,0,0,0,0,0,0,0,0,0,0,0,0,0,0,0,0,0,0,0,0,0,0,0,0,0,0,0,0,0,0,0,0,0,0,0,0,0,0,0,0,0,0,0,4,5,,True,True,False,0.0,2433.56,2358.56,2362.56,2368.56,"5,4,2363.56",0,0.01,2024-06-20 18:00:00,2024-06-20 18:00:00,True,,,2024-06-20 18:13:18,2024-06-14 21:35:00,2333.56,2024-06-17 14:45:00,manual,2319.49,0.01,-248.75,fail,2 days 17:10:00,-5519.14,False,0,40,24,6
2024-06-14 22:35:00,2333.95,2334.64,2333.94,2334.54,343,27,0,2331.697623828311,2333.387333333332,2335.0770428383535,2329.0740549759853,2333.9328594734884,2333.9328594734884,2333.9470144605184,-0.08968162155542814,2333.6991724941727,0.150209790208919,2333.588061383078,0.027183372182662424,2332.935734265735,0.19700466200583833,2332.757470862477,0.1040132090138286,0.0292161661091086,0.0292161661091086,2321.4296450512666,2335.333467393222,-2.155406342241434e-05,-1.5527819984889585e-05,,7.754770125616954,7.754347291477355,7.067947199693893e-05,6.466167728026277e-05,2287.261892608504,2304.2018564498353,0.14707514243536934,0.16242723870527698,2333.6187940423033,2333.1320959972622,0.40278637129722483,0.4862074787922325,0.6420669749543056,0.0292161661091086,-0.10089729328910835,-0.19736373748719416,2335.216993423397,2332.6487255235797,61.64215686274073,47.21501345635949,0,0,0,0,0,0,0,0,0,0,0,0,0,0,0,0,0,0,0,0,0,0,0,0,0,0,0,0,0,0,0,0,0,0,0,0,0,0,0,0,0,0,0,0,0,0,0,0,0,0,0,100,0,0,0,0,0,0,0,0,0,0,4,5,,True,True,False,0.0,2434.54,2359.54,2363.54,2369.54,"5,4,2364.54",0,0.01,2024-06-21 11:15:00,2024-06-21 11:15:00,True,,,2024-06-21 16:02:07,2024-06-14 22:40:00,2334.54,2024-06-17 14:45:00,manual,2319.49,0.01,-266.07,fail,2 days 16:05:00,-5785.21,False,0,41,24,6
2024-06-17 13:10:00,2321.47,2322.3,2321.27,2322.02,471,27,0,2317.552061936699,2320.254,2322.955938063301,2321.7276191731175,2321.5486184649612,2321.5486184649612,2321.527889506866,0.03801853911772923,2320.9567482517473,0.3962354312352545,2320.6462665112836,0.13978632478574582,2319.895431235432,0.3279953379951621,2319.6560878010932,0.0767871017883408,0.0010292918054801703,0.0010292918054801703,2310.9659350664083,2328.281792175618,-6.784665982866867e-06,-6.232069573904455e-06,,7.749268902094839,7.7489052746088944,-1.810370584361587e-05,4.4755632314647764e-07,2315.1745602955366,2340.790814497736,0.001031449080528546,0.17096971651017157,2320.8403192022815,2320.4683757252365,0.32755032998693423,0.3277050890232157,0.7563622999540359,0.0010292918054801703,0.06012829069595682,0.052898034850841213,2323.061343064869,2320.0358938650534,63.64522417154035,44.54894065765652,0,0,0,0,0,0,0,0,0,0,0,0,0,0,0,0,0,0,0,0,0,0,0,0,0,0,0,0,0,0,0,0,0,0,0,0,0,0,0,0,100,0,0,0,0,0,0,0,0,0,0,0,0,0,0,0,0,0,0,0,0,0,4,5,,True,True,False,0.0,2422.02,2355.02,2359.02,2367.02,"5,4,2352.02",0,0.01,2024-06-20 17:20:00,2024-06-20 17:50:00,True,2024-06-21 11:30:00,,2024-06-20 18:20:51,2024-06-17 13:15:00,2322.02,2024-06-17 14:45:00,manual,2319.49,0.01,-44.73,fail,0 days 01:30:00,-5829.94,False,0,42,25,6
2024-06-17 14:25:00,2321.21,2321.83,2320.93,2321.19,669,27,0,2319.3959274402714,2320.976,2322.556072559729,2321.5329039544545,2320.6524805339277,2320.6524805339277,2320.599907057231,-0.02586330490612454,2320.962016317019,0.21089743589800491,2320.7914063714256,0.06571095571052865,2319.858484848483,0.346247086247331,2319.6347008547036,0.0872766122770372,0.04393919169524452,0.04393919169524452,2310.7308871287896,2328.024804032589,-6.785703593067682e-06,-5.763747980089942e-06,,7.749509624608301,7.749418936328004,-2.8678577905790705e-05,-1.9844707256358467e-06,2316.5043734611995,2342.9843006016326,1.325970585912728,0.09739424889176007,2320.7416743010317,2320.712039450136,0.013126654799634707,0.0673520489071619,0.4659533240783421,0.04393919169524452,0.06984204672107808,-0.1913711531356057,2321.5843871820844,2319.720573885771,42.081949058698356,32.188999630865055,100,-100,0,0,0,0,0,0,0,0,0,0,0,0,0,0,0,0,0,100,-100,0,0,0,0,0,0,0,0,0,-100,0,0,0,0,0,0,0,0,100,0,0,0,0,0,0,0,100,0,0,0,0,-100,0,0,0,0,0,0,0,0,0,4,5,,True,True,False,0.0,2421.19,2354.19,2358.19,2366.19,"5,4,2351.19",0,0.01,2024-06-20 17:05:00,2024-06-20 17:50:00,True,2024-06-21 11:30:00,,2024-06-20 18:23:28,2024-06-17 14:30:00,2321.19,2024-06-17 14:45:00,manual,2319.49,0.01,-30.05,fail,0 days 00:15:00,-5859.99,False,0,43,25,6
2024-06-17 14:40:00,2319.97,2320.33,2319.4,2319.58,553,27,0,2318.876460385228,2320.724,2322.5715396147725,2321.4066232177634,2320.189586206897,2320.189586206897,2320.2648790013673,-0.15429810901014207,2320.7579370629355,-0.16440559440979996,2320.915295260314,-0.06802641802778453,2318.9998251748234,-0.0058275058272556635,2319.1512354312395,-0.28621989121938896,-0.05776195773069048,-0.05776195773069048,2310.6837404395765,2327.9836069417265,-6.784774315280246e-06,-5.762346357375828e-06,,7.749269156389922,7.7493477458285795,-3.041203899497296e-05,-7.411537535593078e-06,2319.3867867116237,2343.2346224817693,1.2281902139779959,0.07609186880290508,2320.1612055050855,2320.4055914448195,-0.23543316446375684,-0.06881160795587066,1.0027168451980342,-0.05776195773069048,-0.11035446792811854,-0.29477790137207194,2322.1950198972927,2318.184152516501,30.673114594270412,35.20684428311953,0,0,0,0,0,0,0,0,0,0,0,0,0,0,0,0,0,0,0,0,0,0,0,0,0,0,0,0,0,0,0,0,0,0,0,0,0,0,0,0,0,0,0,0,0,0,0,0,0,0,0,0,0,0,0,0,0,0,0,0,0,0,4,5,,True,False,True,1.0,2219.58,2379.58,2294.58,2289.58,"5,4,2289.58",1,0.01,,,False,,,,2024-06-17 14:45:00,2319.58,2024-06-18 16:15:00,manual,2319.02,0.01,9.9,success,1 days 01:30:00,-5850.09,True,1,0,25,6
2024-06-17 14:45:00,2319.49,2320.93,2318.68,2318.81,907,27,0,2318.729846240393,2320.6086666666665,2322.4874870929402,2321.3589787550522,2320.0514875787917,2320.0514875787917,2320.1628073167794,-0.1020716845878269,2320.7786596736587,0.020722610723169055,2320.8196464646644,-0.09564879564959483,2318.7832284382284,-0.21659673659496548,2318.9295687645727,-0.22166666666680612,-0.1380986281051264,-0.1380986281051264,2310.6683541794396,2327.9705086131708,-6.787345833743005e-06,-5.762818097365889e-06,,7.749269156389922,7.7493477458285795,-3.089602988442481e-05,-8.260583978588621e-06,2319.821504190273,2343.2884205559385,0.4347174786494179,0.05379807416920812,2319.9533277350724,2320.2873994859438,-0.3163798409127594,-0.1183252545472484,1.0823643103010459,-0.1380986281051264,-0.05776195773069048,-0.11035446792811854,2322.216216199394,2317.8867589581896,39.69690176494597,35.495994042819454,0,0,0,0,0,100,0,0,0,0,0,0,0,0,0,0,0,0,0,0,0,0,0,0,0,0,0,0,0,0,0,0,0,0,0,0,0,0,0,0,0,0,0,0,0,0,0,0,0,0,0,0,0,0,0,0,0,0,0,0,0,0,4,5,,True,False,True,1.0,2218.81,2378.81,2293.81,2288.81,"5,4,2288.81",1,0.01,,,False,,,,2024-06-17 14:50:00,2318.81,2024-06-18 16:15:00,manual,2319.02,0.01,-3.71,fail,1 days 01:25:00,-5853.8,False,0,1,25,6
2024-06-17 15:30:00,2318.33,2318.38,2316.85,2316.88,1123,27,0,2317.348091720508,2320.074000000001,2322.799908279494,2320.941456964812,2318.2206407119024,2318.2206407119024,2318.5556581386795,-0.24623458163478062,2319.3255361305355,-0.2837878787850059,2319.5211693861866,-0.09466588966461131,2317.5722027972047,-0.37038461538213596,2317.8142735042798,-0.14507381507337413,-0.3836240266941786,-0.3836240266941786,2310.5571076818537,2327.5168323301514,-6.874933463922634e-06,2.0992837750345305e-07,,7.749010418136713,7.749177321345515,-3.2785371585216764e-05,-1.9291691409525497e-05,2325.292172280709,2343.0851751741993,-0.044907602689818304,-0.07701520013188201,2318.8065615095566,2319.4343967276263,-0.5679318997758855,-0.4173450031633352,0.792075708990152,-0.3836240266941786,-0.23780422692107095,-0.11727549128772807,2319.8047921298826,2316.6364892939223,22.578219959157366,31.09242014563957,0,0,0,0,0,0,0,0,0,0,0,0,0,-100,0,-100,0,0,0,0,0,0,0,0,0,0,0,0,0,0,0,0,0,0,0,0,0,0,0,0,-100,0,0,0,0,0,0,0,0,0,0,0,0,0,0,0,0,0,0,0,0,0,4,5,,True,False,True,1.0,2216.88,2376.88,2291.88,2286.88,"5,4,2286.88",1,0.01,,,False,,,,2024-06-17 15:35:00,2316.88,2024-06-18 16:15:00,manual,2319.02,0.01,-37.83,fail,1 days 00:40:00,-5891.63,False,0,2,25,6
2024-06-17 16:20:00,2325.63,2326.21,2323.91,2324.03,1098,27,0,2316.357059946299,2319.9986666666673,2323.6402733870354,2321.00691964475,2320.919369670006,2320.919369670006,2320.305551600553,0.6242150537636917,2324.60331002331,1.2263286713291564,2323.3034654234843,1.2963947163948433,2322.154452214449,1.1449417249386897,2320.9791219891245,1.10713286713235,0.5388127549140336,0.5388127549140336,2310.3986632562137,2327.519864278308,-6.875639019211447e-06,2.127433281550073e-07,,7.749958116609502,7.749958116609502,-1.9495236468998895e-05,-1.929336947227831e-05,2324.843556453378,2339.455712376528,-0.04475076924563837,-0.06627931463754066,2321.5788331465255,2320.6425819789706,0.8753127294844489,0.213255892893707,2.4457335300947705,0.5388127549140336,0.7638286985547893,0.5700037078231617,2325.810836730195,2316.0279026098165,86.14586440809781,89.34744186109788,0,0,0,0,-100,0,0,0,0,0,0,0,0,0,0,-100,0,0,0,0,0,0,0,0,0,0,0,0,0,0,0,0,0,0,0,0,0,0,0,0,0,0,0,0,0,0,0,0,0,0,0,0,0,0,0,0,0,0,0,0,0,0,4,5,,True,False,True,1.0,2224.03,2384.03,2299.03,2294.03,"5,4,2294.03",1,0.01,,,False,,,,2024-06-17 16:25:00,2324.03,2024-06-18 16:15:00,manual,2319.02,0.01,88.56,success,0 days 23:50:00,-5803.07,True,1,0,25,6
2024-06-17 16:35:00,2325.45,2325.48,2322.48,2322.99,1337,27,0,2315.9297677909926,2320.369000000001,2324.8082322090095,2321.1713359487417,2322.377541713014,2322.377541713014,2321.936844147826,0.4860573476689751,2326.025501165502,0.3154662004681086,2325.6373776223973,0.4740637140639592,2323.24733100233,0.09877622377507578,2323.0816200466247,0.36429292929369694,0.32821876158732266,0.32821876158732266,2310.3515024588623,2327.5214705720964,-6.876524564400828e-06,2.1255796796307948e-07,,7.750121007310215,7.749958116609502,-1.9495533125107295e-05,-1.9293484512376437e-05,2324.709022036681,2339.3191121009972,-0.04476561876390406,-0.045558057247944816,2322.537527045073,2321.342085221837,1.0969655785684154,0.634954268783146,1.7570058745215684,0.32821876158732266,0.6656551724136079,0.464298109007359,2325.8915534620573,2318.863529963971,77.20225510923083,79.49260042283284,0,0,0,0,0,0,0,0,0,0,0,0,0,-100,0,0,0,0,0,0,0,0,0,0,0,0,0,0,0,0,0,0,0,0,0,0,0,0,0,0,0,0,0,0,0,0,0,0,0,0,0,0,0,0,0,0,0,0,0,0,0,0,4,5,,True,False,True,1.0,2222.99,2382.99,2297.99,2292.99,"5,4,2292.99",1,0.01,,,False,,,,2024-06-17 16:40:00,2322.99,2024-06-18 16:15:00,manual,2319.02,0.01,70.17,success,0 days 23:35:00,-5732.9,True,2,0,25,6
2024-06-17 17:35:00,2326.07,2326.66,2323.85,2323.93,872,27,0,2316.3458085618945,2321.3546666666666,2326.3635247714387,2321.3515266985537,2323.6832139414164,2323.6832139414164,2323.3991311333666,0.38408651588179055,2325.327867132867,1.2667599067585797,2323.957342657362,1.3644910644920856,2322.913286713289,1.072226107230108,2321.669079254083,1.2700893550900219,0.18773155357712312,0.18773155357712312,2310.1596324730763,2326.6378404827155,-6.874206665410961e-06,4.59564872878333e-06,,7.7504089465329145,7.750246055832202,-1.5529854319145324e-05,-1.9292196191269693e-05,2324.170838611147,2338.065169429391,-0.044791248617002566,-0.03442245360520246,2322.944772487675,2322.0091701116785,0.8408242331788642,0.5276604332868632,2.626186466605447,0.18773155357712312,0.47678531701967586,0.48774267704857266,2328.9355868746275,2318.4308410082053,79.53250481129602,76.45478322432405,0,0,0,0,-100,0,0,0,0,0,0,0,0,0,0,-100,0,0,0,0,0,0,-100,-100,0,0,0,0,0,0,0,0,0,0,0,0,0,0,0,0,0,0,0,0,0,0,0,0,0,0,0,0,0,0,0,0,0,0,0,0,0,0,4,5,,True,False,True,1.0,2223.93,2383.93,2298.93,2293.93,"5,4,2293.93",1,0.01,,,False,,,,2024-06-17 17:40:00,2323.93,2024-06-18 16:15:00,manual,2319.02,0.01,86.79,success,0 days 22:35:00,-5646.11,True,3,0,25,6
2024-06-17 17:45:00,2324.95,2325.0,2322.65,2323.42,852,27,0,2316.651708067017,2321.6976666666665,2326.743625266316,2321.454115745454,2324.051712272898,2324.051712272898,2323.90624891856,0.1854099616862186,2326.1893123543123,0.18156177156015474,2325.841643356662,0.7094017094009359,2323.752482517485,0.1615967365951292,2323.418885003892,0.6371406371422381,0.06789173155584649,0.06789173155584649,2310.1279967802284,2325.393566737808,-6.874444212650935e-06,6.49156900586872e-06,,7.7504089465329145,7.750246055832202,-1.552779037366612e-05,-1.9292518046741122e-05,2324.081173648733,2337.991167960236,-0.04481009690789506,-0.03684829475969309,2323.277618171649,2322.3146931684487,0.8596523690434879,0.656976858689528,2.1142154911708135,0.06789173155584649,0.30060659992568617,0.18773155357712312,2328.2801432552396,2319.823281290556,62.82741298887449,71.52937338943521,0,0,0,0,-100,0,0,0,0,0,0,0,0,-100,0,0,0,0,0,0,0,0,0,0,0,0,0,0,0,0,0,0,0,0,0,0,0,0,0,0,0,0,0,0,0,0,0,0,0,0,0,0,0,0,0,0,0,0,0,0,0,0,4,5,,True,False,True,1.0,2223.42,2383.42,2298.42,2293.42,"5,4,2293.42",1,0.01,,,False,,,,2024-06-17 17:50:00,2323.42,2024-06-18 16:15:00,manual,2319.02,0.01,77.77,success,0 days 22:25:00,-5568.339999999999,True,4,0,25,6
2024-06-17 18:00:00,2324.41,2325.46,2323.85,2323.89,759,27,0,2317.6806404366143,2322.246666666666,2326.8126928967176,2321.5774472503385,2324.0886132740093,2324.0886132740093,2324.1055108144933,0.012300333703933575,2325.9291841491827,0.046993006993034214,2325.9148212898394,-0.08670940170941321,2324.1022843822843,0.19459207459385652,2323.9179176379207,0.11660062159944573,-0.08075268817174219,-0.08075268817174219,2310.0804242106515,2325.439296989564,-6.874577882394743e-06,7.500077377640139e-06,,7.7504898130779445,7.750246055832202,-1.5528523661742923e-05,-1.9292812523191752e-05,2323.9466544560605,2337.8827406580913,-0.044830770646512974,-0.03655093758561634,2323.476945738036,2322.611730973785,0.7625233431367633,0.7126000241248563,1.1533553536036398,-0.08075268817174219,0.11081275491596898,0.006840934367119189,2326.3953239812167,2321.781902566802,58.88051668460335,58.36622413586593,0,0,0,0,0,0,0,0,0,0,0,0,0,0,0,0,0,0,0,0,0,0,0,0,0,0,0,0,-100,0,0,0,0,0,0,0,0,0,0,0,0,0,0,0,0,0,0,0,0,0,0,0,0,0,0,0,0,0,0,0,0,0,4,5,,True,False,True,1.0,2223.89,2383.89,2298.89,2293.89,"5,4,2293.89",1,0.01,,,False,,,,2024-06-17 18:05:00,2323.89,2024-06-18 16:15:00,manual,2319.02,0.01,86.08,success,0 days 22:10:00,-5482.259999999999,True,5,0,25,6
2024-06-17 20:25:00,2315.66,2315.89,2313.9,2314.13,888,27,0,2309.2048629646297,2316.2326666666663,2323.260470368703,2319.2078864484047,2314.4629202817914,2314.4629202817914,2314.271733531092,0.2602696823619226,2317.4421095571106,-0.4695571095548985,2317.7719191919373,-0.14611111111071295,2315.886223776223,-0.6465151515189973,2316.397218337222,-0.19524864024924682,0.17486243974462923,0.17486243974462923,2313.2661138192834,2322.612578524622,-1.4922798070849791e-05,1.605154502126423e-05,,7.7482003764334095,7.748765501866556,-1.5528084330754468e-05,-2.2253494295047478e-05,2323.756239103327,2336.830055164202,-0.05166864149441608,-0.036842853154666955,2315.9847515864926,2316.5333748129387,-0.4387828592425649,-0.631114281042467,1.218458481690822,0.17486243974462923,0.22383537263567632,0.38211123470546227,2316.899837245173,2312.02600331841,44.78151109311923,62.49263683555727,0,0,0,0,0,0,0,0,0,0,0,0,0,0,0,0,0,0,0,0,0,0,0,0,0,0,0,0,0,0,0,0,0,0,0,0,0,0,0,0,-100,0,0,0,0,0,0,0,0,0,0,0,0,0,0,0,0,0,0,0,0,0,4,5,,True,False,True,1.0,2214.13,2374.13,2289.13,2284.13,"5,4,2284.13",1,0.01,,,False,,,,2024-06-17 20:30:00,2314.13,2024-06-18 16:15:00,manual,2319.02,0.01,-86.45,fail,0 days 19:45:00,-5568.709999999999,False,0,1,25,6
2024-06-18 02:00:00,2320.98,2321.11,2319.88,2319.92,152,32,0,2318.5135720054927,2319.771666666667,2321.0297613278412,2319.1441462868315,2320.2363730070465,2320.2363730070465,2320.188456556679,0.06674477814931379,2320.9028554778574,0.15160839161035256,2320.7859673659855,0.048679098679713206,2320.3183916083917,-0.16205128205274377,2320.4209790209848,-0.051021756021782494,0.03156840934343563,0.03156840934343563,2300.161636175384,2324.6643871287947,1.930701463383713e-05,1.6050735611689906e-05,,7.749298575136033,7.749061381421554,-1.2435662069253659e-05,-2.1553985577264612e-05,2320.741745034913,2333.382421755974,-0.04873736786112204,-0.028261427583856857,2320.2157638245103,2319.797580393039,0.35883820861636195,0.3718047298304305,0.29222972897990074,0.03156840934343563,0.08061253244477484,0.08805339265927614,2320.8208324650063,2319.6519135490867,78.91922255925758,82.76186196306925,0,0,0,0,-100,0,0,0,0,0,0,0,0,0,0,0,0,0,0,0,0,0,0,0,0,0,0,0,0,0,0,0,0,0,0,0,0,0,0,0,0,0,0,0,0,0,0,0,0,0,0,0,0,0,0,0,0,0,0,0,0,0,4,5,,False,False,True,1.0,2219.92,2379.92,2294.92,2289.92,"5,4,2289.92",1,0.01,,,False,,,,2024-06-18 02:05:00,2319.92,2024-06-18 16:15:00,manual,2319.02,0.01,15.91,success,0 days 14:10:00,-5552.799999999999,True,1,0,25,6
2024-06-18 02:50:00,2320.32,2320.44,2320.01,2320.14,120,32,0,2318.4910164993453,2319.7850000000003,2321.0789835006553,2319.249442335747,2320.238353726361,2320.238353726361,2320.2037110369656,0.04252675812585949,2320.0916899766903,0.11151515151459535,2319.951581196598,0.11334887334851373,2319.703997668998,0.15622377622321437,2319.5448329448377,0.12127816627844368,0.01719688542516451,0.01719688542516451,2297.751976480504,2325.061894975117,2.8501264808714755e-05,1.5955360694438526e-05,,7.749241518005574,7.7491972747267335,-1.24337380282963e-05,-2.1553403799316912e-05,2320.2413020951494,2333.0914069764153,-0.048845454626643914,-0.029374303385338862,2319.962333669266,2319.8112584552878,0.12115233295025973,0.1357707220893937,0.3761458686396454,0.01719688542516451,0.06953429736677208,0.04084909158473238,2320.9906454636402,2319.4860619890815,55.00821018062433,48.76847290640813,0,0,0,0,-100,0,0,0,0,0,0,0,0,0,0,0,0,0,0,0,0,0,0,0,0,0,0,0,0,0,0,0,0,0,0,0,0,0,0,0,0,0,0,0,0,0,0,0,0,0,0,0,0,0,0,0,0,0,0,0,0,0,4,5,,False,False,True,1.0,2220.14,2380.14,2295.14,2290.14,"5,4,2290.14",1,0.01,,,False,,,,2024-06-18 02:55:00,2320.14,2024-06-18 16:15:00,manual,2319.02,0.01,19.8,success,0 days 13:20:00,-5532.999999999999,True,2,0,25,6
2024-06-18 13:25:00,2310.56,2310.56,2307.87,2310.03,883,27,0,2310.017501208268,2312.1556666666665,2314.293832125065,2317.005720435598,2310.9692584352983,2310.9692584352983,2311.0508577431824,-0.0643144234331885,2311.278496503499,-0.2328321678314751,2311.4675330225496,-0.13607614607553842,2310.109102564102,-0.7649067599058981,2310.6326107226128,-0.250586635586842,-0.09326065999357525,-0.09326065999357525,2306.0567018530824,2332.0161531977533,2.9987975792203837e-05,4.904625788985275e-06,,7.74578512368063,7.746526782992445,-6.376836529156271e-06,-4.120078120879234e-06,2310.663910441922,2328.5038939669817,1.0163194732986085,-0.01477076805122124,2311.296247364507,2312.3674245519574,-0.9033480327698271,-0.9355519157973168,0.6428730157649305,-0.09326065999357525,-0.05827660363183895,-0.04140600667506078,2312.2550044668283,2309.6835124037684,12.406116119864171,9.410665808202017,0,0,0,0,0,0,0,0,0,0,0,0,0,-100,0,0,0,0,0,0,0,0,0,0,0,0,0,0,0,0,0,0,0,0,0,0,0,0,0,0,0,0,0,0,0,0,0,0,0,0,0,0,0,0,0,0,0,0,0,0,0,0,4,5,,True,False,True,1.0,2210.03,2370.03,2285.03,2280.03,"5,4,2280.03",1,0.01,,,False,,,,2024-06-18 13:30:00,2310.03,2024-06-18 16:15:00,manual,2319.02,0.01,-158.94,fail,0 days 02:45:00,-5691.939999999999,False,0,1,25,6
2024-06-18 14:30:00,2311.18,2311.5,2310.63,2310.91,569,27,0,2306.947780172414,2310.573666666666,2314.1995531609186,2315.2944573011314,2308.5037968112692,2308.5037968112692,2308.379555308377,0.09208799900943632,2310.6234382284356,0.586713286707436,2310.039794094809,0.5556759906748994,2309.4780419580425,0.7895104895110308,2308.7627117327156,0.7220590520582846,0.1348008898748958,0.1348008898748958,2309.3955572585946,2332.1650848793315,2.357417702459956e-05,4.903232081962534e-06,,7.744897805540296,7.7452242200855235,-6.230987707986344e-06,-6.787602556481503e-06,2310.954704332379,2328.2705073322118,-0.015651638507733878,-0.015216803607927432,2309.7757064694974,2310.3823054941745,-0.4739599432386967,-0.9041476410509256,1.5195088492488713,0.1348008898748958,0.10312272895998831,0.03834037819387959,2311.542814509767,2305.4647791127713,89.84185301820402,78.67764697985787,0,0,0,0,0,0,0,0,0,0,0,0,0,0,0,0,0,0,0,0,0,0,0,0,0,0,0,0,0,0,0,0,0,0,0,0,0,0,0,0,0,0,0,0,0,0,0,0,0,0,0,-100,-100,0,0,0,0,0,0,0,0,0,4,5,,True,False,True,1.0,2210.91,2370.91,2285.91,2280.91,"5,4,2280.91",1,0.01,,,False,,,,2024-06-18 14:35:00,2310.91,2024-06-18 16:15:00,manual,2319.02,0.01,-143.38,fail,0 days 01:40:00,-5835.319999999999,False,0,2,25,6
2024-06-18 16:10:00,2318.36,2320.23,2317.98,2318.93,1098,27,0,2305.2819951149995,2313.059999999999,2320.8380048849986,2315.2807068588772,2318.3881001112354,2318.3881001112354,2317.9444785564306,0.3906686441732745,2319.8002564102558,0.12037296037169654,2319.7772494172636,-0.23494560994640779,2316.5070862470843,0.6099999999969441,2316.1082206682227,0.07163558663523872,0.4282054134232567,0.4282054134232567,2313.6045276989926,2332.356596061028,1.516816249363274e-05,5.022546499479611e-06,,7.747815696258234,7.747291643799706,-5.764315621959981e-06,-6.785142621546926e-06,2310.640685871379,2327.9480445032063,-0.015799446002347395,-0.012230269761857926,2316.531040922957,2314.7743690331795,1.5796761313331444,1.4023580642461728,2.736851358288317,0.4282054134232567,0.474453837598503,0.2693466814985186,2323.861802827812,2312.914397394659,49.84326018808659,38.76434834614121,0,0,0,0,0,0,0,0,0,0,0,0,-100,0,0,0,0,0,0,0,0,0,0,0,0,0,0,0,0,0,0,0,0,0,0,0,0,0,0,0,0,0,0,0,0,0,0,0,0,0,0,0,0,-100,0,0,0,0,0,0,0,0,4,5,,True,True,False,0.0,2418.93,2355.93,2359.93,2368.93,"5,4,2348.93",0,0.01,2024-06-20 17:00:00,2024-06-20 18:00:00,True,,,2024-06-20 18:20:25,2024-06-18 16:15:00,2318.93,2024-06-19 13:50:00,manual,2328.09,0.01,161.9,success,0 days 21:35:00,-5673.419999999999,True,1,0,25,6
2024-06-18 16:45:00,2320.91,2321.41,2318.26,2321.28,1377,27,0,2308.468253761308,2315.3766666666666,2322.285079572025,2315.6626383843513,2319.7621994809056,2319.7621994809056,2319.3164128043622,0.26283500185400044,2320.6272494172485,1.116188811191023,2319.6108003108147,0.6800582750579451,2316.8315967365966,1.0304778554791483,2315.951565656569,0.3034071484071319,0.4562550982554967,0.4562550982554967,2318.2599999999993,2332.4381323926195,8.34228211773619e-06,5.0234972643672825e-06,,7.747778028074164,7.747291643799706,-5.7614877365863935e-06,-6.785412154956488e-06,2310.5309514784776,2327.8522613397463,-0.015864689917634678,-0.014281918665346893,2318.118744459151,2316.3590217277074,1.5555804522728067,1.4021598818850682,1.7505585843875877,0.4562550982554967,0.4248498331517112,-0.09259992584566135,2323.2633166496807,2316.2610823121304,60.45197740112939,51.616801687550755,0,0,0,0,0,0,0,0,0,0,0,0,0,0,0,0,0,0,0,0,0,0,0,0,0,0,0,-100,0,0,0,0,0,0,0,0,0,0,0,0,0,0,0,0,0,0,0,0,0,0,0,0,0,0,0,0,0,0,0,0,0,0,4,5,,True,True,False,0.0,2421.28,2354.28,2358.28,2366.28,"5,4,2351.28",0,0.01,2024-06-20 17:05:00,2024-06-20 17:50:00,True,2024-06-21 11:30:00,,2024-06-20 18:23:28,2024-06-18 16:50:00,2321.28,2024-06-19 13:50:00,manual,2328.09,0.01,120.37,success,0 days 21:00:00,-5553.049999999999,True,2,0,25,6
2024-06-18 18:25:00,2323.97,2325.63,2323.53,2325.06,1082,27,0,2315.769365884319,2322.1823333333346,2328.59530078235,2318.2862327691096,2325.6414868372262,2325.6414868372262,2325.717531331122,0.1204936349035961,2324.795839160838,0.25777389277118345,2324.4185742035884,0.4677777777778829,2321.910990675991,0.4103263403267192,2321.488543123547,0.33585081585079024,-0.08520726733740958,-0.08520726733740958,2323.530000000001,2332.672179585679,2.1970471139139053e-07,5.02418432579098e-06,,7.749821406705315,7.749102899235636,2.1205741696383988e-07,-6.8750489326447186e-06,2310.2434405969043,2327.525129113264,-0.015958130571107176,4.021499626105651e-05,2323.7618848073603,2322.378679730451,1.1538179494123142,1.3902461204030563,1.8701241365355972,-0.08520726733740958,-0.05771894697636526,0.5044071190236536,2329.3817351102975,2321.901238564155,77.39545177044972,67.80385836628298,0,0,0,0,0,0,0,0,0,0,0,0,0,0,0,0,0,0,0,0,0,0,0,0,0,0,0,0,0,0,0,0,0,0,0,0,0,0,0,0,0,0,0,0,0,0,0,0,0,0,0,0,0,0,0,0,0,0,0,0,0,0,4,5,,True,True,False,0.0,2425.06,2354.06,2358.06,2365.06,"5,4,2355.06",0,0.01,2024-06-20 17:30:00,2024-06-20 17:45:00,True,2024-06-21 11:25:00,,2024-06-20 18:23:32,2024-06-18 18:30:00,2325.06,2024-06-19 13:50:00,manual,2328.09,0.01,53.56,success,0 days 19:20:00,-5499.489999999999,True,3,0,25,6
2024-06-18 18:40:00,2326.38,2329.73,2326.24,2328.73,1203,27,0,2316.889896569649,2323.066666666668,2329.243436763687,2318.7344184340027,2326.266602150537,2326.266602150537,2325.860952663465,0.20837177110388438,2327.0465967365967,1.2248951048950403,2326.0199106449254,0.7502525252530177,2324.1038578088587,1.0054312354318427,2323.2386013986056,0.7309557109560956,0.4936522061530013,0.4936522061530013,2323.5315314719696,2332.7073391756558,2.1970471139139053e-07,5.02418432579098e-06,,7.75033353535616,7.749547354206403,3.259310971567218e-06,-6.8762996651892175e-06,2310.1964379907777,2327.5195198430533,-0.015454808141385001,-0.008130130436711624,2324.955042639325,2323.2617848289533,1.4477613938429386,1.338603057693836,2.465974162840273,0.4936522061530013,0.22964404894537438,-0.09818094178763204,2331.1985504762174,2321.3346538248566,84.5763620763598,78.09952809952493,0,0,0,0,0,0,0,0,0,0,0,0,0,100,0,0,0,0,0,0,0,0,0,0,0,0,0,0,0,0,0,0,0,0,0,0,0,0,0,0,0,0,0,0,0,0,0,0,0,0,0,0,0,0,0,0,0,0,0,0,0,0,4,5,,True,True,False,0.0,2428.73,2357.73,2361.73,2368.73,"5,4,2358.73",0,0.01,2024-06-20 17:45:00,2024-06-20 18:00:00,True,,,2024-06-20 18:14:52,2024-06-18 18:45:00,2328.73,2024-06-19 13:50:00,manual,2328.09,0.01,-11.31,fail,0 days 19:05:00,-5510.799999999999,False,0,1,25,6
2024-06-18 19:00:00,2326.82,2329.3,2326.82,2328.92,695,27,0,2319.410959216758,2324.445000000001,2329.4790407832443,2319.3775410662665,2326.797904338151,2326.797904338151,2326.6795619824607,0.10061821777298974,2329.1755827505854,0.5001515151539024,2328.7294289044457,0.4498135198155069,2327.331666666665,0.5071911421887307,2326.7305361305403,0.7167404817400893,0.18596588802211045,0.18596588802211045,2323.533573436166,2332.754219453326,2.1970471139139053e-07,5.02418432579098e-06,,7.750953574074122,7.749882543709144,3.2596184646964095e-06,-6.874415365634449e-06,2310.131901602401,2327.5496595152567,-0.01659348765087998,0.008524476687398419,2326.3433485971204,2324.454935578568,1.627874546516523,1.4761232961958752,1.5977282981463297,0.18596588802211045,-0.01690470893663587,0.13279347423258514,2329.993360934444,2323.602447741858,82.16216216216306,81.65165165165233,0,0,0,0,0,0,0,0,0,0,0,0,0,100,0,0,0,0,0,0,0,0,0,0,0,0,0,0,0,0,0,200,0,0,0,0,0,0,0,0,100,0,0,0,0,0,0,0,100,0,0,0,0,0,0,0,0,0,0,0,0,0,4,5,,True,True,False,0.0,2428.92,2357.92,2361.92,2368.92,"5,4,2358.92",0,0.01,2024-06-20 17:45:00,2024-06-20 18:00:00,True,,,2024-06-20 18:14:38,2024-06-18 19:05:00,2328.92,2024-06-19 13:50:00,manual,2328.09,0.01,-14.67,fail,0 days 18:45:00,-5525.469999999999,False,0,2,25,6
2024-06-18 19:55:00,2329.3,2330.66,2329.26,2330.15,814,27,0,2321.3312423166935,2326.397333333334,2331.463424349974,2321.0981838460134,2329.655413422322,2329.655413422322,2329.279178593511,0.2870236064763958,2329.5934965034953,0.25440559440494326,2329.406041181055,0.02809246309197988,2328.148508158509,0.3457226107243514,2327.9193240093296,0.016519036519639485,0.42408083055397583,0.42408083055397583,2323.5391888469567,2332.8831450749353,2.1970471139139053e-07,5.02418432579098e-06,,7.751933441116146,7.750877003685142,7.500077377640139e-06,-6.874577882394743e-06,2309.957292509709,2325.5745327963346,-0.016713785958927474,0.03484288085883236,2328.4827663525,2326.924884136664,1.322776560229613,1.4083007811504058,0.767611090440953,0.42408083055397583,0.2805428253604987,0.15644716351425814,2331.190635603204,2328.12019124144,75.59429840010546,70.72726596878364,0,0,0,0,0,0,0,0,0,0,0,0,0,100,0,0,0,0,0,0,0,0,0,0,0,0,0,0,0,0,0,0,0,0,0,0,0,0,0,0,0,0,0,0,0,0,0,0,0,0,0,0,0,0,0,0,0,0,0,0,0,0,4,5,,True,True,False,0.0,2430.15,2355.15,2359.15,2365.15,"5,4,2360.15",0,0.01,2024-06-20 17:45:00,2024-06-20 17:45:00,True,2024-06-21 11:25:00,,2024-06-20 18:20:50,2024-06-18 20:00:00,2330.15,2024-06-19 13:50:00,manual,2328.09,0.01,-36.42,fail,0 days 17:50:00,-5561.889999999999,False,0,3,25,6
2024-06-18 20:25:00,2330.24,2332.55,2329.87,2331.63,853,27,0,2322.373951938418,2327.5106666666666,2332.647381394915,2322.0147835143075,2330.9042573229494,2330.9042573229494,2330.628427388468,0.21404399950461084,2330.8045454545468,0.7108974358970954,2330.2878321678486,0.19756021756165865,2328.895722610722,0.4252447552439662,2328.6601864801905,0.074459984459736,0.3062832777109179,0.3062832777109179,2323.5422518040155,2332.9534711445112,2.1970471139139053e-07,5.02418432579098e-06,,7.752559874818992,7.751724570856985,1.5247190983787477e-05,-6.875794448834529e-06,2309.862598125927,2322.214859953278,-0.01650038784964636,-0.5693302780177874,2329.447946944286,2328.0206386374102,1.2109189209909346,1.2316399523284631,0.8964493454986774,0.3062832777109179,0.21492324805694807,0.12092547274596654,2332.697156013947,2329.111358631952,75.87270885143109,66.92210862423474,0,0,0,0,0,0,0,0,0,0,0,0,0,0,0,0,0,0,0,0,0,0,0,0,0,0,0,0,0,0,0,0,0,0,0,0,0,0,0,0,0,0,0,0,0,0,0,0,0,0,0,0,0,0,0,0,0,0,0,0,0,0,4,5,,True,True,False,0.0,2431.63,2356.63,2360.63,2366.63,"5,4,2361.63",0,0.01,2024-06-20 17:50:00,2024-06-20 17:50:00,True,2024-06-21 11:30:00,,2024-06-20 18:19:47,2024-06-18 20:30:00,2331.63,2024-06-19 13:50:00,manual,2328.09,0.01,-62.59,fail,0 days 17:20:00,-5624.48,False,0,4,25,6
2024-06-18 21:30:00,2329.86,2330.98,2329.68,2330.74,455,27,0,2327.2058236361477,2329.346666666666,2331.487509697184,2323.6511874255343,2329.9458924731175,2329.9458924731175,2329.8648797429346,0.024106043752453843,2329.365046620049,0.4418181818209632,2329.0027777777927,0.14747086247189145,2328.2625641025634,0.46445221445355855,2327.8788927738965,0.11833333333288465,0.15322951427469889,0.15322951427469889,2323.5488882248305,2333.105851568188,2.1970471139139053e-07,5.02418432579098e-06,,7.752999656724471,7.752725910441398,1.6049209809605285e-05,-1.4924838824749122e-05,2313.344585890461,2322.5303634851853,-0.03516751745110014,0.03825316928896427,2329.551634963753,2329.0147376573113,0.420800232163856,0.5482324080897586,0.9101452005996947,0.15322951427469889,-0.06342083796789666,-0.017490545049440698,2331.766182874317,2328.125602071918,48.48484848484633,35.31392354921743,0,0,0,0,0,0,0,0,0,0,0,0,0,0,0,0,0,0,0,0,0,0,0,0,0,0,0,0,0,0,0,0,0,0,0,0,0,0,0,0,100,0,0,0,0,0,0,0,0,0,0,0,0,0,0,0,0,0,0,0,0,0,4,5,,True,True,False,0.0,2430.74,2355.74,2359.74,2365.74,"5,4,2360.74",0,0.01,2024-06-20 17:50:00,2024-06-20 17:50:00,True,2024-06-21 11:30:00,,2024-06-20 18:20:41,2024-06-18 21:35:00,2330.74,2024-06-19 13:50:00,manual,2328.09,0.01,-46.85,fail,0 days 16:15:00,-5671.33,False,0,5,25,6
2024-06-18 22:45:00,2329.45,2329.87,2329.34,2329.86,254,28,0,2327.947540696023,2329.8133333333344,2331.6791259706456,2325.1274001684333,2329.3740652576926,2329.3740652576926,2329.426739092829,-0.05399035965820076,2329.4959673659673,0.026736596736100182,2329.511371406386,-0.06766122766111948,2328.884242424241,0.09923076922768814,2328.8014763014817,0.015493395492740092,-0.025461624029048835,-0.025461624029048835,2323.556545657018,2333.2816875015947,2.1970471139139053e-07,5.02418432579098e-06,,7.753514577925745,7.753491630432229,1.6052044846864918e-05,-1.9718165811092087e-05,2314.8591496414597,2323.0877914439116,-0.04408854909343063,0.03790815761885824,2329.5741679050416,2329.454667980337,0.07308329378611234,0.15589296940581002,0.3351332364562662,-0.025461624029048835,-0.10709825732055833,-0.029411197624540364,2330.044331730605,2328.7037987847802,40.516273849611146,37.127611396619166,0,0,0,0,0,0,0,0,0,0,0,0,0,0,0,0,0,0,0,0,0,0,0,0,0,0,0,0,0,0,0,0,0,0,0,0,0,0,0,0,0,0,0,0,0,0,0,0,0,0,0,100,0,0,0,0,0,0,0,0,0,0,4,5,,True,True,False,0.0,2429.86,2354.86,2358.86,2364.86,"5,4,2359.86",0,0.01,2024-06-20 17:45:00,2024-06-20 17:45:00,True,2024-06-21 11:25:00,,2024-06-20 18:20:53,2024-06-18 22:50:00,2329.86,2024-06-19 13:50:00,manual,2328.09,0.01,-31.29,fail,0 days 15:00:00,-5702.62,False,0,6,25,6
2024-06-19 13:45:00,2328.46,2328.84,2328.06,2328.06,299,27,0,2326.077862087845,2330.020333333334,2333.9628045788227,2329.5331509335774,2327.3637916203206,2327.3637916203206,2327.392725250293,-0.0073763440855145745,2329.3967249417233,-0.14032634032719216,2329.4954428904543,-0.018053613052870787,2328.409207459208,-0.07769230769008573,2328.4547513597568,-0.007793317792675225,-0.045187986649580125,-0.045187986649580125,2323.6423106216225,2335.2519555631466,2.1970471139139053e-07,5.02418432579098e-06,,7.753559363040252,7.754102803067479,6.157080617152076e-06,3.405489966352251e-05,2305.0986006772114,2331.603513588273,0.07846176844623187,0.13112960856142308,2328.6956494114884,2329.3234328763406,-0.5546053158482209,-0.5970258014350026,0.4255416721519194,-0.045187986649580125,0.0035750834244936414,0.01948387096854276,2328.2148749646244,2326.512708276017,46.31860776438307,47.81395842349486,0,0,0,0,0,0,0,0,0,0,0,0,0,0,0,0,0,0,0,0,0,0,0,0,0,0,0,0,0,0,0,100,0,0,0,0,0,0,0,0,0,0,0,0,0,0,0,0,0,0,0,0,0,0,0,0,0,0,0,0,0,0,4,5,,True,False,True,1.0,2228.06,2303.06,2299.06,2293.06,"5,4,2298.06",1,0.01,2024-06-26 16:30:00,2024-06-26 16:30:00,True,,,2024-06-26 18:18:29,2024-06-19 13:50:00,2328.06,2024-06-19 15:05:00,manual,2332.45,0.01,-77.61,fail,0 days 01:15:00,-5780.23,False,0,7,25,6
2024-06-19 15:00:00,2330.4,2332.82,2330.06,2332.43,599,27,0,2326.0377672304667,2328.610666666668,2331.183566102869,2329.3706721835856,2329.4324998146076,2329.4324998146076,2329.0179031022276,0.38077394635956807,2331.673158508158,0.8535780885777058,2330.9567909868033,0.6348640248634183,2330.0556993006976,0.42142191142238516,2329.621818181824,0.5317210567204711,0.47749202817567493,0.47749202817567493,2323.6499683616885,2335.4279532389787,2.1970471139139053e-07,5.02418432579098e-06,,7.753403549843766,7.753360495482809,4.906795214678839e-06,2.9992019293817405e-05,2306.316326945074,2332.058682112113,0.0692170521197113,0.011172106680078286,2329.746043562991,2329.280494619385,0.45730328846138946,-0.039763055417979656,1.210548134604473,0.47749202817567493,0.28880608083318293,0.3760237300693916,2331.8535960838167,2327.0114035453985,93.35094791893465,91.70729591750758,0,0,0,0,0,0,0,0,0,0,0,0,0,0,0,0,0,0,0,0,0,0,0,0,0,0,0,0,0,0,0,0,0,0,0,0,0,0,0,0,0,0,0,0,0,0,0,0,0,0,0,0,0,0,0,0,0,0,0,0,0,0,4,5,,True,True,False,0.0,2432.43,2357.43,2361.43,2367.43,"5,4,2362.43",0,0.01,2024-06-20 18:00:00,2024-06-20 18:00:00,True,2024-06-21 11:30:00,,2024-06-20 18:14:53,2024-06-19 15:05:00,2332.43,2024-06-19 18:15:00,manual,2325.53,0.01,-121.99,fail,0 days 03:10:00,-5902.219999999999,False,0,8,25,6
2024-06-19 16:50:00,2329.5,2329.91,2328.72,2329.0,606,27,0,2326.2526240293882,2329.1086666666665,2331.964709303945,2329.168527411119,2328.6586466444196,2328.6586466444196,2328.7341255716383,-0.06523594117015818,2330.2061655011653,0.030442890442373027,2330.2203885004005,-0.013562548562276788,2328.741771561771,0.1798018648019024,2328.5985664335744,0.012804972804588033,-0.09108713385376177,-0.09108713385376177,2323.661199759437,2335.686107157224,2.1970471139139053e-07,5.02418432579098e-06,,7.753292175610176,7.753188624011877,4.906355126442437e-06,2.146086952874227e-05,2311.4369663496454,2332.3104852536876,0.049590887085742,0.010968116680487583,2329.0815837504256,2328.9574264239154,0.12055939656374903,0.0482295848820444,0.7125194236210826,-0.09108713385376177,-0.0442625139021402,-0.06035817575411784,2330.083685491662,2327.2336077971772,63.65176314810483,63.84645109818644,0,0,0,0,0,0,0,0,0,0,0,0,0,0,0,0,0,0,0,0,0,0,0,0,0,0,0,0,0,0,0,-100,0,0,0,0,0,0,0,0,0,0,0,0,0,0,0,0,0,0,0,-100,0,0,0,0,0,0,0,0,0,0,4,5,,True,True,False,0.0,2429.0,2358.0,2362.0,2369.0,"5,4,2359.0",0,0.01,2024-06-20 17:45:00,2024-06-20 18:05:00,True,,,2024-06-20 18:14:38,2024-06-19 16:55:00,2329.0,2024-06-19 18:15:00,manual,2325.53,0.01,-61.35,fail,0 days 01:20:00,-5963.57,False,0,9,25,6
2024-06-19 18:10:00,2326.34,2326.47,2325.18,2325.51,562,27,0,2324.4807708737044,2327.5970000000007,2330.713229126297,2328.44486787861,2325.8696307007785,2325.8696307007785,2326.1657854406294,-0.27257100482029273,2326.8533216783208,-0.21136363636333044,2327.0291142191263,-0.07093240093354325,2325.498473193473,-0.15412587412902212,2325.6632517482612,-0.1490947940951628,-0.2948950685940872,-0.2948950685940872,2323.6693680828052,2335.873873384573,2.1970471139139053e-07,5.02418432579098e-06,,7.752404880152581,7.752861657901446,5.022705296045963e-06,1.5165975332622913e-05,2313.911653450865,2332.45904176638,0.03506616162803766,0.011633592556790973,2326.442230988841,2327.0836031975464,-0.5637555101525322,-0.5325334903489504,0.6680876228767492,-0.2948950685940872,-0.2986740823157561,-0.22414386355148963,2327.205805946532,2324.533455455025,47.217982364732485,47.52313199840265,0,0,0,0,-100,0,0,0,0,0,0,0,0,-100,0,0,0,0,0,0,0,0,0,0,0,0,0,0,0,0,0,0,0,0,0,0,0,0,0,0,-100,0,0,0,0,0,0,0,0,0,0,0,0,0,0,0,0,0,0,0,0,0,4,5,,True,False,True,1.0,2225.51,2300.51,2296.51,2290.51,"5,4,2295.51",1,0.01,2024-06-26 16:45:00,2024-06-26 16:45:00,True,,,2024-06-26 17:03:24,2024-06-19 18:15:00,2325.51,2024-06-26 17:03:24,auto,2300.04,0.01,450.19,even,6 days 22:48:24,-5513.38,True,1,0,25,6
