time,open,high,low,close,tick_volume,spread,real_volume,bb_lower,bb_middle,bb_upper,ema_50,lsma,lsma2,lsma3,support_trendline_15,resistance_trendline_15,support_gradient_15,resistance_gradient_15,supertrend_dir,Span_A,Span_B,fixed_resistance_gradient_15,fixed_support_gradient_15,fixed_support_trendline_15,fixed_resistance_trendline_15,ema_short,ema_long,macd_line,macd_signal,lsma_stddev,lsma_slope,prev_lsma_slope_1,prev_lsma_slope_2,lsma_upper_band,lsma_lower_band,stoch_k,stoch_d,is_doji,is_doji_star,3whitesoldiers,3blackcrows,engulfing,inverted_hammer,two_crows,three_inside,three_line_strike,three_outside,three_stars_in_south,abandoned_baby,advance_block,belt_hold,breakaway,closing_marubozu,conceal_baby_swallow,counterattack,dark_cloud_cover,doji,doji_star,dragonfly_doji,evening_doji_star,evening_star,gap_side_side_white,gravestone_doji,hammer,hanging_man,harami,harami_cross,high_wave,hikkake,hikkake_mod,homing_pigeon,identical_three_crows,in_neck,kicking,kicking_by_length,ladder_bottom,long_legged_doji,long_line,matching_low,mat_hold,morning_doji_star,morning_star,on_neck,piercing,rickshaw_man,rise_fall_3_methods,separating_lines,shooting_star,short_line,spinning_top,stalled_pattern,stick_sandwich,takuri,tasuki_gap,thrusting,tristar,unique_3_river,upside_gap_two_crows,xside_gap_3_methods,be_increment,be_condition_increment,ticket,is_buy2,is_sell2,signal,tp,sl,be,be_condition,order_type,lot,first_time_to_trail,last_time_to_trail,sl_updated,time_to_trail,time_tp_hit,time_sl_hit,entry_time,entry_price,exit_time,exit,exit_price,lot_size,type,profit,duration,account_balance,success,win_streak,losing_streak,Week,Month
2024-03-13 20:00:00,2174.41,2176.45,2174.15,2174.73,5010,29,0,2151.739878068214,2163.421500000002,2175.1031219317906,2166.5063769881676,2171.079488721802,2161.194335654261,2156.179073229293,2172.4450151594237,2180.398681691345,-0.0003611268582124107,-0.00027307851442359585,,7.681084371890954,7.681557598555969,0.0005261644450058174,0.00029555309348026774,2155.8565291809564,2167.9712044205503,2168.2263726907695,2166.309731529261,1.9095163389506524,-0.06319081585498337,4.679109919977252,1.7451804511247246,1.8826842105286232,1.8313157894717733,2180.4377085617566,2161.7212688818477,82.55115710140682,84.47920729266552,100,0,0,0,0,0,0,0,0,0,0,0,-100,0,0,0,0,0,0,100,0,0,0,0,0,100,0,0,0,0,0,0,0,0,0,0,0,0,0,100,0,0,0,0,0,0,0,0,0,0,0,0,0,0,0,0,0,0,0,0,0,0,8,10,,False,True,1.0,2074.73,2162.73,2154.73,2149.73,1,0.01,2024-03-14 18:00:00,2024-03-14 18:00:00,True,2024-03-18 05:00:00,,2024-03-14 19:15:14,2024-03-13 21:00:00,2174.73,2024-03-14 19:15:14.000000000,auto,2162.64,0.01,even,0.0,0 days 22:15:14,700.0,True,1,0,11,3
2024-03-15 12:00:00,2171.76,2172.58,2168.54,2169.16,5176,29,0,2156.1696242266103,2163.885500000003,2171.601375773396,2166.2370387134124,2169.0035864661645,2166.968146458585,2163.463912124851,2159.398372482056,2172.580000000001,-0.0004490239069887592,-0.0005306394503104149,,7.680098855909655,7.680707814753429,0.0002257042302839537,0.00036394833950470214,2157.861408062592,2167.5349923127255,2167.0010377224053,2166.118636119029,0.8649182729691347,-0.09758213541318164,2.534673478617735,0.8655112781943899,1.4522932330842195,1.4557669172922942,2174.0729334234,2163.934239508929,84.62765077950452,85.03883568697405,0,0,0,0,0,0,0,0,0,0,0,0,0,0,0,0,0,0,0,0,0,0,0,0,0,0,0,0,0,0,0,0,0,0,0,0,0,0,0,0,-100,0,0,0,0,0,0,0,0,0,0,0,0,0,0,0,0,0,0,0,0,0,8,10,,False,True,1.0,2069.16,2157.16,2149.16,2144.16,1,0.01,2024-03-18 04:00:00,2024-03-18 04:00:00,True,,,2024-03-18 12:33:39,2024-03-15 13:00:00,2169.16,2024-03-18 12:33:39.000000000,auto,2157.07,0.01,even,213.27,2 days 23:33:39,913.27,True,2,0,11,3
2024-03-21 18:00:00,2174.63,2180.28,2172.9,2179.81,10463,27,0,2177.7334212315827,2198.7185000000045,2219.7035787684263,2190.7124741542516,2192.50742857143,2207.7756052821137,2197.693340216086,2172.900000000001,2192.8739981890553,-0.0003423496241229665,-0.00040341797698407273,,7.691035928568581,7.689477526043385,-0.00041873818371794574,-0.00041893770616844683,2175.6797634711747,2216.584645138595,2191.4984229648553,2188.5192233050584,2.20161520007332,6.664996322972577,14.939368352978615,-4.628751879699848,-5.690887218042917,-7.145225563910117,2222.386165277387,2162.628691865473,16.95096810671544,16.974916568169863,0,0,0,0,0,0,0,0,0,0,0,0,0,0,0,100,0,0,0,0,0,0,0,0,0,0,0,0,0,0,0,0,0,0,0,0,0,0,0,0,100,0,0,0,0,0,0,0,0,0,0,0,0,0,0,0,0,0,0,0,0,-100,8,10,,True,False,0.0,2279.81,2191.81,2199.81,2204.81,0,0.01,2024-03-26 13:00:00,2024-03-26 13:00:00,True,2024-03-28 13:00:00,,2024-03-26 14:35:37,2024-03-21 19:00:00,2179.81,2024-03-26 14:35:37.000000000,auto,2191.92,0.01,even,213.62,4 days 19:35:37,1126.8899999999999,True,3,0,12,3
2024-04-04 16:00:00,2288.16,2290.99,2284.65,2287.44,13228,27,0,2287.209883510774,2295.7940000000053,2304.3781164892366,2291.6059607230104,2291.1399624060155,2302.570647779111,2298.389200480192,2280.0344773098795,2309.8605812959013,-0.0004935338417413613,-0.00037531667064711894,,7.735559499511136,7.730886251932834,-0.00034448541718062436,-0.00014844074812930873,2286.1734687260678,2304.2063587836615,2292.0883289416342,2290.210585173947,1.351327268402656,3.293982495804367,3.034511022093714,-1.686323308269948,-2.1822857142869907,-2.207225563907741,2297.208984450203,2285.070940361828,16.366969254085415,16.651987725416745,0,0,0,0,0,0,0,0,0,0,0,0,0,0,0,0,0,0,0,0,0,0,0,0,0,0,0,0,0,0,-100,0,0,0,0,0,0,0,0,0,0,0,0,0,0,0,0,0,0,0,0,0,-100,0,0,0,0,0,0,0,0,0,8,10,,True,False,0.0,2387.44,2299.44,2307.44,2312.44,0,0.01,2024-04-04 22:00:00,2024-04-04 22:00:00,True,2024-04-05 18:00:00,2024-04-12 04:01:19,2024-04-04 22:01:44,2024-04-04 17:00:00,2287.44,2024-04-04 22:01:44.000000000,auto,2299.41,0.01,even,211.15,0 days 05:01:44,1338.04,True,4,0,14,4
2024-04-05 06:00:00,2273.72,2279.35,2273.5,2276.62,4170,27,0,2273.5036904303392,2288.3675000000044,2303.2313095696695,2286.3748834020025,2281.6066766917297,2296.3257541416606,2288.5811049219687,2257.333980319852,2284.7626817495284,0.001123314162338192,0.0015744506294432887,,7.734791417562993,7.7342641717006675,-2.712109917132792e-05,-0.0005494505104439813,2279.2691714755756,2305.7344493243236,2283.8216431345604,2286.9238416367107,-3.0176708354397306,-0.8418913027655179,7.4532906203767935,-1.6381203007522345,-2.4533233082697734,-2.8377744360909674,2296.513257932483,2266.7000954509763,16.75475687103543,16.298822288529934,0,0,0,0,0,0,0,0,0,0,0,0,0,0,0,0,0,0,0,0,0,0,0,0,0,0,0,0,0,0,0,-100,0,0,0,0,0,0,0,0,0,0,0,0,0,0,0,0,0,0,0,0,0,0,0,0,0,0,0,0,0,0,8,10,,True,False,0.0,2376.62,2288.62,2296.62,2301.62,0,0.01,2024-04-05 14:00:00,2024-04-05 14:00:00,True,2024-04-05 18:00:00,2024-04-11 23:34:29,2024-04-05 15:30:02,2024-04-05 07:00:00,2276.62,2024-04-05 15:30:02.000000000,auto,2288.6,0.01,even,211.33,0 days 08:30:02,1549.37,True,5,0,14,4
2024-04-12 23:00:00,2343.28,2345.28,2341.57,2344.41,3343,27,0,2339.961255254472,2384.6015000000034,2429.241744745535,2373.446428578679,2367.218616541354,2399.426492196878,2383.6184120047997,2341.5905497995304,2373.7905877551702,-0.00043571763530020406,-0.0003078199945134489,,7.775754434003938,7.773988114113891,0.001038588328371442,-0.0010809425580465136,2358.802776174259,2415.752637564099,2369.576362479811,2372.9559950786474,-3.6940454539926577,4.172137365058218,32.8356703906001,-7.828804511278122,-8.615969924810997,-10.091075187970546,2432.8899573225544,2301.5472757601538,7.9793810301894625,8.154179625875921,100,0,0,0,0,0,0,0,0,0,0,0,0,0,0,0,0,0,0,100,0,0,0,0,0,0,0,-100,0,0,0,0,0,0,0,0,0,0,0,100,0,0,0,0,0,0,0,0,0,0,0,100,0,0,0,0,0,0,0,0,0,0,8,10,,True,False,0.0,2444.41,2356.41,2364.41,2369.41,0,0.01,2024-04-15 03:00:00,2024-04-15 03:00:00,True,2024-04-15 22:00:00,,2024-04-15 03:31:07,2024-04-13 00:00:00,2344.41,2024-04-15 03:31:07.000000000,auto,2356.48,0.01,even,212.91,2 days 03:31:07,1762.28,True,6,0,15,4
2024-04-16 02:00:00,2384.31,2387.19,2381.03,2381.91,4203,27,0,2337.037623440157,2362.0095000000038,2386.9813765598506,2367.6688498145386,2374.971744360903,2362.876613685475,2349.586945978391,2362.3521461241658,2387.1665163419175,3.1820960834657636e-05,0.00027052011207545027,,7.765546439319056,7.773712839369846,0.0007419028580577688,-4.252341458045785e-05,2324.6287080694974,2373.993673559222,2371.181195362363,2366.7352318512635,4.204614227575803,0.45751435204275126,13.470333475035101,3.4844887218050644,3.9374060150375954,3.9108496240592103,2401.9124113109733,2348.0310774108325,88.87900015937379,92.59867182201158,0,0,0,0,0,0,0,0,0,0,0,0,0,0,0,0,0,0,0,0,0,0,0,0,0,0,0,0,0,0,0,0,0,0,0,0,0,0,0,0,0,0,0,0,0,0,0,0,0,0,0,-100,0,0,0,0,0,0,0,0,0,0,8,10,,False,True,1.0,2281.91,2369.91,2361.91,2356.91,1,0.01,2024-04-16 11:00:00,2024-04-16 11:00:00,True,2024-04-22 10:00:00,,2024-04-16 11:18:41,2024-04-16 03:00:00,2381.91,2024-04-16 11:18:41.000000000,auto,2369.83,0.01,even,213.09,0 days 08:18:41,1975.37,True,7,0,16,4
2024-04-16 20:00:00,2397.39,2397.53,2379.64,2384.61,18917,27,0,2363.3119092225475,2379.828500000004,2396.345090777461,2377.9724269124445,2378.5936992481224,2382.589090036015,2375.039544777912,2379.145339827218,2397.5299999999993,-0.00023027930332297184,-5.343923613100399e-05,,7.772952049435727,7.773712839369846,0.0001419990632034734,-0.0001339534279546047,2363.317205023926,2394.6911356188625,2380.5119098195146,2376.5036615936433,3.5506016547801664,2.6075900302257784,10.04256930343671,1.115909774440297,3.718864661651878,1.0031353383465103,2398.678837854996,2358.508560641249,78.68718567685026,72.24685862308951,0,0,0,0,0,0,0,0,0,0,0,0,0,-100,0,0,0,0,0,0,0,0,0,0,0,0,0,0,0,0,0,0,0,0,0,0,0,0,0,0,0,0,0,0,0,0,0,0,0,0,0,0,0,0,0,0,0,0,0,0,0,100,8,10,,False,True,1.0,2284.61,2372.61,2364.61,2359.61,1,0.01,2024-04-18 00:00:00,2024-04-18 00:00:00,True,2024-04-22 10:00:00,,2024-04-18 05:37:06,2024-04-16 21:00:00,2384.61,2024-04-18 05:37:06.000000000,auto,2372.63,0.01,even,211.33,1 days 08:37:06,2186.7,True,8,0,16,4
2024-04-17 21:00:00,2372.16,2379.05,2371.82,2374.33,9714,27,0,2371.246358639326,2383.243000000003,2395.2396413606803,2381.953220925373,2381.5437669172916,2390.438927250901,2382.0769430972396,2352.7780458805837,2379.0499999999997,0.0003727465932636008,0.00031711639089205114,,7.774376654938969,7.766819862633393,0.00010468993002344184,-0.0004889444454930948,2371.7064419585704,2393.6681466911155,2381.0770128830004,2381.77078529525,-0.800600040563495,0.992632380789518,8.257846052609654,-1.5256541353405737,-2.2426691729306185,-1.819759398496899,2398.059459022511,2365.028074812072,34.562167392355626,40.358541973438385,0,0,0,0,0,0,0,0,0,0,0,0,0,0,0,0,0,0,0,0,0,0,0,0,0,0,0,0,0,0,0,-100,0,0,0,0,0,0,0,0,0,0,0,0,0,0,0,0,0,0,0,0,0,0,0,0,0,0,0,0,0,-100,8,10,,True,False,0.0,2474.33,2394.33,2402.33,2409.33,0,0.01,2024-04-19 05:00:00,2024-04-19 06:00:00,True,,,2024-04-19 06:09:04,2024-04-17 22:00:00,2374.33,2024-04-19 06:09:04.000000000,auto,2395.04,0.01,even,365.32,1 days 08:09:04,2552.02,True,9,0,16,4
2024-04-18 01:00:00,2365.51,2367.61,2363.38,2365.18,2717,27,0,2363.126113983412,2380.590500000003,2398.054886016594,2377.792489183364,2373.4598947368404,2384.72711884754,2375.731493877552,2362.773109543086,2368.3927343153905,0.0001776866748833296,0.000680446807987259,,7.7727134120807335,7.7714875709598985,8.594861940537931e-05,-0.000546756309773829,2367.7182205535214,2394.608965012084,2375.0406391202882,2378.5120896325902,-3.3119609719360597,-0.7547111212156805,9.25840997997007,-2.55524060150492,-3.651714285714206,-1.8769172932320544,2391.9767146967806,2354.9430747769,24.890994260021174,29.604166373914513,100,0,0,0,0,0,0,0,0,0,0,0,0,0,0,0,0,0,0,100,0,0,0,0,0,0,0,0,100,100,-100,0,0,100,0,0,0,0,0,100,0,0,0,0,0,0,0,100,0,0,0,-100,-100,0,0,0,0,0,0,0,0,0,8,10,,True,False,0.0,2465.18,2377.18,2385.18,2390.18,0,0.01,2024-04-18 10:00:00,2024-04-18 10:00:00,True,2024-04-19 05:00:00,,2024-04-18 10:30:20,2024-04-18 02:00:00,2365.18,2024-04-18 10:30:20.000000000,auto,2377.17,0.01,even,211.5,0 days 08:30:20,2763.52,True,10,0,16,4
2024-04-29 06:00:00,2324.23,2329.49,2323.6,2328.48,5236,27,0,2324.9770861729867,2338.376500000005,2351.775913827023,2334.702618124351,2329.7106541353382,2344.460495558223,2337.8574722689073,2322.792769880392,2342.2804543798,0.00012164283200272153,0.00014271141730932884,,7.755054934360779,7.753030618840009,-0.0004991181731478079,-0.00037678453681137055,2327.979440330937,2348.241163016665,2333.412481636335,2334.717192849356,-1.3528356753085973,0.37717668301012897,5.105968496369607,-1.6406466165431084,-2.7995939849606657,-1.8755263157891022,2339.9225911280773,2319.498717142599,25.830900774229615,24.67782898018835,0,0,0,0,0,0,0,0,0,0,0,0,0,0,0,0,0,0,0,0,0,0,0,0,0,0,0,0,0,0,0,100,0,0,0,0,0,0,0,0,100,0,0,0,0,0,0,0,0,0,0,0,0,0,0,0,0,0,0,0,0,0,8,10,,True,False,0.0,2428.48,2298.48,2340.48,2343.48,0,0.01,,,False,,,2024-04-30 17:32:50,2024-04-29 07:00:00,2328.48,2024-04-30 17:32:50.000000000,auto,2298.4,0.01,fail,-531.51,1 days 10:32:50,2232.01,False,0,1,18,4
2024-05-01 19:00:00,2307.3,2307.3,2301.82,2303.71,8701,27,0,2277.548968916439,2292.0045000000055,2306.4600310835717,2297.3479823153516,2300.253781954887,2284.939823289314,2278.7364172869147,2296.1689531885268,2333.3875244486435,-6.074686577705831e-05,-0.0003754218775407137,,7.739135055551053,7.746661967864682,0.00043522026225229393,0.00024064714297356008,2281.9303520423196,2301.089862966131,2297.956056623767,2298.5596274298505,-0.1133794524730547,-3.219911771294766,5.831593141834194,2.06881203007606,2.8266766917304267,2.950037593984689,2311.9169682385555,2288.5905956712186,81.7867036011078,86.38480701317594,0,0,0,0,-100,0,0,0,0,0,0,0,0,-100,0,0,0,0,0,0,0,0,0,0,0,0,0,0,0,0,0,100,0,0,0,0,0,0,0,0,-100,0,0,0,0,0,0,0,0,0,0,0,0,0,0,0,0,0,0,0,0,0,8,10,,False,True,1.0,2203.71,2333.71,2291.71,2288.71,1,0.01,,,False,,,2024-05-09 17:14:11,2024-05-01 20:00:00,2303.71,2024-05-09 17:14:11.000000000,auto,2333.87,0.01,fail,-532.92,7 days 21:14:11,1699.0900000000001,False,0,2,18,5
2024-05-01 22:00:00,2325.06,2327.79,2309.61,2309.61,17690,27,0,2274.0802531383342,2295.2940000000053,2316.5077468616764,2301.0613573805203,2308.7664360902245,2289.7634861944775,2280.454617046818,2308.3009010028995,2334.180356385392,-0.0005854074114085291,-0.0006196585219171031,,7.743799772707019,7.746661967864682,0.0008519274257505993,0.0005305204665946373,2283.432954650932,2307.9677373162385,2303.433942360598,2301.247094375421,2.3667802012623724,-0.8583905017894162,8.501625054766766,2.3461578947362796,5.44854887217889,0.7179473684223012,2325.769686199758,2291.763185980691,71.09229826881655,74.71152073162163,0,0,0,0,0,0,0,0,0,0,0,0,0,0,0,-100,0,0,0,0,0,0,0,0,0,0,0,0,0,0,0,0,0,0,0,0,0,0,0,0,0,0,0,0,0,0,0,0,0,0,0,0,0,0,0,0,0,0,0,0,0,0,8,10,,False,True,1.0,2209.61,2297.61,2289.61,2284.61,1,0.01,2024-05-02 16:00:00,2024-05-02 16:00:00,True,,,2024-05-02 17:20:00,2024-05-01 23:00:00,2309.61,2024-05-02 17:20:00.000000000,auto,2297.32,0.01,even,216.79,0 days 18:20:00,1915.88,True,1,0,18,5
2024-05-06 06:00:00,2311.1,2311.88,2308.26,2309.31,5887,27,0,2289.1950924791668,2300.123500000004,2311.051907520841,2301.976133201235,2303.33260150376,2301.4237834333726,2292.646936854742,2307.1281875501327,2322.8191460408807,0.00034112240376696183,0.00039489595061354766,,7.741117723785207,7.741365485688824,-0.00016568370721862572,0.0006413609819165374,2279.6494671302194,2319.235081638519,2302.884430260315,2301.9017959581497,0.987476361420704,-0.4136090893861921,6.208548829788812,1.5677142857130093,2.568849624059567,2.234661654138108,2315.749699163338,2290.9155038441822,78.38116836727623,64.9734969137608,0,0,0,0,0,0,0,0,0,0,0,0,0,0,0,0,0,0,0,0,0,0,0,0,0,0,0,0,0,0,0,0,0,0,0,0,0,0,0,0,0,0,0,0,0,0,0,0,0,0,0,-100,0,0,0,0,0,0,0,0,0,0,8,10,,False,True,1.0,2209.31,2339.31,2297.31,2294.31,1,0.01,,,False,,,2024-05-09 22:37:02,2024-05-06 07:00:00,2309.31,2024-05-09 22:37:02.000000000,auto,2339.2,0.01,fail,-528.15,3 days 15:37:02,1387.73,False,0,1,19,5
2024-05-07 13:00:00,2313.67,2315.8,2312.12,2315.27,6012,27,0,2314.544720753958,2322.4925000000035,2330.440279246049,2319.6723358066374,2318.364120300753,2329.7980196878743,2325.6674780312105,2310.4322096540373,2324.102890079039,-0.00011021310091702706,-6.783093203415446e-05,,7.749358432557008,7.742571909080237,-0.0001996978559748491,-0.00016984964772934717,2315.348713830754,2330.928362683645,2319.375783191215,2319.0280475059676,0.09259300772464485,1.8260362101000998,3.9362761136924402,-0.94921052631571,-1.7305037593982888,-1.8532631578941618,2326.2366725281377,2310.491568073368,17.50045812717549,17.369870516822825,0,0,0,0,0,0,0,0,0,0,0,0,0,0,0,0,0,0,0,0,0,0,0,0,0,0,0,0,0,0,0,100,0,0,0,0,0,0,0,0,0,0,0,0,0,0,0,0,0,0,0,0,0,0,0,0,0,0,0,0,0,0,8,10,,True,False,0.0,2415.27,2359.27,2367.27,2380.27,0,0.01,2024-05-09 18:00:00,2024-05-10 13:00:00,True,,,2024-05-10 17:56:28,2024-05-07 14:00:00,2315.27,2024-05-10 17:56:28.000000000,auto,2359.44,0.01,even,779.15,3 days 03:56:28,2166.88,True,1,0,19,5
2024-05-07 15:00:00,2312.31,2317.24,2309.9,2315.99,11696,27,0,2312.251537276976,2321.6180000000036,2330.9844627230314,2318.688964231737,2315.687812030077,2328.805894837933,2325.0874636254503,2309.9223624822334,2323.762635915646,-0.0001449379569765558,-6.65395083490542e-05,,7.748971119946087,7.742571909080237,-0.0003747425208617349,-0.00017488072181848625,2314.4719859487873,2330.1003886813005,2317.9376909238877,2318.3436072582026,-0.570289247418259,0.9849863773966812,3.2713780408411224,-0.8101654135325589,-1.8661428571431316,-0.94921052631571,2322.2305681117596,2309.1450559483947,17.893346892796163,15.591228024798653,0,0,0,0,100,0,0,0,0,0,0,0,0,0,0,0,0,0,0,0,0,0,0,0,0,0,0,0,0,0,0,0,0,0,0,0,0,0,0,0,0,0,0,0,0,0,0,0,0,0,0,0,0,0,0,0,0,0,0,0,0,0,8,10,,True,False,0.0,2415.99,2359.99,2367.99,2380.99,0,0.01,2024-05-09 18:00:00,2024-05-10 13:00:00,True,,,2024-05-10 17:56:13,2024-05-07 16:00:00,2315.99,2024-05-10 17:56:13.000000000,auto,2360.02,0.01,even,776.69,3 days 01:56:13,2943.57,True,2,0,19,5
2024-05-08 05:00:00,2307.69,2317.4,2307.26,2317.07,8685,27,0,2309.6173026166252,2314.873500000004,2320.1296973833823,2315.269222594586,2312.9902706766907,2320.7222857142856,2316.2727361344546,2301.5014084555846,2321.342570724482,0.00014973287057315723,-1.0849555839428418e-05,,7.747266750586434,7.745774052737138,-0.00022454810151926322,-0.00011020234683144773,2309.4777468365555,2323.239720637895,2314.345609376858,2315.6198831112592,-1.1942777589456455,-1.0996891371434343,2.6881804787093855,0.8765112781948119,-0.8196691729349368,0.33205263158151865,2318.3666316341096,2307.6139097192718,32.31485617903223,30.237931482701082,0,0,0,0,100,0,0,0,0,0,0,0,0,0,0,100,0,0,0,0,0,0,0,0,0,0,0,0,0,0,0,0,0,0,0,0,0,0,0,0,100,0,0,0,0,0,0,0,0,0,0,0,0,0,0,0,0,0,0,0,0,0,8,10,,True,False,0.0,2417.07,2329.07,2337.07,2342.07,0,0.01,2024-05-09 18:00:00,2024-05-09 18:00:00,True,2024-05-09 23:00:00,,2024-05-09 18:53:41,2024-05-08 06:00:00,2317.07,2024-05-09 18:53:41.000000000,auto,2329.39,0.01,even,217.32,1 days 12:53:41,3160.8900000000003,True,3,0,19,5
2024-05-13 13:00:00,2340.03,2344.05,2339.2,2343.26,6163,27,0,2340.466645045975,2357.292500000004,2374.1183549540333,2353.2648791996567,2346.0326842105246,2371.4501853541415,2366.133724849939,2330.4434916618084,2350.233369540447,0.00014296959055925187,-0.00010497283781594231,,7.763865130894342,7.758826478255706,-0.000561545910236472,-0.0005033716916414665,2348.5391124683847,2367.0264542118557,2350.6687005446215,2353.33320574724,-2.767060579153622,0.017862860361787636,5.954575521646985,-1.8629699248144789,-2.9447593984959894,-2.1584962406009254,2357.9418352538187,2334.1235331672306,8.61317864838234,7.501061144288616,0,0,0,0,100,0,0,0,0,0,0,0,0,0,0,0,0,0,0,0,0,0,0,0,0,0,0,0,0,0,0,0,0,0,0,0,0,0,0,0,100,0,0,0,0,0,0,0,0,0,0,0,0,0,0,0,0,0,0,0,0,0,8,10,,True,False,0.0,2443.26,2363.26,2371.26,2378.26,0,0.01,2024-05-15 06:00:00,2024-05-15 12:00:00,True,2024-05-15 20:00:00,2024-05-20 08:30:58,2024-05-15 14:33:33,2024-05-13 14:00:00,2343.26,2024-05-15 14:33:33.000000000,auto,2363.3,0.01,even,353.5,2 days 00:33:33,3514.3900000000003,True,4,0,20,5
2024-05-14 18:00:00,2352.97,2353.82,2347.21,2347.81,13198,27,0,2332.8551606921933,2342.9095000000048,2352.963839307816,2345.3925276617956,2349.223849624059,2338.9258996398544,2333.9555654261703,2345.4565383046906,2356.103153749725,0.0003339779954631367,0.0004784813948405276,,7.760270436934905,7.76434758484139,0.00044209761833364006,5.593206576318664e-05,2335.2736323253084,2346.4347128208233,2346.500657903443,2345.3085923095805,1.1956874795378098,-0.17118900391335695,3.9146939307643507,0.4999022556366981,1.4862781954875572,1.9121729323319414,2357.0532374855875,2341.39446176253,76.78833230616495,81.98181420133778,0,0,0,0,0,0,0,-100,0,0,0,0,0,0,0,-100,0,0,0,0,0,0,0,0,0,0,0,0,0,0,0,0,0,0,0,0,0,0,0,0,-100,0,0,0,0,0,0,0,0,0,0,0,0,0,0,0,0,0,0,0,0,0,8,10,,False,True,1.0,2247.81,2377.81,2335.81,2332.81,1,0.01,,,False,,,2024-05-15 15:30:25,2024-05-14 19:00:00,2347.81,2024-05-15 15:30:25.000000000,auto,2377.67,0.01,fail,-527.62,0 days 20:30:25,2986.7700000000004,False,0,1,20,5
2024-05-16 18:00:00,2373.28,2382.31,2373.05,2381.47,11746,27,0,2375.441881608078,2386.118000000005,2396.794118391932,2381.7185539636844,2380.429007518801,2396.0606521008403,2389.146642977191,2371.2026260403923,2383.370633868865,0.00011242711970010015,0.00014657415123460205,,7.773900371648812,7.769209258035336,-0.00029569397485176846,-0.00030106630380437847,2378.1994614423174,2395.2734144933556,2381.9158233308776,2380.389645104533,1.0236849974312463,3.250421219246346,4.9178479613860855,-0.9096390977415467,-2.2039999999992688,-2.4708571428573123,2390.264703441573,2370.593311596029,22.477874011096286,15.623363501895993,0,0,0,0,0,0,0,0,0,0,0,0,0,100,0,0,0,0,0,0,0,0,0,0,0,0,0,0,0,0,0,0,0,0,0,0,0,0,0,0,100,0,0,0,100,0,0,0,0,0,0,0,0,0,0,0,0,0,0,0,0,0,8,10,,True,False,0.0,2481.47,2433.47,2441.47,2456.47,0,0.01,2024-05-17 17:00:00,2024-05-20 09:00:00,True,,,2024-05-20 09:38:11,2024-05-16 19:00:00,2381.47,2024-05-20 09:38:11.000000000,auto,2433.52,0.01,even,918.16,3 days 14:38:11,3904.9300000000003,True,1,0,20,5
2024-05-27 07:00:00,2345.95,2346.01,2340.94,2342.93,2437,27,0,2330.6453933996218,2338.1075000000046,2345.5696066003875,2339.4961344208486,2339.8946090225572,2331.0757147659065,2327.0261551020412,2334.944905256203,2350.014461515633,0.00034079223012608943,0.0003557700867496029,,7.7570435041406265,7.763992130986944,3.8505107276429195e-06,-2.6365387970883375e-05,2331.9192448184444,2347.374938768046,2339.937443004006,2340.4384070145343,-0.08626567741066538,-1.793127733391838,4.525900068355918,0.8549624060165115,1.5564511278207647,1.652481203007028,2348.946409159269,2330.8428088858454,84.44031708204791,72.9136613576697,0,0,0,0,0,0,0,0,0,0,0,0,0,-100,0,0,0,0,0,0,0,0,0,0,0,0,0,0,0,0,0,0,0,0,0,0,0,0,0,0,0,0,0,0,0,0,0,0,0,0,0,0,0,0,0,0,0,0,0,0,0,0,8,10,,False,True,1.0,2242.93,2330.93,2322.93,2317.93,1,0.01,2024-05-30 09:00:00,2024-05-30 09:00:00,True,,,2024-05-30 09:51:31,2024-05-27 08:00:00,2342.93,2024-05-30 09:51:31.000000000,auto,2330.83,0.01,even,213.44,3 days 01:51:31,4118.37,True,2,0,22,5
2024-05-27 18:00:00,2354.27,2356.81,2352.11,2352.31,8138,27,0,2331.4431893059964,2343.2265000000048,2355.009810694013,2344.9689800163287,2350.5985563909767,2344.381703241295,2340.7737325330113,2347.426396681628,2356.786974382333,-0.00023782524649169294,0.00016953497383466562,,7.760724661455718,7.761086852302904,0.00042201131481391845,0.00026040608608189365,2335.551762040212,2348.2235770057555,2347.2255088909005,2344.39757540868,2.7365183641545627,1.3335129080392116,4.817387962976287,1.070669172932412,1.501789473682038,1.9959172932335605,2360.233332316929,2340.9637804650242,81.2327720784777,84.38875117285208,0,0,0,0,0,100,0,0,0,0,0,0,0,0,0,0,0,0,0,0,0,0,0,0,0,0,0,0,0,0,0,0,0,0,0,0,0,0,0,0,0,0,0,0,0,0,0,0,0,0,0,0,0,0,0,0,0,0,0,0,0,0,8,10,,False,True,1.0,2252.31,2332.31,2324.31,2317.31,1,0.01,2024-05-29 23:00:00,2024-05-30 09:00:00,True,,,2024-05-30 09:54:01,2024-05-27 19:00:00,2352.31,2024-05-30 09:54:01.000000000,auto,2332.21,0.01,even,354.56,2 days 14:54:01,4472.93,True,3,0,22,5
2024-05-29 13:00:00,2345.64,2347.21,2343.02,2346.4,7227,27,0,2346.3014824993365,2355.4985000000047,2364.695517500673,2352.759101652221,2350.8357067669153,2359.005427611044,2353.560368307323,2335.9945128320574,2350.324367407672,-0.00032162325570532935,-0.00032187860118400183,,7.762816659407358,7.762587199462063,-6.151218412480194e-05,-0.00016723201806152923,2344.7948861267346,2362.1564141549725,2351.8721904928425,2352.685716242082,-0.8721830548806793,0.7552272292567883,5.7073372262699404,-1.7302180451156346,-2.0800526315788375,-2.6432706766913725,2362.250381219455,2339.4210323143757,17.560522556326713,14.72110572976463,0,0,0,0,0,0,0,0,0,0,0,0,0,0,0,0,0,0,0,0,0,0,0,0,0,0,0,0,0,0,0,0,0,0,0,0,0,0,0,0,0,0,0,0,0,0,0,0,0,0,0,0,100,0,0,0,0,0,0,0,0,0,8,10,,True,False,0.0,2446.4,2316.4,2358.4,2361.4,0,0.01,2024-06-06 05:00:00,2024-06-06 05:00:00,False,2024-06-06 05:00:00,,2024-06-03 08:44:02,2024-05-29 14:00:00,2346.4,2024-06-03 08:44:02.000000000,auto,2316.61,0.01,fail,-526.39,4 days 18:44:02,3946.5400000000004,False,0,1,22,5
2024-05-30 17:00:00,2348.75,2351.75,2342.66,2344.0,16436,27,0,2326.8700339137963,2336.472500000003,2346.0749660862098,2339.0634246781997,2338.6800075187966,2335.9280705882334,2329.1183414165653,2341.023138151366,2351.7500000000005,-0.000145117663155851,-0.00013545267094117994,,7.756811123014822,7.759254962391191,0.0001679536214275047,-8.436597438287406e-05,2322.949024527775,2347.3144052073803,2339.134292824426,2339.7245615597076,-0.3461420926378196,-2.1611971624955464,5.4369207409192635,1.8921804511310256,2.6017669172892965,1.148842105265885,2349.553849000635,2327.806166036958,85.4301451302676,84.93211393536404,0,0,0,0,0,0,0,0,0,0,0,0,0,0,0,0,0,0,-100,0,0,0,0,0,0,0,0,0,0,0,0,0,0,0,0,0,0,0,0,0,0,0,0,0,0,0,0,0,0,0,0,0,0,0,0,0,0,0,0,0,0,0,8,10,,False,True,1.0,2244.0,2332.0,2324.0,2319.0,1,0.01,2024-05-31 21:00:00,2024-05-31 21:00:00,True,2024-06-04 18:00:00,,2024-06-03 13:42:56,2024-05-30 18:00:00,2344.0,2024-06-03 13:42:56.000000000,auto,2331.86,0.01,even,214.15,3 days 19:42:56,4160.6900000000005,True,1,0,22,5
2024-05-31 19:00:00,2329.96,2336.68,2329.63,2332.79,13631,27,0,2332.388740100518,2342.786500000004,2353.1842598994895,2341.3408086639256,2339.9138195488736,2346.895333493397,2339.97450660264,2322.277786287027,2336.6800000000007,-0.0002534108131765774,-5.4589281142901896e-05,,7.7594245078127315,7.75832346524864,0.00040014299014395183,-0.00032774152355242336,2335.4587843669306,2351.817948645767,2340.371329737175,2341.6053345226574,-1.1596570249671458,0.19461404684349404,8.254792114723676,-1.9376390977440678,-2.492977443608652,-1.5596015037604047,2356.423403778321,2323.4042353194263,9.357336167211178,25.8286253319512,0,0,0,0,0,0,0,0,0,0,0,0,0,0,0,0,0,0,0,0,0,0,0,0,0,0,0,0,0,0,0,0,0,0,0,0,0,0,0,0,0,0,0,0,0,0,0,0,0,0,0,0,0,0,0,0,0,0,0,0,0,0,8,10,,True,False,0.0,2432.79,2344.79,2352.79,2357.79,0,0.01,2024-06-03 20:00:00,2024-06-03 20:00:00,True,2024-06-06 05:00:00,,2024-06-03 22:31:00,2024-05-31 20:00:00,2332.79,2024-06-03 22:31:00.000000000,auto,2344.85,0.01,even,212.74,3 days 02:31:00,4373.43,True,2,0,22,5
2024-06-03 16:00:00,2333.87,2336.6,2329.78,2333.23,14651,27,0,2319.0933051959582,2326.5725000000043,2334.0516948040504,2329.548997728705,2328.81464661654,2328.319026650662,2322.24926914766,2329.7799999999993,2355.602868895034,-7.027297284464366e-05,-0.00010363869444033121,,7.754178552033329,7.756626300490941,6.374379235999262e-05,-0.00018533071655181275,2316.46170686372,2334.903936403136,2329.0264190042203,2330.4543248087784,-1.1128785029386563,-2.616459870231885,4.039534759315364,1.6704887218020303,1.6098721804532943,1.286120300750099,2336.8937161351705,2320.7355770979093,88.53658982935578,86.95759945591821,0,0,0,0,0,0,0,0,0,0,0,0,0,0,0,0,0,0,0,0,0,0,0,0,0,0,0,0,-100,0,-100,0,0,0,0,0,0,0,0,0,0,0,0,0,0,0,0,0,0,0,0,0,-100,0,0,0,0,0,0,0,0,0,8,10,,False,True,1.0,2233.23,2321.23,2313.23,2308.23,1,0.01,2024-06-04 18:00:00,2024-06-04 18:00:00,True,2024-06-07 19:00:00,,2024-06-04 18:04:51,2024-06-03 17:00:00,2333.23,2024-06-04 18:04:51.000000000,auto,2321.06,0.01,even,214.68,1 days 01:04:51,4588.110000000001,True,3,0,23,6
2024-06-04 15:00:00,2327.91,2335.91,2326.62,2335.03,12255,27,0,2328.035818964387,2343.537500000004,2359.039181035621,2338.617376244718,2334.1278721804506,2343.566210324129,2338.4416388955583,2313.8493256792353,2337.6450202800115,0.0003587266131591619,0.00010479216566675199,,7.757549550577927,7.756626300490941,-0.0001353762166097666,-0.00039169214368060833,2334.198208651654,2353.3701649445943,2337.209477906373,2338.7512303515714,-1.53205895894871,0.6076674732584927,7.36035519330731,-1.624135338347969,-3.1117067669138123,-3.6806315789490327,2348.848582567065,2319.407161793836,18.18202756100131,12.456543600571848,0,0,0,0,100,0,0,0,-100,0,0,0,0,0,0,0,0,0,0,0,0,0,0,0,0,0,0,0,0,0,0,0,0,0,0,0,0,0,0,0,100,0,0,0,0,0,0,0,0,0,0,0,0,0,0,0,0,0,0,0,0,0,8,10,,True,False,0.0,2435.03,2363.03,2371.03,2380.03,0,0.01,2024-06-05 19:00:00,2024-06-06 06:00:00,True,2024-06-07 08:00:00,,2024-06-06 10:44:40,2024-06-04 16:00:00,2335.03,2024-06-06 10:44:40.000000000,auto,2363.21,0.01,even,497.09,1 days 18:44:40,5085.200000000001,True,4,0,23,6
2024-06-10 20:00:00,2312.85,2313.31,2309.02,2311.81,6246,27,0,2287.726167770697,2299.8620000000055,2311.997832229314,2305.995894380405,2306.481518796995,2284.365418967586,2277.4487058823543,2301.713563138551,2313.286888784659,-0.0001614287365342671,0.0001578744928138412,,7.7414713198644165,7.756447460643388,0.00034788446237499443,0.0004520187794426568,2287.4171389814396,2305.4311911429427,2304.941440730091,2308.6706571979507,-2.7561612590943696,-6.374422236082568,4.658253619822379,1.726518796995606,1.796729323306863,2.0344661654144147,2315.7980260366394,2297.16501155735,94.4040323641592,88.35897433701945,0,0,0,0,0,0,0,0,0,0,0,0,0,0,0,0,0,0,0,0,0,0,0,0,0,0,0,0,0,0,0,0,0,0,0,0,0,0,0,0,0,0,0,0,0,0,0,0,0,0,0,0,0,0,0,0,0,0,0,0,0,0,8,10,,False,True,1.0,2211.81,2341.81,2299.81,2296.81,1,0.01,,,False,,,,2024-06-10 21:00:00,2311.81,2262-04-11 23:47:16.854775807,auto,,0.01,running,0.0,,5085.200000000001,False,0,1,24,6
2024-06-11 16:00:00,2317.91,2319.52,2309.16,2314.59,17723,27,0,2298.406526092182,2307.496000000004,2316.5854739078263,2307.657928608183,2307.4550977443623,2305.1943524609837,2301.959119327731,2304.8347818474745,2319.519999999999,0.00014245527864424685,-5.022124671863721e-05,,7.744449932239666,7.7535428872884244,0.0001578744928138412,-0.0001614287365342671,2298.8368704736013,2316.1178893015945,2308.6198425401008,2307.9378405787243,0.858571810774265,-0.5514935818775113,5.290335528190783,1.6885037593983725,1.9212105263136436,-0.17633834585967634,2318.035768800744,2296.8744266879808,78.63672829852179,73.8829545670996,0,0,0,0,0,0,0,0,0,0,0,0,0,0,0,0,0,0,0,0,0,0,0,0,0,0,0,0,0,0,0,0,0,0,0,0,0,0,0,0,0,0,0,0,0,0,0,0,0,0,0,0,0,0,0,0,0,0,0,0,0,0,8,10,,False,True,1.0,2214.59,2302.59,2294.59,2289.59,1,0.01,2024-06-13 19:00:00,2024-06-13 19:00:00,True,,,2024-06-13 20:02:35,2024-06-11 17:00:00,2314.59,2024-06-13 20:02:35.000000000,auto,2302.42,0.01,even,214.68,2 days 03:02:35,5299.880000000001,True,1,0,24,6
2024-06-14 15:00:00,2331.9,2333.31,2327.17,2330.26,13299,27,0,2290.3723998697083,2310.720500000005,2331.0686001303015,2316.008498366764,2324.3154511278185,2311.7342266506603,2306.118306842736,2324.6109573967374,2342.450326933783,-0.00023273586814749676,-0.0004355147222386876,,7.748430520486444,7.748637172958948,0.0008155441419788811,0.00047320226426999005,2299.8943256389502,2317.106481838554,2319.3224564641673,2315.0243759400487,4.048699529007081,1.0502007547027268,8.766725137900522,2.752917293232258,4.496135338346903,4.2719999999962965,2341.8489014036195,2306.7820008520175,87.3293341939841,90.45444050434372,0,0,0,0,-100,0,0,0,0,0,0,0,0,0,0,0,0,0,0,0,0,0,0,0,0,0,0,0,0,0,0,0,0,0,0,0,0,0,0,0,0,0,0,0,0,0,0,0,0,0,0,0,0,0,0,0,0,0,0,0,0,0,8,10,,False,True,1.0,2230.26,2318.26,2310.26,2305.26,1,0.01,2024-06-17 19:00:00,2024-06-17 19:00:00,True,,,2024-06-17 20:03:53,2024-06-14 16:00:00,2330.26,2024-06-17 20:03:53.000000000,auto,2318.26,0.01,even,211.68,3 days 04:03:53,5511.560000000001,True,2,0,24,6
2024-06-17 10:00:00,2317.34,2320.06,2315.51,2316.86,8944,27,0,2316.818708267462,2327.192500000004,2337.5662917325462,2323.0205183764033,2321.1152556390966,2329.884582953182,2325.328108043217,2305.622366001663,2328.825266193674,0.00023169832598999974,-7.825008894278646e-05,,7.75006398252806,7.7475683625650005,-0.0004081391096626319,-0.00023273867477755097,2320.9629971664217,2335.560232888059,2322.7365579120114,2322.4714423518562,0.057673041236739664,1.9869084961875507,3.8692108830840772,-1.6685338345882883,-2.326045112780321,-2.5505864661668056,2328.853677405265,2313.3768338729283,7.099679588905009,10.131769558615584,0,0,0,0,0,0,0,0,0,0,0,0,0,0,0,0,0,0,0,0,0,0,0,0,0,0,0,0,0,0,-100,0,0,0,0,0,0,0,0,0,0,0,0,0,0,0,0,0,0,0,0,0,-100,0,0,0,0,0,0,0,0,0,8,10,,True,False,0.0,2416.86,2328.86,2336.86,2341.86,0,0.01,2024-06-19 12:00:00,2024-06-19 12:00:00,True,2024-06-20 10:00:00,,2024-06-19 12:30:49,2024-06-17 11:00:00,2316.86,2024-06-19 12:30:49.000000000,auto,2328.92,0.01,even,212.74,2 days 01:30:49,5724.300000000001,True,3,0,25,6
2024-06-19 18:00:00,2326.07,2329.77,2325.18,2329.74,6470,27,0,2326.256837762683,2329.129000000004,2332.001162237325,2328.0702553665747,2328.9071052631575,2332.342930132055,2328.638567106842,2325.2016449547687,2329.7473743531714,0.00019413858177983094,0.0007884277671832163,,7.752223648897696,7.749607590597654,0.00012107640427412275,-9.239625302131579e-05,2325.8409178811426,2333.6998208862256,2328.6679247358397,2327.4590053043544,1.003430508510064,1.4834234418370067,1.9428692884350014,0.2597669172919268,-0.5473759398487346,-0.18091729323077743,2332.7928438400277,2325.0213666862874,35.28362650949501,33.6494819631931,0,0,0,0,0,0,0,0,0,0,0,0,0,0,0,100,0,0,0,0,0,0,0,0,0,0,0,0,0,0,0,0,0,0,0,0,0,0,0,0,100,0,0,0,0,0,0,0,0,0,0,0,0,0,0,0,0,0,0,0,0,0,8,10,,True,False,0.0,2429.74,2357.74,2365.74,2374.74,0,0.01,2024-06-20 17:00:00,2024-06-21 12:00:00,True,,,2024-06-21 16:24:48,2024-06-19 19:00:00,2329.74,2024-06-21 16:24:48.000000000,auto,2358.1,0.01,even,500.27,1 days 21:24:48,6224.5700000000015,True,4,0,25,6
2024-06-27 18:00:00,2328.93,2330.85,2325.04,2327.45,11460,27,0,2285.404475049762,2307.1865000000034,2328.968524950245,2312.4949972934974,2321.659315789473,2306.3754352941187,2301.8793819927973,2317.003244374666,2330.826794288474,9.585737369694952e-05,0.00014101236441028852,,7.746619936776709,7.747250584060686,0.0007535727874498985,0.0005750540582099606,2293.473957641777,2312.8406078611256,2316.172385044223,2311.5931360768413,4.392453690452385,1.1734786643233026,7.500849475750084,3.1387142857156505,3.9866541353358116,3.1161203007532094,2336.6610147409733,2306.657616837973,92.06787467841734,92.19928960818196,0,0,0,0,0,0,0,0,0,0,0,0,0,0,0,0,0,0,0,0,0,0,0,0,0,0,0,0,0,0,0,0,0,0,0,0,0,0,0,0,0,0,0,0,0,0,0,0,0,0,0,0,-100,0,0,0,0,0,0,0,0,0,8,10,,False,True,1.0,2227.45,2357.45,2315.45,2312.45,1,0.01,,,False,,,2024-07-03 16:43:31,2024-06-27 19:00:00,2327.45,2024-07-03 16:43:31.000000000,auto,2357.1,0.01,fail,-523.91,5 days 21:43:31,5700.660000000002,False,0,1,26,6
2024-07-08 13:00:00,2370.08,2374.27,2369.59,2374.06,6171,27,0,2371.493224080699,2382.8625000000034,2394.231775919308,2378.089736254168,2376.7644210526305,2389.250868187275,2382.884296278513,2350.7725786315154,2382.670630299062,1.8497009579171795e-05,-0.00033710024301883033,,7.772731558221713,7.771279967668672,-0.0002498321131700723,-0.00014262569226855112,2371.739379501056,2392.371072101391,2378.09173835303,2376.9903133254397,0.6803206136410154,2.983326708419901,5.351234670623623,-1.6045488721815673,-3.230774436088268,-3.2381353383489113,2387.4668903938777,2366.0619517113832,12.15893412604098,7.584737728664287,0,0,0,0,100,0,0,0,0,0,0,0,0,100,0,100,0,0,0,0,0,0,0,0,0,0,0,0,0,0,0,0,0,0,0,0,0,0,0,0,100,0,0,0,0,0,0,0,0,0,0,0,0,0,0,0,0,0,0,0,0,0,8,10,,True,False,0.0,2474.06,2402.06,2410.06,2419.06,0,0.01,2024-07-11 16:00:00,2024-07-11 18:00:00,True,2024-07-15 18:00:00,,2024-07-12 10:18:43,2024-07-08 14:00:00,2374.06,2024-07-12 10:18:43.000000000,auto,2402.05,0.01,even,493.74,3 days 20:18:43,6194.4000000000015,True,1,0,28,7
2024-07-12 14:00:00,2400.23,2402.64,2398.22,2401.66,5801,27,0,2399.83673076725,2409.700000000002,2419.563269232754,2404.3925328584787,2403.088661654136,2417.574605522209,2411.6264033613434,2390.728252099373,2419.665152878157,0.00023075991256761428,-0.00010508573485214897,,7.784388472846421,7.781384077950083,-0.0003963784585515679,-0.000309161909106335,2405.6244949173242,2416.9811871489724,2405.3110836238047,2402.620616529386,2.0517660635314314,4.233822811986706,3.0025938191505888,-0.9153383458665303,-2.1967067669156677,-1.4264210526303032,2409.0938492924374,2397.083474015835,15.49163261691173,21.89096609846669,0,0,0,0,0,0,0,0,0,0,0,0,0,0,0,0,0,0,0,0,0,0,0,0,0,0,0,0,100,0,0,0,0,0,0,0,0,0,0,0,0,0,0,0,0,0,0,0,0,0,0,0,0,0,0,0,0,0,0,0,0,0,8,10,,True,False,0.0,2501.66,2413.66,2421.66,2426.66,0,0.01,2024-07-12 21:00:00,2024-07-12 21:00:00,True,2024-07-15 18:00:00,,2024-07-12 22:00:37,2024-07-12 15:00:00,2401.66,2024-07-12 22:00:37.000000000,auto,2413.72,0.01,even,212.74,0 days 07:00:37,6407.140000000001,True,2,0,28,7
2024-07-12 16:00:00,2397.89,2405.57,2396.73,2403.8,19192,27,0,2397.7137864124647,2408.343500000002,2418.9732135875397,2403.7723454918614,2401.0831578947345,2417.540245378152,2411.0163279711883,2396.729999999999,2419.1566840063906,0.00011040506303555134,-0.00010508803653934006,,7.783657746965846,7.781975176913992,-0.0003393650543439597,-0.00043213903889189573,2401.859361854576,2414.743153044314,2404.1073438963335,2402.380775488157,1.2028975133184758,3.164090494224261,2.9639018684263663,-0.6064962406026098,-1.3990075187989532,-0.9153383458665303,2407.010961631587,2395.155354157882,31.871175258160076,21.078303330667584,0,0,0,0,0,0,0,0,0,0,0,0,0,0,0,0,0,0,0,0,0,0,0,0,0,0,0,0,0,0,0,0,0,0,0,0,0,0,0,0,0,0,0,0,0,0,0,0,0,0,0,0,0,0,0,0,0,0,0,0,0,0,8,10,,True,False,0.0,2503.8,2423.8,2431.8,2438.8,0,0.01,2024-07-15 17:00:00,2024-07-15 18:00:00,True,2024-07-16 13:00:00,,2024-07-15 20:19:32,2024-07-12 17:00:00,2403.8,2024-07-15 20:19:32.000000000,auto,2424.26,0.01,even,360.91,3 days 03:19:32,6768.050000000001,True,3,0,28,7
2024-07-17 21:00:00,2452.47,2458.08,2451.42,2457.87,6287,27,0,2453.6932389095973,2468.611000000002,2483.528761090407,2463.8724435223667,2463.066187969922,2482.948282833133,2473.1836024009604,2451.442587744372,2462.27302319125,0.00013733220041109713,0.0004242359144832442,,7.810947589880943,7.802721758435402,4.544924205262705e-05,-0.00034315202683388304,2460.370682874442,2482.808202285789,2463.9965922937527,2462.131420170969,1.1957012665470756,4.364532384588134,10.091041199996923,-1.9579624060174865,-3.1192857142873436,-2.7614285714257676,2483.2482703699156,2442.884105569928,10.465346000859334,11.758862301138828,0,0,0,0,100,0,0,0,0,0,0,0,0,0,0,100,0,0,0,0,0,0,0,0,0,0,0,0,0,0,0,0,0,0,0,0,0,0,0,0,100,0,0,0,0,0,0,0,0,0,0,0,0,0,0,0,0,0,0,0,0,0,8,10,,True,False,0.0,2557.87,2427.87,2469.87,2472.87,0,0.01,,,False,,,2024-07-19 03:18:14,2024-07-17 22:00:00,2457.87,2024-07-19 03:18:14.000000000,auto,2428.03,0.01,fail,-527.27,1 days 05:18:14,6240.780000000001,False,0,1,29,7
2024-07-23 13:00:00,2406.76,2408.2,2405.48,2407.6,7324,27,0,2385.777189054108,2396.782000000002,2407.786810945896,2399.545621583825,2402.3328195488743,2397.271163025212,2392.091974069627,2397.4608187307867,2411.548195781234,0.00022129554014900716,0.00017489483929324732,,7.782013318690636,7.785224964695429,0.0002721097341327511,0.00012340386529169809,2386.0749992467513,2402.402486553596,2400.1060115015703,2400.1856746667563,0.21120739523030352,-1.502882572078118,6.383083530470907,1.69693233083035,1.850669172929429,1.7517969924824683,2415.098986609816,2389.5666524879325,91.348236630682,75.68442561678934,0,0,0,0,0,0,0,0,0,0,0,0,0,0,0,0,0,0,0,0,0,0,0,0,0,0,0,-100,0,0,0,0,0,0,0,0,0,0,0,0,0,0,0,0,0,0,0,0,0,0,0,100,0,0,0,0,0,0,0,0,0,0,8,10,,False,True,1.0,2307.6,2379.6,2371.6,2362.6,1,0.01,2024-07-25 05:00:00,2024-07-25 10:00:00,True,2024-07-25 20:00:00,,2024-07-25 13:53:14,2024-07-23 14:00:00,2407.6,2024-07-25 13:53:14.000000000,auto,2379.67,0.01,even,492.68,1 days 23:53:14,6733.460000000001,True,1,0,30,7
2024-07-25 01:00:00,2397.58,2398.04,2392.96,2397.77,3106,27,0,2397.152221858764,2413.9850000000024,2430.817778141241,2410.344493227327,2408.3747443609004,2420.0228134453782,2412.9757214885954,2371.6034263212364,2405.4438260967654,-0.0004130945018318344,-0.0007621752679247046,,7.788353136056063,7.786896751210647,-0.00021211701683072914,-0.0003105410918824647,2401.3105526185477,2434.032409587348,2408.830432642215,2410.327478878883,-1.5467598214841018,1.313769678025444,12.845548353412799,-3.4073308270694724,-3.6387669172909227,-3.5469248120321026,2434.065841067726,2382.683647654075,4.793322270734269,4.554752630041372,100,0,0,0,0,0,0,0,0,0,0,0,0,0,0,0,0,0,0,100,0,100,0,0,0,0,100,0,0,0,0,0,0,0,0,0,0,0,0,100,0,0,0,0,0,0,0,0,0,0,0,0,100,0,0,100,0,0,0,0,0,0,8,10,,True,False,0.0,2497.77,2367.77,2409.77,2412.77,0,0.01,2024-07-31 07:00:00,2024-07-31 07:00:00,False,2024-07-31 07:00:00,,2024-07-25 06:21:11,2024-07-25 02:00:00,2397.77,2024-07-25 06:21:11.000000000,auto,2367.76,0.01,fail,-530.27,0 days 04:21:11,6203.1900000000005,False,0,1,30,7
2024-07-26 20:00:00,2389.07,2389.08,2381.07,2383.35,7565,27,0,2360.289935025215,2374.2085000000015,2388.127064974788,2376.9130468395847,2383.2780000000025,2366.6960998799527,2360.22013589436,2381.0699999999997,2404.10870089992,0.0001014889600267864,-0.00010179449933074004,,7.7732116671460965,7.779941643960657,0.0003958070602843657,0.0005875194836585944,2362.3197245377046,2382.8789603825794,2379.1672649779653,2376.7029484101854,2.497901723783798,0.4558857245536625,5.719925074416112,0.9840676691737826,2.1394285714291073,1.3581729323323088,2394.7178501488347,2371.8381498511703,81.00091467398377,81.7423863805184,0,0,0,0,-100,0,0,0,0,0,0,0,0,-100,0,0,0,0,0,0,0,0,0,0,0,0,0,0,0,0,0,0,0,0,0,0,0,0,0,0,0,0,0,0,0,0,0,0,0,0,0,0,0,0,0,0,0,0,0,0,0,0,8,10,,False,True,1.0,2283.35,2413.35,2371.35,2368.35,1,0.01,,,False,,,2024-07-31 06:13:25,2024-07-26 21:00:00,2383.35,2024-07-31 06:13:25.000000000,auto,2413.42,0.01,fail,-531.34,4 days 09:13:25,5671.85,False,0,2,30,7
2024-07-29 20:00:00,2378.13,2383.29,2377.34,2378.18,8692,27,0,2377.485904877319,2390.327000000002,2403.168095122685,2386.0918317847986,2382.5245112781977,2399.012243937576,2392.5521080432177,2370.924951449215,2383.856664907145,0.000327708485673857,0.00030409520219047806,,7.776819459871944,7.773995360736956,-0.0001992068151167775,-0.0004281787000880082,2378.939075551062,2400.1123572626457,2385.1012879258064,2385.8944124870536,-0.8897074471619817,1.3170032359910278,7.2399318021542,-2.4795338345847995,-2.6662781954873935,-3.1496616541362528,2397.004374882506,2368.0446476738894,29.86469864698691,24.78506154023526,100,0,0,0,0,0,0,0,0,0,0,0,0,0,0,0,0,0,0,100,0,0,0,0,0,0,0,0,0,0,100,-100,0,0,0,0,0,0,0,100,0,0,0,0,0,0,0,0,0,0,0,0,100,0,0,0,0,0,0,0,0,0,8,10,,True,False,0.0,2478.18,2390.18,2398.18,2403.18,0,0.01,2024-07-30 17:00:00,2024-07-30 17:00:00,True,2024-07-30 21:00:00,,2024-07-30 17:00:01,2024-07-29 21:00:00,2378.18,2024-07-30 17:00:01.000000000,auto,2391.5,0.01,even,234.96,0 days 20:00:01,5906.81,True,1,0,31,7
2024-08-07 16:00:00,2403.8,2404.81,2396.98,2400.02,14711,27,0,2380.439642012901,2391.639500000003,2402.839357987105,2395.267362667685,2397.2986466165426,2393.817313325331,2389.043461704685,2377.46269640968,2404.809999999999,0.0001700921288526019,-0.0001106576444951083,,7.782064477829596,7.782823477822767,0.00026962832167237835,0.00043783250750870935,2379.7359300436624,2400.3260679163855,2395.8647826619545,2396.0237021196695,0.1677344826193803,-1.960717817318735,4.742868330435776,1.418097744361603,2.0669548872197083,1.819729323305637,2406.7843832774142,2387.812909955671,86.09989356768357,90.18386494658449,0,0,0,0,-100,0,0,0,0,0,0,0,0,0,0,0,0,0,0,0,0,0,0,0,0,0,0,0,0,0,0,0,0,0,0,0,0,0,0,0,0,0,0,0,0,0,0,0,0,0,0,0,0,0,0,0,0,0,0,0,0,0,8,10,,False,True,1.0,2300.02,2388.02,2380.02,2375.02,1,0.01,2024-08-08 00:00:00,2024-08-08 00:00:00,True,,,2024-08-08 03:36:07,2024-08-07 17:00:00,2400.02,2024-08-08 03:36:07.000000000,auto,2388.05,0.01,even,211.15,0 days 10:36:07,6117.96,True,2,0,32,8
2024-08-15 15:00:00,2463.49,2470.02,2440.95,2441.06,18181,27,0,2440.102490521597,2451.1775000000025,2462.2525094784082,2454.273225781898,2456.4902556390985,2454.359718607443,2447.8494823529413,2430.977278664703,2470.019999999999,0.0004576212052819661,-0.00012322779258317347,,7.806771830521541,7.807481604278098,0.0005277652187829329,6.336000224708251e-05,2439.218467167825,2455.4630937705574,2453.6943988096014,2454.8848980546477,-0.9923546864006312,-1.329226637758465,6.344158027004161,-2.3771428571435536,2.1517218045105437,1.850383458649958,2469.1785716931067,2443.80193958509,60.3494561247714,77.77606829342695,0,0,0,0,-100,0,0,0,100,0,0,0,0,0,0,-100,0,0,0,0,0,0,0,0,0,0,0,0,0,0,0,0,0,0,0,0,0,0,0,0,0,0,0,0,0,0,0,0,0,0,0,0,0,0,0,0,0,0,0,0,0,0,8,10,,False,True,1.0,2341.06,2471.06,2429.06,2426.06,1,0.01,,,False,,,2024-08-16 14:19:16,2024-08-15 16:00:00,2441.06,2024-08-16 14:19:16.000000000,auto,2471.07,0.01,fail,-530.27,0 days 22:19:16,5587.6900000000005,False,0,1,33,8
2024-08-19 16:00:00,2491.16,2495.77,2485.61,2494.67,15725,27,0,2491.004718590888,2500.7770000000028,2510.5492814091176,2495.068597173486,2495.642744360905,2511.516523409364,2504.945178391356,2485.6100000000006,2504.057591606987,0.00029255692656086294,0.00044168285473628803,,7.820704593960073,7.81221038375126,-0.0001034528863793121,-0.00015720102566996316,2490.0063737690166,2508.672883565429,2496.7072834291944,2492.7006002245716,3.17749588085735,5.707186836285784,5.391652277908152,-1.4804736842038437,-2.4472481203069947,-2.171736842104565,2506.4260489167214,2484.8594398050886,32.95428092790765,25.268051179579896,0,0,0,0,0,0,0,0,0,0,0,0,0,0,0,0,0,0,0,0,0,0,0,0,0,0,0,0,0,0,0,0,0,0,0,0,0,0,0,0,0,0,0,0,0,0,0,0,0,0,0,0,0,0,0,0,0,0,0,0,0,0,8,10,,True,False,0.0,2594.67,2522.67,2530.67,2539.67,0,0.01,2024-08-20 11:00:00,2024-08-20 17:00:00,True,,,2024-08-20 17:24:22,2024-08-19 17:00:00,2494.67,2024-08-20 17:24:22.000000000,auto,2522.75,0.01,even,495.33,1 days 00:24:22,6083.02,True,1,0,34,8
2024-08-21 18:00:00,2501.48,2511.01,2501.36,2508.43,12476,27,0,2502.3266039932564,2511.774500000002,2521.222396006747,2510.1219441763374,2506.6891353383444,2519.019761344539,2511.4781522208873,2501.3600000000006,2521.067804436015,-7.217295949954877e-05,-0.00026557587692589295,,7.827618870421373,7.827449962152922,-0.00013097726004105732,-0.00038085437425022393,2503.40009539221,2520.227052722444,2508.7993390898837,2510.292635279627,-1.501274837845358,-0.44411342029450424,3.611675511474409,-0.5085563909806297,-2.066676691728844,-1.9999097744325809,2513.9124863612933,2499.4657843153955,36.27074520012985,34.486084074683276,0,0,0,0,0,0,0,0,0,0,0,0,0,100,0,0,0,0,0,0,0,0,0,0,0,0,0,0,0,0,0,0,0,0,0,0,0,0,0,0,0,0,0,0,0,0,0,0,0,0,0,0,0,0,0,0,0,0,0,0,0,0,8,10,,True,False,0.0,2608.43,2478.43,2520.43,2523.43,0,0.01,2024-08-26 12:00:00,2024-08-26 12:00:00,False,2024-08-26 12:00:00,,2024-08-22 17:11:02,2024-08-21 19:00:00,2508.43,2024-08-22 17:11:02.000000000,auto,2478.5,0.01,fail,-528.86,0 days 22:11:02,5554.160000000001,False,0,1,34,8
2024-08-27 06:00:00,2508.61,2509.19,2505.74,2508.87,6145,27,0,2507.5803408390893,2517.9150000000004,2528.2496591609115,2514.438869762278,2511.275157894738,2524.9436509003617,2520.448907563024,2494.731072990173,2515.1385243381555,0.0003500826922865481,0.00028898741876449323,,7.8299397465063425,7.826143080050448,-0.0003035131646085931,-0.00018508218274676291,2510.4004290796533,2524.7941887898455,2513.8189459717573,2514.023981546148,-0.3881288171369306,1.265791540773692,4.091348886906012,-1.8801127819529029,-2.3245112781946773,-2.195593984963125,2519.45785566855,2503.0924601209263,12.070245173811529,13.959294825907671,100,0,0,0,0,0,0,0,0,0,0,0,0,0,0,0,0,0,0,100,0,100,0,0,0,0,0,0,0,0,0,0,0,0,0,0,0,0,0,100,0,0,0,0,0,0,0,0,0,0,0,0,100,0,0,100,0,0,0,0,0,0,8,10,,True,False,0.0,2608.87,2520.87,2528.87,2533.87,0,0.01,2024-08-27 22:00:00,2024-08-27 22:00:00,True,,,2024-08-28 04:05:37,2024-08-27 07:00:00,2508.87,2024-08-28 04:05:37.000000000,auto,2520.24,0.01,even,200.57,0 days 21:05:37,5754.7300000000005,True,1,0,35,8
2024-08-29 07:00:00,2516.52,2518.08,2515.5,2515.86,6427,27,0,2499.2218937364687,2507.873500000002,2516.5251062635352,2510.456695607633,2512.157436090226,2511.5299951980796,2506.8766208883544,2496.8562402648763,2521.3070660541202,0.0003356595741433505,0.00022339728756324878,,7.82733476924809,7.828569055717608,0.00015146032837786688,0.0002709773389529586,2496.369746420158,2513.7992562068303,2511.1186366335687,2510.5198003005394,0.6401384978125861,-0.7343597191806959,4.317452746053779,1.6145187969950712,1.696593984961055,0.9550451127811357,2520.7923415823334,2503.5225305981185,92.08425563212647,90.5114838478827,0,0,0,0,0,0,0,0,0,0,0,0,0,0,0,0,0,0,0,0,0,0,0,0,0,0,0,0,0,0,0,0,0,0,0,0,0,0,0,0,0,0,0,0,0,0,0,0,0,0,0,0,0,0,0,0,0,0,0,0,0,0,8,10,,False,True,1.0,2415.86,2503.86,2495.86,2490.86,1,0.01,2024-08-30 20:00:00,2024-08-30 20:00:00,True,2024-09-03 15:00:00,,2024-08-30 21:27:15,2024-08-29 08:00:00,2515.86,2024-08-30 21:27:15.000000000,auto,2503.84,0.01,even,212.03,1 days 13:27:15,5966.76,True,2,0,35,8
2024-08-29 09:00:00,2518.52,2521.04,2516.12,2516.87,10457,27,0,2498.249932345274,2508.744000000002,2519.23806765473,2511.770038808062,2515.6007518796982,2512.294482593037,2507.666173349341,2498.74089645026,2526.031111213452,0.00032179161124147224,9.384259577333853e-05,,7.828042259603668,7.828569055717608,0.00022084677907643056,0.0005517774678946889,2498.9831441094057,2514.8053474439434,2512.9786688323184,2511.5450688447695,1.390372010214378,-0.00917409188677587,3.445966327267441,1.588751879695792,1.854563909776516,1.6145187969950712,2522.492684534233,2508.7088192251636,89.27703178570005,91.91759424377807,0,0,0,0,0,0,0,0,0,0,0,0,0,0,0,0,0,0,0,0,0,0,0,0,0,0,0,0,-100,0,0,0,0,0,0,0,0,0,0,0,0,0,0,0,0,0,0,0,0,0,0,0,0,0,0,0,0,0,0,0,0,0,8,10,,False,True,1.0,2416.87,2504.87,2496.87,2491.87,1,0.01,2024-08-30 20:00:00,2024-08-30 20:00:00,True,2024-09-03 15:00:00,,2024-09-02 03:44:54,2024-08-29 10:00:00,2516.87,2024-09-02 03:44:54.000000000,auto,2504.82,0.01,even,212.56,3 days 17:44:54,6179.320000000001,True,3,0,35,8
2024-09-06 21:00:00,2495.35,2496.67,2492.0,2494.51,9545,27,0,2493.9400150921497,2512.536500000003,2531.132984907856,2508.444655856446,2502.8858045112797,2521.2970079231686,2512.278059063625,2489.307795373736,2496.893319773207,-0.0001366062272668753,0.00017874972933021153,,7.826795928709668,7.826200017075627,0.0001840992547449826,-0.0007291103768915462,2501.7555722437323,2526.480373064034,2505.5833753441,2508.9628022251068,-3.299716512130999,-0.19605186911618555,11.392803492939676,-3.0682781954847087,-3.17137593985035,-4.7320375939852966,2525.671411497159,2480.1001975254003,17.88376692530042,16.872684901513097,100,0,0,0,0,0,0,0,0,0,0,0,0,0,0,0,0,0,0,100,0,0,0,0,0,0,0,0,0,0,0,0,0,0,0,0,0,0,0,100,0,0,0,0,0,0,0,100,0,0,0,-100,-100,0,0,0,0,0,0,0,0,0,8,10,,True,False,0.0,2594.51,2506.51,2514.51,2519.51,0,0.01,2024-09-10 16:00:00,2024-09-10 16:00:00,True,2024-09-11 09:00:00,,2024-09-10 16:53:44,2024-09-06 22:00:00,2494.51,2024-09-10 16:53:44.000000000,auto,2506.63,0.01,even,213.8,3 days 18:53:44,6393.120000000001,True,4,0,36,9
2024-09-09 20:00:00,2504.16,2506.58,2499.48,2499.96,9082,27,0,2489.432548480754,2496.755500000002,2504.07845151925,2498.867622359176,2498.6154661654123,2496.875357022808,2489.915077070828,2498.7750290227145,2506.5557800471856,3.800701830826064e-05,0.00017805644410131912,,7.824228809225014,7.826795928709668,0.0001660958158509831,0.00018010152748079768,2485.491227410862,2501.931396925773,2498.5834223007814,2499.54939369147,-0.7310443869851042,-1.9482002985008484,2.9641208646442303,0.628481203004867,1.3308796992473617,0.3676240601535028,2504.5437078947007,2492.687224436124,77.39648340334718,72.72612206960655,0,0,0,0,0,0,0,0,0,0,0,0,0,0,0,-100,0,0,0,0,0,0,0,0,0,0,0,0,0,0,0,0,0,0,0,0,0,0,0,0,0,0,0,0,0,0,0,0,0,0,0,0,0,0,0,0,0,0,0,0,0,0,8,10,,False,True,1.0,2399.96,2529.96,2487.96,2484.96,1,0.01,,,False,,,2024-09-12 15:45:51,2024-09-09 21:00:00,2499.96,2024-09-12 15:45:51.000000000,auto,2530.79,0.01,fail,-544.76,2 days 18:45:51,5848.360000000001,False,0,1,37,9
2024-09-10 16:00:00,2513.47,2515.05,2506.48,2507.01,16640,27,0,2499.4145755094514,2504.833000000002,2510.2514244905524,2504.55263482551,2506.119375939848,2504.272313085233,2501.476761584632,2499.9428399282356,2516.9014711800146,0.0004627675184771512,0.0002976045968254902,,7.826378071223213,7.826795928709668,0.00017805644410131912,3.800701830826064e-05,2499.5184629017276,2510.0514024924105,2505.6853740319602,2504.0558245808893,1.4927994421268522,1.0350214207798971,3.4525146115533687,0.3522406015031265,1.1972556390996942,-0.37482706767241325,2513.0244051629547,2499.214346716741,64.5682049623257,64.98908024299662,0,0,0,0,0,0,0,0,0,0,0,0,0,0,0,0,0,0,0,0,0,0,0,0,0,0,0,0,0,0,0,0,0,0,0,0,0,0,0,0,0,0,0,0,0,0,0,0,0,0,0,0,0,0,0,0,0,0,0,0,0,0,8,10,,False,True,1.0,2407.01,2537.01,2495.01,2492.01,1,0.01,,,False,,,2024-09-12 16:09:15,2024-09-10 17:00:00,2507.01,2024-09-12 16:09:15.000000000,auto,2535.14,0.01,fail,-497.06,1 days 23:09:15,5351.3,False,0,2,37,9
2024-09-11 16:00:00,2507.84,2512.53,2503.44,2509.49,22612,27,0,2509.4231795767473,2518.411000000002,2527.3988204232564,2516.698628128583,2519.308165413533,2524.465043457385,2519.055744537815,2500.2604127914924,2519.3629029350905,0.0003277470230773469,6.97321708838127e-05,,7.830161616115576,7.827842938133493,0.00032299106843336044,-0.0002248474882459115,2508.240255892727,2525.534366228151,2517.3939280917148,2515.679303458585,1.3644976818955001,2.944255180827162,6.94712054944448,-1.9319849624057497,-2.4349624060191672,-0.0817819548838088,2533.202406512422,2505.413924314644,32.95568210975845,42.129112073267486,0,0,0,0,0,0,0,0,0,0,0,0,0,0,0,0,0,0,0,0,0,0,0,0,0,0,0,0,100,0,0,0,0,0,0,0,0,0,0,0,0,0,0,0,0,0,0,0,0,0,0,0,100,0,0,0,0,0,0,0,0,0,8,10,,True,False,0.0,2609.49,2569.49,2577.49,2594.49,0,0.01,2024-09-12 16:00:00,2024-09-16 06:00:00,True,,,2024-09-17 15:39:35,2024-09-11 17:00:00,2509.49,2024-09-17 15:39:35.000000000,auto,2569.78,0.01,even,1063.51,5 days 22:39:35,6414.81,True,1,0,37,9
2024-09-17 07:00:00,2577.16,2579.25,2574.85,2576.87,5876,27,0,2576.7689398619455,2582.112500000002,2587.4560601380585,2581.013186121081,2579.897706766917,2588.3882280912353,2584.2904547418957,2571.88135412863,2588.4584559493405,-0.00035279073812033527,-0.00024749778073539225,,7.856075152006681,7.852844284907738,-8.838936939069918e-05,-9.93483135966642e-06,2575.160219719329,2588.3515259544943,2580.758255990908,2580.3786213852877,0.09720989213974462,1.118596717607192,2.5647692041076393,-0.9680451127824199,-0.735578947365866,0.21328571428011855,2585.0272451751325,2574.7681683587016,21.598217395630655,32.18089861958544,100,100,0,0,0,0,0,0,0,0,0,0,0,0,0,0,0,0,0,100,100,0,0,0,0,0,0,0,0,0,-100,0,0,0,0,0,0,0,0,100,0,0,0,0,0,0,0,100,0,0,0,0,-100,0,0,0,0,0,0,0,0,0,8,10,,True,False,0.0,2676.87,2604.87,2612.87,2621.87,0,0.01,2024-09-20 08:00:00,2024-09-20 14:00:00,True,2024-09-20 19:00:00,,2024-09-20 16:34:52,2024-09-17 08:00:00,2576.87,2024-09-20 16:34:52.000000000,auto,2605.13,0.01,even,498.5,3 days 08:34:52,6913.31,True,2,0,38,9
2024-09-17 14:00:00,2573.17,2581.3,2572.12,2579.55,11002,27,0,2574.2414325013997,2580.485500000003,2586.7295674986062,2579.8117399745656,2578.180210526315,2585.120145498201,2580.071426170466,2557.9068437502146,2583.403735168836,0.00017929214689288702,-0.00017342556487226564,,7.855112995839848,7.854092412876565,6.241282768664146e-05,-0.0001697763755976603,2574.2799138907867,2585.88811211009,2579.1001746153875,2579.690932673611,-0.6936574056335303,0.009587799043047823,4.149591847270913,-0.20415037593920715,-0.8439097744362698,-1.26604511278083,2586.4793942208566,2569.8810268317734,29.308469543838726,32.821794566653594,0,0,0,0,0,0,0,0,0,0,0,0,0,0,0,0,0,0,0,0,0,0,0,0,0,0,0,0,0,0,0,0,0,0,0,0,0,0,0,0,0,0,0,0,0,0,0,0,0,0,0,0,0,0,0,0,0,0,0,0,0,0,8,10,,True,False,0.0,2679.55,2549.55,2591.55,2594.55,0,0.01,2024-09-20 10:00:00,2024-09-20 10:00:00,False,2024-09-20 10:00:00,,2024-09-18 22:48:43,2024-09-17 15:00:00,2579.55,2024-09-18 22:48:43.000000000,auto,2549.66,0.01,fail,-528.15,1 days 07:48:43,6385.160000000001,False,0,1,38,9
2024-10-01 11:00:00,2645.52,2646.64,2642.47,2646.27,11268,27,0,2629.0823596115374,2637.754500000003,2646.426640388469,2641.5352828034543,2642.1987218045097,2635.602611284513,2630.733238415364,2642.4700000000007,2673.989349160187,0.00020108947700373615,-3.877529467950895e-05,,7.879110801919139,7.882067631602205,6.833601344424092e-05,0.0004470349573585912,2626.957899018759,2645.3442658717927,2641.339671070322,2642.5626479591883,-0.8427071320493269,-2.7444509269650763,3.7633246602367216,1.837609022554716,1.4490375939853948,2.3633909774407584,2649.725371124983,2634.672072484036,95.59207444086599,94.51717495282543,0,0,0,0,0,0,0,0,0,0,0,0,0,0,0,0,0,0,0,0,0,0,0,0,0,0,0,0,0,0,0,0,0,0,0,0,0,0,0,0,0,0,0,0,0,0,0,0,0,0,0,0,0,0,0,0,0,0,0,0,0,0,8,10,,False,True,1.0,2546.27,2618.27,2610.27,2601.27,1,0.01,2024-10-08 18:00:00,2024-10-08 20:00:00,True,,,2024-10-08 22:45:06,2024-10-01 12:00:00,2646.27,2024-10-08 22:45:06.000000000,auto,2618.29,0.01,even,493.57,7 days 10:45:06,6878.7300000000005,True,1,0,40,10
2024-10-01 14:00:00,2650.06,2652.07,2646.83,2650.09,11053,27,0,2628.0745808928104,2639.8005000000035,2651.5264191071965,2643.6333381653053,2647.384481203006,2637.3165469387754,2632.9992105642245,2646.830000000001,2679.072848337952,-4.947112107103813e-05,-0.00044189787036293294,,7.87898378389669,7.882067631602205,0.00023010405059246825,0.0004628032641862278,2630.6875040481505,2645.268086604517,2644.6182895742368,2644.016160867872,0.790754496588761,-1.223806330073965,3.648526120977551,1.4368270676686734,1.8043984962373543,1.944533834590402,2654.681533444961,2640.087428961051,95.3482503414507,95.95359273711954,100,0,0,0,0,0,0,0,0,0,0,0,0,0,0,0,0,0,0,100,0,0,0,0,0,0,0,0,0,0,100,0,0,0,0,0,0,0,0,100,0,0,0,0,0,0,0,100,0,0,0,0,100,0,0,0,0,0,0,0,0,0,8,10,,False,True,1.0,2550.09,2638.09,2630.09,2625.09,1,0.01,2024-10-08 11:00:00,2024-10-08 11:00:00,True,2024-10-08 18:00:00,,2024-10-08 11:39:36,2024-10-01 15:00:00,2650.09,2024-10-08 11:39:36.000000000,auto,2638.04,0.01,even,212.56,6 days 20:39:36,7091.290000000001,True,2,0,40,10
2024-10-10 17:00:00,2626.4,2629.7,2622.86,2625.18,20446,27,0,2602.484540451163,2614.0340000000047,2625.5834595488463,2616.9587526567157,2621.6488496240595,2612.938663145257,2607.4505085234086,2612.787126585017,2629.6745485261063,0.0004848090563876693,0.0005157477473166259,,7.869424504123507,7.873859656045294,0.0003754982900007489,-5.860332052584144e-05,2603.8823872227063,2618.735495602889,2618.5695959188415,2616.8547078257393,1.755610018050902,-0.022954136219310195,5.144060201404441,1.7236390977450355,2.104819548870637,2.4659248120306074,2631.9369700268685,2611.3607292212505,89.9598704191256,83.84155013382671,0,0,0,0,0,0,0,0,0,0,0,0,0,0,0,0,0,0,0,0,0,0,0,0,0,0,0,0,0,0,0,0,0,0,0,0,0,0,0,0,0,0,0,0,0,0,0,0,0,0,0,0,-100,0,0,0,0,0,0,0,0,0,8,10,,False,True,1.0,2525.18,2655.18,2613.18,2610.18,1,0.01,,,False,,,2024-10-11 17:42:25,2024-10-10 18:00:00,2625.18,2024-10-11 17:42:25.000000000,auto,2655.12,0.01,fail,-529.04,0 days 23:42:25,6562.250000000001,False,0,1,41,10
2024-10-21 22:00:00,2716.49,2720.89,2714.18,2719.94,9812,27,0,2715.9817350571684,2728.188000000004,2740.39426494284,2724.7951642784456,2725.477714285717,2738.641508283313,2731.6800523409374,2714.18,2727.5378532087307,0.0003788028284942692,0.00038218466144848473,,7.9110079513893865,7.905498592546225,0.00020460346128841548,-0.000142239226330709,2718.465447941278,2737.546630643309,2724.94734296081,2723.437195445348,0.9865799869257899,3.398925914368026,8.396298504025747,-1.8656541353334433,-2.5323834586502016,-1.5599398496210597,2742.2703112937684,2708.6851172776655,17.515071618313446,19.601481867941512,0,0,0,0,0,0,0,0,0,0,0,0,0,0,0,0,0,0,0,0,0,0,0,0,0,0,0,0,0,0,0,0,0,0,0,0,0,0,0,0,0,0,0,0,0,0,0,0,0,0,0,0,0,0,0,0,0,0,0,0,0,0,8,10,,True,False,0.0,2819.94,2731.94,2739.94,2744.94,0,0.01,2024-10-22 14:00:00,2024-10-22 14:00:00,True,2024-10-22 20:00:00,,2024-10-22 14:41:38,2024-10-21 23:00:00,2719.94,2024-10-22 14:41:38.000000000,auto,2731.94,0.01,even,211.68,0 days 15:41:38,6773.930000000001,True,1,0,43,10
