time,open,high,low,close,tick_volume,spread,real_volume,support_trendline_15,resistance_trendline_15,support_gradient_15,resistance_gradient_15,fixed_resistance_gradient_15,fixed_support_gradient_15,fixed_support_trendline_15,fixed_resistance_trendline_15,hourly_time,time2,prev_hour_lsma_slope,prev_hour_macd_line,hour_lsma,fixed_support_gradient,fixed_resistance_gradient,prev_hour_lsma,fixed_support_trendline,fixed_resistance_trendline,prev_fixed_support_trendline,prev_fixed_resistance_trendline,prev_fixed_resistance_gradient,prev_fixed_support_gradient,ema_50,ema_24,stoch_k,stoch_d,prev_hour_macd_signal,prev_psar,prev_psar_direction,prev_nadaraya_watson,prev_nadaraya_watson_trend,ema_short,ema_long,lsma,macd_line,macd_signal,lsma_stddev,lsma_slope,prev_lsma_slope_1,prev_lsma_slope_2,lsma_upper_band,lsma_lower_band,ticket,is_buy2,is_sell2,signal,tp,sl,be,be_condition,order_type,lot,sl_updated,time_to_trail,time_tp_hit,time_sl_hit,entry_time,entry_price,exit_time,exit_price,lot_size,type,success,profit,account_balance,win_streak,losing_streak,Week,Month
2024-07-03 04:40:00,1.07419,1.07423,1.07416,1.07423,57,12,0,1.07413666955448,1.0743183405006653,-7.293344769327754e-05,-5.430614241972201e-05,-8.376746665625974e-05,-6.516289463343936e-05,1.0743249910432606,1.0745735656602164,2024-07-03 04:00:00,2024-07-03 04:00:00,-2.1428571432835497e-06,0.00043166008908168685,1.0745610714285712,-0.00030750682637647493,-6.513348070461525e-05,1.074767857142857,1.074607078354882,1.0754450363444943,1.0744486739152568,1.0748780332111787,0.00024217149768861873,0.00011201596948156677,1.0739349123454407,1.0738948165142252,4.687984743920604,3.9365294590562185,0.0002865549992749083,,1.0,0.07210012050736839,bullish,1.0744649526350045,1.0746010459018032,1.0742374097007221,-0.00013609326679864253,-6.813922729308598e-05,0.00029818897809801725,-5.933264533841687e-05,-6.746130031021202e-05,-7.62160302723025e-05,1.07453559867882,1.0739392207226242,,True,False,0.0,1.08423,1.0798299999999994,1.0806299999999993,1.0822299999999991,0,0.01,True,2024-07-05 06:30:00,2024-07-08 11:47:13,2024-07-03 18:34:58,2024-07-03 04:45:00,1.07423,2024-07-03 18:34:58,1.07984,0.01,even,True,102.85,802.85,1,0,27,7
2024-07-03 04:55:00,1.07398,1.07415,1.07397,1.07413,93,12,0,1.07397,1.0742000009379806,0.0001181440779363319,0.00011635169201042284,-5.430614241972201e-05,-7.293344769327754e-05,1.0741310673597908,1.0743141684060968,2024-07-03 04:00:00,2024-07-03 04:00:00,-2.1428571432835497e-06,0.00043166008908168685,1.0745610714285712,-0.00030750682637647493,-6.513348070461525e-05,1.074767857142857,1.074607078354882,1.0754450363444943,1.0744486739152568,1.0748780332111787,0.00024217149768861873,0.00011201596948156677,1.0739349123454407,1.0738948165142252,6.339869281049604,4.734422209016322,0.0002865549992749083,,1.0,0.07210012050736839,bullish,1.0743100919240742,1.0744917381606296,1.074078249054008,-0.00018164623655536616,-0.00011952718049136943,0.00036657559474055206,-3.0522875815730544e-05,-5.767113863242024e-05,-7.096663226602296e-05,1.0744448246487486,1.0737116734592673,,True,False,0.0,1.08413,1.0757299999999999,1.0765299999999998,1.0771299999999997,0,0.01,True,2024-07-03 15:40:00,2024-07-05 15:32:28,2024-07-03 11:58:26,2024-07-03 05:00:00,1.07413,2024-07-03 11:58:26,1.07573,0.01,even,True,29.33,832.1800000000001,2,0,27,7
2024-07-03 10:00:00,1.07463,1.07527,1.07463,1.07517,425,12,0,1.07463,1.0755650134634998,0.0001366806345543821,-6.044769740820107e-05,0.00030993061226132143,0.00019704948702379502,1.073872047600957,1.0742841317981078,2024-07-03 10:00:00,2024-07-03 10:00:00,0.000147261904761109,0.00017511029851258186,1.074752857142857,0.0009396524367621757,0.000892625580117018,1.074187380952381,1.0726860571014778,1.074250130862096,1.0735342638373189,1.0744025657687246,0.00016251389444840776,3.658959729685567e-05,1.074229372444733,1.0741621169078077,94.19079828083794,90.25495440392787,0.00023773500256189648,,1.0,0.07157071613570043,bullish,1.0742013595844582,1.0740728060770677,1.074300543515652,0.0001285535073904942,-2.3527529034036305e-05,0.0003444696406477076,0.00023619539043706617,0.00013546267629926945,7.888544891576643e-05,1.0746450131562997,1.0739560738750045,,True,False,0.0,1.08517,1.0759699999999999,1.0767699999999998,1.0771699999999997,0,0.01,True,2024-07-03 15:40:00,,2024-07-03 11:57:00,2024-07-03 10:05:00,1.07517,2024-07-03 11:57:00,1.076,0.01,even,True,15.22,847.4000000000001,3,0,27,7
2024-07-04 05:45:00,1.07868,1.07874,1.07863,1.07873,59,12,0,1.07863,1.078779999542297,-3.684676935589313e-05,-9.269604411493018e-06,-1.890430312192325e-05,-1.324458902067195e-06,1.078639891733291,1.0787888480580472,2024-07-04 05:00:00,2024-07-04 05:00:00,9.511904762038448e-05,0.0007069863727560133,1.0789433333333345,-9.698063022732523e-05,-0.000101932911932968,1.0790807142857148,1.078792085806805,1.079541711960067,1.0787511705112547,1.079169160165795,0.0001304287630199915,1.4268879112857768e-05,1.077903280511042,1.0776098841020627,12.02185792351537,12.386156648468193,0.0008418771797205192,,1.0,0.07611195261377966,bullish,1.0788048121483307,1.0788822481769633,1.078705968352253,-7.74360286326381e-05,-4.237378620447952e-05,0.00019027786694618466,-3.443068455544207e-05,-3.3859649122502944e-05,-2.617131062976341e-05,1.0788962462191993,1.0785156904853068,,True,False,0.0,1.08873,1.0795299999999999,1.0803299999999998,1.0807299999999997,0,0.01,True,2024-07-04 18:00:00,2024-07-11 15:30:27,2024-07-04 12:37:03,2024-07-04 05:50:00,1.07873,2024-07-04 12:37:03,1.07952,0.01,even,True,14.48,861.8800000000001,4,0,27,7
2024-07-08 03:35:00,1.08225,1.08228,1.08212,1.08219,198,12,0,1.0820116680337488,1.0823033410847476,-6.623810950477385e-05,-6.776618625684751e-05,-8.776214122747984e-05,-0.0001474399829754137,1.0825573926716976,1.0829425603168068,2024-07-08 03:00:00,2024-07-08 03:00:00,-0.00016440476190493492,0.00016711595620022557,1.0823355952380957,4.6588777941524284e-05,-0.000166574768428961,1.0826530952380946,1.0817539765443098,1.083215762824169,1.0797198013088822,1.082898328298184,0.00033260091728577816,0.0011660547925672854,1.0823789077000792,1.082239604963622,25.29239766081348,39.397489180664735,0.00032431899573958186,,-1.0,0.07901085604979688,bearish,1.0825164911050753,1.0825482478714816,1.0825074269005852,-3.175676640632119e-05,5.739821271103753e-06,0.00014000952333363673,-9.225318197358945e-05,-8.248710010305693e-05,8.981768145677194e-06,1.082647436423919,1.0823674173772515,,False,True,1.0,1.07219,1.08139,1.0805900000000002,1.0801900000000002,1,0.01,True,,,2024-07-09 19:12:14,2024-07-08 03:40:00,1.08219,2024-07-09 19:12:14,1.08135,0.01,even,True,15.4,877.2800000000001,5,0,28,7
2024-07-08 03:40:00,1.0822,1.08223,1.08194,1.08203,224,12,0,1.0818733376981045,1.08223,-1.5407631651726007e-05,-9.49343068261915e-06,-0.00023864453806788117,-0.00016632919527855862,1.0824058291693992,1.0829980493639635,2024-07-08 03:00:00,2024-07-08 03:00:00,-0.00016440476190493492,0.00016711595620022557,1.0823355952380957,4.6588777941524284e-05,-0.000166574768428961,1.0826530952380946,1.0817539765443098,1.083215762824169,1.0797198013088822,1.082898328298184,0.00033260091728577816,0.0011660547925672854,1.0823789077000792,1.082239604963622,6.261664800303477,22.12295909197496,0.00032431899573958186,,-1.0,0.07901085604979688,bearish,1.082441646319679,1.0825098591402607,1.0823977880976954,-6.821282058155909e-05,-9.050707099428816e-06,0.00017482181392554198,-0.00010963880288983319,-9.225318197358945e-05,-8.248710010305693e-05,1.0825726099116209,1.08222296628377,,False,True,1.0,1.07203,1.0812300000000001,1.0804300000000002,1.0800300000000003,1,0.01,True,,,2024-07-09 18:50:25,2024-07-08 03:45:00,1.08203,2024-07-09 18:50:25,1.08121,0.01,even,True,15.03,892.3100000000001,6,0,28,7
2024-07-10 09:20:00,1.08155,1.0818699999999999,1.08155,1.08181,220,12,0,1.08155,1.0819383354499472,3.414932479155265e-05,-2.6189866900283454e-05,5.2139532061446506e-05,-9.99957735550019e-06,1.0814407773407047,1.0816944349613742,2024-07-10 09:00:00,2024-07-10 09:00:00,4.523809523870881e-05,-4.657475286107271e-06,1.0819222619047628,-0.0001024642380825293,0.00012437703283597337,1.0817448809523813,1.0816328875472876,1.0820006234550659,1.0815780684551806,1.082039997175054,9.620755643482937e-06,-2.274262628835008e-05,1.0816920524258014,1.0817343582873042,39.02786921219697,22.885090261537062,-0.0001264650904059586,,1.0,0.07863168404825627,bullish,1.0816594456125925,1.0817054502405075,1.0815682215342284,-4.600462791493065e-05,-3.779047038026794e-05,0.00014628738824449527,4.157550739658511e-05,-1.0543515652106095e-05,-4.2301341588668606e-05,1.081714508922473,1.0814219341459839,,True,False,0.0,1.09181,1.0826099999999999,1.0834099999999998,1.0838099999999997,0,0.01,True,2024-07-11 04:50:00,2024-07-15 13:21:29,2024-07-11 00:01:01,2024-07-10 09:25:00,1.08181,2024-07-11 00:01:01,1.08233,0.01,even,True,9.53,901.84,7,0,28,7
2024-07-10 09:25:00,1.08183,1.08191,1.08182,1.08185,187,12,0,1.081624995130429,1.08191,-4.618182813553858e-06,-2.4899245420112577e-05,0.00013866220072615435,0.00011020836736454579,1.0813210099661938,1.081581811460042,2024-07-10 09:00:00,2024-07-10 09:00:00,4.523809523870881e-05,-4.657475286107271e-06,1.0819222619047628,-0.0001024642380825293,0.00012437703283597337,1.0817448809523813,1.0816328875472876,1.0820006234550659,1.0815780684551806,1.082039997175054,9.620755643482937e-06,-2.274262628835008e-05,1.0816920524258014,1.0817343582873042,66.66666666666664,40.546689569409864,-0.0001264650904059586,,1.0,0.07863168404825627,bullish,1.0816887616721935,1.0817161576300995,1.0816032886136904,-2.7395957906017898e-05,-3.5711567885417934e-05,0.0001467855577343773,3.506707946199228e-05,4.157550739658511e-05,-1.0543515652106095e-05,1.0817500741714248,1.081456503055956,,True,False,0.0,1.09185,1.08265,1.0834499999999998,1.0838499999999998,0,0.01,True,2024-07-11 04:50:00,2024-07-15 13:21:29,2024-07-11 00:01:01,2024-07-10 09:30:00,1.08185,2024-07-11 00:01:01,1.08233,0.01,even,True,8.8,910.64,8,0,28,7
2024-07-11 15:30:00,1.08461,1.08931,1.0845,1.08866,1689,12,0,1.0845,1.08931,0.0013345627714251111,0.0001556311391929586,0.0011773888842753406,0.00012833001147009014,1.0840943766680546,1.085577732856288,2024-07-11 15:00:00,2024-07-11 15:00:00,0.0004259523809519994,0.0005895022737234523,1.086312023809524,-7.415595977763742e-05,0.00218878803276609,1.0849329761904758,1.0845040059372626,1.085360895980159,1.0842454341160568,1.0852204458623893,0.0002299317474002594,0.0002665951066569369,1.0841532551105284,1.0839270841260193,39.644959200796045,27.49687563734999,0.0004386373931385516,,1.0,0.08152376662313376,bullish,1.0856005450452066,1.0852574761370675,1.0857711179910556,0.0003430689081391769,0.000181403832724094,0.000775449976852402,0.0006593016855862555,-0.00012364981080237314,-0.00012396628826860656,1.086546567967908,1.0849956680142032,,True,False,0.0,1.09866,1.0894599999999999,1.0902599999999998,1.0906599999999997,0,0.01,True,2024-07-12 17:55:00,,2024-07-11 15:50:11,2024-07-11 15:35:00,1.08866,2024-07-11 15:50:11,1.08948,0.01,even,True,15.03,925.67,9,0,28,7
2024-07-11 15:40:00,1.08791,1.08966,1.08784,1.08964,1454,12,0,1.08784,1.0898933732992193,0.00018100119431758264,1.2215128647342903e-05,0.0006852189773328903,0.0014762495187452633,1.0830374354956962,1.0886278756156074,2024-07-11 15:00:00,2024-07-11 15:00:00,0.0004259523809519994,0.0005895022737234523,1.086312023809524,-7.415595977763742e-05,0.00218878803276609,1.0849329761904758,1.0845040059372626,1.085360895980159,1.0842454341160568,1.0852204458623893,0.0002299317474002594,0.0002665951066569369,1.0841532551105284,1.0839270841260193,86.09756900147691,61.59296175084367,0.0004386373931385516,,1.0,0.08152376662313376,bullish,1.0865226387601774,1.0857640364686791,1.0869739662882703,0.0007586022914982671,0.0003481207386525305,0.0012804391173592716,0.0007452700378400845,0.0004575782593745359,0.0006593016855862555,1.0882544054056296,1.085693527170911,,True,False,0.0,1.09964,1.0904399999999999,1.0912399999999998,1.0916399999999997,0,0.01,True,2024-07-15 17:30:00,,2024-07-12 17:56:48,2024-07-11 15:45:00,1.08964,2024-07-12 17:56:48,1.09044,0.01,even,True,14.67,940.3399999999999,10,0,28,7
2024-07-12 02:55:00,1.08721,1.08738,1.08714,1.08735,327,12,0,1.08714,1.0875137339925096,-0.000122402625716574,-0.0001237712961058907,0.00020392242632861926,0.0002852484572273545,1.0861660817274705,1.0868769032511802,2024-07-12 02:00:00,2024-07-12 02:00:00,0.0001014285714289187,0.0005348997622087737,1.0868550000000003,9.62622733799296e-05,0.0002939824720495525,1.0865458333333338,1.086219613969611,1.0867567546807384,1.0862045815243329,1.0867346635043271,7.361788175961662e-06,-4.599834810926312e-06,1.0859561190426634,1.085690404116054,87.60787765811195,60.20925388935546,0.0007307568889750556,,1.0,0.08307748678337382,bullish,1.08684844126872,1.0867321022323795,1.0869045132438935,0.00011633903634056253,4.9965903176774445e-05,0.00022928294002346714,0.00011663914688653243,9.703818369311001e-05,5.30581355366877e-05,1.087133796183917,1.08667523030387,,True,False,0.0,1.09735,1.08815,1.0889499999999999,1.0893499999999998,0,0.01,True,2024-07-12 16:20:00,,2024-07-12 12:25:03,2024-07-12 03:00:00,1.08735,2024-07-12 12:25:03,1.08815,0.01,even,True,14.67,955.0099999999999,11,0,28,7
2024-07-12 09:45:00,1.0864,1.08666,1.08635,1.08645,207,12,0,1.0862166667497006,1.08666,2.148098110074094e-05,-2.1736794175631894e-05,-1.5073200142831617e-05,-4.68159366458123e-05,1.0863874990183777,1.0867077812716937,2024-07-12 09:00:00,2024-07-12 09:00:00,1.523809523740205e-05,0.00030269030784468853,1.0866364285714292,-0.00023969159962338176,-8.400401665397675e-06,1.0867863095238095,1.0867392542049836,1.0871775081538908,1.0864033631280223,1.0870066748636966,8.318463467337016e-05,0.00014764416058183423,1.086327739968524,1.0861342850603934,13.624146287733133,15.016771703147464,0.0004431878610532147,,1.0,0.08329921827879344,bullish,1.0866479154042892,1.0867513526168617,1.086537117303062,-0.00010343721257255467,-4.409073524597743e-05,0.00020617306625972452,-6.476436188473933e-05,-7.266941864503274e-05,-7.052631578918778e-05,1.0867432903693217,1.0863309442368023,,True,False,0.0,1.09645,1.0880499999999997,1.0888499999999997,1.0894499999999996,0,0.01,True,2024-07-12 16:35:00,,2024-07-12 15:30:01,2024-07-12 09:50:00,1.08645,2024-07-12 15:30:01,1.08862,0.01,even,True,39.79,994.7999999999998,12,0,28,7
2024-07-12 09:55:00,1.0863,1.08652,1.08627,1.08644,233,12,0,1.0862808539025652,1.0866233344952116,-5.243191009594833e-05,-2.1474548742496688e-05,-3.681143014472429e-05,-2.7615947839595523e-05,1.0862975096311713,1.0866966857510054,2024-07-12 09:00:00,2024-07-12 09:00:00,1.523809523740205e-05,0.00030269030784468853,1.0866364285714292,-0.00023969159962338176,-8.400401665397675e-06,1.0867863095238095,1.0867392542049836,1.0871775081538908,1.0864033631280223,1.0870066748636966,8.318463467337016e-05,0.00014764416058183423,1.086327739968524,1.0861342850603934,15.643237648202108,14.078848275083809,0.0004431878610532147,,1.0,0.08329921827879344,bullish,1.0865719394314732,1.086698018361507,1.08640879256966,-0.00012607893003369064,-7.307088239034168e-05,0.00023762715876924473,-4.507395940755998e-05,-8.32507739945143e-05,-6.476436188473933e-05,1.0866464197284291,1.0861711654108908,,True,False,0.0,1.09644,1.08804,1.0888399999999998,1.0894399999999997,0,0.01,True,2024-07-12 16:20:00,,2024-07-12 15:30:01,2024-07-12 10:00:00,1.08644,2024-07-12 15:30:01,1.08862,0.01,even,True,39.97,1034.7699999999998,13,0,28,7
2024-07-12 15:40:00,1.08789,1.08888,1.08779,1.08856,897,12,0,1.08779,1.08888,0.00032797651896569887,0.00010060346102982272,-4.8712229402075193e-05,7.820959306714238e-05,1.0871821842578466,1.0890346353982694,2024-07-12 15:00:00,2024-07-12 15:00:00,0.00026714285714168895,0.000658827671177642,1.088955476190476,-0.000533529408448034,4.9579439354998286e-05,1.0886892857142851,1.088371290590038,1.089126601413306,1.088102124697865,1.0889927446591967,0.0001377349020590929,0.00023928761667587952,1.087349287069869,1.087097022629621,53.13028764805429,47.3470885431563,0.0005042693853210444,,1.0,0.08497924690877523,bullish,1.0886709606036886,1.0887165307531195,1.0885973168214655,-4.557014943085136e-05,5.017374682967912e-05,0.0002465245083770048,-4.642930856513239e-05,-0.0001804506363958236,-8.874097007094406e-05,1.0888438413298425,1.0883507923130886,,True,False,0.0,1.09856,1.0893599999999999,1.0901599999999998,1.0905599999999998,0,0.01,True,2024-07-12 17:55:00,,2024-07-12 16:42:14,2024-07-12 15:45:00,1.08856,2024-07-12 16:42:14,1.08935,0.01,even,True,14.48,1049.2499999999998,14,0,28,7
2024-07-12 15:45:00,1.08855,1.08894,1.0885,1.08883,728,12,0,1.0885,1.0890786796718812,7.429760610175819e-05,1.8767729401163473e-05,5.663814844819902e-05,0.000248655249748843,1.0872830082829472,1.0888235778442334,2024-07-12 15:00:00,2024-07-12 15:00:00,0.00026714285714168895,0.000658827671177642,1.088955476190476,-0.000533529408448034,4.9579439354998286e-05,1.0886892857142851,1.088371290590038,1.089126601413306,1.088102124697865,1.0889927446591967,0.0001377349020590929,0.00023928761667587952,1.087349287069869,1.087097022629621,59.7292724196267,50.306546245631715,0.0005042693853210444,,1.0,0.08497924690877523,bullish,1.0886954282031212,1.088724935882518,1.088609267285861,-2.9507679396800768e-05,3.423746158438315e-05,0.00024582378491612574,1.1950464395393823e-05,-4.642930856513239e-05,-0.0001804506363958236,1.088855091070777,1.0883634435009448,,True,False,0.0,1.09883,1.0904299999999998,1.0912299999999997,1.0918299999999996,0,0.01,True,2024-07-15 18:15:00,,2024-07-12 18:17:37,2024-07-12 15:50:00,1.08883,2024-07-12 18:17:37,1.09045,0.01,even,True,29.7,1078.9499999999998,15,0,28,7
2024-07-12 15:50:00,1.08885,1.08911,1.08857,1.08904,664,12,0,1.08857,1.0891473284867834,1.8639870833463197e-05,-8.363983130821586e-06,6.707222781667302e-05,0.0003292877453217649,1.0874624063062828,1.0888862295343362,2024-07-12 15:00:00,2024-07-12 15:00:00,0.00026714285714168895,0.000658827671177642,1.088955476190476,-0.000533529408448034,4.9579439354998286e-05,1.0886892857142851,1.088371290590038,1.089126601413306,1.088102124697865,1.0889927446591967,0.0001377349020590929,0.00023928761667587952,1.087349287069869,1.087097022629621,78.68020304568627,63.84658770445581,0.0005042693853210444,,1.0,0.08497924690877523,bullish,1.088748439248795,1.0887482739652945,1.0886591640866876,1.6528350044175966e-07,2.742302596759487e-05,0.0002485806372796934,4.989680082667647e-05,1.1950464395393823e-05,-4.642930856513239e-05,1.0889077447239672,1.088410583449408,,True,False,0.0,1.09904,1.08984,1.0906399999999998,1.0910399999999998,0,0.01,True,2024-07-15 12:40:00,,2024-07-15 00:00:05,2024-07-12 15:55:00,1.08904,2024-07-15 00:00:05,1.08821,0.01,even,True,-15.22,1063.7299999999998,16,0,28,7
2024-07-15 00:00:00,1.08821,1.0883,1.08779,1.08819,53,65,0,1.08779,1.088396677403341,0.0003187945797238547,0.00035513154990566203,-0.00028004257151389246,-0.0007837494638714904,1.0902784521491455,1.0911851734572569,2024-07-15 00:00:00,2024-07-15 00:00:00,-2.1547619045714228e-05,0.0008744467567298742,1.0899591666666664,-0.0012077449602624802,-0.0008209567515847016,1.0906409523809535,1.090308674327928,1.0915295458642418,1.0900526071641825,1.0910051884325196,5.500686760656503e-05,0.00013341259062334493,1.089003784211786,1.0887042423196727,30.484435963878752,23.658244651383082,0.0008489768240539704,,-1.0,0.08668830479248765,bearish,1.0901662081727748,1.0903643704093084,1.0900360371517033,-0.00019816223653368326,-2.7869305479013725e-05,0.0005094251661232948,-0.0004204059167518537,2.4385964912498892e-05,-1.3309253526827547e-05,1.0905454623178266,1.08952661198558,,False,True,1.0,1.07819,1.08739,1.0865900000000002,1.0861900000000002,1,0.01,True,,,2024-07-16 16:22:24,2024-07-15 00:05:00,1.08819,2024-07-16 16:22:24,1.08739,0.01,even,True,14.66,1078.3899999999999,17,0,29,7
2024-07-15 19:20:00,1.09016,1.09057,1.0901399999999999,1.09056,194,12,0,1.0901399999999999,1.090628205462532,1.8619244993183627e-05,-7.253477280994128e-05,-2.4724796342233295e-05,-4.086075386552416e-07,1.0901412977033047,1.0906376622970548,2024-07-15 19:00:00,2024-07-15 19:00:00,-9.35714285719147e-05,0.0005544513073176827,1.0910258333333345,-0.0003526984748929441,-0.00045707886939479387,1.0912250000000001,1.0906766545990862,1.0926151148134877,1.0906196708748324,1.0916048668416296,0.00027058544618001465,0.00010168444220321951,1.0902062743697114,1.0900112525160508,9.623731049102643,5.34500437103073,0.0004475031437316355,,1.0,0.08746668086291187,bullish,1.0907844469632815,1.0910163458165734,1.0904377089783286,-0.00023189885329188975,-0.0001065295470191868,0.00048820316796298796,-8.267285861629503e-05,-0.0001850842793265084,-0.00021449260405836945,1.0909259121462915,1.0899495058103656,,True,False,0.0,1.10056,1.0929599999999997,1.0937599999999996,1.0945599999999995,0,0.01,True,,,2024-07-17 14:02:15,2024-07-15 19:25:00,1.09056,2024-07-17 14:02:15,1.09295,0.01,even,True,43.82,1122.2099999999998,18,0,29,7
2024-07-15 19:40:00,1.09026,1.09166,1.09021,1.09027,1055,12,0,1.0898817833969203,1.09166,5.423074044470632e-05,-0.00031491377710311244,0.00033936714792124993,-2.669170332331172e-05,1.0902565854332569,1.0905811311567546,2024-07-15 19:00:00,2024-07-15 19:00:00,-9.35714285719147e-05,0.0005544513073176827,1.0910258333333345,-0.0003526984748929441,-0.00045707886939479387,1.0912250000000001,1.0906766545990862,1.0926151148134877,1.0906196708748324,1.0916048668416296,0.00027058544618001465,0.00010168444220321951,1.0902062743697114,1.0900112525160508,10.801496566383017,14.826566283465292,0.0004475031437316355,,1.0,0.08746668086291187,bullish,1.0905513948387453,1.0908297551461008,1.090192552459581,-0.00027836030735550743,-0.00020067626067466897,0.0005683358747642695,-1.0863433091312658e-05,-7.071207430420223e-05,-8.160302717552526e-05,1.0907608883343454,1.0896242165848167,,True,False,0.0,1.10027,1.0934699999999997,1.0942699999999996,1.0952699999999995,0,0.01,True,,,2024-07-17 13:42:40,2024-07-15 19:45:00,1.09027,2024-07-17 13:42:40,1.09346,0.01,even,True,58.49,1180.6999999999998,19,0,29,7
2024-07-15 19:50:00,1.09025,1.09036,1.09,1.0903100000000001,429,12,0,1.0900108733914358,1.0906882058745637,-0.00017474135301918437,-5.4191601141489014e-05,-0.000366601924881123,-0.00011161721622396942,1.0901628162292212,1.092025663366217,2024-07-15 19:00:00,2024-07-15 19:00:00,-9.35714285719147e-05,0.0005544513073176827,1.0910258333333345,-0.0003526984748929441,-0.00045707886939479387,1.0912250000000001,1.0906766545990862,1.0926151148134877,1.0906196708748324,1.0916048668416296,0.00027058544618001465,0.00010168444220321951,1.0902062743697114,1.0900112525160508,16.537584847682464,13.368935396786854,0.0004475031437316355,,1.0,0.08746668086291187,bullish,1.090475022340167,1.0907514910374663,1.0901392638458884,-0.0002764686972993591,-0.00022881197324339643,0.0005952372075161195,-2.2019263846706494e-05,-3.126934984587493e-05,-1.0863433091312658e-05,1.0907345010534046,1.0895440266383722,,True,False,0.0,1.1003100000000001,1.0935099999999998,1.0943099999999997,1.0953099999999996,0,0.01,True,,,2024-07-17 13:42:36,2024-07-15 19:55:00,1.0903100000000001,2024-07-17 13:42:36,1.09353,0.01,even,True,59.04,1239.7399999999998,20,0,29,7
2024-07-15 19:55:00,1.0903100000000001,1.09064,1.0903100000000001,1.09055,450,12,0,1.0896116379800391,1.090710475083661,1.685175213368295e-05,-0.0001288005696283397,-0.00031491377710311244,5.423074044470632e-05,1.0898869067661319,1.0916302009213643,2024-07-15 19:00:00,2024-07-15 19:00:00,-9.35714285719147e-05,0.0005544513073176827,1.0910258333333345,-0.0003526984748929441,-0.00045707886939479387,1.0912250000000001,1.0906766545990862,1.0926151148134877,1.0906196708748324,1.0916048668416296,0.00027058544618001465,0.00010168444220321951,1.0902062743697114,1.0900112525160508,25.433526011556044,18.246278545177862,0.0004475031437316355,,1.0,0.08746668086291187,bullish,1.0904865573647566,1.0907365657754318,1.0901681905744758,-0.0002500084106751288,-0.00023305126072974293,0.0005856426668302218,2.89267285873418e-05,-2.2019263846706494e-05,-3.126934984587493e-05,1.090753833241306,1.0895825479076455,,True,False,0.0,1.10055,1.0929499999999996,1.0937499999999996,1.0945499999999995,0,0.01,True,,,2024-07-17 14:03:04,2024-07-15 20:00:00,1.09055,2024-07-17 14:03:04,1.09296,0.01,even,True,44.19,1283.9299999999998,21,0,29,7
2024-07-16 10:35:00,1.08959,1.08966,1.08946,1.08947,158,12,0,1.089225021614226,1.08966,9.637432593026763e-05,5.784415736261293e-05,1.917580823869213e-05,-2.447784722022162e-05,1.0894710494071698,1.0896599995735006,2024-07-16 10:00:00,2024-07-16 10:00:00,-0.00010964285714321065,-0.0002913030041367115,1.089228333333333,0.00043096829125100703,0.0003529683400076253,1.0888978571428563,1.087882287837352,1.0892130817963088,1.0889720093327806,1.0893585054529193,-0.00016709241059378353,-0.0003223599809422158,1.0894934654938229,1.0895024389950803,88.3076396025963,92.30741942205162,-0.0001914032167299062,,-1.0,0.08518806320959045,bearish,1.0892450161416336,1.0890675222822224,1.0895366597867218,0.0001774938594112374,7.386552967231818e-05,0.00039399661576425385,6.99380804956018e-05,0.00011945992432127461,0.00013818369452955892,1.089930656402486,1.0891426631709575,,False,True,1.0,1.07947,1.08867,1.0878700000000001,1.0874700000000002,1,0.01,True,2024-07-16 16:10:00,,2024-07-16 15:42:42,2024-07-16 10:40:00,1.08947,2024-07-16 15:42:42,1.08867,0.01,even,True,14.66,1298.59,22,0,29,7
2024-07-17 03:35:00,1.08966,1.08977,1.08963,1.08977,81,12,0,1.08963,1.0899266636575353,3.392165366574885e-05,3.0610659135641635e-06,3.867555707920868e-05,3.338122287798827e-05,1.0895240124904793,1.0896436228505215,2024-07-17 03:00:00,2024-07-17 03:00:00,6.571428571389148e-05,0.00022063380955672507,1.0900070238095245,-7.302271871509404e-05,9.998321920577596e-06,1.0901315476190474,1.0896731653754446,1.0901991357268745,1.0895932124717898,1.089978377280608,0.00014219416057399556,8.71707058475235e-05,1.0895068175207652,1.0894877730920536,27.230046948348004,20.255944267754593,3.126409869553893e-05,,1.0,0.08620623291714807,bullish,1.0898162645099785,1.0898748562155391,1.089733436532508,-5.859170556066218e-05,-1.4903298717706217e-05,0.00016556166996110176,-2.342277261746517e-05,-4.6948744410579835e-05,-4.65944272443064e-05,1.0898989982024692,1.0895678748625468,,True,False,0.0,1.09977,1.0905699999999998,1.0913699999999997,1.0917699999999997,0,0.01,True,2024-07-17 11:35:00,,2024-07-17 10:57:59,2024-07-17 03:40:00,1.08977,2024-07-17 10:57:59,1.09057,0.01,even,True,14.67,1313.26,23,0,29,7
2024-07-17 03:40:00,1.08976,1.08993,1.08972,1.08989,141,12,0,1.08972,1.0899278602420026,-4.255626767371153e-05,-2.6871436985803456e-05,7.979935337479726e-05,2.1412373046735685e-05,1.0895853460926743,1.0896765889246482,2024-07-17 03:00:00,2024-07-17 03:00:00,6.571428571389148e-05,0.00022063380955672507,1.0900070238095245,-7.302271871509404e-05,9.998321920577596e-06,1.0901315476190474,1.0896731653754446,1.0901991357268745,1.0895932124717898,1.089978377280608,0.00014219416057399556,8.71707058475235e-05,1.0895068175207652,1.0894877730920536,37.558685446005875,28.169014084500997,3.126409869553893e-05,,1.0,0.08620623291714807,bullish,1.0898276084315202,1.089875977977351,1.0897392397660814,-4.836954583087305e-05,-2.1596548140339584e-05,0.00016436747415560224,5.803233573464794e-06,-2.342277261746517e-05,-4.6948744410579835e-05,1.089903607240237,1.0895748722919258,,True,False,0.0,1.09989,1.09069,1.0914899999999998,1.0918899999999998,0,0.01,True,2024-07-17 11:40:00,,2024-07-17 10:49:58,2024-07-17 03:45:00,1.08989,2024-07-17 10:49:58,1.09071,0.01,even,True,15.03,1328.29,24,0,29,7
2024-07-17 08:20:00,1.09023,1.09039,1.09023,1.09035,44,12,0,1.0901866672204827,1.090379102710743,1.2229738621994096e-05,-2.7827473692960976e-06,2.4187364420224602e-05,1.3756916194810616e-05,1.090001306562676,1.0903022811026228,2024-07-17 08:00:00,2024-07-17 08:00:00,1.3571428569614241e-05,0.0002794028447088426,1.0903509523809531,1.8761353010507513e-05,3.301025645889643e-05,1.0903147619047608,1.089991769248824,1.09056111300976,1.0900274856691314,1.090608272915715,-8.755661656896878e-06,-2.6701005937389256e-05,1.0898345340471134,1.0897777663535746,32.16374269006372,21.682219733733977,0.00018415503528284606,,1.0,0.08652611275499159,bullish,1.0902565193402647,1.090271830195312,1.0901505572755417,-1.5310855047356853e-05,4.947593924203715e-06,0.0001553222453166707,1.5583075335445784e-05,-2.0175438596004014e-05,-6.986240110151698e-05,1.0903058795208584,1.0899952350302249,,True,False,0.0,1.10035,1.0935499999999996,1.0943499999999995,1.0953499999999994,0,0.01,True,,,2024-07-17 13:42:28,2024-07-17 08:25:00,1.09035,2024-07-17 13:42:28,1.09354,0.01,even,True,58.48,1386.77,25,0,29,7
2024-07-17 09:10:00,1.09008,1.09032,1.09004,1.09027,286,12,0,1.089735009805144,1.0903166684143963,6.881270590716525e-05,-3.05802661814521e-06,-7.363860034050957e-05,-7.639202893344857e-06,1.0898976063491705,1.090543059496416,2024-07-17 09:00:00,2024-07-17 09:00:00,3.6190476192299315e-05,0.0002773740683881254,1.0901722619047616,-0.00019226972018457778,-0.0001275495035340455,1.0903509523809531,1.0901019952514892,1.0907462646825903,1.089991769248824,1.09056111300976,3.301025645889643e-05,1.8761353010507513e-05,1.0898217212807215,1.0897715450452885,30.630630630632794,36.434795451192365,0.00020279884190390195,,1.0,0.08652852763442055,bullish,1.090264006110154,1.0902776384775992,1.0902904403164775,-1.3632367445115534e-05,2.3067877964511186e-06,0.00014946794491491435,2.645338836870792e-06,-3.671138630823023e-05,-5.366357069247485e-05,1.0904399082613925,1.0901409723715625,,True,False,0.0,1.10027,1.0934699999999997,1.0942699999999996,1.0952699999999995,0,0.01,True,,,2024-07-17 13:42:40,2024-07-17 09:15:00,1.09027,2024-07-17 13:42:40,1.09346,0.01,even,True,58.48,1445.25,26,0,29,7
2024-07-17 09:20:00,1.09003,1.0903100000000001,1.09003,1.0902,334,12,0,1.09003,1.0903199964122166,1.9172261804755875e-05,6.878405911020424e-05,-1.529021433179572e-06,-5.0463417495002546e-05,1.0899152466770463,1.0903215231490577,2024-07-17 09:00:00,2024-07-17 09:00:00,3.6190476192299315e-05,0.0002773740683881254,1.0901722619047616,-0.00019226972018457778,-0.0001275495035340455,1.0903509523809531,1.0901019952514892,1.0907462646825903,1.089991769248824,1.09056111300976,3.301025645889643e-05,1.8761353010507513e-05,1.0898217212807215,1.0897715450452885,41.91386508460747,35.871237090755756,0.00020279884190390195,,1.0,0.08652852763442055,bullish,1.090223696682418,1.090254902672839,1.0902304403164782,-3.1205990421057095e-05,-9.771208540205114e-06,0.0001457943753738379,-1.4833161334104616e-05,-4.516683866517823e-05,2.645338836870792e-06,1.090376234691852,1.0900846459411044,,True,False,0.0,1.1002,1.091,1.0917999999999999,1.0921999999999998,0,0.01,True,2024-07-17 11:40:00,,2024-07-17 11:12:21,2024-07-17 09:25:00,1.0902,2024-07-17 11:12:21,1.09104,0.01,even,True,15.4,1460.65,27,0,29,7
2024-07-17 09:30:00,1.0901399999999999,1.09047,1.09013,1.09027,279,12,0,1.0901408809842026,1.090550018283696,-0.00010118912605782327,-5.044419408938754e-05,6.753146310163858e-05,0.00010118954681035032,1.0898195308052643,1.0902554624567775,2024-07-17 09:00:00,2024-07-17 09:00:00,3.6190476192299315e-05,0.0002773740683881254,1.0901722619047616,-0.00019226972018457778,-0.0001275495035340455,1.0903509523809531,1.0901019952514892,1.0907462646825903,1.089991769248824,1.09056111300976,3.301025645889643e-05,1.8761353010507513e-05,1.0898217212807215,1.0897715450452885,48.780487804888175,43.23958104446939,0.00020279884190390195,,1.0,0.08652852763442055,bullish,1.0902225283939204,1.0902495118937232,1.0902224079807359,-2.698349980279069e-05,-1.7086377811273178e-05,0.00013255564827951692,1.002063983479573e-05,-1.805297557710972e-05,-1.4833161334104616e-05,1.0903549636290153,1.0900898523324565,,True,False,0.0,1.10027,1.0934699999999997,1.0942699999999996,1.0952699999999995,0,0.01,True,,,2024-07-17 13:42:40,2024-07-17 09:35:00,1.09027,2024-07-17 13:42:40,1.09346,0.01,even,True,58.48,1519.13,28,0,29,7
2024-07-18 11:40:00,1.0934,1.0934,1.09301,1.0930900000000001,277,12,0,1.09301,1.0934,-1.8016764037886718e-05,-5.5162485150201694e-05,-0.00011124658248778804,-8.204788448413758e-05,1.0932820157726673,1.093920857447991,2024-07-18 11:00:00,2024-07-18 11:00:00,-4.9285714285529636e-05,0.00010054173742646277,1.0931280952380948,6.405791862411349e-05,7.357160316811413e-05,1.0931988095238092,1.0924962384302923,1.0936562202909275,1.0929815181764952,1.0938395624191228,-0.00019118310727295486,-0.00029281416413678025,1.0931058617311697,1.0929664519661995,60.00000000000947,74.60202020203005,0.00029608546406052305,,-1.0,0.08915900912614068,bearish,1.0932095415689231,1.0931728538095387,1.0933340832473328,3.6687759384479435e-05,-1.977246417282725e-06,0.00021813604288393988,2.1355349155927073e-05,7.50326797394063e-05,0.00010084279325561774,1.0935522192902167,1.093115947204449,,False,True,1.0,1.08309,1.0914900000000003,1.0906900000000004,1.0900900000000004,1,0.01,True,2024-07-18 21:15:00,2024-07-24 10:42:16,2024-07-18 17:55:15,2024-07-18 11:45:00,1.0930900000000001,2024-07-18 17:55:15,1.09147,0.01,even,True,29.69,1548.8200000000002,29,0,29,7
2024-07-18 15:45:00,1.0930900000000001,1.09313,1.09268,1.09273,697,12,0,1.0925933262992191,1.09313,-0.00012967452490776843,-9.176835289321365e-05,-0.00010516862553029478,-0.00010037873328409998,1.093010270524723,1.0936898215759616,2024-07-18 15:00:00,2024-07-18 15:00:00,-0.00016357142857215123,-3.503144523420154e-05,1.0928419047619051,-0.00022334343550886528,3.70016134432109e-05,1.0929372619047604,1.0927763769509469,1.093552660564193,1.0926460519329062,1.09349617854157,6.403951456979549e-05,-4.076261321713603e-05,1.0930424422265812,1.0929522472055637,49.69135802469282,64.78052126199874,0.00012675010255997274,,-1.0,0.08891032208131933,bearish,1.0930488838233272,1.0930449080710907,1.0930691847265226,3.975752236540231e-06,-3.6270981284998836e-06,0.00024043571532782404,-5.056759545918332e-05,2.9133126934421938e-05,9.865497076155805e-05,1.0933096204418504,1.0928287490111948,,False,True,1.0,1.08273,1.0911300000000002,1.0903300000000002,1.0897300000000003,1,0.01,True,2024-07-18 21:45:00,2024-07-24 10:55:36,2024-07-18 17:34:34,2024-07-18 15:50:00,1.09273,2024-07-18 17:34:34,1.09113,0.01,even,True,29.32,1578.14,30,0,29,7
2024-07-18 15:50:00,1.09274,1.09283,1.09247,1.09251,552,12,0,1.0924663882960943,1.0928833436592238,-0.00013317739326926546,-1.983035014712863e-05,-0.00025156465797670894,-0.0002466306808907335,1.0932061445163481,1.0937207688243662,2024-07-18 15:00:00,2024-07-18 15:00:00,-0.00016357142857215123,-3.503144523420154e-05,1.0928419047619051,-0.00022334343550886528,3.70016134432109e-05,1.0929372619047604,1.0927763769509469,1.093552660564193,1.0926460519329062,1.09349617854157,6.403951456979549e-05,-4.076261321713603e-05,1.0930424422265812,1.0929522472055637,23.37164750958421,48.22264793529312,0.00012675010255997274,,-1.0,0.08891032208131933,bearish,1.0929659786197383,1.0930052852510097,1.092995816993464,-3.930663127138523e-05,-1.0763004757076953e-05,0.00024639264032332524,-7.336773305866018e-05,-5.056759545918332e-05,2.9133126934421938e-05,1.0932422096337873,1.0927494243531406,,False,True,1.0,1.08251,1.0917100000000002,1.0909100000000003,1.0905100000000003,1,0.01,True,2024-07-18 21:05:00,2024-07-24 10:58:04,2024-07-18 16:40:24,2024-07-18 15:55:00,1.09251,2024-07-18 16:40:24,1.09171,0.01,even,True,14.66,1592.8000000000002,31,0,29,7
2024-07-19 01:30:00,1.08993,1.08993,1.0897000000000001,1.0897000000000001,71,12,0,1.0896516693938711,1.08993,3.517631647311744e-05,-4.003188239586351e-05,-8.35047830724521e-06,2.7344719154275286e-07,1.0897100255970462,1.0899565227976369,2024-07-19 01:00:00,2024-07-19 01:00:00,-0.00024273809523789325,-0.0008659968424766795,1.0895473809523804,5.048075699766732e-05,6.922378449612167e-05,1.0896546428571436,1.0893597310572658,1.0898055900177466,1.0893051912650187,1.0899248078618489,-5.5461245830231195e-05,5.548372564981614e-05,1.0912705329399608,1.0914358058376572,76.13240418120954,84.0406046149799,-0.0006000373651117819,,-1.0,0.08585046618460804,bearish,1.0897573333367427,1.0897391824642622,1.0898063398692817,1.8150872480582336e-05,-8.134262178623889e-06,0.00010472185333778093,-1.1007911935978498e-05,3.6381148949438114e-05,3.1510147920021936e-05,1.0899110617226195,1.0897016180159438,,False,True,1.0,1.0797,1.0889000000000002,1.0881000000000003,1.0877000000000003,1,0.01,True,2024-07-19 21:45:00,,2024-07-19 05:07:03,2024-07-19 01:35:00,1.0897000000000001,2024-07-19 05:07:03,1.08885,0.01,even,True,15.58,1608.38,32,0,29,7
2024-07-19 10:10:00,1.08855,1.08856,1.08817,1.08817,525,12,0,1.087862759948788,1.08856,0.00020132490273501766,0.00011301123395850184,-0.00015307534616435838,-7.630708857566883e-05,1.0884229820985982,1.0891426227104763,2024-07-19 10:00:00,2024-07-19 10:00:00,-0.00014119047618943448,-0.0007581705323254084,1.0886369047619042,-0.0001323219430744123,9.591203611625648e-06,1.0885686904761909,1.0883957603713248,1.0889699985637935,1.0885306736176823,1.0890323696091908,-6.346661175323072e-05,-0.00012025119155702698,1.0898323122645337,1.0900761024553445,34.27230046948974,40.36440867427612,-0.000771625377994036,,-1.0,0.08492273199236193,bearish,1.0885347223509059,1.088613854547939,1.0884672927416572,-7.913219703303831e-05,-5.3320786717068956e-05,0.00015631911775198135,-7.54385964916171e-05,-2.411420710002332e-06,2.3993808048849985e-05,1.0886236118594093,1.0883109736239052,,False,True,1.0,1.07817,1.0873700000000002,1.0865700000000003,1.0861700000000003,1,0.01,True,2024-07-23 13:10:00,,2024-07-23 11:18:49,2024-07-19 10:15:00,1.08817,2024-07-23 11:18:49,1.08739,0.01,even,True,14.3,1622.68,33,0,29,7
2024-07-19 14:20:00,1.08881,1.08891,1.0887,1.08878,319,12,0,1.0887066649603925,1.0889933348747227,-2.6024657015204754e-05,3.978981053363058e-05,0.00012937682376183829,0.00012025580857525914,1.0883211320478974,1.0887102395603505,2024-07-19 14:00:00,2024-07-19 14:00:00,1.9761904761050886e-05,-0.0006756867844259773,1.0884942857142863,0.00048634810021867483,0.00039454263837321063,1.0881795238095235,1.087217200397413,1.0884267111517143,1.0875663357212564,1.0887040365750955,-6.469819532992885e-05,5.936337394425703e-05,1.0893641869726416,1.0896017437368475,90.08620689654902,88.68978432131355,-0.0007364520269061953,,-1.0,0.08439465426386351,bearish,1.0885249572813813,1.0883712858751355,1.0887396112831098,0.00015367140624578113,9.526685790769102e-05,0.00031854722294196575,6.73305813552183e-05,0.00010481252150063014,9.596491227981119e-05,1.0890581585060517,1.088421064060168,,False,True,1.0,1.07878,1.0879800000000002,1.0871800000000003,1.0867800000000003,1,0.01,True,2024-07-23 12:55:00,,2024-07-19 22:01:31,2024-07-19 14:25:00,1.08878,2024-07-19 22:01:31,1.08797,0.01,even,True,14.85,1637.53,34,0,29,7
2024-07-19 14:30:00,1.08901,1.08908,1.08865,1.08871,314,12,0,1.0885983378481408,1.08908,6.582757911771204e-05,-3.3321210077393847e-06,3.394138549280031e-05,-5.854594604842257e-06,1.0886794582702017,1.0889722524532024,2024-07-19 14:00:00,2024-07-19 14:00:00,1.9761904761050886e-05,-0.0006756867844259773,1.0884942857142863,0.00048634810021867483,0.00039454263837321063,1.0881795238095235,1.087217200397413,1.0884267111517143,1.0875663357212564,1.0887040365750955,-6.469819532992885e-05,5.936337394425703e-05,1.0893641869726416,1.0896017437368475,79.74306964165169,86.63849447824997,-0.0007364520269061953,,-1.0,0.08439465426386351,bearish,1.0886165670476162,1.0884401833634565,1.0888236050911597,0.00017638368415973105,0.00012520451878232354,0.00034080786362727293,-4.1107671142626145e-06,8.81045751641718e-05,6.73305813552183e-05,1.089164412954787,1.0884827972275324,,False,True,1.0,1.07871,1.0879100000000002,1.0871100000000002,1.0867100000000003,1,0.01,True,2024-07-23 12:55:00,,2024-07-19 22:01:30,2024-07-19 14:35:00,1.08871,2024-07-19 22:01:30,1.08792,0.01,even,True,14.48,1652.01,35,0,29,7
2024-07-19 14:45:00,1.08896,1.08908,1.08881,1.08881,188,12,0,1.0887866672870854,1.0890691161867998,-1.683888388181254e-05,8.289958409970978e-05,-3.3321210077393847e-06,6.582757911771204e-05,1.088604435064285,1.0890796912298493,2024-07-19 14:00:00,2024-07-19 14:00:00,1.9761904761050886e-05,-0.0006756867844259773,1.0884942857142863,0.00048634810021867483,0.00039454263837321063,1.0881795238095235,1.087217200397413,1.0884267111517143,1.0875663357212564,1.0887040365750955,-6.469819532992885e-05,5.936337394425703e-05,1.0893641869726416,1.0896017437368475,77.25490196078381,76.07843137254959,-0.0007364520269061953,,-1.0,0.08439465426386351,bearish,1.0887213521804173,1.0885318470280956,1.088875954592363,0.00018950515232174503,0.00015690268186460118,0.000355961140074074,1.2057103543128278e-05,2.638114895026078e-05,1.39112487098636e-05,1.089231915732437,1.088519993452289,,False,True,1.0,1.07881,1.0880100000000001,1.0872100000000002,1.0868100000000003,1,0.01,True,2024-07-23 12:55:00,,2024-07-19 22:02:13,2024-07-19 14:50:00,1.08881,2024-07-19 22:02:13,1.08803,0.01,even,True,14.3,1666.31,36,0,29,7
2024-07-22 00:15:00,1.08832,1.08833,1.0883,1.0883099999999999,27,54,0,1.0882826488345412,1.0883191222659032,8.377364646803815e-06,6.45819478558955e-05,2.2564231869327916e-05,0.00017489735366181379,1.0877560996168831,1.088402078325142,2024-07-22 00:00:00,2024-07-22 00:00:00,-8.916666666780593e-05,-0.0003678844010219784,1.0880314285714288,9.113338630524754e-05,0.0001695834785891824,1.0879838095238092,1.087550162122286,1.0881656451687285,1.087515513234782,1.08839280115903,-7.849864295303506e-05,6.016706040058737e-05,1.0886793420105956,1.0888600228399044,77.5621968392944,65.7065027644009,-0.0004003056224512504,,-1.0,0.0842158431019863,bearish,1.088116090853248,1.0880605600162787,1.088207292741658,5.553083696918648e-05,1.9345200775267206e-05,0.00015635216632340783,3.5982112142285416e-05,4.524251806081736e-05,2.0760233917505033e-05,1.0883636449079814,1.0880509405753345,,False,True,1.0,1.0783099999999999,1.08751,1.08671,1.08631,1,0.01,True,2024-07-23 13:10:00,,2024-07-23 11:21:03,2024-07-22 00:20:00,1.0883099999999999,2024-07-23 11:21:03,1.08751,0.01,even,True,14.66,1680.97,37,0,30,7
2024-07-22 00:40:00,1.0884,1.08844,1.08832,1.08835,31,14,0,1.0880800087361613,1.08844,6.432340660854333e-05,2.7156190046692544e-05,9.999215901932317e-06,1.2521753647231283e-05,1.0882911537257596,1.0885091528142445,2024-07-22 00:00:00,2024-07-22 00:00:00,-8.916666666780593e-05,-0.0003678844010219784,1.0880314285714288,9.113338630524754e-05,0.0001695834785891824,1.0879838095238092,1.087550162122286,1.0881656451687285,1.087515513234782,1.08839280115903,-7.849864295303506e-05,6.016706040058737e-05,1.0886793420105956,1.0888600228399044,88.8888888888889,89.38866577420804,-0.0004003056224512504,,-1.0,0.0842158431019863,bearish,1.0882751570000144,1.0881672734103698,1.0883715239078091,0.00010788358964464173,7.124539003500684e-05,0.0002113646136733666,1.1750945993149742e-05,4.66769865843375e-05,5.0770553834844634e-05,1.0885828885214826,1.0881601592941357,,False,True,1.0,1.07835,1.08755,1.08675,1.0863500000000001,1,0.01,True,2024-07-23 13:10:00,,2024-07-23 11:21:45,2024-07-22 00:45:00,1.08835,2024-07-23 11:21:45,1.08754,0.01,even,True,14.85,1695.82,38,0,30,7
2024-07-24 08:10:00,1.08472,1.08476,1.0846,1.08466,154,12,0,1.0845825358286647,1.08476,3.6099238499370604e-05,3.3542906735796186e-05,5.377095959059805e-05,1.2551694191489346e-05,1.0845711062979533,1.0847880743219054,2024-07-24 08:00:00,2024-07-24 08:00:00,-3.4523809513409276e-06,-0.0005048600393815494,1.0846854761904765,0.00029431491488801957,0.0003552659002170051,1.08445130952381,1.083987842270003,1.0845206613654268,1.0841241736337663,1.0847667170853166,-3.725698987493501e-05,7.009787134578481e-05,1.085384967756008,1.0856007030015118,77.11184090494514,81.16417674022529,-0.0005894392681992318,,-1.0,0.08105878846726397,bearish,1.084599762965839,1.0845385283061733,1.084662886136911,6.123465966578756e-05,2.8316876863999103e-05,0.00013695863096935712,1.7963536290910298e-05,3.621259030017754e-05,5.676986584113308e-05,1.0847998447678804,1.0845259275059416,,False,True,1.0,1.07466,1.0830600000000001,1.0822600000000002,1.0816600000000003,1,0.01,True,2024-07-29 15:05:00,,2024-07-24 11:10:56,2024-07-24 08:15:00,1.08466,2024-07-24 11:10:56,1.08306,0.01,even,True,29.32,1725.1399999999999,39,0,30,7
2024-07-24 08:50:00,1.08518,1.0852,1.08508,1.08512,131,12,0,1.085090006239561,1.085330006806509,-9.216962347683393e-05,-6.450486394381653e-05,5.0685802199835707e-05,6.170174744686236e-05,1.084895468349245,1.0850944899920698,2024-07-24 08:00:00,2024-07-24 08:00:00,-3.4523809513409276e-06,-0.0005048600393815494,1.0846854761904765,0.00029431491488801957,0.0003552659002170051,1.08445130952381,1.083987842270003,1.0845206613654268,1.0841241736337663,1.0847667170853166,-3.725698987493501e-05,7.009787134578481e-05,1.085384967756008,1.0856007030015118,93.50641025641653,95.02430107711824,-0.0005894392681992318,,-1.0,0.08105878846726397,bearish,1.0849018262766426,1.084740231994806,1.085070787753698,0.00016159428183648572,0.00010882523230775691,0.00024389683596814005,4.8837289301939535e-05,7.837633298879432e-05,8.000000000096819e-05,1.0853146845896662,1.0848268909177299,,False,True,1.0,1.07512,1.0835200000000003,1.0827200000000003,1.0821200000000004,1,0.01,True,2024-07-29 14:55:00,,2024-07-24 11:40:34,2024-07-24 08:55:00,1.08512,2024-07-24 11:40:34,1.08352,0.01,even,True,29.32,1754.4599999999998,40,0,30,7
2024-07-24 10:25:00,1.08486,1.08491,1.08459,1.08459,272,12,0,1.0834132178381088,1.08491,-0.00024298191461637563,-0.00048297952176686086,-3.530621829474076e-05,5.609914159466054e-05,1.0842449391196352,1.0853652078964544,2024-07-24 10:00:00,2024-07-24 10:00:00,-0.00011202380952379798,-0.0004151053278813599,1.0840267857142853,-0.0009594967410526825,3.7248975295640255e-05,1.0845734523809527,1.0845171502884983,1.0852523665427611,1.08426720120952,1.0853311276857462,-8.216637720652713e-05,-3.190782410921087e-05,1.0850485110202241,1.0852835710204796,51.30434782608908,43.99787296972729,-0.0005237000564993329,,-1.0,0.08129382602812674,bearish,1.0845916097518817,1.084625485788339,1.0844438321293441,-3.38760364573254e-05,-4.8306432840241e-05,0.00031388055041361854,4.081527347876701e-05,8.09115927074e-05,8.144822841460453e-05,1.0847577126797578,1.0841299515789304,,False,True,1.0,1.07459,1.08379,1.0829900000000001,1.0825900000000002,1,0.01,True,2024-07-29 14:45:00,,2024-07-24 12:40:16,2024-07-24 10:30:00,1.08459,2024-07-24 12:40:16,1.08381,0.01,even,True,14.3,1768.7599999999998,41,0,30,7
2024-07-24 10:30:00,1.0839,1.0839,1.08315,1.08343,776,12,0,1.08315,1.0839,-3.655141565589369e-05,-0.00019405440661067418,-0.00031956307613863796,-0.0003473381257952007,1.0842598215109343,1.0855758170632133,2024-07-24 10:00:00,2024-07-24 10:00:00,-0.00011202380952379798,-0.0004151053278813599,1.0840267857142853,-0.0009594967410526825,3.7248975295640255e-05,1.0845734523809527,1.0845171502884983,1.0852523665427611,1.08426720120952,1.0853311276857462,-8.216637720652713e-05,-3.190782410921087e-05,1.0850485110202241,1.0852835710204796,35.87554846429919,45.509754719882324,-0.0005237000564993329,,-1.0,0.08129382602812674,bearish,1.0844129005592846,1.084536931285499,1.0842539834881315,-0.00012403072621447464,-6.345129151508773e-05,0.0004062031510567196,-0.000189848641212631,4.081527347876701e-05,8.09115927074e-05,1.0846601866391883,1.0838477803370747,,False,True,1.0,1.0734299999999999,1.0810300000000002,1.0802300000000002,1.0794300000000003,1,0.01,True,,,2024-07-29 17:53:13,2024-07-24 10:35:00,1.08343,2024-07-29 17:53:13,1.08102,0.01,even,True,44.17,1812.9299999999998,42,0,30,7
2024-07-24 10:35:00,1.08344,1.08357,1.08319,1.08335,488,12,0,1.08319,1.0835875767190661,-0.00011979074958789274,-0.0001469445888316759,-0.0006025442113055314,-0.0007226637216440631,1.084653883748869,1.0855115384685403,2024-07-24 10:00:00,2024-07-24 10:00:00,-0.00011202380952379798,-0.0004151053278813599,1.0840267857142853,-0.0009594967410526825,3.7248975295640255e-05,1.0845734523809527,1.0845171502884983,1.0852523665427611,1.08426720120952,1.0853311276857462,-8.216637720652713e-05,-3.190782410921087e-05,1.0850485110202241,1.0852835710204796,19.223507512297335,35.46780126756192,-0.0005237000564993329,,-1.0,0.08129382602812674,bearish,1.0842493773963178,1.0844490104495361,1.0840707086343317,-0.000199633053218351,-9.068764385574039e-05,0.0004817305608555669,-0.00018327485379976416,-0.000189848641212631,4.081527347876701e-05,1.0845524391951873,1.0835889780734762,,False,True,1.0,1.07335,1.0809500000000003,1.0801500000000004,1.0793500000000005,1,0.01,True,,,2024-07-29 17:52:38,2024-07-24 10:40:00,1.08335,2024-07-29 17:52:38,1.08095,0.01,even,True,43.99,1856.9199999999998,43,0,30,7
2024-07-25 04:50:00,1.08408,1.08413,1.08374,1.08382,230,12,0,1.0837312460935962,1.08413,-4.6523419010301263e-05,-0.00011710610019149934,9.224369562247048e-06,-4.9465437191252976e-05,1.0838965193401837,1.084210802519628,2024-07-25 04:00:00,2024-07-25 04:00:00,7.714285714355285e-05,-0.00026601806260551086,1.083829761904761,-9.226585183765807e-06,0.00013651810877886734,1.0838019047619054,1.0834391925107514,1.0839459064045993,1.0837187016943592,1.0841559386639126,-4.650248871680776e-05,-0.0001388082466025767,1.084316704353238,1.0844423920571977,61.87492540877137,74.78510541578906,-0.0002210655744122586,,-1.0,0.08050709657686798,bearish,1.0839390953626542,1.0838963265931107,1.0840417337461303,4.276876954345532e-05,3.2361329598821384e-05,0.0001657427723892692,-2.7234262126141218e-05,3.059855521181376e-05,4.790161678736027e-05,1.0842074765185197,1.083875990973741,,False,True,1.0,1.07382,1.08302,1.0822200000000002,1.0818200000000002,1,0.01,True,2024-07-29 15:00:00,,2024-07-29 12:10:42,2024-07-25 04:55:00,1.08382,2024-07-29 12:10:42,1.08303,0.01,even,True,14.48,1871.3999999999999,44,0,30,7
2024-07-25 04:55:00,1.08381,1.08385,1.08367,1.08374,182,12,0,1.083636669865735,1.083839180869195,-2.6148684871135004e-05,7.713017385053812e-05,-8.224058009901684e-05,-6.43391049041974e-05,1.083884391942129,1.0843011624413275,2024-07-25 04:00:00,2024-07-25 04:00:00,7.714285714355285e-05,-0.00026601806260551086,1.083829761904761,-9.226585183765807e-06,0.00013651810877886734,1.0838019047619054,1.0834391925107514,1.0839459064045993,1.0837187016943592,1.0841559386639126,-4.650248871680776e-05,-0.0001388082466025767,1.084316704353238,1.0844423920571977,33.58545172455674,57.838249097654945,-0.0002210655744122586,,-1.0,0.08050709657686798,bearish,1.0839084653068614,1.0838847468454729,1.083990350877194,2.3718461388488876e-05,3.0632755956754884e-05,0.00016695109044060561,-5.138286893635602e-05,-2.7234262126141218e-05,3.059855521181376e-05,1.0841573019676345,1.0838233997867535,,False,True,1.0,1.07374,1.0813400000000002,1.0805400000000003,1.0797400000000004,1,0.01,True,,,2024-07-29 17:57:40,2024-07-25 05:00:00,1.08374,2024-07-29 17:57:40,1.08134,0.01,even,True,43.99,1915.3899999999999,45,0,30,7
2024-07-26 09:20:00,1.08506,1.0852,1.08499,1.08517,196,12,0,1.08499,1.0852537259222441,9.47486235420686e-06,-3.186071515457567e-05,-0.0001016094196166365,-6.297348434094292e-05,1.0851527484914592,1.0855109845612614,2024-07-26 09:00:00,2024-07-26 09:00:00,9.761904762317641e-06,0.0002569164249688338,1.0855784523809515,-0.0002906296877276162,-0.0001151197440312871,1.0857785714285717,1.0855950552096445,1.0861148073898086,1.0853507183738071,1.0858065904622702,9.287112945693722e-05,0.00012015781457404302,1.0851596699661479,1.0851041149952032,10.645264389076253,10.635944425549582,0.0001903628472931569,,1.0,0.08225540525102179,bullish,1.085435055611365,1.0855565618010528,1.0853144719642243,-0.00012150618968775895,-4.0455118259533654e-05,0.00023429468607802042,-8.233574131422117e-05,-0.00011187134502921303,-0.00010430684554596503,1.0855487666503023,1.0850801772781462,,True,False,0.0,1.09517,1.0859699999999999,1.0867699999999998,1.0871699999999997,0,0.01,True,,,2024-07-26 15:07:58,2024-07-26 09:25:00,1.08517,2024-07-26 15:07:58,1.08597,0.01,even,True,14.67,1930.06,46,0,30,7
2024-07-26 09:40:00,1.08502,1.08518,1.08502,1.08516,187,12,0,1.08502,1.0851785710751638,1.8824360731361443e-05,2.501151179291262e-05,-1.868966284767408e-05,-7.680107130102594e-06,1.0850076519152938,1.0852283423576645,2024-07-26 09:00:00,2024-07-26 09:00:00,9.761904762317641e-06,0.0002569164249688338,1.0855784523809515,-0.0002906296877276162,-0.0001151197440312871,1.0857785714285717,1.0855950552096445,1.0861148073898086,1.0853507183738071,1.0858065904622702,9.287112945693722e-05,0.00012015781457404302,1.0851596699661479,1.0851041149952032,9.627062706273355,11.349834983502362,0.0001903628472931569,,1.0,0.08225540525102179,bullish,1.0852750950318966,1.085437440870268,1.0850426694186457,-0.00016234583837149152,-0.00010805479566962806,0.00030212138828305743,-4.15376676985435e-05,-7.792569659303972e-05,-8.400756794113562e-05,1.0853447908069287,1.0847405480303627,,True,False,0.0,1.09516,1.0859599999999998,1.0867599999999997,1.0871599999999997,0,0.01,True,,,2024-07-26 15:09:23,2024-07-26 09:45:00,1.08516,2024-07-26 15:09:23,1.08595,0.01,even,True,14.48,1944.54,47,0,30,7
2024-07-26 09:55:00,1.08515,1.08526,1.08509,1.08517,175,12,0,1.0851008488888765,1.0853066612153726,-8.321275627187607e-05,6.142530917005332e-05,2.501151179291262e-05,1.8824360731361443e-05,1.0850216694567953,1.0851807895702237,2024-07-26 09:00:00,2024-07-26 09:00:00,9.761904762317641e-06,0.0002569164249688338,1.0855784523809515,-0.0002906296877276162,-0.0001151197440312871,1.0857785714285717,1.0855950552096445,1.0861148073898086,1.0853507183738071,1.0858065904622702,9.287112945693722e-05,0.00012015781457404302,1.0851596699661479,1.0851041149952032,17.909016168823502,15.216268845307958,0.0001903628472931569,,1.0,0.08225540525102179,bullish,1.0852231549783589,1.0853764351774593,1.0849819539043697,-0.00015328019910043622,-0.00013252771561773582,0.000323155277317742,2.865497076287582e-06,-1.831441348421059e-05,-4.526659786807663e-05,1.0853051091816874,1.084658798627052,,True,False,0.0,1.09517,1.0859699999999999,1.0867699999999998,1.0871699999999997,0,0.01,True,,,2024-07-26 15:07:58,2024-07-26 10:00:00,1.08517,2024-07-26 15:07:58,1.08597,0.01,even,True,14.67,1959.21,48,0,30,7
2024-07-29 01:50:00,1.08562,1.08563,1.0855299999999999,1.08557,102,12,0,1.0855299999999999,1.0856633378124494,-4.3432001750968647e-05,-1.9959538076144984e-05,-2.609870767969911e-05,-3.658556038260866e-05,1.0856567388293028,1.0858343496176164,2024-07-29 01:00:00,2024-07-29 01:00:00,-9.404761904585612e-06,5.754516838907264e-05,1.085541428571429,2.302721841234872e-05,0.00010591119241588113,1.0856427380952385,1.0851670625939644,1.0857744388262476,1.085468900109848,1.085831230769538,2.3418071324141023e-05,-0.00013398753679028883,1.0855947922606015,1.0855463049520953,36.2318840579745,48.30917874396607,0.00014696377812432353,,-1.0,0.08210460869507169,bearish,1.0857239939990184,1.0857231640849068,1.0857285792913656,8.299141116552278e-07,2.0294834162396515e-05,0.00014025809516115582,-3.375300997521258e-05,-4.086687306559256e-05,-1.3766769865419803e-05,1.0858688373865266,1.0855883211962045,,False,True,1.0,1.07557,1.08397,1.0831700000000002,1.0825700000000003,1,0.01,True,2024-07-29 14:45:00,,2024-07-29 12:53:07,2024-07-29 01:55:00,1.08557,2024-07-29 12:53:07,1.08395,0.01,even,True,29.69,1988.9,49,0,31,7
2024-07-29 01:55:00,1.08556,1.08562,1.0855,1.08555,80,12,0,1.0855,1.0857083427039713,-5.922544692800952e-05,-8.137203598602344e-05,-7.521770312476929e-05,-5.833987626468285e-05,1.085648135926119,1.0858549684491563,2024-07-29 01:00:00,2024-07-29 01:00:00,-9.404761904585612e-06,5.754516838907264e-05,1.085541428571429,2.302721841234872e-05,0.00010591119241588113,1.0856427380952385,1.0851670625939644,1.0857744388262476,1.085468900109848,1.085831230769538,2.3418071324141023e-05,-0.00013398753679028883,1.0855947922606015,1.0855463049520953,21.739130434784688,35.507246376815615,0.00014696377812432353,,-1.0,0.08210460869507169,bearish,1.0856972256914772,1.0857103371156545,1.0856973890608868,-1.3111424177258968e-05,1.3613582494465419e-05,0.000135421563736679,-3.119023047881697e-05,-3.375300997521258e-05,-4.086687306559256e-05,1.0858328106246233,1.0855619674971502,,False,True,1.0,1.07555,1.0839500000000002,1.0831500000000003,1.0825500000000003,1,0.01,True,2024-07-29 14:45:00,,2024-07-29 12:53:00,2024-07-29 02:00:00,1.08555,2024-07-29 12:53:00,1.08395,0.01,even,True,29.32,2018.22,50,0,31,7
2024-07-29 18:20:00,1.08221,1.08232,1.08206,1.08217,286,12,0,1.0820708152981084,1.0823400190688295,-0.00010666580958515796,-7.854852492310143e-05,3.105206205731653e-05,3.734538035906521e-05,1.0819231906956501,1.0822218336359481,2024-07-29 18:00:00,2024-07-29 18:00:00,-0.00016916666666633162,-0.0011377632333746668,1.0814316666666675,0.0001988541948771294,0.0002907539465438979,1.0814195238095243,1.0800321054026207,1.0817047371967323,1.081402901128585,1.0820684248104788,-0.0002545751943605526,-0.0005647141989181209,1.0836989966203872,1.0839299775425262,93.1333274725729,93.5489784072443,-0.0006928377800170527,,-1.0,0.07823734512272812,bearish,1.081580322981213,1.0814554880239997,1.0817280048159612,0.00012483495721338222,-9.197580200839696e-05,0.0005805178721983481,0.00019288957688279318,0.00021906432748597382,0.00021273133814903034,1.0823085226881595,1.081147486943763,,False,True,1.0,1.07217,1.08817,1.0813700000000002,1.0811700000000002,1,0.01,False,,,,2024-07-29 18:25:00,1.08217,,,0.01,running,False,0.0,2018.22,0,1,31,7
2024-07-29 18:30:00,1.08217,1.08217,1.08184,1.08198,337,12,0,1.0818333346102387,1.08217,-3.3894821680930115e-05,-6.185935361207425e-05,-5.082015327323926e-05,-4.288840965712145e-05,1.0819863436444876,1.0823706709670722,2024-07-29 18:00:00,2024-07-29 18:00:00,-0.00016916666666633162,-0.0011377632333746668,1.0814316666666675,0.0001988541948771294,0.0002907539465438979,1.0814195238095243,1.0800321054026207,1.0817047371967323,1.081402901128585,1.0820684248104788,-0.0002545751943605526,-0.0005647141989181209,1.0836989966203872,1.0839299775425262,89.95215311004893,92.60007173799352,-0.0006928377800170527,,-1.0,0.07823734512272812,bearish,1.0817198762173184,1.0815440329423867,1.0820348572411427,0.00017584327493169738,2.452206713102476e-06,0.0006245953356173136,0.00013062607499247925,0.00017622635018899047,0.00019288957688279318,1.0826594525767599,1.0814102619055255,,False,True,1.0,1.07198,1.08798,1.08118,1.08098,1,0.01,False,,,,2024-07-29 18:35:00,1.08198,,,0.01,running,False,0.0,2018.22,0,2,31,7
2024-07-29 18:35:00,1.08197,1.08201,1.08186,1.08191,298,12,0,1.081763333842554,1.0820550015183112,-3.0818641997877855e-06,-2.310585609604155e-05,-7.854852492310143e-05,-0.00010666580958515796,1.0820617285539562,1.0823333259333876,2024-07-29 18:00:00,2024-07-29 18:00:00,-0.00016916666666633162,-0.0011377632333746668,1.0814316666666675,0.0001988541948771294,0.0002907539465438979,1.0814195238095243,1.0800321054026207,1.0817047371967323,1.081402901128585,1.0820684248104788,-0.0002545751943605526,-0.0005647141989181209,1.0836989966203872,1.0839299775425262,85.80542264752647,90.15743679631139,-0.0006928377800170527,,-1.0,0.07823734512272812,bearish,1.0817491260300387,1.081571141613321,1.0821432094943242,0.0001779844167177913,3.7558648714040244e-05,0.0006349335922820568,0.00010835225318150954,0.00013062607499247925,0.00017622635018899047,1.0827781430866061,1.0815082759020422,,False,True,1.0,1.07191,1.08791,1.08111,1.08091,1,0.01,False,,,,2024-07-29 18:40:00,1.08191,,,0.01,running,False,0.0,2018.22,0,3,31,7
2024-07-29 18:45:00,1.08192,1.08198,1.0818,1.0818699999999999,247,12,0,1.0818,1.082003335434106,-6.446570186655618e-05,-1.540473422787623e-05,-6.185935361207425e-05,-3.3894821680930115e-05,1.08183044912845,1.0821647322517083,2024-07-29 18:00:00,2024-07-29 18:00:00,-0.00016916666666633162,-0.0011377632333746668,1.0814316666666675,0.0001988541948771294,0.0002907539465438979,1.0814195238095243,1.0800321054026207,1.0817047371967323,1.081402901128585,1.0820684248104788,-0.0002545751943605526,-0.0005647141989181209,1.0836989966203872,1.0839299775425262,79.74481658691944,82.34981392875959,-0.0006928377800170527,,-1.0,0.07823734512272812,bearish,1.0817886641990218,1.081616520587552,1.0822800963192292,0.00017214361146966617,8.688763939331119e-05,0.0006538407043065685,5.537667698596316e-05,8.151014791901723e-05,0.00010835225318150954,1.0829339370235358,1.0816262556149225,,False,True,1.0,1.0718699999999999,1.08787,1.08107,1.08087,1,0.01,False,,,,2024-07-29 18:50:00,1.0818699999999999,,,0.01,running,False,0.0,2018.22,0,4,31,7
