time,open,high,low,close,tick_volume,spread,real_volume,hourly_time,time2,prev_hour_lsma_slope,prev_hour_macd_line,hour_lsma,fixed_support_gradient,fixed_resistance_gradient,prev_hour_lsma,fixed_support_trendline,fixed_resistance_trendline,prev_fixed_support_trendline,prev_fixed_resistance_trendline,prev_fixed_resistance_gradient,prev_fixed_support_gradient,ema_50,ema_24,stoch_k,stoch_d,prev_hour_macd_signal,ema_short,ema_long,lsma,macd_line,macd_signal,lsma_stddev,lsma_slope,prev_lsma_slope_1,prev_lsma_slope_2,lsma_upper_band,lsma_lower_band,is_buy2,is_sell2,tp,sl,be,be_condition,time_updated,sl_updated,time_to_trail,time_tp_hit,time_sl_hit,lot_size,type,success,profit,account_balance,win_streak,losing_streak,Week,Month
2023-12-06 00:15:00,44151.938,44491.137,44093.738,44392.238,3277,46386,0,2023-12-06 00:00:00,2023-12-06 00:00:00,209.56657142854965,590.1578086358495,44151.315428571404,0.006471759611680691,0.0020997675188054008,43956.70298809521,44826.6001884621,44955.332339015054,44841.34858628044,45875.89509864702,0.00500880793503213,0.007257528469854434,41500.839552189645,42581.75264901036,85.51644309684485,77.17518607111401,375.44624173776174,43893.88140922092,43513.69189042075,44001.248173374624,380.18951880017266,379.4609864443487,463.20704899569046,82.02451014794497,42.93300240790268,70.8790399036734,44628.07768951881,43375.91865723044,True,False,45092.238,43942.238,44862.238,44892.238,,False,,,2023-12-06 01:14:28,0.02,fail,False,-164.08,535.92,0,1,49,12
2023-12-07 21:00:00,43301.238,43331.34,43182.059,43232.039,1367,35121,0,2023-12-07 21:00:00,2023-12-07 21:00:00,-74.62263095234084,-80.5595301577996,43388.369119047595,0.0004214706311623597,-0.0008569867680629217,43494.92763095239,43134.46964047737,43644.07110509345,43426.61105924381,44391.21358449176,0.0015574872446686037,0.0011625445750340327,43298.89609412316,43541.253888050116,9.31558100493447,16.588938195398057,-79.46681215614629,43413.03769357399,43451.50156274273,43345.72127313382,-38.46386916873598,1.4185512383665237,182.3650741821412,-73.74942758854013,-61.07958410734864,-69.43233058135229,43591.91412327971,43098.02842298793,False,True,42532.039,43682.039,42762.039,42732.039,,False,,,2023-12-08 13:43:54,0.02,fail,False,-164.08,371.8399999999999,0,2,49,12
2023-12-07 21:15:00,43233.84,43272.039,43129.066,43134.438,1206,42325,0,2023-12-07 21:00:00,2023-12-07 21:00:00,-74.62263095234084,-80.5595301577996,43388.369119047595,0.0004214706311623597,-0.0008569867680629217,43494.92763095239,43134.46964047737,43644.07110509345,43426.61105924381,44391.21358449176,0.0015574872446686037,0.0011625445750340327,43298.89609412316,43541.253888050116,6.4287702162856775,11.02821065755343,-79.46681215614629,43370.176202254916,43428.01537290993,43265.67790368074,-57.83917065501737,-10.432993140310256,191.81768957753712,-80.04336945308023,-73.74942758854013,-61.07958410734864,43524.631784610414,43005.22402275107,False,True,42434.438,43584.438,42664.438,42634.438,,False,,,2023-12-08 13:37:49,0.02,fail,False,-164.08,207.7599999999999,0,3,49,12
2023-12-07 21:30:00,43134.438,43237.637,43070.965,43073.238,1300,42825,0,2023-12-07 21:00:00,2023-12-07 21:00:00,-74.62263095234084,-80.5595301577996,43388.369119047595,0.0004214706311623597,-0.0008569867680629217,43494.92763095239,43134.46964047737,43644.07110509345,43426.61105924381,44391.21358449176,0.0015574872446686037,0.0011625445750340327,43298.89609412316,43541.253888050116,2.9207711157032157,6.221707445641122,-79.46681215614629,43324.49340190801,43401.7355675092,43186.65401616788,-77.24216560118657,-23.79482763248552,203.96272247610452,-79.02388751286344,-80.04336945308023,-73.74942758854013,43462.00369151062,42909.80434082514,False,True,42373.238,43523.238,42603.238,42573.238,,False,,,2023-12-08 04:54:17,0.02,fail,False,-164.08,43.67999999999989,0,4,49,12
2023-12-08 03:15:00,43317.445,43417.738,43313.305,43386.34,640,48281,0,2023-12-08 03:00:00,2023-12-08 03:00:00,75.01589285720547,-83.1971144594354,43332.32444047619,0.0003039255585536445,-0.00011510531687432637,43276.153642857185,43194.61715235538,43405.55416473125,43182.91924907799,43259.84923025323,-0.0009371742400946459,0.0003088842707742104,43299.82351633956,43449.12363418231,81.81864635641502,77.12135622132541,-93.61659376106292,43325.01489790337,43323.48914325412,43325.404067079464,1.5257546492503025,-17.27780977302893,91.41844606729529,10.62978912969993,-7.098457860323833,17.67399621599907,43450.31896927031,43201.98916488862,True,False,44086.34,43856.34,43856.34,43886.34,2023-12-08 16:45:00,True,2023-12-08 16:45:00,2023-12-08 22:33:09,2023-12-08 16:53:25,0.02,even,True,171.33,215.0099999999999,1,0,49,12
2023-12-08 03:30:00,43386.238,43418.738,43362.891,43410.84,633,43422,0,2023-12-08 03:00:00,2023-12-08 03:00:00,75.01589285720547,-83.1971144594354,43332.32444047619,0.0003039255585536445,-0.00011510531687432637,43276.153642857185,43194.61715235538,43405.55416473125,43182.91924907799,43259.84923025323,-0.0009371742400946459,0.0003088842707742104,43299.82351633956,43449.12363418231,85.54737265745082,80.21002298463095,-93.61659376106292,43338.218759764386,43329.959577087146,43343.771121775055,8.25918267724046,-12.170411282975053,90.18918358283953,18.367054695590923,10.62978912969993,-7.098457860323833,43467.026519611885,43222.015723938224,True,False,44110.84,43880.84,43880.84,43910.84,2023-12-08 16:45:00,True,2023-12-08 16:45:00,2023-12-08 22:33:09,2023-12-08 16:46:15,0.02,even,True,171.33,386.3399999999999,2,0,49,12
2023-12-08 04:00:00,43403.738,43500.738,43394.039,43471.387,662,45922,0,2023-12-08 04:00:00,2023-12-08 04:00:00,56.170797619008226,-65.14420921399869,43403.66596428568,0.0007569925152595637,0.00040448992374755323,43332.32444047619,43338.75059216419,43597.17129027959,43194.61715235538,43405.55416473125,-0.00011510531687432637,0.0003039255585536445,43307.59039805173,43453.02406344773,94.95311306249307,91.51120294097996,-87.92211685165007,43367.23531320409,43345.4959309732,43391.36461678705,21.739382230887713,-1.3813471866869351,85.82410455485524,28.779889920879214,18.81360509111255,18.367054695590923,43508.727157936104,43275.50207563799,True,False,44171.387,43941.387,43941.387,43971.387,2023-12-08 22:30:00,True,2023-12-08 22:30:00,2023-12-08 22:35:38,2023-12-11 00:00:06,0.02,success,True,255.17,641.5099999999999,3,0,49,12
2023-12-08 04:30:00,43473.027,43508.039,43442.645,43508.039,760,44426,0,2023-12-08 04:00:00,2023-12-08 04:00:00,56.170797619008226,-65.14420921399869,43403.66596428568,0.0007569925152595637,0.00040448992374755323,43332.32444047619,43338.75059216419,43597.17129027959,43194.61715235538,43405.55416473125,-0.00011510531687432637,0.0003039255585536445,43307.59039805173,43453.02406344773,95.30154363788047,94.63697048614416,-87.92211685165007,43403.061212412395,43366.48972957236,43462.71719057444,36.57148284003779,11.039603009131417,97.77293956538284,39.201532163715456,32.151041623677884,28.779889920879214,43596.21065898771,43330.72372216117,True,False,44208.039,43978.039,43978.039,44008.039,2023-12-08 22:30:00,True,2023-12-08 22:30:00,2023-12-08 22:41:23,2023-12-11 00:00:06,0.02,success,True,255.17,896.6799999999998,4,0,49,12
2023-12-08 13:00:00,43372.34,43473.637,43369.637,43450.738,1134,44723,0,2023-12-08 13:00:00,2023-12-08 13:00:00,36.51151190474775,-48.19885289070953,43363.776773809484,-0.0002438182120074061,0.0006375886092669545,43239.47891666662,43024.67361897666,43856.63683030255,42696.67165451155,43236.78788347548,-0.0008259701157434301,-0.0014251462490310605,43321.68760331557,43402.11837663324,85.44080134107539,67.21290304922009,-49.63880467458869,43287.49979962807,43301.66186405778,43272.81818954247,-14.162064429707243,-38.47189881029655,114.2224597055155,49.502275885795825,40.523470588239434,23.091707946296083,43428.51851014492,43118.617868940026,True,False,44150.738,43920.738,43920.738,43950.738,2023-12-08 17:00:00,True,2023-12-08 17:00:00,2023-12-08 22:33:55,2023-12-08 17:02:29,0.02,even,True,171.33,1068.0099999999998,5,0,49,12
2023-12-08 13:15:00,43450.84,43522.039,43420.668,43503.738,1137,39426,0,2023-12-08 13:00:00,2023-12-08 13:00:00,36.51151190474775,-48.19885289070953,43363.776773809484,-0.0002438182120074061,0.0006375886092669545,43239.47891666662,43024.67361897666,43856.63683030255,42696.67165451155,43236.78788347548,-0.0008259701157434301,-0.0014251462490310605,43321.68760331557,43402.11837663324,96.72970410929992,83.6867918036573,-49.63880467458869,43320.76721506991,43316.63046672016,43330.86692053665,4.136748349745176,-29.950169378288205,116.80045543509131,58.048730994181824,49.502275885795825,40.523470588239434,43490.047535374026,43173.18630569928,True,False,44203.738,43973.738,43973.738,44003.738,2023-12-08 22:30:00,True,2023-12-08 22:30:00,2023-12-08 22:41:23,2023-12-11 00:00:06,0.02,success,True,255.17,1323.1799999999998,6,0,49,12
2023-12-08 13:30:00,43503.738,43692.238,43466.039,43669.938,1590,42723,0,2023-12-08 13:00:00,2023-12-08 13:00:00,36.51151190474775,-48.19885289070953,43363.776773809484,-0.0002438182120074061,0.0006375886092669545,43239.47891666662,43024.67361897666,43856.63683030255,42696.67165451155,43236.78788347548,-0.0008259701157434301,-0.0014251462490310605,43321.68760331557,43402.11837663324,95.52767348608769,92.56605964548766,-49.63880467458869,43374.48579736684,43342.80139511126,43416.3365249398,31.684402255581517,-17.62325505151426,135.15920560525944,85.46960440314433,58.048730994181824,49.502275885795825,43600.3014525069,43233.871597372694,True,False,44369.938,44139.938,44139.938,44169.938,2023-12-08 22:45:00,True,2023-12-08 22:45:00,2023-12-08 22:56:56,2023-12-11 00:00:06,0.02,success,True,255.17,1578.35,7,0,49,12
2023-12-08 22:15:00,43948.602,44040.438,43946.859,44031.539,799,40765,0,2023-12-08 22:00:00,2023-12-08 22:00:00,48.99567857140937,121.6890927850327,44031.811571428596,0.0009361959962832404,0.0013749563825156432,43845.801833333324,43898.34135308268,44641.08092860089,43849.205961741805,43918.28231182748,-0.0003436379835484037,0.0009037882316310555,43487.02342191771,43657.22618996498,91.66351214464186,86.38165040528469,78.60856222944665,43882.75184986435,43808.91805437543,43902.07568524251,73.83379548892117,63.669134158052046,101.22623683004967,32.92769556240091,36.06566047472734,34.49651702785195,44040.23110496308,43765.42026552194,True,False,44731.539,43581.539,44501.539,44531.539,,False,2023-12-08 23:30:00,2023-12-08 23:25:53,2023-12-11 01:18:14,0.02,success,True,255.17,1833.52,8,0,49,12
2023-12-08 22:30:00,44028.066,44270.109,44024.336,44222.637,1634,42824,0,2023-12-08 22:00:00,2023-12-08 22:00:00,48.99567857140937,121.6890927850327,44031.811571428596,0.0009361959962832404,0.0013749563825156432,43845.801833333324,43898.34135308268,44641.08092860089,43849.205961741805,43918.28231182748,-0.0003436379835484037,0.0009037882316310555,43487.02342191771,43657.22618996498,92.28510373219923,90.54297781911093,78.60856222944665,43935.04187296214,43839.56390219947,43979.41643515651,95.47797076266579,70.0309014789748,119.56932354313291,77.34074991400121,32.92769556240091,36.06566047472734,44142.33502193974,43817.997848373285,True,False,44922.637,43772.637,44692.637,44722.637,,False,,,2023-12-11 00:01:48,0.02,fail,False,-164.07,1669.45,0,1,49,12
2023-12-08 22:45:00,44221.84,44414.938,44152.957,44366.938,2044,33715,0,2023-12-08 22:00:00,2023-12-08 22:00:00,48.99567857140937,121.6890927850327,44031.811571428596,0.0009361959962832404,0.0013749563825156432,43845.801833333324,43898.34135308268,44641.08092860089,43849.205961741805,43918.28231182748,-0.0003436379835484037,0.0009037882316310555,43487.02342191771,43657.22618996498,94.64724186553697,92.865285914126,78.60856222944665,44001.487430967965,43878.62865018469,44078.09180564158,122.85878078327369,80.59647733983458,155.4814152127565,98.67537048507074,77.34074991400121,32.92769556240091,44289.4917161788,43868.19189510436,True,False,45066.938,43916.938,44836.938,44866.938,,False,,,2023-12-11 00:00:06,0.02,fail,False,-164.07,1505.38,0,2,49,12
2023-12-11 03:15:00,43382.637,43398.738,43234.285,43311.84,1484,33722,0,2023-12-11 03:00:00,2023-12-11 03:00:00,-126.89825000003475,75.76852988929022,43613.2038809524,-0.0017741556002885694,-0.0029113762485643564,43874.011833333316,42907.15173547771,43754.48439637497,43446.453737788404,45115.107892107306,0.0012391248355260885,-0.00038139932758212943,43530.075649624625,43673.09842209934,11.257111774613875,11.430946865837901,116.07315206178063,43654.43747917303,43773.68250648341,43414.2857416581,-119.24502731038228,-50.67682084003087,324.1793735752841,-70.11711283113982,-83.07566047464934,-63.29621706227044,43851.927895984736,42975.14358733147,False,True,42611.84,43761.84,42841.84,42811.84,,False,2023-12-11 04:15:00,2023-12-11 04:07:10,,0.02,success,True,255.18,1760.5600000000002,1,0,50,12
2023-12-11 03:45:00,43257.824,43367.438,43212.66,43215.539,951,38726,0,2023-12-11 03:00:00,2023-12-11 03:00:00,-126.89825000003475,75.76852988929022,43613.2038809524,-0.0017741556002885694,-0.0029113762485643564,43874.011833333316,42907.15173547771,43754.48439637497,43446.453737788404,45115.107892107306,0.0012391248355260885,-0.00038139932758212943,43530.075649624625,43673.09842209934,9.230560199775226,10.83686257945664,116.07315206178063,43535.66381644932,43697.15716399469,43309.547746474,-161.49334754537267,-87.42276102001433,372.9731907200306,-37.035348813231394,-67.70264637086802,-70.11711283113982,43813.06155394604,42804.533939001965,False,True,42515.539,43665.539,42745.539,42715.539,,False,2023-12-11 04:15:00,2023-12-11 04:07:12,,0.02,success,True,255.18,2015.7400000000002,2,0,50,12
2023-12-13 17:30:00,41746.738,41943.039,41725.84,41895.938,2308,42223,0,2023-12-13 17:00:00,2023-12-13 17:00:00,46.62583333337534,31.45225224871683,41540.06252380952,0.0006867764460522104,0.0022806587928473894,41322.92464285715,41171.78420110098,42299.80841087632,41215.24870009113,41680.80237712303,0.0009810061023630629,0.0009958041282282638,41544.64543764796,41310.000436722396,89.07564152936821,87.56955697183412,-41.31875060886641,41526.37630584519,41371.710374304086,41678.07017371858,154.6659315411016,97.59936393646566,225.24760242700287,92.37475954591355,71.72488820087892,92.11598796006729,41983.654436995035,41373.98591044213,True,False,42595.938,41445.938,42365.938,42395.938,,False,2023-12-13 21:45:00,2023-12-13 21:36:26,2023-12-14 15:30:45,0.02,success,True,255.18,2270.92,3,0,50,12
2023-12-13 17:45:00,41895.938,41949.738,41844.25,41933.738,1407,43325,0,2023-12-13 17:00:00,2023-12-13 17:00:00,46.62583333337534,31.45225224871683,41540.06252380952,0.0006867764460522104,0.0022806587928473894,41322.92464285715,41171.78420110098,42299.80841087632,41215.24870009113,41680.80237712303,0.0009810061023630629,0.0009958041282282638,41544.64543764796,41310.000436722396,91.39303595785731,89.25960100342336,-41.31875060886641,41589.04733571516,41413.342050281564,41764.54376814583,175.7052854335925,113.22054823589104,255.1140883672049,86.47359442724701,92.37475954591355,71.72488820087892,42110.44778744155,41420.1397488501,True,False,42633.738,41483.738,42403.738,42433.738,,False,2023-12-13 21:45:00,2023-12-13 21:36:47,2023-12-14 15:30:45,0.02,success,True,255.18,2526.1,4,0,50,12
2023-12-13 18:00:00,41934.039,42221.938,41885.57,42154.34,2716,31321,0,2023-12-13 18:00:00,2023-12-13 18:00:00,217.13788095237396,103.87099095399753,41706.05032142857,0.0025635782882946828,0.0032782120609406926,41540.06252380952,41795.204961140334,42729.08035870642,41171.78420110098,42299.80841087632,0.0022806587928473894,0.0006867764460522104,41557.1391067598,41354.259121784606,95.39406634595683,91.95424794439411,-12.280802296293622,41676.01543791283,41468.23078729775,41874.69415755075,207.78465061508177,132.1333687117292,300.7308881125655,110.15038940492377,86.47359442724701,92.37475954591355,42282.18085650272,41468.70745859879,True,False,42854.34,41704.34,42624.34,42654.34,,False,2023-12-13 21:45:00,2023-12-13 21:40:12,2023-12-14 15:30:41,0.02,success,True,255.18,2781.2799999999997,5,0,50,12
2023-12-13 21:00:00,42115.137,42459.738,42115.137,42363.84,3976,39723,0,2023-12-13 21:00:00,2023-12-13 21:00:00,144.35654761902697,226.20196170116105,42326.57813095237,0.004121837186771378,0.005155119330496734,42057.64324999999,42755.72847882574,43696.8956281471,42421.029187128464,43375.99486066834,0.004774336870181948,0.003570036076114227,41643.867087735365,41570.85944030421,80.022676450898,78.74643093503852,88.53272082438255,42050.587477991154,41834.1638838617,42198.15259786721,216.4235941294537,204.6582550951018,321.2523072927402,34.10815204679966,-2.089968008323922,4.606748194062675,42633.3432127124,41764.46198302201,True,False,43063.84,41913.84,42833.84,42863.84,,False,2023-12-14 00:00:00,2023-12-13 23:54:41,2023-12-14 15:29:35,0.02,success,True,255.18,3036.4599999999996,6,0,50,12
2023-12-13 21:15:00,42363.84,42428.938,42238.438,42371.539,2418,41824,0,2023-12-13 21:00:00,2023-12-13 21:00:00,144.35654761902697,226.20196170116105,42326.57813095237,0.004121837186771378,0.005155119330496734,42057.64324999999,42755.72847882574,43696.8956281471,42421.029187128464,43375.99486066834,0.004774336870181948,0.003570036076114227,41643.867087735365,41570.85944030421,84.890239554581,80.19799071162436,88.53272082438255,42099.96463522328,41873.96944802009,42223.45747024427,225.99518720318883,208.92564151671922,323.8338254753183,25.304872377062566,34.10815204679966,-2.089968008323922,42662.13313463595,41786.28180585259,True,False,43071.539,41921.539,42841.539,42871.539,,False,2023-12-14 00:00:00,2023-12-13 23:54:42,2023-12-14 15:29:35,0.02,success,True,255.18,3291.6399999999994,7,0,50,12
2023-12-13 21:30:00,42375.137,42879.625,42301.746,42721.34,3920,35610,0,2023-12-13 21:00:00,2023-12-13 21:00:00,144.35654761902697,226.20196170116105,42326.57813095237,0.004121837186771378,0.005155119330496734,42057.64324999999,42755.72847882574,43696.8956281471,42421.029187128464,43375.99486066834,0.004774336870181948,0.003570036076114227,41643.867087735365,41570.85944030421,87.32169114549778,84.0782023836589,88.53272082438255,42195.56084518893,41936.737637055645,42333.593485036145,258.8232081332826,218.9051548400319,351.2781016065863,110.13601479187491,25.304872377062566,34.10815204679966,42809.318922205035,41859.368047867254,True,False,43421.34,42271.34,43191.34,43221.34,,False,2023-12-14 00:15:00,2023-12-14 00:13:45,2023-12-14 15:29:33,0.02,success,True,255.18,3546.8199999999993,8,0,50,12
2023-12-15 15:15:00,42578.137,42608.738,42424.738,42437.137,1546,44023,0,2023-12-15 15:00:00,2023-12-15 15:00:00,-36.19405952379748,-25.863372911378974,42605.111083333315,-0.0010862301526073249,-0.0004542357643727888,42769.255309523825,42018.476473883005,42878.43751764057,42654.634067358624,43251.46906251401,0.0007787282092666009,0.00035763608827049794,42577.30210268688,42720.148106341105,11.433625890989303,18.383912288660984,-5.561982719526444,42671.713488429785,42723.38829937017,42597.42648847609,-51.674810940385214,-16.552693429251395,122.72963632741579,-60.52501375992142,-46.25004231162893,-46.38934158927441,42763.111497518104,42430.24147943408,False,True,41737.137,42887.137,41967.137,41937.137,,False,2023-12-15 17:45:00,2023-12-15 17:39:15,2023-12-19 02:10:12,0.02,success,True,255.18,3801.999999999999,9,0,50,12
2023-12-15 15:30:00,42435.941,42513.438,42251.738,42290.938,2600,42023,0,2023-12-15 15:00:00,2023-12-15 15:00:00,-36.19405952379748,-25.863372911378974,42605.111083333315,-0.0010862301526073249,-0.0004542357643727888,42769.255309523825,42018.476473883005,42878.43751764057,42654.634067358624,43251.46906251401,0.0007787282092666009,0.00035763608827049794,42577.30210268688,42720.148106341105,12.277214751946474,15.179630058142182,-5.561982719526444,42613.13264405597,42691.35494386127,42529.29577812175,-78.22229980529664,-28.886614704460445,152.90356706756896,-68.13071035434405,-60.52501375992142,-46.25004231162893,42735.715593662964,42321.37596258053,False,True,41590.938,41820.938,41820.938,41790.938,2023-12-15 17:45:00,True,2023-12-15 17:45:00,2023-12-18 01:18:21,2023-12-15 17:48:43,0.02,even,True,171.33,3973.329999999999,10,0,50,12
2023-12-15 15:45:00,42295.438,42351.238,42185.5,42285.238,2041,40707,0,2023-12-15 15:00:00,2023-12-15 15:00:00,-36.19405952379748,-25.863372911378974,42605.111083333315,-0.0010862301526073249,-0.0004542357643727888,42769.255309523825,42018.476473883005,42878.43751764057,42654.634067358624,43251.46906251401,0.0007787282092666009,0.00035763608827049794,42577.30210268688,42720.148106341105,7.610727731360726,10.440522791432159,-5.561982719526444,42562.687314201205,42661.272207278955,42460.99596869623,-98.58489307775017,-42.82627037911839,177.15249237469644,-68.29980942551629,-68.13071035434405,-60.52501375992142,42700.15183340207,42220.34010399039,False,True,41585.238,41815.238,41815.238,41785.238,2023-12-15 17:45:00,True,2023-12-15 17:45:00,2023-12-18 01:21:36,2023-12-15 17:48:43,0.02,even,True,171.34,4144.669999999999,11,0,50,12
2023-12-18 22:45:00,41886.84,42044.574,41884.137,41968.238,1880,38824,0,2023-12-18 22:00:00,2023-12-18 22:00:00,81.30932142855454,39.739122405553644,41716.75698809524,0.0019345555378586796,0.0011577963086406586,41603.66948809522,41757.238054359754,42221.98882918601,41675.998615718054,41759.833222084926,1.8565066694709227e-05,0.0019345752006200729,41760.564219499276,41519.37053115634,84.52699520074265,79.84955670522585,-77.89580357179187,41695.61542106553,41555.400222047516,41796.54382937737,140.21519901801366,111.84024116869395,175.32651947710121,59.322696594448644,45.308253525945474,14.214866185066057,42034.73463067145,41559.853028083286,True,False,42668.238,42438.238,42438.238,42468.238,2023-12-18 23:45:00,True,2023-12-18 23:45:00,2023-12-18 23:47:15,2023-12-19 00:09:35,0.02,success,True,255.18,4399.849999999999,12,0,51,12
2023-12-18 23:00:00,41968.238,42579.039,41955.813,42426.738,2973,32766,0,2023-12-18 23:00:00,2023-12-18 23:00:00,113.08750000002328,92.81709192958078,42019.33329761905,0.002882256450561734,0.0033750045114916676,41716.75698809524,42125.43167841996,43281.99826677032,41757.238054359754,42221.98882918601,0.0011577963086406586,0.0019345555378586796,41790.97883834244,41600.71184866383,88.8783408530961,83.5390188717913,-43.75322447151734,41808.09581782468,41619.94376115511,41929.5322005504,188.152056669569,127.10260426886896,249.2916886025309,132.988371173029,59.322696594448644,45.308253525945474,42267.57598016381,41592.988420936985,True,False,43126.738,41976.738,42896.738,42926.738,,False,2023-12-19 04:00:00,2023-12-19 03:54:20,2023-12-19 19:12:33,0.02,success,True,255.18,4655.03,13,0,51,12
2023-12-18 23:30:00,42422.637,42497.738,42324.004,42489.238,1861,61422,0,2023-12-18 23:00:00,2023-12-18 23:00:00,113.08750000002328,92.81709192958078,42019.33329761905,0.002882256450561734,0.0033750045114916676,41716.75698809524,42125.43167841996,43281.99826677032,41757.238054359754,42221.98882918601,0.0011577963086406586,0.0019345555378586796,41790.97883834244,41600.71184866383,89.3092681356614,88.8399500819941,-43.75322447151734,41993.21181039518,41739.56180071597,42179.911014791905,253.65000967920787,167.8256727789234,341.6879073384657,122.02918128653982,128.3496329549671,132.988371173029,42642.68968969883,41718.63233988498,True,False,43189.238,42039.238,42959.238,42989.238,,False,2023-12-19 04:00:00,2023-12-19 03:54:21,2023-12-19 19:10:37,0.02,success,True,255.18,4910.21,14,0,51,12
2023-12-19 00:00:00,42606.84,42713.738,42427.039,42661.637,2288,57922,0,2023-12-19 00:00:00,2023-12-19 00:00:00,302.57630952380714,190.3210809355951,42272.634130952385,0.0028823918549258716,0.004282447723227205,42019.33329761905,42246.93404679626,43611.675864151475,42125.43167841996,43281.99826677032,0.0033750045114916676,0.002882256450561734,41818.53802115254,41672.153940770724,89.44075079180602,88.83327724004987,3.0616366099051504,42166.72310685099,41862.49845466047,42439.793209150324,304.2246521905181,212.76078367401755,414.14724835514943,132.4480636395092,127.43413071890973,122.02918128653982,43000.391994429774,41880.694423870875,True,False,43361.637,42211.637,43131.637,43161.637,,False,2023-12-19 04:00:00,2023-12-19 03:55:35,2023-12-19 19:05:30,0.02,success,True,255.18,5165.39,15,0,51,12
2023-12-19 03:45:00,42843.539,43411.238,42841.84,43319.938,3321,3188,0,2023-12-19 03:00:00,2023-12-19 03:00:00,173.47260714288132,333.2684122315186,42934.75983333334,0.004926186513408577,0.004856955501810601,42645.783821428595,43378.98081203464,44374.920131429884,43316.4744924753,44447.463623701246,0.0058415508640086095,0.005391087188795558,41940.58234861837,41945.59200008688,87.07815172853833,77.43263197409031,147.7324449745176,42760.2263425689,42468.60937803167,42879.604944960454,291.61696453722834,274.34761965994767,399.81525633429123,112.94391434471618,29.925533195731987,-3.094070863473462,43420.85554101175,42339.85434890916,True,False,44019.938,42869.938,43789.938,43819.938,,False,2023-12-20 16:30:00,2023-12-20 16:27:52,2023-12-19 06:41:21,0.02,fail,False,-164.07,5001.320000000001,0,1,51,12
2023-12-19 10:15:00,43140.238,43172.438,43067.164,43166.137,1552,42086,0,2023-12-19 10:00:00,2023-12-19 10:00:00,-15.705880952395091,343.09003221139574,42978.824583333306,0.0010307894578480729,-0.0012311610527366114,42991.26610714285,43071.60901125766,42993.60616572608,42910.79641816412,42833.4515988566,-0.001803798719402088,0.0007496518436964091,42201.13523079797,42415.187736533255,87.36918798700606,74.6463427489998,336.33772064676896,43021.042535774635,42933.45218119841,43028.28548985208,87.59035457622667,88.38936007235876,88.39469596420764,45.573072239429166,36.72004299963737,18.295122807016014,43149.11832940376,42908.9526503004,True,False,43866.137,42716.137,43636.137,43666.137,,False,2023-12-20 16:00:00,2023-12-20 16:01:56,2023-12-19 16:07:30,0.02,fail,False,-164.07,4837.250000000001,0,2,51,12
2023-12-20 06:45:00,42616.465,42871.625,42585.754,42815.238,2088,42422,0,2023-12-20 06:00:00,2023-12-20 06:00:00,27.905178571447323,-40.48491903614922,42530.2357380952,9.684611413174582e-05,0.0013808166344051527,42394.353511904745,42222.01961700716,43089.114179337084,42254.81882815733,42453.77272903886,-0.00016253312942741467,0.0002846360655720581,42353.661664186024,42449.21948882329,83.08178095896956,79.34640663009897,-49.15799305918232,42513.44934728625,42438.18258385918,42558.92949088408,75.26676342706924,34.992845377762336,131.2300378212178,67.56605503956962,35.68704747161246,31.72859993120801,42737.59004194273,42381.76893982544,True,False,43515.238,43285.238,43285.238,43315.238,2023-12-20 15:30:00,True,2023-12-20 15:30:00,2023-12-20 15:45:54,2023-12-20 15:33:03,0.02,even,True,171.33,5008.580000000001,1,0,51,12
2023-12-20 15:15:00,43126.039,43411.539,43121.918,43403.84,2682,25609,0,2023-12-20 15:00:00,2023-12-20 15:00:00,48.74584523809608,115.82070305573143,43194.08500000002,0.0009549417135374351,0.002558171483185546,42898.36670238095,42945.63608559622,44222.91138905747,42770.08503069458,42996.27715648108,-8.262077364623057e-05,0.0004056992226541013,42541.285115135965,42739.273206601116,93.40860145261253,87.13623242279733,77.05092196442564,42995.13162547719,42886.55758374727,43036.583686274505,108.57404172991664,67.85020162790849,139.00047758777248,92.13189817681268,61.738438252512424,27.191441348477383,43225.734331018,42848.93304153101,True,False,44103.84,42953.84,43873.84,43903.84,,False,2023-12-20 16:30:00,2023-12-20 16:28:42,,0.02,success,True,255.17,5263.750000000001,2,0,51,12
2023-12-20 15:30:00,43396.508,43448.738,43259.215,43448.738,2619,30922,0,2023-12-20 15:00:00,2023-12-20 15:00:00,48.74584523809608,115.82070305573143,43194.08500000002,0.0009549417135374351,0.002558171483185546,42898.36670238095,42945.63608559622,44222.91138905747,42770.08503069458,42996.27715648108,-8.262077364623057e-05,0.0004056992226541013,42541.285115135965,42739.273206601116,96.44285044688439,91.90170159248709,77.05092196442564,43064.91722155762,42928.20057754377,43134.550851737185,136.71664401384623,81.62349010509604,177.5522072048254,97.96716546267999,92.13189817681268,61.738438252512424,43375.7463314637,42894.85537201067,True,False,44148.738,42998.738,43918.738,43948.738,,False,2023-12-20 16:30:00,2023-12-20 16:28:56,,0.02,success,True,255.17,5518.920000000001,3,0,51,12
2023-12-20 15:45:00,43448.738,43807.738,43433.84,43792.637,3416,18324,0,2023-12-20 15:00:00,2023-12-20 15:00:00,48.74584523809608,115.82070305573143,43194.08500000002,0.0009549417135374351,0.002558171483185546,42898.36670238095,42945.63608559622,44222.91138905747,42770.08503069458,42996.27715648108,-8.262077364623057e-05,0.0004056992226541013,42541.285115135965,42739.273206601116,99.1804571387235,96.34396967940681,77.05092196442564,43176.87411054876,42992.232905133125,43296.01315170279,184.6412054156317,102.22703316720319,249.83071251400187,161.46229996560578,97.96716546267999,92.13189817681268,43634.78461359669,42958.74168980889,True,False,44492.637,44262.637,44262.637,44292.637,2023-12-20 17:15:00,True,2023-12-20 17:15:00,,2023-12-20 17:15:11,0.02,even,True,171.33,5690.250000000001,4,0,51,12
2023-12-26 07:15:00,43241.84,43264.238,43030.723,43089.738,1690,36226,0,2023-12-26 07:00:00,2023-12-26 07:00:00,-86.07285714284808,-48.74105944658368,43332.29990476187,-0.0028331014905394456,-0.0015291468076036867,43630.54504761903,42183.72526417223,43449.964531944934,43305.14297874268,43722.815859342016,-0.0008721676665454934,-0.00041072212639319585,43588.85567728484,43634.92862999533,15.800935470299896,17.333569989671272,-32.538256732899,43459.237106167566,43568.79601481877,43362.71551737184,-109.55890865120455,-49.972572310773074,200.07267290733893,-72.27575335404254,-56.92133298931731,-28.76691296867648,43632.81362579675,43091.117408946935,False,True,42389.738,42619.738,42619.738,42589.738,2023-12-26 11:45:00,True,2023-12-26 11:45:00,2023-12-26 11:45:20,2023-12-26 12:34:57,0.02,success,True,255.17,5945.420000000001,5,0,52,12
2023-12-26 07:30:00,43092.637,43132.84,42623.84,42757.238,3780,33922,0,2023-12-26 07:00:00,2023-12-26 07:00:00,-86.07285714284808,-48.74105944658368,43332.29990476187,-0.0028331014905394456,-0.0015291468076036867,43630.54504761903,42183.72526417223,43449.964531944934,43305.14297874268,43722.815859342016,-0.0008721676665454934,-0.00041072212639319585,43588.85567728484,43634.92862999533,12.585071325959696,15.842851070740553,-32.538256732899,43351.237243680254,43508.680606313676,43226.713907120735,-157.4433626334212,-71.4667303753027,267.2843108150347,-136.0016102511072,-72.27575335404254,-56.92133298931731,43587.54772672103,42864.38008752044,False,True,42057.238,43207.238,42287.238,42257.238,,False,2023-12-26 19:45:00,2023-12-26 19:37:32,2023-12-27 12:44:30,0.02,success,True,255.18,6200.600000000001,6,0,52,12
2023-12-27 12:30:00,43073.938,43225.34,43018.0,43212.938,2274,39125,0,2023-12-27 12:00:00,2023-12-27 12:00:00,117.0691666666753,25.002673986273294,42867.87234523809,0.0013976443751057813,0.002961967322545777,42644.294749999994,42754.31489768426,43708.60690815614,42693.919486211395,42985.89237325564,0.001088080241650795,0.0013974823810141107,42837.998297253325,42619.788371390045,93.06172770458569,91.394937213223,-68.33472597913448,42786.43389529494,42633.098711563885,42911.09867320263,153.3351837310547,97.90638006938347,223.16724239125617,101.83413691092574,83.38097385613946,13.018722050233919,43213.87445043083,42609.82289597443,True,False,43912.938,42762.938,43682.938,43712.938,,False,,,2023-12-27 15:02:49,0.02,fail,False,-164.07,6036.530000000002,0,1,52,12
2023-12-27 12:45:00,43208.801,43235.539,43109.84,43216.738,1675,38723,0,2023-12-27 12:00:00,2023-12-27 12:00:00,117.0691666666753,25.002673986273294,42867.87234523809,0.0013976443751057813,0.002961967322545777,42644.294749999994,42754.31489768426,43708.60690815614,42693.919486211395,42985.89237325564,0.001088080241650795,0.0013974823810141107,42837.998297253325,42619.788371390045,96.79014197483332,93.86754580060209,-68.33472597913448,42852.634526788024,42676.33125144804,43003.070085999316,176.30327533998206,113.58575912350321,250.77162467225426,91.97141279668722,101.83413691092574,83.38097385613946,43343.11177930686,42664.52839269177,True,False,43916.738,42766.738,43686.738,43716.738,,False,,,2023-12-27 15:02:49,0.02,fail,False,-164.07,5872.460000000002,0,2,52,12
2023-12-27 22:30:00,43325.539,43491.34,43265.691,43460.566,1859,36625,0,2023-12-27 22:00:00,2023-12-27 22:00:00,51.49683333330904,146.88039297915384,43255.252047619055,0.0010446800263721643,0.0015403586433228441,43128.89066666665,43164.279967306466,43812.104123950645,43085.402928184296,43318.6721734813,0.00041207660900447287,0.0009076505162647284,42918.785107459014,42891.39235641342,92.97474103750267,85.07330173455374,113.95736497424684,43175.3832572898,43078.863779975785,43218.61985620915,96.51947731401742,63.89357964471816,137.79100041785895,62.24715479873703,44.68548469214875,28.666770553849346,43406.13770677326,43032.60200564504,True,False,44160.566,43010.566,43930.566,43960.566,,False,,,2023-12-28 08:31:15,0.02,fail,False,-164.07,5708.390000000002,0,3,52,12
2023-12-28 09:00:00,43045.039,43075.438,42966.324,43002.438,1574,45726,0,2023-12-28 09:00:00,2023-12-28 09:00:00,-123.1081190476034,62.14028388920269,43127.45132142858,-0.0018981680158524175,-0.0016900293678639817,43214.82007142857,42513.711368828335,43151.13946144364,42821.51943795247,43385.07933609913,-0.0010346316952113952,-0.0010771099491713213,43056.69652958614,43131.06748389179,10.043346531650712,10.658565201861643,130.40787442722913,43180.433548909416,43269.24122761821,43086.36500068803,-88.80767870879208,-47.895439084823906,180.3217714991743,-46.87539146885683,-43.44492088062543,-39.86505916749593,43329.79939221191,42841.43060916414,False,True,42302.438,42532.438,42532.438,42502.438,2023-12-28 17:30:00,True,2023-12-28 17:30:00,2023-12-28 18:27:37,2023-12-28 17:37:05,0.02,even,True,171.33,5879.720000000002,1,0,52,12
2023-12-28 14:45:00,42920.539,42977.84,42751.34,42799.84,1886,29024,0,2023-12-28 14:00:00,2023-12-28 14:00:00,17.055166666643345,-17.405553283206245,42966.93834523812,-0.0002766856203800513,-0.0007442284190779128,43038.97859523806,42708.43092649967,43036.81009910307,42709.23465057082,42911.06709511263,-0.0015792582236694441,-0.00031006143543101507,43046.12623619238,43084.91232728296,19.01827715433261,39.69561133786952,37.8275009798084,43015.60490915532,43071.33099390937,43030.65755280356,-55.72608475404559,-40.54325870112431,95.5293597450154,-52.17759614723036,-25.378013071909663,-18.262060199514963,43159.62218845933,42900.19291714779,False,True,42099.84,43249.84,42329.84,42299.84,,False,2023-12-29 03:45:00,2023-12-29 03:01:32,,0.02,success,True,255.17,6134.890000000002,2,0,52,12
2023-12-29 12:30:00,42747.738,42828.738,42741.137,42796.738,1009,44223,0,2023-12-29 12:00:00,2023-12-29 12:00:00,15.450380952381238,-43.15112696681172,42569.10345238094,-0.0006998253625208417,5.658747039454426e-05,42529.47909523811,42030.626095630134,42837.61392395187,42174.99737460534,42650.803561256966,-0.0003899257512776493,-0.00021956735583688762,42764.33317305953,42649.73885842182,89.3732399174154,88.82015523921298,-69.83856611894845,42632.920055449475,42591.299410769585,42646.276774681784,41.620644679889665,5.71496250485173,134.34375106108564,55.95880701753049,50.99384932923567,41.49799174401414,42829.14083861425,42464.91271074932,True,False,43496.738,42346.738,43266.738,43296.738,,False,2024-01-02 00:15:00,2024-01-02 00:00:00,2023-12-29 17:48:23,0.02,fail,False,-164.07,5970.820000000002,0,1,52,12
2023-12-29 13:45:00,42852.34,42923.738,42818.84,42882.637,873,33988,0,2023-12-29 13:00:00,2023-12-29 13:00:00,39.624357142834924,-22.297537260237732,42680.077166666684,0.0008187439106680854,0.0005874084836177986,42569.10345238094,42492.91785229162,43055.16153716961,42030.626095630134,42837.61392395187,5.658747039454426e-05,-0.0006998253625208417,42768.9725388219,42668.37070974807,85.57945206452113,85.16096408291118,-60.33036034720631,42743.149425613185,42664.299352844835,42879.42043962849,78.85007276834949,45.72640183680433,166.4740507175025,43.492028207816475,45.88688304090465,56.379756105969136,43105.66040809712,42654.68047115986,True,False,43582.637,42432.637,43352.637,43382.637,,False,2024-01-02 00:15:00,2024-01-02 00:00:00,2023-12-29 17:47:26,0.02,fail,False,-164.07,5806.750000000003,0,2,52,12
2023-12-29 19:00:00,41970.84,42060.637,41723.938,41889.34,4205,34125,0,2023-12-29 19:00:00,2023-12-29 19:00:00,-281.0821904762779,-71.53627171810513,42182.096642857185,-0.0033211959887581664,-0.002037921763205256,42456.26695238091,41158.328924665744,42563.79335131887,41507.916613554815,43422.500811051425,0.0011391231602421513,-0.002080357198703577,42697.714825411356,42564.27394410689,18.731587814663296,21.952967770586707,-11.289815481589706,42352.66644966636,42526.59683627389,42174.22853525971,-173.93038660753518,-69.89604251061151,325.7870230687947,-127.19001685587136,-120.80542414860975,-75.49781871344749,42614.04101640258,41732.91605411684,False,True,41189.34,42339.34,41419.34,41389.34,,False,,2024-01-03 14:09:28,2024-01-02 00:00:00,0.02,fail,False,-164.07,5642.680000000003,0,3,52,12
2024-01-02 01:00:00,43547.84,43723.738,43547.84,43697.539,1714,63485,0,2024-01-02 01:00:00,2024-01-02 01:00:00,589.4606428571133,-5.608957644319162,43165.27394047617,0.002303910597104843,0.006159810152533922,42499.78427380951,42412.51883139151,45247.91586346567,42095.35769168748,44022.899692905645,0.0020792545110529595,0.0011999628966516945,42698.04445052736,42639.4239229081,92.99248234782245,90.85218047626182,-93.26651210199599,42898.90762281253,42588.15452341493,43200.47395837633,310.7530993975961,103.71470918786896,644.3256920296182,220.75326109388698,198.89283178536425,210.37668730651785,44071.81364261631,42330.63427413635,True,False,44397.539,43247.539,44167.539,44197.539,,False,2024-01-02 02:15:00,2024-01-02 02:06:09,2024-01-03 14:01:17,0.02,success,True,255.17,5897.850000000003,1,0,1,1
2024-01-02 01:30:00,44022.938,44138.832,43953.34,44103.738,2398,57726,0,2024-01-02 01:00:00,2024-01-02 01:00:00,589.4606428571133,-5.608957644319162,43165.27394047617,0.002303910597104843,0.006159810152533922,42499.78427380951,42412.51883139151,45247.91586346567,42095.35769168748,44022.899692905645,0.0020792545110529595,0.0011999628966516945,42698.04445052736,42639.4239229081,98.44868019852088,95.95127323196006,-93.26651210199599,43230.58962343382,42798.82761198125,43689.54253801171,431.76201145257073,213.11391092424037,790.954910258984,235.16236910904263,253.9062105263365,220.75326109388698,44758.83166686134,42621.75340916208,True,False,44803.738,44573.738,44573.738,44603.738,2024-01-02 02:15:00,True,2024-01-02 02:15:00,2024-01-02 02:15:07,2024-01-02 02:16:10,0.02,success,True,255.18,6153.030000000003,2,0,1,1
2024-01-02 01:45:00,44103.738,44229.738,44054.496,44194.039,1824,57125,0,2024-01-02 01:00:00,2024-01-02 01:00:00,589.4606428571133,-5.608957644319162,43165.27394047617,0.002303910597104843,0.006159810152533922,42499.78427380951,42412.51883139151,45247.91586346567,42095.35769168748,44022.899692905645,0.0020792545110529595,0.0011999628966516945,42698.04445052736,42639.4239229081,98.41508528533764,97.75880754446514,-93.26651210199599,43378.812604444,42902.17660368635,43916.73942242862,476.63600075765135,265.8183288909226,845.6729572423214,227.1968844169096,235.16236910904263,253.9062105263365,45059.897914705754,42775.08093015148,True,False,44894.039,44664.039,44664.039,44694.039,2024-01-02 02:15:00,True,2024-01-02 02:15:00,2024-01-02 02:24:21,2024-01-02 02:15:53,0.02,even,True,171.33,6324.360000000003,3,0,1,1
2024-01-02 02:00:00,44195.238,44747.336,44174.516,44716.289,3012,31406,0,2024-01-02 02:00:00,2024-01-02 02:00:00,665.4896666666536,187.8711904942611,43991.94866666669,0.006714964951629391,0.010753041309176843,43165.27394047617,43791.04029452822,47198.076041009095,42412.51883139151,45247.91586346567,0.006159810152533922,0.002303910597104843,42794.227766192955,42840.327529075454,98.62634712856756,98.49670420414202,-37.038971582744566,43584.578203760306,43036.55529970958,44211.306416924665,548.0229040507256,322.25924392288323,931.4779868096338,294.5669944960464,227.1968844169096,235.16236910904263,45470.30169911767,42953.81113473166,True,False,45416.289,44266.289,45186.289,45216.289,,False,2024-01-02 04:45:00,2024-01-02 03:08:42,2024-01-03 13:50:30,0.02,success,True,255.17,6579.530000000003,4,0,1,1
2024-01-02 04:30:00,45141.137,45334.039,45094.438,45305.637,1840,42925,0,2024-01-02 04:00:00,2024-01-02 04:00:00,532.325880952354,547.7616778641968,45072.052833333335,0.014026689021244003,0.014530782957888611,44524.27454761905,47307.82396649488,49280.909824498616,46022.96182424254,48055.29074189886,0.012303467385720397,0.012294907500283185,42975.43485606662,43196.038023809466,84.45966992311197,78.64994906339506,153.57446999653973,44758.27129005298,44088.37176366347,45320.72595768836,669.8995263895122,636.5213920079177,1198.9749099874348,91.32610663916421,-37.75321568625077,-9.92458857929887,46940.8420861714,43702.10982920532,True,False,46005.637,45775.637,45775.637,45805.637,2024-01-02 11:30:00,True,2024-01-02 11:30:00,,2024-01-02 11:33:43,0.02,even,True,171.33,6750.860000000003,5,0,1,1
2024-01-02 04:45:00,45304.129,45399.938,45176.539,45391.684,1733,34422,0,2024-01-02 04:00:00,2024-01-02 04:00:00,532.325880952354,547.7616778641968,45072.052833333335,0.014026689021244003,0.014530782957888611,44524.27454761905,47307.82396649488,49280.909824498616,46022.96182424254,48055.29074189886,0.012303467385720397,0.012294907500283185,42975.43485606662,43196.038023809466,90.58023724517545,84.31289901594664,153.57446999653973,44855.7193992756,44184.913410799505,45396.82011592708,670.8059884760951,643.3783113015531,1168.43203501337,76.09415823872405,91.32610663916421,-37.75321568625077,46975.703363195134,43819.43686865903,True,False,46091.684,44941.684,45861.684,45891.684,,False,,,2024-01-02 17:18:03,0.02,fail,False,-164.07,6586.790000000004,0,1,1,1
2024-01-03 13:15:00,44730.727,44871.34,44323.84,44357.094,4547,9778,0,2024-01-03 13:00:00,2024-01-03 13:00:00,-17.22898809522303,43.42418496731989,44703.24361904759,-0.005303876639259622,0.0009634789327114188,45200.2852738095,42632.421414770535,45804.03654420183,44750.45126098268,45738.47288311781,0.0008573774572829954,-0.0006087852745544925,44564.54062001127,44956.193518406944,13.244153917133112,23.70278399382742,66.46944182476007,45034.48778879757,45129.769549070435,44998.07490884066,-95.28176027286827,-12.64395955202249,229.39329690444694,-147.4033247334737,-92.64020639831142,-13.634777777799172,45307.755859661665,44686.89395801965,False,True,43657.094,44807.094,43887.094,43857.094,,False,2024-01-03 14:00:00,2024-01-03 13:55:56,,0.02,success,True,255.17,6841.960000000004,1,0,1,1
2024-01-03 13:45:00,44498.938,44518.34,43473.84,43691.879,5332,14226,0,2024-01-03 13:00:00,2024-01-03 13:00:00,-17.22898809522303,43.42418496731989,44703.24361904759,-0.005303876639259622,0.0009634789327114188,45200.2852738095,42632.421414770535,45804.03654420183,44750.45126098268,45738.47288311781,0.0008573774572829954,-0.0006087852745544925,44564.54062001127,44956.193518406944,9.389466100770708,9.76018085257091,66.46944182476007,44758.216049967494,44979.992227941046,44652.90146405231,-221.77617797355197,-73.39869332054668,393.4819804761245,-241.00372686618357,-104.16971792216646,-147.4033247334737,45184.102137695074,44120.200790409544,False,True,42991.879,44141.879,43221.879,43191.879,,False,2024-01-03 14:15:00,2024-01-03 14:01:27,2024-01-04 17:29:07,0.02,success,True,255.17,7097.130000000004,2,0,1,1
2024-01-04 17:00:00,43644.203,43804.637,43583.34,43796.738,2637,24922,0,2024-01-04 17:00:00,2024-01-04 17:00:00,199.26128571430309,69.04134855506709,43671.518190476185,0.0035290521337506204,0.004468767445527249,43435.97972619049,43949.349354458245,45053.83012840063,43400.963724392896,44001.96986040282,0.0016312583830285065,0.002358099696969847,43538.389951097204,43316.9203284558,93.14731044161795,84.67106471751136,-60.50749635315571,43394.642796793356,43245.373425311125,43512.53961575505,149.26937148223078,98.57725908232999,234.62056455677418,83.90916718263179,48.54193051254697,30.69457378739753,43830.77737790669,43195.80185360341,True,False,44496.738,44266.738,44266.738,44296.738,2024-01-04 21:30:00,True,2024-01-04 21:30:00,2024-01-04 22:38:39,2024-01-04 21:32:33,0.02,even,True,171.33,7268.460000000004,3,0,1,1
2024-01-08 19:30:00,45262.438,45422.238,45187.438,45362.438,2836,33750,0,2024-01-08 19:00:00,2024-01-08 19:00:00,50.36223809519288,329.07342600024276,45218.45577380951,0.003913309725844352,0.002147147987535704,45012.56940476189,45525.598019046025,46007.95015037003,45456.15475672563,46378.83263666697,0.0034710084073280734,0.004165461799912516,44015.2536175891,44290.59051617735,80.45419578239103,62.78786798285059,222.63489201195432,45034.8921343455,44821.962517640146,45073.7145249398,212.92961670535442,208.67719567489198,235.19532675707717,83.55063123498257,70.74309769520914,24.502004815956752,45392.728216061856,44756.20083381775,True,False,46062.438,44912.438,45832.438,45862.438,,False,2024-01-08 20:15:00,2024-01-08 20:05:16,2024-01-09 23:25:20,0.02,success,True,255.17,7523.630000000004,4,0,2,1
2024-01-08 19:45:00,45362.438,45641.473,45286.082,45633.137,3219,30023,0,2024-01-08 19:00:00,2024-01-08 19:00:00,50.36223809519288,329.07342600024276,45218.45577380951,0.003913309725844352,0.002147147987535704,45012.56940476189,45525.598019046025,46007.95015037003,45456.15475672563,46378.83263666697,0.0034710084073280734,0.004165461799912516,44015.2536175891,44290.59051617735,92.23334761133974,78.33287194292036,222.63489201195432,45126.929805984655,44882.04951633347,45205.42169418649,244.88028965118428,215.91781447015046,229.59395849418704,131.70716924668523,83.55063123498257,70.74309769520914,45516.87353815364,44895.469850219335,True,False,46333.137,45183.137,46103.137,46133.137,,False,2024-01-08 20:45:00,2024-01-08 20:36:15,2024-01-09 23:25:17,0.02,success,True,255.17,7778.800000000004,5,0,2,1
2024-01-08 20:45:00,46929.84,46993.34,46599.949,46949.664,4560,25922,0,2024-01-08 20:00:00,2024-01-08 20:00:00,205.88636904762097,402.42754087917274,45799.715571428555,0.00357905171554585,0.006982352586148852,45218.45577380951,45636.21768428761,48336.73034076364,45525.598019046025,46007.95015037003,0.002147147987535704,0.003913309725844352,44130.328534546396,44503.316394883164,92.13022538132508,90.3730172324199,258.59342178539805,45803.834602199546,45302.66990115885,46140.87407361545,501.16470104069595,327.24290128560256,598.123092311147,298.2379287926087,323.2726955624894,156.02264189883135,46949.8402482355,45333.4078989954,True,False,47649.664,46499.664,47419.664,47449.664,,False,2024-01-09 23:15:00,2024-01-09 23:12:03,2024-01-09 02:37:33,0.02,fail,False,-164.07,7614.730000000004,0,1,2,1
2024-01-08 21:00:00,46949.637,47258.305,46750.547,47105.164,4248,0,0,2024-01-08 21:00:00,2024-01-08 21:00:00,581.2597976190445,589.4857921317816,46298.329583333325,0.0030689797638471066,0.006982444100130335,45799.715571428555,45665.647218050384,48675.65936129992,45636.21768428761,48336.73034076364,0.006982352586148852,0.00357905171554585,44242.097533191634,44701.48612329252,93.95142336870121,91.54366250811444,324.77189585467477,46004.03912493808,45436.1879825545,46442.99773684208,567.8511423835807,375.36454950519817,703.1932603582202,302.12366322663,298.2379287926087,323.2726955624894,47393.808638325674,45493.68683535849,True,False,47805.164,46655.164,47575.164,47605.164,,False,2024-01-09 23:15:00,2024-01-09 23:12:05,2024-01-08 21:28:27,0.02,fail,False,-164.07,7450.660000000004,0,2,2,1
2024-01-10 09:30:00,45875.137,45901.637,45709.238,45814.238,1203,24523,0,2024-01-10 09:00:00,2024-01-10 09:00:00,25.147726190436515,-127.87488227949507,45917.66733333336,0.00036698727186022524,-0.00015240410387284064,45981.42910714285,45772.30087831789,46147.28463857784,46043.60038355888,46224.474938301755,4.711121205437901e-06,0.001085230264016693,45844.75298511188,46138.06894692534,15.479564654930456,23.04169686777514,-98.37940128496238,45933.015990098975,45988.636156296525,45873.92233505332,-55.620166197550134,-48.532086877889576,106.57536916843934,-23.737876161052554,-30.677718954226293,-38.486477812126395,46017.79908343071,45728.54558667593,False,True,45114.238,45344.238,45344.238,45314.238,2024-01-10 11:00:00,True,2024-01-10 11:00:00,2024-01-10 13:53:11,2024-01-10 11:00:13,0.02,even,True,171.33,7621.990000000004,1,0,2,1
2024-01-10 09:45:00,45817.738,45845.738,45728.867,45740.137,1419,42762,0,2024-01-10 09:00:00,2024-01-10 09:00:00,25.147726190436515,-127.87488227949507,45917.66733333336,0.00036698727186022524,-0.00015240410387284064,45981.42910714285,45772.30087831789,46147.28463857784,46043.60038355888,46224.474938301755,4.711121205437901e-06,0.001085230264016693,45844.75298511188,46138.06894692534,14.568643766706934,17.13118922934063,-98.37940128496238,45903.342299314514,45970.22881138567,45842.57513347094,-66.88651207115618,-52.2029719165429,107.51861252937786,-31.347201582379057,-23.737876161052554,-30.677718954226293,45987.7252603856,45695.92500655628,False,True,45040.137,46190.137,45270.137,45240.137,,False,2024-01-10 14:30:00,2024-01-10 13:53:12,2024-01-10 19:43:25,0.02,success,True,255.17,7877.160000000004,2,0,2,1
2024-01-10 10:15:00,45759.746,45807.438,45690.039,45717.586,1317,44023,0,2024-01-10 10:00:00,2024-01-10 10:00:00,-63.7617738094923,-146.4255458714979,45691.82988095236,-0.0010182931738218764,-0.0012117019820287044,45917.66733333336,45113.92594903883,45743.31764086284,45772.30087831789,46147.28463857784,-0.00015240410387284064,0.00036698727186022524,45823.22698569573,46070.69063117131,9.304799325950135,12.722269335912408,-107.98863020226949,45856.994877024,45937.564679171526,45785.606355005184,-80.56980214752548,-61.175226925121336,126.05824647854202,-29.19539938080561,-27.773379084952467,-31.347201582379057,45955.78498775121,45613.927722259155,False,True,45017.586,46167.586,45247.586,45217.586,,False,2024-01-10 14:45:00,2024-01-10 13:53:12,2024-01-10 19:43:05,0.02,success,True,255.17,8132.3300000000045,3,0,2,1
2024-01-10 10:30:00,45717.586,45746.039,45606.84,45625.367,1579,27515,0,2024-01-10 10:00:00,2024-01-10 10:00:00,-63.7617738094923,-146.4255458714979,45691.82988095236,-0.0010182931738218764,-0.0012117019820287044,45917.66733333336,45113.92594903883,45743.31764086284,45772.30087831789,46147.28463857784,-0.00015240410387284064,0.00036698727186022524,45823.22698569573,46070.69063117131,8.33674856766411,10.644970936231466,-107.98863020226949,45821.359819020305,45914.43892515882,45751.26257653937,-93.07910613851709,-67.55600276780049,141.35095707398256,-34.343778465816285,-29.19539938080561,-27.773379084952467,45942.08636858925,45558.93878448949,False,True,44925.367,46075.367,45155.367,45125.367,,False,2024-01-10 14:45:00,2024-01-10 13:53:13,2024-01-10 19:42:46,0.02,success,True,255.17,8387.500000000004,4,0,2,1
2024-01-10 10:45:00,45628.637,45719.438,45284.801,45295.84,2804,0,0,2024-01-10 10:00:00,2024-01-10 10:00:00,-63.7617738094923,-146.4255458714979,45691.82988095236,-0.0010182931738218764,-0.0012117019820287044,45917.66733333336,45113.92594903883,45743.31764086284,45772.30087831789,46147.28463857784,-0.00015240410387284064,0.00036698727186022524,45823.22698569573,46070.69063117131,4.41844751630191,7.353331803305383,-107.98863020226949,45740.5106160941,45868.61678255446,45655.99140660483,-128.10616646036215,-79.66603550631282,192.22212800750782,-95.2711699345382,-34.343778465816285,-29.19539938080561,45915.491279414964,45394.991533794695,False,True,44595.84,45745.84,44825.84,44795.84,,False,2024-01-10 15:00:00,2024-01-10 14:54:46,2024-01-10 19:35:52,0.02,success,True,255.16,8642.660000000003,5,0,2,1
2024-01-10 19:45:00,46266.539,46413.801,45981.84,46378.949,4222,31101,0,2024-01-10 19:00:00,2024-01-10 19:00:00,14.018464285742084,-233.21793599932425,45578.046083333305,0.001528963376168591,0.002172109641855044,45152.90482142859,44799.69422344732,46792.85564817957,44036.51603261398,45703.6585744395,-2.1923576425936524e-05,-0.0007961437216141082,45695.35807851654,45726.52936711353,94.73235704144389,83.93688984743766,-240.59565836225408,45629.41923987824,45488.896732889894,45815.46440591676,140.5225069883454,1.063686993325149,381.26811542257605,197.08041726862575,175.4760729274276,29.096334709363873,46331.67636173724,45300.75245009628,True,False,47078.949,45928.949,46848.949,46878.949,,False,2024-01-11 01:15:00,2024-01-11 01:05:23,2024-01-10 20:09:36,0.02,fail,False,-164.07,8478.590000000004,0,1,2,1
2024-01-11 08:00:00,46046.309,46072.137,45594.617,45688.34,2887,19223,0,2024-01-11 08:00:00,2024-01-11 08:00:00,-247.7467142857422,116.10590264006896,46126.136964285666,-0.002322871624437334,-0.0044720512129205634,46287.537511904746,45192.210423580735,45429.2060144768,45950.11015175308,45632.11421216831,-0.004471866661527091,0.00046992412425612745,45961.66090743277,46129.90860162846,16.057106118593275,20.681479948240305,144.48789003991925,46202.13302889894,46294.51167560413,46092.869836257305,-92.37864670519048,-2.5314339168620066,222.77339609993518,-118.39548641210422,-47.891377708976506,-74.2346869624962,46393.61392099222,45790.62575152239,False,True,44988.34,46138.34,45218.34,45188.34,,False,2024-01-12 17:15:00,2024-01-12 17:19:18,2024-01-11 09:28:56,0.02,fail,False,-164.07,8314.520000000004,0,2,2,1
2024-01-11 13:00:00,46841.609,46966.438,46678.246,46961.539,3021,15922,0,2024-01-11 13:00:00,2024-01-11 13:00:00,249.79616666673246,94.7736856588017,46624.93410714286,0.003225569582687043,0.002005574225041328,46334.985000000044,46892.110752216744,47498.3592603499,45918.59262469406,46997.30267636607,0.0008432838781837022,0.0009378751359636978,46058.713443805114,46262.6943098105,98.64613895370883,96.29334046921967,81.76200456952782,46480.08403940784,46346.78564563491,46638.18043962848,133.29839377292956,38.300739228262344,303.3796423424699,106.5029253526227,87.71774234602344,71.84207086339302,47049.24295679081,46228.61792246615,True,False,47661.539,46511.539,47431.539,47461.539,,False,2024-01-11 16:15:00,2024-01-11 16:05:04,2024-01-11 17:50:57,0.02,success,True,255.16,8569.680000000004,1,0,2,1
2024-01-12 17:30:00,44932.34,44943.438,44482.965,44534.582,5141,34922,0,2024-01-12 17:00:00,2024-01-12 17:00:00,-140.7018333333399,-175.34995545545826,45272.459702380955,-0.004035732193740531,-0.002545418230729828,45711.9683095238,43676.30747557203,45355.28268779272,45044.1394086554,46258.259234927355,1.4536388652896458e-05,-0.0011597467862405533,46067.64028682144,45943.517223150266,8.126374245799823,9.56604873236711,-136.2253554329875,45367.65199928643,45621.17345721454,45136.06191847269,-253.52145792811643,-132.05666922710097,386.12625841948596,-202.9350395596921,-141.00013347090135,-119.14650945991889,45657.332367339,44613.29146960638,False,True,43834.582,44984.582,44064.582,44034.582,,False,2024-01-12 18:45:00,2024-01-12 18:20:08,,0.02,success,True,255.16,8824.840000000004,2,0,2,1
2024-01-12 17:45:00,44537.938,44663.738,44333.84,44468.84,4802,36074,0,2024-01-12 17:00:00,2024-01-12 17:00:00,-140.7018333333399,-175.34995545545826,45272.459702380955,-0.004035732193740531,-0.002545418230729828,45711.9683095238,43676.30747557203,45355.28268779272,45044.1394086554,46258.259234927355,1.4536388652896458e-05,-0.0011597467862405533,46067.64028682144,45943.517223150266,10.45077474483226,10.708267054272149,-136.2253554329875,45229.37323016544,45535.8154233468,44962.378108703146,-306.4421931813631,-166.9337740179534,458.9145933871964,-173.6838097695436,-202.9350395596921,-141.00013347090135,45581.91280977586,44341.34340763043,False,True,43768.84,44918.84,43998.84,43968.84,,False,2024-01-12 18:45:00,2024-01-12 18:36:23,,0.02,success,True,255.17,9080.010000000004,3,0,2,1
2024-01-12 18:00:00,44465.605,44684.113,44300.359,44363.84,4424,37800,0,2024-01-12 18:00:00,2024-01-12 18:00:00,-439.508607142845,-305.3991523512959,44624.876488095266,-0.0074288161263408176,-0.002545624089943377,45272.459702380955,42030.43660443285,45242.108125660445,43676.30747557203,45355.28268779272,-0.002545418230729828,-0.004035732193740531,45972.244157926485,45758.838965298244,5.0598372845121515,7.878995425048078,-170.0601148166492,45096.21427167845,45449.00242902481,44781.55601272787,-352.7881573463601,-204.10465068363476,525.9747992668096,-180.82209597527253,-173.6838097695436,-202.9350395596921,45491.621991738066,44069.99003371768,False,True,43663.84,44813.84,43893.84,43863.84,,False,2024-01-12 18:45:00,2024-01-12 18:37:24,,0.02,success,True,255.17,9335.180000000004,4,0,2,1
2024-01-15 00:15:00,42518.059,42533.738,42288.938,42295.238,1675,64324,0,2024-01-15 00:00:00,2024-01-15 00:00:00,-35.46648809522594,-690.5739900479821,43022.09020238095,-0.004529210888572681,-0.006006138311662458,43367.19564285717,41348.93102238731,42639.81373588196,42658.114352405784,42805.455083940724,-0.006538923155859137,-0.001444983695887348,45407.55364004895,44789.615011699345,13.065517366771429,19.51293034768534,-527.5667843237245,43264.69440858737,43696.56656114042,43170.064272789816,-431.8721525530491,-376.1350233327285,383.43338860004826,-207.59455899553723,-202.50598383210308,-40.0362242862393,43687.69934739988,42650.92919817975,False,True,41595.238,41825.238,41825.238,41795.238,2024-01-15 02:00:00,True,2024-01-15 02:00:00,,2024-01-15 02:04:37,0.02,even,True,171.33,9506.510000000004,5,0,3,1
2024-01-15 00:30:00,42295.238,42336.34,42038.137,42270.371,2029,44922,0,2024-01-15 00:00:00,2024-01-15 00:00:00,-35.46648809522594,-690.5739900479821,43022.09020238095,-0.004529210888572681,-0.006006138311662458,43367.19564285717,41348.93102238731,42639.81373588196,42658.114352405784,42805.455083940724,-0.006538923155859137,-0.001444983695887348,45407.55364004895,44789.615011699345,5.647525128888283,11.42445098617358,-527.5667843237245,43111.721576497,43590.922445500386,42970.91194220845,-479.20086900338356,-396.74819246685956,436.6355484517551,-199.152330581368,-207.59455899553723,-202.50598383210308,43560.36993261832,42379.953951798576,False,True,41570.371,41800.371,41800.371,41770.371,2024-01-15 02:00:00,True,2024-01-15 02:00:00,,2024-01-15 02:04:30,0.02,even,True,171.33,9677.840000000004,6,0,3,1
2024-01-15 00:45:00,42270.402,42398.738,42148.039,42243.738,2123,65410,0,2024-01-15 00:00:00,2024-01-15 00:00:00,-35.46648809522594,-690.5739900479821,43022.09020238095,-0.004529210888572681,-0.006006138311662458,43367.19564285717,41348.93102238731,42639.81373588196,42658.114352405784,42805.455083940724,-0.006538923155859137,-0.001444983695887348,45407.55364004895,44789.615011699345,7.664679243503268,8.792573913054323,-527.5667843237245,42978.185641651304,43491.13100509295,42775.96183900925,-512.9453634416495,-419.98762666181756,496.83533726420194,-194.95010319919675,-199.152330581368,-207.59455899553723,43446.68954431592,42103.73413370258,False,True,41543.738,41773.738,41773.738,41743.738,2024-01-15 02:00:00,True,2024-01-15 02:00:00,,2024-01-15 02:01:20,0.02,even,True,171.33,9849.170000000004,7,0,3,1
2024-01-16 23:15:00,43285.238,43453.84,43254.68,43431.34,2426,50769,0,2024-01-16 23:00:00,2024-01-16 23:00:00,65.79530952386267,87.82018538018019,43251.59048809523,0.0037873568561431164,0.0006002854037592865,43149.86847619051,43758.52854509384,43639.71319968875,43666.20166524042,43429.08724227524,4.845122479522142e-05,0.00396296256334306,43239.565749577385,42990.50461894447,84.23163803782336,74.27772878077256,64.76093983414391,43181.60946565902,43093.52302284205,43228.779630202946,88.08644281697343,62.69521735859545,121.89147508223779,74.05473993806663,47.50228861368669,14.45036738905037,43394.83312156397,43064.22613884192,True,False,44131.34,42981.34,43901.34,43931.34,,False,,,2024-01-17 03:50:58,0.02,fail,False,-164.07,9685.100000000004,0,1,3,1
2024-01-17 03:45:00,43077.738,43088.34,42924.988,42931.137,1253,39484,0,2024-01-17 03:00:00,2024-01-17 03:00:00,-21.78107142855879,74.01014744244458,43086.91622619048,0.00042013518347524756,-0.0006010660339026041,43170.450452380945,42991.60063492192,43343.62620697802,43152.90426820167,43792.21826198275,0.0008527109186819408,0.0008507116958534935,43213.16470495312,43009.33744346634,16.66556870086464,17.5532485958828,82.64353372484395,43086.186694358315,43111.40391994759,42990.784704506375,-25.217225589272857,1.5518128331906516,129.99007249131543,-25.762236670096172,-15.057925696586608,-11.320887512913032,43166.27130236965,42813.7981066431,False,True,42231.137,42461.137,42461.137,42431.137,2024-01-17 18:30:00,True,2024-01-17 18:30:00,2024-01-17 19:03:18,2024-01-17 20:41:44,0.02,success,True,255.17,9940.270000000004,1,0,3,1
2024-01-17 05:30:00,42947.688,42951.438,42874.953,42888.438,1319,44813,0,2024-01-17 05:00:00,2024-01-17 05:00:00,-71.88722619049076,27.87463319226663,42915.48857142858,-0.0007391013996496912,-0.0019271803595552683,43015.02899999999,42696.96124756956,42740.318298405546,42868.89323921601,42835.91083390143,-0.0018909803375801453,-9.792892605279684e-05,43188.381415068216,42990.884248949915,18.26223138653178,25.319756892445568,65.65162323906577,42994.087476796136,43047.53684133697,42941.377256621985,-53.44936454083654,-34.90939436696024,147.64297295464883,-17.566811145494285,-10.497082215333648,-5.869535259727854,43140.69527011076,42740.55924313321,False,True,42188.438,42418.438,42418.438,42388.438,2024-01-17 18:30:00,True,2024-01-17 18:30:00,2024-01-17 19:05:44,2024-01-17 19:30:49,0.02,success,True,255.17,10195.440000000004,2,0,3,1
2024-01-17 05:45:00,42888.438,42927.438,42812.34,42815.84,1069,36523,0,2024-01-17 05:00:00,2024-01-17 05:00:00,-71.88722619049076,27.87463319226663,42915.48857142858,-0.0007391013996496912,-0.0019271803595552683,43015.02899999999,42696.96124756956,42740.318298405546,42868.89323921601,42835.91083390143,-0.0018909803375801453,-9.792892605279684e-05,43188.381415068216,42990.884248949915,9.2004241516865,17.888588856046756,65.65162323906577,42966.66478805827,43030.37411234905,42913.173255245965,-63.70932429077948,-40.66938035172409,147.73208716422968,-28.204001376019733,-17.566811145494285,-10.497082215333648,43112.611572917674,42712.234937574256,False,True,42115.84,42345.84,42345.84,42315.84,2024-01-17 18:45:00,True,2024-01-17 18:45:00,2024-01-18 18:40:44,2024-01-17 18:55:04,0.02,even,True,171.32,10366.760000000004,3,0,3,1
2024-01-17 09:45:00,42723.898,42727.637,42589.145,42627.84,2034,38524,0,2024-01-17 09:00:00,2024-01-17 09:00:00,-30.29682142859383,-53.841077041572134,42709.20905952381,-0.001318648529425396,-0.0013539737264294288,42772.55620238096,42370.9740826514,42610.739656746206,42405.7299068191,42613.412046449885,-0.0015025085261335508,-0.0014059442891102558,43121.92536264343,42918.56744072292,19.515882458814335,27.119386474949465,6.448454508726963,42767.17089282131,42846.09726760479,42730.175732714146,-78.92637478347751,-73.301049411404,95.60891962745069,-21.56137289302569,-5.72832714136166,-5.185564155457541,42859.2477742112,42599.60369121709,False,True,41927.84,43077.84,42157.84,42127.84,,False,2024-01-18 18:45:00,2024-01-18 18:40:49,,0.02,success,True,255.17,10621.930000000004,4,0,3,1
2024-01-18 08:00:00,42750.84,42848.637,42750.84,42832.539,1102,44523,0,2024-01-18 08:00:00,2024-01-18 08:00:00,39.049642857164145,-1.1721845370557276,42695.86171428569,0.0004453380233984897,0.00033142377486557146,42648.3475,42653.09389692851,42909.01080007951,42661.70189047421,42766.02812615644,-1.1565537805272526e-05,0.000559718190485303,42827.91870149095,42682.68713874732,91.26657602878082,88.56385864215777,-26.309582624410673,42691.97892437386,42656.97784722226,42715.66706914345,35.00107715160266,13.235547847047329,70.43247897006817,25.552712762306328,25.19304196765006,19.513157894725737,42812.250915753044,42620.58322253385,True,False,43532.539,42382.539,43302.539,43332.539,,False,,,2024-01-18 12:55:55,0.02,fail,False,-164.07,10457.860000000004,0,1,3,1
2024-01-18 09:00:00,42782.738,42900.848,42776.676,42886.223,1370,42824,0,2024-01-18 09:00:00,2024-01-18 09:00:00,47.51421428568574,13.562332716435776,42782.38190476187,0.0008729900898447648,0.0004384742603661689,42695.86171428569,42812.27257560758,42971.24354586443,42653.09389692851,42909.01080007951,0.00033142377486557146,0.0004453380233984897,42830.43322300111,42699.43528764754,82.4634495228562,80.28305812682196,-18.335199556241385,42750.74567486285,42697.16433252083,42811.0194258686,53.581342342018615,32.60169507182572,95.92450082159215,39.496753009989334,21.456537667676457,16.355973168218043,42942.01750197775,42681.52134975945,True,False,43586.223,42436.223,43356.223,43386.223,,False,,,2024-01-18 12:53:03,0.02,fail,False,-164.07,10293.790000000005,0,2,3,1
2024-01-18 19:00:00,41927.637,41929.039,41613.84,41674.84,3354,8121,0,2024-01-18 19:00:00,2024-01-18 19:00:00,-193.5015952381509,-96.33438823714823,42158.10277380953,-0.003224620322107742,0.00015103101951563925,42352.225904761886,40948.14732998777,42831.60796305115,41286.039583637605,42752.48388320584,-0.00021473788301068858,-0.002705596218311377,42689.769461893,42515.89258820409,16.722086546817337,20.455154300672813,-36.700510744040436,42282.759314892144,42423.861964898264,42250.24525662196,-141.1026500061198,-58.321077995919424,231.04643602094328,-153.14990436875087,-112.71639834880625,-85.52038149294094,42562.157945250234,41936.83256799368,False,True,40974.84,42124.84,41204.84,41174.84,,False,2024-01-18 22:00:00,2024-01-18 21:57:01,2024-01-18 19:27:02,0.02,fail,False,-164.07,10129.720000000005,0,3,3,1
2024-01-19 05:00:00,41085.438,41117.238,40977.238,41039.137,1481,41941,0,2024-01-19 05:00:00,2024-01-19 05:00:00,3.078654761920916,-323.80245928707154,41171.835666666666,0.00022258406440362467,0.00017163333256652152,41236.1299047619,40745.88032961816,41391.34286257961,41298.93498774742,41126.32630832862,-0.001023504533730788,0.0016466315028431982,42188.37301373978,41752.24770114882,10.66881421079485,20.991312217372382,-310.5932753895694,41152.432048540606,41237.371898870544,41121.925401444794,-84.93985032993805,-91.90754138634686,104.40497636240408,-28.128476436184428,-29.779276229783136,-30.35105366355856,41262.87211953404,40979.47868335555,False,True,40339.137,41489.137,40569.137,40539.137,,False,2024-01-19 18:45:00,2024-01-19 18:42:16,2024-01-19 09:01:35,0.02,fail,False,-164.07,9965.650000000005,0,4,3,1
2024-01-19 05:15:00,41041.238,41074.238,40868.496,40915.84,1857,35007,0,2024-01-19 05:00:00,2024-01-19 05:00:00,3.078654761920916,-323.80245928707154,41171.835666666666,0.00022258406440362467,0.00017163333256652152,41236.1299047619,40745.88032961816,41391.34286257961,41298.93498774742,41126.32630832862,-0.001023504533730788,0.0016466315028431982,42188.37301373978,41752.24770114882,12.738897209023307,13.759381282649917,-310.5932753895694,41116.033271842054,41213.55472117643,41079.11503577573,-97.52144933437376,-93.03032297595225,103.26936681927528,-42.810365669065504,-28.128476436184428,-29.779276229783136,41218.52868098175,40938.20139056971,False,True,40215.84,41365.84,40445.84,40415.84,,False,2024-01-19 18:45:00,2024-01-22 20:49:20,2024-01-19 08:46:24,0.02,fail,False,-164.07,9801.580000000005,0,5,3,1
2024-01-24 09:15:00,39896.563,40161.34,39893.563,40075.34,2674,36422,0,2024-01-24 09:00:00,2024-01-24 09:00:00,-2.4113333333662013,99.87386932035588,39788.3854404762,-0.0003588582276014287,-0.00023030274976937567,39724.59883333332,39438.3842664951,40127.69961140071,39644.549582446205,39657.9327799017,-0.0014818776458300326,0.0005072681803178954,39937.604805098184,39643.46575397469,92.0087709840311,89.81027781520321,37.962711379590615,39818.77751290826,39742.74395746001,39873.851287925674,76.03355544825172,51.01076184754301,116.67936955494542,70.8329865840642,45.10507327145024,38.376579635369126,40032.86843682485,39716.3341390265,True,False,40775.34,39625.34,40545.34,40575.34,,False,2024-01-26 12:45:00,2024-01-26 13:02:57,2024-01-24 20:23:19,0.02,fail,False,-164.07,9637.510000000006,0,6,4,1
2024-01-25 07:00:00,39930.137,39941.438,39798.238,39810.34,1353,36422,0,2024-01-25 07:00:00,2024-01-25 07:00:00,-40.49497619047179,26.60334185072861,39925.79271428573,0.00015339412335695427,-0.00038277148000997096,39988.63748809526,39782.42895236642,40035.21403067595,40099.32505169082,40145.77004120198,-2.1064525564051914e-05,0.001508499746101991,39941.91774952498,39888.50038950301,18.814889965162013,23.308827413391146,31.756684960894052,39945.40485175287,39954.11991664383,39909.426959752294,-8.715064890959184,12.468569537664752,76.71042055519442,-24.83501238394092,-15.013933264526713,-8.873642930870119,40012.98602750181,39804.36789200278,False,True,39110.34,40260.34,39340.34,39310.34,,False,,,2024-01-25 13:28:15,0.02,fail,False,-164.07,9473.440000000006,0,7,4,1
2024-01-25 07:15:00,39810.34,39829.938,39765.738,39793.539,1215,36422,0,2024-01-25 07:00:00,2024-01-25 07:00:00,-40.49497619047179,26.60334185072861,39925.79271428573,0.00015339412335695427,-0.00038277148000997096,39988.63748809526,39782.42895236642,40035.21403067595,40099.32505169082,40145.77004120198,-2.1064525564051914e-05,0.001508499746101991,39941.91774952498,39888.50038950301,12.650594766337699,19.223015608661434,31.756684960894052,39922.04087456012,39942.22503392948,39887.931178534556,-20.184159369353438,5.9380237562611144,87.40508254399131,-21.495781217738113,-24.83501238394092,-15.013933264526713,40005.928039968945,39768.43431710017,False,True,39093.539,40243.539,39323.539,39293.539,,False,,,2024-01-25 13:13:17,0.02,fail,False,-164.07,9309.370000000006,0,8,4,1
2024-01-25 15:30:00,39812.738,39936.637,39763.852,39805.34,2076,36422,0,2024-01-25 15:00:00,2024-01-25 15:00:00,-74.73034523811657,24.226374536636285,39958.20660714288,-0.0005478202934525447,-0.0005040815693895127,40025.399785714275,39617.24954760094,40167.92071189415,39820.04787350147,40474.28791426566,0.0010383560017378564,0.00014126724309469188,39960.3058938564,39944.44013940603,10.782837685466179,11.565949668257673,35.55306878089166,39943.381577689666,39985.92663684735,39915.070724114186,-42.54505915768095,-3.0650373410893774,118.96072448370084,-37.7778682490607,-41.91651737186476,-40.982613347085135,40075.667702167186,39752.97374606119,False,True,39105.34,40255.34,39335.34,39305.34,,False,,,2024-01-26 11:42:35,0.02,fail,False,-164.07,9145.300000000007,0,9,4,1
2024-01-26 04:15:00,40035.637,40162.637,40021.84,40145.84,1865,36422,0,2024-01-26 04:00:00,2024-01-26 04:00:00,-0.036428571424039546,-4.241536092114984,39972.8504047619,0.0009552619421528462,0.0009630128923026931,39908.23064285713,39968.678977109754,40369.83538776162,39930.32164932375,39891.80455419841,-0.0002967992737533424,0.0009552623618696503,39930.28855421318,39913.16545247492,84.13427197101628,67.31653475999435,-13.32418395982735,39941.81052939201,39905.98097281722,39949.6741513588,35.82955657479033,15.562507337508976,79.35527013153694,45.08658754731732,19.043935328510997,1.894755417961278,40058.30376603638,39842.54453668122,True,False,40845.84,40615.84,40615.84,40645.84,2024-01-26 13:00:00,True,2024-01-26 13:00:00,2024-01-26 13:04:33,,0.02,success,True,255.17,9400.470000000007,1,0,4,1
2024-01-26 11:00:00,40098.152,40171.84,40079.762,40159.137,857,36422,0,2024-01-26 11:00:00,2024-01-26 11:00:00,12.870678571467579,35.61811049622338,40025.47219047621,-0.0002041989406559661,0.0005609882356597247,40039.38845238096,39817.89092498481,40469.636009572365,39917.43123028083,40101.13106323603,-0.000334608359217185,0.0002944108937803435,39957.037107764474,39968.83690414416,89.76026391655837,87.66741556084258,24.89148538674374,40068.052793862764,40043.4990827106,40049.08979738561,24.553711152162577,15.476905028421736,71.679504201495,28.356212934268115,14.882746818031592,16.697797385641024,40147.35712805763,39952.322466713595,True,False,40859.137,39709.137,40629.137,40659.137,,False,2024-01-26 13:15:00,2024-01-26 13:04:39,,0.02,success,True,255.17,9655.640000000007,2,0,4,1
2024-01-26 11:30:00,40145.84,40281.039,40139.77,40277.137,979,36422,0,2024-01-26 11:00:00,2024-01-26 11:00:00,12.870678571467579,35.61811049622338,40025.47219047621,-0.0002041989406559661,0.0005609882356597247,40039.38845238096,39817.89092498481,40469.636009572365,39917.43123028083,40101.13106323603,-0.000334608359217185,0.0002944108937803435,39957.037107764474,39968.83690414416,95.47282319529359,91.74678765691532,24.89148538674374,40111.47815418577,40068.421501638026,40119.00657275542,43.05665254774067,23.258006090722652,83.8371967111508,45.61979910561058,24.29697626419511,28.356212934268115,40233.68678831547,40005.826357195365,True,False,40977.137,39827.137,40747.137,40777.137,,False,2024-01-26 13:30:00,2024-01-26 13:29:13,,0.02,success,True,255.17,9910.810000000007,3,0,4,1
2024-01-26 12:45:00,40608.996,40724.453,40491.848,40654.238,2864,36422,0,2024-01-26 12:00:00,2024-01-26 12:00:00,-13.916261904749263,34.97927583540877,40236.20259523811,-0.0004680602752582516,0.001989066874423189,40025.47219047621,39739.84502600295,41018.16181591211,39817.89092498481,40469.636009572365,0.0005609882356597247,-0.0002041989406559661,39984.37831922469,40023.66899181263,86.13615196519703,68.99562401383255,26.909043476476747,40268.68483424619,40160.93072694316,40363.79826487789,107.75410730302974,52.80287681551796,177.77917531452744,101.4619109047344,102.5862855177038,36.572490884078434,40605.3001515525,40123.79637820328,True,False,41354.238,41124.238,41124.238,41154.238,2024-01-26 13:45:00,True,2024-01-26 13:45:00,2024-01-26 14:00:08,2024-01-26 13:47:35,0.02,even,True,171.33,10082.140000000007,4,0,4,1
2024-01-26 13:00:00,40646.652,40866.238,40645.086,40776.547,2893,36422,0,2024-01-26 13:00:00,2024-01-26 13:00:00,210.73040476189635,101.46648209866544,40603.802166666675,0.0014328590996263541,0.003963361604516158,40236.20259523811,40301.47403029263,41925.291063893674,39739.84502600295,41018.16181591211,0.001989066874423189,-0.0004680602752582516,40034.15713023549,40122.07451246762,91.41769238778348,82.50812465102995,41.82053120091449,40346.81747513139,40206.531932354774,40476.57231750945,140.28554277661897,70.29941000773817,220.64504523233694,112.77405263156106,101.4619109047344,102.5862855177038,40775.94312857311,40178.701506445796,True,False,41476.547,41246.547,41246.547,41276.547,2024-01-26 14:15:00,True,2024-01-26 14:15:00,2024-01-26 16:59:28,2024-01-26 14:42:54,0.02,even,True,171.33,10253.470000000007,5,0,4,1
2024-01-26 13:45:00,41216.738,41301.367,41120.688,41253.738,2426,36422,0,2024-01-26 13:00:00,2024-01-26 13:00:00,210.73040476189635,101.46648209866544,40603.802166666675,0.0014328590996263541,0.003963361604516158,40236.20259523811,40301.47403029263,41925.291063893674,39739.84502600295,41018.16181591211,0.001989066874423189,-0.0004680602752582516,40034.15713023549,40122.07451246762,94.29697882487169,93.49700938697147,41.82053120091449,40665.08283086021,40400.09209709107,40904.900693498465,264.9907337691402,147.9502180900982,395.2358736541298,142.93394530443766,159.14655108360603,126.24787960096728,41439.96912293154,40371.332264065386,True,False,41953.738,41723.738,41723.738,41753.738,2024-01-26 18:30:00,True,2024-01-26 18:30:00,2024-01-26 18:54:56,2024-01-26 18:30:19,0.02,even,True,171.33,10424.800000000007,6,0,4,1
2024-01-26 18:15:00,41601.637,41781.738,41545.23,41780.137,2694,36422,0,2024-01-26 18:00:00,2024-01-26 18:00:00,115.72771428572742,371.9654808276464,41638.016547619045,0.0054440997107731825,0.0034418531586856817,41403.496845238085,42193.17869855831,42574.79419058788,42035.68276731767,42673.29981304488,0.004201674983976597,0.0056498284537723036,40283.30829525419,40566.71519421025,89.43806148387993,76.45389044472624,225.46637007715356,41381.64531415944,41114.14248417862,41471.232297213624,267.5028299808182,256.57346840003635,332.8379243963524,94.05224492600246,63.1862394221389,4.20646886825125,41922.0634951487,41021.90109927855,True,False,42480.137,42250.137,42250.137,42280.137,2024-01-29 05:15:00,True,2024-01-29 05:15:00,2024-01-29 17:52:25,2024-01-29 06:17:06,0.02,even,True,171.33,10596.130000000006,7,0,4,1
2024-01-26 18:30:00,41777.848,41864.738,41689.852,41781.84,2652,36422,0,2024-01-26 18:00:00,2024-01-26 18:00:00,115.72771428572742,371.9654808276464,41638.016547619045,0.0054440997107731825,0.0034418531586856817,41403.496845238085,42193.17869855831,42574.79419058788,42035.68276731767,42673.29981304488,0.004201674983976597,0.0056498284537723036,40283.30829525419,40566.71519421025,95.67317408656852,87.22111558652296,225.46637007715356,41443.21372736568,41163.60155942465,41561.160523219805,279.612167941028,261.1812083082347,297.44266383277295,89.92822600618092,94.05224492600246,63.1862394221389,41964.20811939405,41159.612927045564,True,False,42481.84,42251.84,42251.84,42281.84,2024-01-29 05:15:00,True,2024-01-29 05:15:00,2024-01-29 17:52:25,2024-01-29 06:17:06,0.02,even,True,171.33,10767.460000000006,8,0,4,1
2024-01-26 18:45:00,41778.023,41963.34,41756.539,41926.137,2580,36422,0,2024-01-26 18:00:00,2024-01-26 18:00:00,115.72771428572742,371.9654808276464,41638.016547619045,0.0054440997107731825,0.0034418531586856817,41403.496845238085,42193.17869855831,42574.79419058788,42035.68276731767,42673.29981304488,0.004201674983976597,0.0056498284537723036,40283.30829525419,40566.71519421025,96.00136328230225,93.70419961758354,225.46637007715356,41517.50961546326,41220.085666133935,41683.45497213626,297.423949329328,268.42975651245337,300.6872648314046,122.29444891645107,89.92822600618092,94.05224492600246,42090.882779658656,41277.52716461386,True,False,42626.137,42396.137,42396.137,42426.137,2024-01-29 05:30:00,True,2024-01-29 05:30:00,2024-01-29 18:00:14,2024-01-29 05:32:47,0.02,even,True,171.33,10938.790000000006,9,0,4,1
2024-01-26 20:30:00,41997.438,42125.938,41960.199,42122.34,2140,36422,0,2024-01-26 20:00:00,2024-01-26 20:00:00,102.21132142856368,465.2345769327876,41881.15242857144,0.0041071623810591505,0.003441814345266621,41740.22786904761,42294.76056847488,42869.33607178525,42423.02979246066,42721.39715889144,0.00344180139778587,0.005443610199726641,40413.18110376983,40782.91711957956,87.02547316251075,85.29293644843784,307.195025015674,41812.47098611024,41514.64247370633,42030.27687891296,297.8285124039103,288.4023298090751,350.5799775182572,53.493600963178324,31.122707258349692,36.68565875473723,42505.05984856261,41556.993909263314,True,False,42822.34,41672.34,42592.34,42622.34,,False,2024-01-29 18:30:00,2024-01-29 18:20:11,2024-01-29 00:39:32,0.02,fail,False,-164.07,10774.720000000007,0,1,4,1
2024-01-30 04:00:00,43407.039,43549.066,43407.039,43541.039,1834,36422,0,2024-01-30 04:00:00,2024-01-30 04:00:00,91.0103333333318,294.0347780320444,43384.10825000001,0.0009877717197878636,0.0021204903247496352,43256.17583333335,43313.90747727114,44111.23376854121,43270.97923217204,43782.71717549178,0.0014929771898046758,0.0009878222646368803,42022.89155839212,42682.26246487686,80.72057457080994,79.74313841033667,278.3374171193511,43307.19073636636,43171.22793121022,43384.482513931885,135.9628051561449,118.39600124040027,139.79851775626878,61.77482662534749,34.74203921571461,39.112016167870024,43574.71051290285,43195.75451496092,True,False,44241.039,43091.039,44011.039,44041.039,,False,,,2024-01-30 16:10:49,0.02,fail,False,-164.07,10610.650000000007,0,2,5,1
2024-01-31 01:30:00,42855.926,42967.738,42661.938,42747.098,2544,36422,0,2024-01-31 01:00:00,2024-01-31 01:00:00,-52.541190476185875,53.25084765440988,43246.69688095242,-0.0017744127848034843,0.00024100669904713527,43429.903642857134,42370.60125482367,43802.05837231804,43337.950591995366,43887.55003203822,0.000626665166544423,0.00037795740948898965,42784.25589651701,43236.378521622755,3.1983124248350627,3.7444447239893637,88.7857846928334,43229.67493205169,43328.523763657315,43164.996165806675,-98.84883160562458,-14.329863001958483,209.8512864597023,-133.58983625728433,-121.62710010322917,-64.29427966977528,43448.29540252727,42880.19692908608,False,True,42047.098,43197.098,42277.098,42247.098,,False,2024-02-01 03:15:00,2024-02-01 03:19:27,2024-01-31 17:33:44,0.02,fail,False,-164.07,10446.580000000007,0,3,5,1
2024-01-31 11:15:00,42805.738,42861.738,42745.738,42748.637,1438,36422,0,2024-01-31 11:00:00,2024-01-31 11:00:00,13.161726190468471,-80.3434233294538,42859.93801190477,-0.0001381126611636029,0.00012782391540707016,42979.096142857175,42561.13144960502,43082.67838903168,43075.11452242833,43115.81757298911,0.0003196651906349036,0.0010893713300746822,42815.31738864299,43032.9931481105,16.605257695764806,27.015699170961444,-73.69013941561967,42899.69994139045,42931.0051975733,42893.23688476094,-31.305256182851736,-18.129546831045786,56.35848071967666,-37.400371173003805,-30.586733746167738,-3.642722050230077,42969.320833732505,42815.652935789374,False,True,42048.637,43198.637,42278.637,42248.637,,False,2024-02-01 03:15:00,2024-02-01 03:19:21,2024-01-31 17:33:44,0.02,fail,False,-164.07,10282.510000000007,0,4,5,1
2024-01-31 11:45:00,42819.137,42869.738,42582.246,42619.938,1480,36422,0,2024-01-31 11:00:00,2024-01-31 11:00:00,13.161726190468471,-80.3434233294538,42859.93801190477,-0.0001381126611636029,0.00012782391540707016,42979.096142857175,42561.13144960502,43082.67838903168,43075.11452242833,43115.81757298911,0.0003196651906349036,0.0010893713300746822,42815.31738864299,43032.9931481105,12.993325950838724,14.238453732811545,-73.69013941561967,42846.172159220376,42900.2904670553,42812.93066563466,-54.11830783492769,-28.092655011612443,85.9062261474941,-59.98126762988977,-20.324951496389986,-37.400371173003805,42928.90407093378,42695.45726033554,False,True,41919.938,43069.938,42149.938,42119.938,,False,2024-02-01 03:30:00,2024-02-01 03:21:12,2024-01-31 17:31:45,0.02,fail,False,-164.07,10118.440000000008,0,5,5,1
2024-01-31 17:30:00,42982.34,43441.738,42976.426,43349.637,3700,36422,0,2024-01-31 17:00:00,2024-01-31 17:00:00,67.64813095240243,-104.54584107402479,42907.620952380945,0.00010113387849924145,0.0012695716667480217,42664.65083333335,42355.52992825261,43644.61358489975,42125.88468567883,42908.903452011094,-0.00035557126163247453,-0.000699174154483243,42805.68009496914,42937.765130848726,89.51965968760913,83.68111750819982,-118.2202654107487,42848.69296115446,42778.60568514096,42942.58041142068,70.08727601350256,-8.064643627849579,198.97537442076478,112.70107774333883,42.372106983166304,49.02750257997104,43212.69716688871,42673.96365595264,True,False,44049.637,42899.637,43819.637,43849.637,,False,,,2024-01-31 22:05:31,0.02,fail,False,-164.07,9954.370000000008,0,6,5,1
2024-02-01 16:45:00,42499.457,42618.438,42437.867,42609.137,2339,36422,0,2024-02-01 16:00:00,2024-02-01 16:00:00,11.567250000000058,-122.23155927841435,42290.36472619049,-0.0008485010410050797,0.0011611187224804364,42135.88705952384,41707.56327740517,42799.92998395751,41765.04881427185,42360.14533397379,0.00019468583058156254,-0.0007365855270919586,42543.768734188845,42399.57600064836,94.34709727914178,88.96312348870373,-159.36545156291362,42292.077294940595,42230.38808365967,42317.01884038529,61.68921128092188,12.639752960606598,126.29944645614272,82.21755693153682,62.9857113863618,32.84334124523593,42489.02309310108,42146.514587669495,True,False,43309.137,43079.137,43079.137,43109.137,2024-02-01 22:00:00,True,2024-02-01 22:00:00,2024-02-02 02:19:45,2024-02-01 22:02:14,0.02,even,True,171.33,10125.700000000008,1,0,5,2
2024-02-01 17:00:00,42593.891,42774.938,42530.637,42748.438,2947,36422,0,2024-02-01 17:00:00,2024-02-01 17:00:00,154.4776666666512,-58.65809554016596,42375.6244642857,0.0008845020344393963,0.002305477344774241,42290.36472619049,42156.241075523205,43276.75956155959,41707.56327740517,42799.92998395751,0.0011611187224804364,-0.0008485010410050797,42541.34015637752,42406.157120596494,97.02847746528941,93.6326438179032,-139.2239803583641,42362.286634180506,42268.76215153673,42413.45688132094,93.52448264377745,28.81669889724077,166.9138870854025,96.43804093565268,82.21755693153682,62.9857113863618,42640.290628886236,42188.123133755646,True,False,43448.438,43218.438,43218.438,43248.438,2024-02-02 02:30:00,True,2024-02-02 02:30:00,2024-02-02 18:05:41,2024-02-02 02:32:41,0.02,even,True,171.33,10297.030000000008,2,0,5,2
2024-02-05 09:30:00,42882.738,43068.738,42880.191,43038.137,2113,36422,0,2024-02-05 09:00:00,2024-02-05 09:00:00,72.74004761900142,-47.66264581098949,42875.61222619046,0.002110617528000889,0.001842739130831118,42731.167964285705,43087.31997462067,43442.55645470091,42938.28043514214,43007.22715146363,0.0008625757088197778,0.0019557267828711564,42787.24726281515,42787.05375363393,86.93774448629314,83.4881893792395,-71.77558951493732,42776.00429661675,42704.255180096516,42840.88317096664,71.7491165202373,33.694203063829555,159.42896389629047,49.2022707258584,18.99257894729817,4.003355693152116,43057.61227222663,42625.65406970665,True,False,43738.137,42588.137,43508.137,43538.137,,False,2024-02-07 20:30:00,2024-02-07 22:05:20,2024-02-05 17:56:59,0.02,fail,False,-164.07,10132.960000000008,0,1,6,2
2024-02-05 09:45:00,43038.137,43150.137,43005.539,43040.738,2050,36422,0,2024-02-05 09:00:00,2024-02-05 09:00:00,72.74004761900142,-47.66264581098949,42875.61222619046,0.002110617528000889,0.001842739130831118,42731.167964285705,43087.31997462067,43442.55645470091,42938.28043514214,43007.22715146363,0.0008625757088197778,0.0019557267828711564,42787.24726281515,42787.05375363393,86.98501368620073,86.5603560605747,-71.77558951493732,42816.732558675714,42729.1798334227,42885.69310904714,87.55272525301552,44.46590750166675,173.31827621669433,44.809938080499705,49.2022707258584,18.99257894729817,43121.17278193968,42651.713436154605,True,False,43740.738,42590.738,43510.738,43540.738,,False,2024-02-07 20:30:00,2024-02-07 22:05:21,2024-02-05 17:56:59,0.02,fail,False,-164.07,9968.890000000009,0,2,6,2
2024-02-05 12:30:00,43142.938,43187.539,43127.891,43151.82,970,36422,0,2024-02-05 12:00:00,2024-02-05 12:00:00,56.43983333330834,41.55804291907407,43051.199797619076,0.001981330465433458,0.0021450102320163824,43002.89522619048,43317.31979978247,43772.07849210382,43231.366718039826,43795.94383075459,0.0026204115726333158,0.0019813064889460602,42816.26170855056,42844.22111196571,82.07700960034776,76.41058253405787,-25.183237316027977,43019.839091234215,42908.033887664875,43119.35669005847,111.80520356933994,97.75693392419232,172.62478418398845,21.43829136561544,27.90654489166627,28.832321637462883,43353.90014870685,42886.31323141009,True,False,43851.82,42701.82,43621.82,43651.82,,False,2024-02-07 22:15:00,2024-02-07 22:15:41,2024-02-05 17:43:52,0.02,fail,False,-164.07,9804.820000000009,0,3,6,2
2024-02-05 15:00:00,43222.039,43295.738,43182.738,43231.738,1632,36422,0,2024-02-05 15:00:00,2024-02-05 15:00:00,57.957119047641754,102.7940943491194,43269.1838571429,0.0016401336205899893,0.0015515000051150244,43171.86189285717,43418.13284608759,43802.981840617154,43346.6786207976,43425.77383228332,0.0007340861758688701,0.0016401729228602703,42867.57819978188,42939.27044680236,81.9877167933699,74.61117913449458,29.445696199240352,43139.206265674526,43041.59850813303,43204.49150085999,97.60775754149654,98.5364934164054,110.73093728462727,16.281222910220094,21.939213622288662,18.973823185406218,43355.47826619424,43055.00473552575,True,False,43931.738,42781.738,43701.738,43731.738,,False,2024-02-07 22:15:00,2024-02-07 22:16:44,2024-02-05 17:20:08,0.02,fail,False,-164.07,9640.75000000001,0,4,6,2
2024-02-05 15:15:00,43231.738,43423.438,43231.738,43356.738,1868,36422,0,2024-02-05 15:00:00,2024-02-05 15:00:00,57.957119047641754,102.7940943491194,43269.1838571429,0.0016401336205899893,0.0015515000051150244,43171.86189285717,43418.13284608759,43802.981840617154,43346.6786207976,43425.77383228332,0.0007340861758688701,0.0016401729228602703,42867.57819978188,42939.27044680236,84.2759884579297,79.68350950338844,29.445696199240352,43172.67268633998,43064.94217419725,43244.10220433434,107.73051214273437,100.3752971616712,108.44249834323095,39.61070347434725,16.281222910220094,21.939213622288662,43391.999577097704,43097.704831570976,True,False,44056.738,42906.738,43826.738,43856.738,,False,2024-02-07 22:30:00,2024-02-07 22:17:11,2024-02-05 17:16:57,0.02,fail,False,-164.07,9476.68000000001,0,5,6,2
2024-02-05 23:15:00,42376.039,42410.438,42332.723,42366.738,1083,56422,0,2024-02-05 23:00:00,2024-02-05 23:00:00,-124.5014166667097,-84.2706136331617,42479.32038095241,-0.0010102053565824204,-0.0026953220149520526,42538.45253571426,42097.16484807686,42237.26113377957,41727.399978778325,42351.24109569898,-0.002695140658849986,-0.0022958787383335843,42809.976513023954,42793.51101152565,15.495759138631401,18.31684293913051,-7.496209785524611,42528.396460604956,42659.78723519335,42458.34138390089,-131.39077458839165,-107.84888073449268,142.509970084368,-42.4400890953184,-57.93461885108263,-57.246376332950604,42650.72984351479,42264.452924287,False,True,41666.738,42816.738,41896.738,41866.738,,False,,,2024-02-06 04:36:50,0.02,fail,False,-164.07,9312.61000000001,0,6,6,2
2024-02-06 05:00:00,42809.691,42922.84,42801.84,42904.84,911,36422,0,2024-02-06 05:00:00,2024-02-06 05:00:00,100.88801190476806,-52.37636154502252,42755.1764047619,0.0019283177493535169,0.000536789624310231,42655.61292857147,42995.44033338739,43016.38931549685,42548.139215393145,42941.023017499945,0.0002047865869762529,0.0008154536058679675,42779.375009428346,42746.75191412391,88.28855970218734,86.47127865015948,-66.46132470856885,42726.17090435939,42666.720706139626,42801.358506019926,59.45019821976166,19.510716195515077,158.60598502158425,30.837296525627607,18.799056071511586,42.44643722053297,43016.976585799064,42587.24042624079,True,False,43604.84,43374.84,43374.84,43404.84,2024-02-07 19:30:00,True,2024-02-07 19:30:00,2024-02-07 19:36:28,2024-02-07 19:47:43,0.02,success,True,255.18,9567.79000000001,1,0,6,2
2024-02-06 17:45:00,43156.137,43229.738,43107.355,43213.84,1878,36422,0,2024-02-06 17:00:00,2024-02-06 17:00:00,5.904000000031374,27.135545069504587,42944.1648214286,-0.00022818727993874268,0.0005984284389735992,42829.94160714289,42547.96721891878,43339.222901352616,42560.578601928886,43037.90120090152,-0.00013707870165205244,-0.0002182083856794707,42816.77837820967,42836.074605929876,91.00864541480432,83.04613263717111,16.386661199125392,42996.060936893846,42919.37861647356,43070.46340350874,76.6823204202883,37.37256351793459,131.35352063405043,54.13150739586854,45.67447609223018,56.64301995182905,43249.290656364705,42893.13615065277,True,False,43913.84,42763.84,43683.84,43713.84,,False,2024-02-07 22:15:00,2024-02-07 22:16:40,2024-02-07 05:52:28,0.02,fail,False,-164.07,9403.72000000001,0,1,6,2
2024-02-07 05:45:00,42827.891,42842.938,42745.238,42764.84,1157,36422,0,2024-02-07 05:00:00,2024-02-07 05:00:00,-26.56094047620718,34.17225811367098,42939.50265476191,-0.0009676874211523678,-0.0006215890985590939,43027.66032142857,42593.97034371265,43002.586973538666,42846.41016862085,43027.97614913077,-0.0006254762666800041,-0.0004550483117149739,42911.93813014548,42972.81084940439,4.622371562821047,7.988504953974978,62.52883011635667,42954.912357943984,43017.01850848314,42908.65892844858,-62.10615053915535,-31.371668274891462,98.87540859339988,-47.58936635704595,-35.84878947369725,-21.23277089784824,43042.14073004967,42773.67712684749,False,True,42064.84,43214.84,42294.84,42264.84,,False,,,2024-02-07 16:46:27,0.02,fail,False,-164.07,9239.65000000001,0,2,6,2
2024-02-09 05:00:00,46252.738,46329.238,46071.961,46264.738,2888,36422,0,2024-02-09 05:00:00,2024-02-09 05:00:00,313.1271071428346,286.52212946468353,45810.38167857144,0.000746440587908075,0.0028499556170355793,45635.53155952381,45427.25589820216,46996.64178711618,45393.49615485372,46863.53041206978,0.0028498223916177887,0.0007462965670321311,44492.5938514344,45084.63984614144,92.85630428575429,91.40360002230629,240.2513584469774,45703.388149808015,45496.11056300414,45853.400584795316,207.27758680387342,104.88989597474443,301.10044509532105,142.43046405229688,162.53827210178133,109.78303336776298,46261.386185674,45446.914983916635,True,False,46964.738,45814.738,46734.738,46764.738,,False,2024-02-09 13:45:00,2024-02-09 13:44:31,2024-02-09 06:19:31,0.02,fail,False,-164.07,9075.58000000001,0,3,6,2
2024-02-09 09:15:00,46208.324,46283.539,46149.633,46283.539,1187,36422,0,2024-02-09 09:00:00,2024-02-09 09:00:00,85.59071428575407,343.47195675005787,46224.35382142859,0.0033448236209609413,0.0006052667829027087,46189.46363095239,46731.038359606675,46612.368322442824,46691.58514762008,47173.11628035388,0.0022284857932923603,0.003630931893075088,44733.71059156216,45380.1284226357,86.56162319790519,80.04903274058707,294.2529502501413,46122.52776513771,45945.93583842372,46174.13697213626,176.5919267139907,180.67718515945498,289.21427080904624,51.89381940148451,12.305480908114987,-5.774204678287788,46566.07623772847,45783.697706544044,True,False,46983.539,46753.539,46753.539,46783.539,2024-02-09 13:45:00,True,2024-02-09 13:45:00,2024-02-09 13:45:01,2024-02-09 16:20:55,0.02,success,True,255.18,9330.760000000011,1,0,6,2
2024-02-14 08:00:00,49532.84,49643.637,49498.039,49616.738,890,36422,0,2024-02-14 08:00:00,2024-02-14 08:00:00,20.653154761916085,19.732205832464388,49503.96505952383,-0.0004747659213533166,-0.00033111057838066126,49463.184000000016,49062.1979773836,49580.52395997003,49123.167676295816,49548.27289863786,-0.0004312451191665423,-0.0003154516188738391,49022.87091118022,49423.168930718704,83.14505636966231,75.98930693714674,-11.996319716918425,49495.5602297746,49465.425420287575,49501.56354833165,30.13480948702636,22.81348582772622,71.02598439979955,17.670005159925495,8.591318197453802,7.887009631966066,49598.948627271384,49405.67846939192,True,False,50316.738,49166.738,50086.738,50116.738,,False,2024-02-14 11:00:00,2024-02-14 10:55:19,,0.02,success,True,255.18,9585.940000000011,2,0,7,2
2024-02-14 08:45:00,49559.738,49628.039,49531.84,49616.438,1362,36422,0,2024-02-14 08:00:00,2024-02-14 08:00:00,20.653154761916085,19.732205832464388,49503.96505952383,-0.0004747659213533166,-0.00033111057838066126,49463.184000000016,49062.1979773836,49580.52395997003,49123.167676295816,49548.27289863786,-0.0004312451191665423,-0.0003154516188738391,49022.87091118022,49423.168930718704,86.96222300470981,86.60296066749726,-11.996319716918425,49531.81978053254,49490.37037524734,49543.26450773996,41.449405285202374,30.206856028861992,78.81826520898218,19.253641210838396,8.86739903686248,13.579919160605641,49651.16916577208,49436.859849707835,True,False,50316.438,49166.438,50086.438,50116.438,,False,2024-02-14 11:00:00,2024-02-14 10:55:19,,0.02,success,True,255.15,9841.090000000011,3,0,7,2
2024-02-14 09:00:00,49616.438,49717.238,49616.438,49649.637,1330,36422,0,2024-02-14 09:00:00,2024-02-14 09:00:00,40.781059523811564,36.00726031549857,49633.41614285712,0.00021947226969788286,0.000517076034982112,49503.96505952383,49271.42046381,49977.777171097085,49062.1979773836,49580.52395997003,-0.00033111057838066126,-0.0004747659213533166,49054.39511074178,49455.45445626121,87.24436715934074,87.06374706014982,-2.395603710435025,49549.945506604454,49502.1679030068,49570.12463536292,47.77760359765671,33.72100554262094,85.79884705457252,26.860127622960135,19.253641210838396,8.86739903686248,49687.45307888659,49454.29619183925,True,False,50349.637,49199.637,50119.637,50149.637,,False,2024-02-14 11:00:00,2024-02-14 10:55:21,,0.02,success,True,255.15,10096.24000000001,4,0,7,2
2024-02-14 09:15:00,49649.637,49848.383,49611.34,49833.328,1033,36422,0,2024-02-14 09:00:00,2024-02-14 09:00:00,40.781059523811564,36.00726031549857,49633.41614285712,0.00021947226969788286,0.000517076034982112,49503.96505952383,49271.42046381,49977.777171097085,49062.1979773836,49580.52395997003,-0.00033111057838066126,-0.0004747659213533166,49054.39511074178,49455.45445626121,92.85748060469977,89.02135692291677,-2.395603710435025,49593.54281328069,49526.69828056185,49627.065802201556,66.84453271883831,40.345710977864414,108.02282180035057,56.94116683863831,26.860127622960135,19.253641210838396,49774.39661163203,49481.23499277108,True,False,50533.328,49383.328,50303.328,50333.328,,False,2024-02-14 11:00:00,2024-02-14 10:57:59,,0.02,success,True,255.15,10351.39000000001,5,0,7,2
2024-02-14 09:45:00,49791.184,49869.738,49758.008,49826.738,1552,36422,0,2024-02-14 09:00:00,2024-02-14 09:00:00,40.781059523811564,36.00726031549857,49633.41614285712,0.00021947226969788286,0.000517076034982112,49503.96505952383,49271.42046381,49977.777171097085,49062.1979773836,49580.52395997003,-0.00033111057838066126,-0.0004747659213533166,49054.39511074178,49455.45445626121,91.84812370926737,91.60215091274644,-2.395603710435025,49653.917777556,49566.41588114013,49726.12789370481,87.50189641587349,55.626563476764275,128.04555627919967,50.37734709318465,48.68474441007129,56.94116683863831,49900.48939468173,49553.26639272789,True,False,50526.738,49376.738,50296.738,50326.738,,False,2024-02-14 11:00:00,2024-02-14 10:57:58,,0.02,success,True,255.15,10606.54000000001,6,0,7,2
2024-02-14 11:00:00,50767.168,51667.438,50631.773,50988.438,4749,36422,0,2024-02-14 11:00:00,2024-02-14 11:00:00,409.9161904761859,197.63400554266263,50623.321761904794,0.0026586162848184895,0.006089949143877549,50043.3323333333,50369.518530860914,52934.944998945626,50233.716936723715,51611.17720134104,0.003834867001536459,0.002658277802352255,49217.410058781636,49720.76080857949,83.13925049942587,81.35349042880068,49.15149446911113,50042.773265262666,49793.043654929614,50236.509775369756,249.72961033305182,124.28106002618054,387.40420563334266,213.84403130369174,199.79709838324197,43.343899552797666,50761.005452974765,49713.514097764746,True,False,51688.438,50538.438,51458.438,51488.438,,False,2024-02-14 12:00:00,2024-02-14 11:50:36,,0.02,success,True,255.15,10861.69000000001,7,0,7,2
2024-02-14 15:45:00,51794.938,51824.637,51668.027,51801.84,2301,36422,0,2024-02-14 15:00:00,2024-02-14 15:00:00,229.02904761902755,562.6262114389247,51790.12388095241,0.007108214432966232,0.005266525997264737,51601.17221428572,52954.63573998223,53892.16146849814,52668.081411497245,54909.49348458566,0.008767992970940813,0.007326136966808159,49566.652756778756,50250.07646091186,88.25177211927587,78.69224730547835,311.03761345790133,51556.04468224819,51151.529090163865,51687.72237942891,404.51559208432445,429.8248426339854,661.0620386217583,38.62635534913716,23.89229274156969,3.4250718954281183,52581.656131568285,50795.288627289534,True,False,52501.84,51351.84,52271.84,52301.84,,False,2024-02-15 02:45:00,2024-02-15 02:37:40,2024-02-14 17:16:30,0.02,fail,False,-164.05,10697.64000000001,0,1,7,2
2024-02-19 08:15:00,52372.738,52481.738,52332.805,52437.637,1883,36422,0,2024-02-19 08:00:00,2024-02-19 08:00:00,-18.595119047589833,28.60094514445518,52219.21784523808,0.00043645478637342825,0.00010193046883848837,52120.571440476226,52116.236933930755,52524.23677213064,52104.59570466169,51962.75349771261,-0.001099291059636729,0.0004922464833712794,51879.84320129512,52094.83782158405,83.75819149447335,61.70732636387394,21.03495113810689,52191.307894832215,52147.69630046695,52191.95722566222,43.611594365262135,16.12873176833577,102.05813168502324,55.384112831139646,39.2641114551152,3.3233298933701008,52331.235703437,52054.17874788744,True,False,53137.637,51987.637,52907.637,52937.637,,False,,,2024-02-19 18:51:58,0.02,fail,False,-164.05,10533.590000000011,0,2,8,2
2024-02-20 08:00:00,51923.039,52044.238,51912.941,52032.781,681,36422,0,2024-02-20 08:00:00,2024-02-20 08:00:00,71.34885714288976,-74.8488831321738,51846.961547619045,0.0013219323783350318,9.336802245771584e-05,51752.06152380954,51916.74591161447,52076.30833878935,51412.88024933923,51937.85723038787,-0.0003186160994390588,0.00024912164702095384,51913.782761038485,51918.189359933196,91.35686811005405,89.54082538225482,-89.65165785746669,51847.45993231624,51805.397487165006,51917.99853835576,42.06244515123399,-3.895106382828569,138.1033015001868,41.85855624359829,16.696830409382528,52.224327485397225,52105.93799538101,51731.5590813305,True,False,52732.781,51582.781,52502.781,52532.781,,False,2024-02-20 15:45:00,2024-02-20 15:34:58,2024-02-20 11:20:21,0.02,fail,False,-164.05,10369.540000000012,0,3,8,2
2024-02-21 00:00:00,52023.84,52163.039,51999.84,52153.695,968,56422,0,2024-02-21 00:00:00,2024-02-21 00:00:00,209.11091666668653,-3.8432499268310494,52062.32708333331,0.004623658095053576,0.0005841608154378605,51890.895202380954,52893.59116893081,52431.478702943146,51683.346056853676,51772.20700896932,-0.001975099843329357,0.002268227312546791,51931.542920691885,51940.2758094464,87.45754279529096,86.98603865314386,-23.29866946771846,51993.00931409962,51893.42117825221,52236.730629859005,99.5881358474071,46.071449188689954,361.7014470975049,15.35964705888182,-1.2497856897753081,45.75409838324413,52726.527583440635,51748.433676277375,True,False,52853.695,51703.695,52623.695,52653.695,,False,,,2024-02-21 08:50:19,0.02,fail,False,-164.05,10205.490000000013,0,4,8,2
2024-02-21 00:15:00,52155.738,52200.738,52098.988,52157.637,862,56422,0,2024-02-21 00:00:00,2024-02-21 00:00:00,209.11091666668653,-3.8432499268310494,52062.32708333331,0.004623658095053576,0.0005841608154378605,51890.895202380954,52893.59116893081,52431.478702943146,51683.346056853676,51772.20700896932,-0.001975099843329357,0.002268227312546791,51931.542920691885,51940.2758094464,88.54806360324618,87.78396471757844,-23.29866946771846,52018.33665039199,51912.9927206039,52252.0007901617,105.34392978809046,57.925945308570064,372.36255506217157,15.270160302694421,15.35964705888182,-1.2497856897753081,52756.190239495634,51749.311340827764,True,False,52857.637,51707.637,52627.637,52657.637,,False,,,2024-02-21 08:49:12,0.02,fail,False,-164.05,10041.440000000013,0,5,8,2
2024-02-21 00:30:00,52158.039,52260.738,52116.125,52260.738,500,56422,0,2024-02-21 00:00:00,2024-02-21 00:00:00,209.11091666668653,-3.8432499268310494,52062.32708333331,0.004623658095053576,0.0005841608154378605,51890.895202380954,52893.59116893081,52431.478702943146,51683.346056853676,51772.20700896932,-0.001975099843329357,0.002268227312546791,51931.542920691885,51940.2758094464,94.08449717339592,90.03003452397768,-23.29866946771846,52055.6291657163,51938.751630188795,52270.587148950806,116.87753552750655,69.71626335235737,387.08785677291434,18.58635878910718,15.270160302694421,15.35964705888182,52794.65575559424,51748.01854230737,True,False,52960.738,51810.738,52730.738,52760.738,,False,,,2024-02-21 08:06:11,0.02,fail,False,-164.05,9877.390000000014,0,6,8,2
2024-02-21 07:45:00,51870.137,51891.738,51832.738,51848.039,1334,36422,0,2024-02-21 07:00:00,2024-02-21 07:00:00,-66.7120595238448,30.708552729200164,51956.44751190474,-0.0005663274252744289,-0.0012967072527920924,52050.43279761902,51681.120985091155,51876.28242219778,51786.80009718037,51809.24670532894,-0.001588722169387322,-0.0001832252782279361,51963.584907104436,51989.427135748134,19.417750141322227,36.098951102566815,34.10062817358075,51975.96793504734,52025.27174544483,51917.5877110423,-49.30381039749045,-23.253069911199283,134.75139319401967,-25.773541795708297,-16.17696594420704,-11.582088063310948,52099.50209185423,51734.17333023038,False,True,51148.039,51378.039,51378.039,51348.039,2024-02-21 11:45:00,True,2024-02-21 11:45:00,2024-02-21 11:56:18,2024-02-21 12:50:20,0.02,success,True,255.15,10132.540000000014,1,0,8,2
2024-02-21 20:45:00,50944.531,50986.238,50831.84,50850.105,972,36422,0,2024-02-21 20:00:00,2024-02-21 20:00:00,-85.86780952385016,-201.25780617461714,51031.71423809521,0.0008074152289318501,-6.556551128267328e-05,51111.71279761901,50970.758196165756,51419.429459207575,51138.32284678227,51422.80014363538,-6.553978433689704e-05,0.0012699540559305668,51658.47026291101,51453.84755445001,10.52754453727916,18.385041743907582,-178.6950085309435,51030.09581824077,51122.14793388745,51013.85276608192,-92.05211564667843,-70.42833545192411,156.90064958026568,-62.07724148604757,-28.926820433378452,-48.33857103547052,51225.668643015284,50800.53688914856,False,True,50150.105,51300.105,50380.105,50350.105,,False,,,2024-02-21 23:29:59,0.02,fail,False,-164.05,9968.490000000014,0,1,8,2
2024-02-22 01:00:00,51496.984,51674.438,51484.063,51621.84,1620,56422,0,2024-02-22 01:00:00,2024-02-22 01:00:00,125.27803571425466,-87.09486994606414,51461.238166666684,0.0018054505426062697,0.0014595365633577233,51220.08546428572,51368.31300568254,52260.995848282626,50619.80438670839,51573.80661583743,0.0002648645224814939,-7.218978986049061e-05,51604.33139534214,51428.22682167476,94.5449778693145,92.22087401388455,-162.31861471189714,51319.668259899976,51223.566183306044,51459.99470966629,96.102076593932,34.63592519570238,213.40939649148734,74.8876859304437,52.79440522880759,59.64741417262849,51749.5973949298,51171.892024402776,True,False,52321.84,51171.84,52091.84,52121.84,,False,,,2024-02-22 03:53:21,0.02,fail,False,-164.05,9804.440000000015,0,2,8,2
2024-02-22 08:30:00,51634.738,51769.738,51634.738,51754.418,1117,36422,0,2024-02-22 08:00:00,2024-02-22 08:00:00,-9.258690476141055,36.428838160732994,51562.11302380952,0.0010232846348531578,-0.00039055348881684196,51478.67557142859,51623.595323569214,51748.29114983729,51349.15911156047,51530.70062374271,-0.0008581640344000377,0.00047523767116744084,51584.14852116126,51473.32402597491,82.76165035408808,72.58549103151812,-17.546522910123027,51594.871722571625,51536.67864452667,51634.93444341245,58.193078044954746,48.87029303574489,104.88232484302719,25.806185758490756,-1.678853801175137,9.40014757480094,51778.02558195054,51493.34330487436,True,False,52454.418,51304.418,52224.418,52254.418,,False,,,2024-02-22 15:15:48,0.02,fail,False,-164.05,9640.390000000016,0,3,8,2
2024-02-22 08:45:00,51753.215,51826.738,51730.289,51780.84,1569,36422,0,2024-02-22 08:00:00,2024-02-22 08:00:00,-9.258690476141055,36.428838160732994,51562.11302380952,0.0010232846348531578,-0.00039055348881684196,51478.67557142859,51623.595323569214,51748.29114983729,51349.15911156047,51530.70062374271,-0.0008581640344000377,0.00047523767116744084,51584.14852116126,51473.32402597491,88.69162787764265,80.03632282975934,-17.546522910123027,51623.48222679138,51554.76467085803,51667.79052872377,68.7175559333482,52.83974561526556,116.13371382345477,32.85608531132311,25.806185758490756,-1.678853801175137,51826.07104238544,51511.01001506211,True,False,52480.84,51330.84,52250.84,52280.84,,False,,,2024-02-22 15:15:47,0.02,fail,False,-164.05,9476.340000000017,0,4,8,2
2024-02-22 09:30:00,51859.84,51930.84,51793.484,51891.637,1527,36422,0,2024-02-22 09:00:00,2024-02-22 09:00:00,83.43745238093106,68.32314788499934,51700.29902380952,0.001307677121919123,0.00010186388254385375,51562.11302380952,51821.56123026372,51950.756978255056,51623.595323569214,51748.29114983729,-0.00039055348881684196,0.0010232846348531578,51594.27367719415,51502.84530389692,89.80047445815843,89.43015542911753,-0.3725887510985526,51708.89477827006,51612.72608231249,51767.93322703826,96.16869595757453,69.3141006981418,153.08198289199285,40.35878431382298,36.57430615755584,23.209607843105914,51976.09390394245,51561.27255013407,True,False,52591.637,51441.637,52361.637,52391.637,,False,,,2024-02-22 14:40:39,0.02,fail,False,-164.05,9312.290000000017,0,5,8,2
2024-02-22 15:00:00,51539.75,51566.637,51371.34,51423.238,1149,36422,0,2024-02-22 15:00:00,2024-02-22 15:00:00,-101.65861904763733,67.71501591356355,51490.94915476192,-0.0016494142579320664,-0.0011566481949645223,51707.007940476164,50627.40875224908,51589.608864490736,51433.95502191168,52179.65159290409,0.0003358677569840925,-3.418855203491804e-06,51603.226259620606,51548.21099689675,12.327706415494644,17.805216895364797,74.2439992764838,51624.29039948645,51669.21368651586,51534.644221190254,-44.923287029414496,-0.7477771629666048,140.1128513561625,-52.86798245616228,-39.779406948699034,-47.24710629515175,51723.79657052107,51343.991871859434,False,True,50723.238,51873.238,50953.238,50923.238,,False,2024-02-23 17:30:00,2024-02-23 18:06:06,2024-02-22 22:28:38,0.02,fail,False,-164.05,9148.240000000018,0,6,8,2
2024-02-22 15:15:00,51422.09,51422.09,51114.023,51268.539,2399,36422,0,2024-02-22 15:00:00,2024-02-22 15:00:00,-101.65861904763733,67.71501591356355,51490.94915476192,-0.0016494142579320664,-0.0011566481949645223,51707.007940476164,50627.40875224908,51589.608864490736,51433.95502191168,52179.65159290409,0.0003358677569840925,-3.418855203491804e-06,51603.226259620606,51548.21099689675,14.26526579693344,14.884043581753112,74.2439992764838,51569.55941495007,51639.53408010728,51465.35015548674,-69.97466515721317,-14.593154761815919,169.9943657257122,-69.2940657035142,-52.86798245616228,-39.779406948699034,51694.84254921645,51234.357761757026,False,True,50568.539,51718.539,50798.539,50768.539,,False,2024-02-23 18:15:00,,2024-02-22 18:07:01,0.02,fail,False,-164.05,8984.190000000019,0,7,8,2
2024-02-22 15:30:00,51268.539,51368.738,51078.445,51078.938,1534,36422,0,2024-02-22 15:00:00,2024-02-22 15:00:00,-101.65861904763733,67.71501591356355,51490.94915476192,-0.0016494142579320664,-0.0011566481949645223,51707.007940476164,50627.40875224908,51589.608864490736,51433.95502191168,52179.65159290409,0.0003358677569840925,-3.418855203491804e-06,51603.226259620606,51548.21099689675,8.615101774473718,11.736024662300595,74.2439992764838,51494.07919726544,51598.00844454378,51361.61236876504,-103.92924727834179,-32.46037326512109,211.85265509166223,-103.7377867217001,-69.2940657035142,-52.86798245616228,51647.61345313879,51074.11128439129,False,True,50378.938,51528.938,50608.938,50578.938,,False,,,2024-02-22 17:32:30,0.02,fail,False,-164.05,8820.14000000002,0,8,8,2
2024-02-26 00:30:00,51832.238,51876.84,51832.238,51874.137,639,56422,0,2024-02-26 00:00:00,2024-02-26 00:00:00,-24.103833333356306,-49.22722743124905,51301.212988095234,0.0013837608995469898,0.0020509373990895497,51076.619119047595,51329.873308762275,52289.58095876635,51257.97593346126,51035.63831396492,-0.0005737537550915791,0.0013838874515331296,51328.644616358135,51217.350633714974,96.44736561340768,72.84317928755884,-64.98001121539767,51356.75856389693,51217.13019254947,51415.25726762985,139.62837134746223,50.942916117365286,252.42512207434294,121.00476367389638,134.88482318542083,129.15346233228047,51757.53118243021,51074.48335282949,True,False,52574.137,51424.137,52344.137,52374.137,,False,2024-02-26 17:30:00,2024-02-26 17:31:51,2024-02-26 05:06:24,0.02,fail,False,-164.06,8656.08000000002,0,9,9,2
2024-02-26 11:30:00,51064.004,51102.438,50956.844,50969.074,2410,36422,0,2024-02-26 11:00:00,2024-02-26 11:00:00,-60.224654761907004,31.047381030286488,51237.893095238076,-0.001448833284584155,-0.0004406696875514896,51403.671821428565,50637.11320161464,51471.38454202628,51152.06327897145,51521.96616171421,-0.000347567027222487,-0.0005673827774124967,51371.662837243864,51341.92687611563,9.918910930959257,10.437975060663767,63.990676025484866,51276.35979789421,51374.48024140605,51176.176671138615,-98.12044351183431,-50.6812172789093,160.53767343700812,-73.40372893023596,-61.922221878150594,-18.673592707280477,51392.902530278574,50957.95081199866,False,True,50269.074,51419.074,50499.074,50469.074,,False,,,2024-02-26 15:26:11,0.02,fail,False,-164.06,8492.02000000002,0,10,9,2
2024-02-26 11:45:00,50968.398,51051.039,50919.539,50966.137,1534,36422,0,2024-02-26 11:00:00,2024-02-26 11:00:00,-60.224654761907004,31.047381030286488,51237.893095238076,-0.001448833284584155,-0.0004406696875514896,51403.671821428565,50637.11320161464,51471.38454202628,51152.06327897145,51521.96616171421,-0.000347567027222487,-0.0005673827774124967,51371.662837243864,51341.92687611563,3.3477495906316577,7.654782209254549,63.990676025484866,51228.63321360279,51344.23259389449,51104.38163742693,-115.59938029170007,-63.66484988146746,184.27108347389955,-71.79503371168539,-73.40372893023596,-61.922221878150594,51353.147600116696,50854.115674737164,False,True,50266.137,51416.137,50496.137,50466.137,,False,,,2024-02-26 15:26:11,0.02,fail,False,-164.06,8327.960000000021,0,11,9,2
2024-02-26 17:00:00,51703.039,52044.637,51649.859,51960.738,2092,36422,0,2024-02-26 17:00:00,2024-02-26 17:00:00,199.4844285713989,12.583797389663232,51897.48338095232,0.002436441518523995,0.003990220215179025,51356.9534642857,51831.42808223321,53689.56768405606,51067.38438154272,51835.565749990004,0.0005117917242426635,0.00032637082888758886,51418.943918731355,51455.97319249864,94.06795410184701,89.36281509283135,-3.1801954066297498,51469.62003298997,51374.08680164903,51575.42399931199,95.53323134094535,17.000731977283614,221.90976869822796,121.39721362231649,82.10533195731114,51.855483316147,51876.5021870546,51275.84581156939,True,False,52660.738,51510.738,52430.738,52460.738,,False,2024-02-26 17:45:00,2024-02-26 17:32:08,,0.02,success,True,255.15,8583.11000000002,1,0,9,2
2024-02-26 17:15:00,51960.738,52466.539,51960.738,52389.738,3284,36422,0,2024-02-26 17:00:00,2024-02-26 17:00:00,199.4844285713989,12.583797389663232,51897.48338095232,0.002436441518523995,0.003990220215179025,51356.9534642857,51831.42808223321,53689.56768405606,51067.38438154272,51835.565749990004,0.0005117917242426635,0.00032637082888758886,51418.943918731355,51455.97319249864,94.28238684927935,93.20381195483435,-3.1801954066297498,51611.17664329921,51449.3202237491,51764.03591262471,161.85641955010942,45.97186949184878,315.97253249880276,188.6119133127213,121.39721362231649,82.10533195731114,52192.09883149809,51337.47299375133,True,False,53089.738,51939.738,52859.738,52889.738,,False,2024-02-26 18:15:00,2024-02-26 18:07:42,,0.02,success,True,255.15,8838.26000000002,2,0,9,2
2024-02-26 17:45:00,52564.84,52865.738,52532.039,52854.039,2829,36422,0,2024-02-26 17:00:00,2024-02-26 17:00:00,199.4844285713989,12.583797389663232,51897.48338095232,0.002436441518523995,0.003990220215179025,51356.9534642857,51831.42808223321,53689.56768405606,51067.38438154272,51835.565749990004,0.0005117917242426635,0.00032637082888758886,51418.943918731355,51455.97319249864,94.19394690443994,93.43061568051893,-3.1801954066297498,51926.53176236216,51629.88373915389,52202.04377502585,296.64802320826857,124.90244343730708,488.6879425816016,236.53872652221617,201.4691358789205,188.6119133127213,52863.27249751101,51542.31505254069,True,False,53554.039,52404.039,53324.039,53354.039,,False,2024-02-26 18:15:00,2024-02-26 18:12:12,,0.02,success,True,255.15,9093.41000000002,3,0,9,2
2024-02-26 18:00:00,52854.039,53667.238,52761.117,53543.738,4749,36422,0,2024-02-26 18:00:00,2024-02-26 18:00:00,540.5299166666155,178.15117648074374,52529.174809523814,0.0024367661876073536,0.006369522650239167,51897.48338095232,51959.31569663206,55012.16794704654,51831.42808223321,53689.56768405606,0.003990220215179025,0.002436441518523995,51497.44564740855,51613.15437709875,94.24752527599497,93.41899515609079,33.086078970844945,52175.332721998755,51771.65072143879,52534.98623942203,403.6820005599657,180.6583548618388,634.0143119481924,332.9424643961829,236.53872652221617,201.4691358789205,53392.40556055209,51679.066918291974,True,False,54243.738,53093.738,54013.738,54043.738,,False,2024-02-26 21:30:00,2024-02-26 21:15:28,,0.02,success,True,255.15,9348.56000000002,4,0,9,2
2024-02-26 21:30:00,54274.738,54571.039,54231.84,54547.84,3394,36422,0,2024-02-26 21:00:00,2024-02-26 21:00:00,401.38596428565506,556.2663718515541,53976.17142857141,0.008532643733221342,0.010118812486189822,53427.96224999997,55254.940462680235,57551.78875510235,54657.98228646856,56675.86423665132,0.009261649419349736,0.008235961131809246,51768.798617168126,52121.742660874275,94.64920943387934,94.16334209361021,249.06301555546494,53667.28074740688,53048.63423747969,54063.016998968014,618.6465099271954,553.9187433126812,998.155229104292,112.45821396628162,77.84669040247536,16.912017543872935,55412.02655825881,52715.50743967722,True,False,55247.84,54097.84,55017.84,55047.84,,False,2024-02-27 03:45:00,2024-02-27 03:44:13,,0.02,success,True,255.15,9603.71000000002,5,0,9,2
2024-02-27 03:45:00,55186.539,55870.238,55091.438,55838.91,4015,36422,0,2024-02-27 03:00:00,2024-02-27 03:00:00,34.102630952394975,791.8201517593843,55074.61725,0.0033514443620614675,0.003273858671730894,54674.33992857143,55252.70076334897,56593.36562678064,55299.00976083299,55840.32190173102,0.002003273128567191,0.0038313392064537894,52414.71773814445,53184.40863383217,86.37218951828595,74.63690692232134,656.9473757582457,54862.770406569834,54501.28727954694,54945.186298933564,361.48312702289695,327.76405443628613,289.6347914137461,222.9881348468989,103.48329170966463,24.786361541060614,55337.69326734212,54554.17933052501,True,False,56538.91,55388.91,56308.91,56338.91,,False,2024-02-27 04:15:00,2024-02-27 04:06:53,,0.02,success,True,255.15,9858.860000000019,6,0,9,2
2024-02-27 10:30:00,56384.039,56470.539,56280.836,56431.84,1308,36422,0,2024-02-27 10:00:00,2024-02-27 10:00:00,-31.910107142932247,878.1481405651211,56189.355988095274,0.00393587401471098,-0.0031960377708569456,56238.59483333326,56928.49304169452,55792.59256338123,56704.13762435649,56022.292916698614,-0.0030951372298374464,0.0039359434025424255,53320.33265873658,54486.09870987051,87.80408807391616,72.84968492220098,873.5469719138039,56226.33395140146,55998.49596286219,56329.0471998624,227.83798853927146,264.75405085130745,250.10775226904076,38.48441898862802,25.483373925017077,86.31731647748529,56668.1926654256,55991.401734299194,True,False,57131.84,56901.84,56901.84,56931.84,2024-02-27 14:30:00,True,2024-02-27 14:30:00,2024-02-27 14:32:14,2024-02-27 14:30:25,0.02,even,True,171.32,10030.180000000018,7,0,9,2
2024-02-28 18:15:00,61080.137,61626.637,61001.949,61460.137,3232,36422,0,2024-02-28 18:00:00,2024-02-28 18:00:00,299.30880952378357,992.0031903043928,61383.70667857141,0.007070128798887674,0.007317398330606791,60562.64825,62371.03556241181,64515.13939931501,61101.606301857355,63009.60857222546,0.005135798055101126,0.005347970099344629,56989.755139026696,58659.07642415863,85.63129135525844,83.00941548801559,725.0233710013117,60783.581738160574,60139.96804552777,61354.59416546268,643.6136926328036,610.4013367101526,813.1743578913109,105.55625937391596,81.9640670794397,109.27206639149517,62453.87954861595,60256.80878230941,True,False,62160.137,61010.137,61930.137,61960.137,,False,2024-02-28 19:00:00,2024-02-28 18:54:24,2024-02-28 19:31:07,0.02,success,True,255.15,10285.330000000018,8,0,9,2
2024-03-01 22:30:00,62533.348,62662.34,62446.57,62616.938,1485,36422,0,2024-03-01 22:00:00,2024-03-01 22:00:00,83.33190476191521,108.02453203953337,62335.487130952424,0.0018395980611068206,0.0010054698248015295,61998.855226190484,62208.89530004374,63432.57467709818,61444.34056032396,62342.30147560928,-0.0006203154846089478,0.0005325720586807181,61303.93454103835,61926.7902611886,92.33246379874755,86.60396947938922,62.81839005503459,62289.23285877913,62148.32020289737,62541.4849501204,140.91265588175884,80.6860460077084,364.96898492350624,61.31831682151096,49.0359838321383,53.36823426208866,63035.69307976714,62048.776820473664,True,False,63316.938,63086.938,63086.938,63116.938,2024-03-04 00:30:00,True,2024-03-04 00:30:00,2024-03-04 02:11:54,2024-03-04 00:42:43,0.02,even,True,171.32,10456.650000000018,9,0,9,3
2024-03-01 22:45:00,62618.238,63175.34,62453.84,62917.438,2796,36422,0,2024-03-01 22:00:00,2024-03-01 22:00:00,83.33190476191521,108.02453203953337,62335.487130952424,0.0018395980611068206,0.0010054698248015295,61998.855226190484,62208.89530004374,63432.57467709818,61444.34056032396,62342.30147560928,-0.0006203154846089478,0.0005325720586807181,61303.93454103835,61926.7902611886,92.22259537412641,90.21430198756786,62.81839005503459,62385.87980358234,62205.291891571644,62648.85730546953,180.58791201069835,100.6664192083064,408.4211836735052,107.37235534912907,61.31831682151096,49.0359838321383,63201.72590342876,62097.488707510296,True,False,63617.438,62467.438,63387.438,63417.438,,False,2024-03-04 02:30:00,2024-03-04 02:27:54,2024-03-01 23:03:13,0.02,fail,False,-164.06,10292.590000000018,0,1,9,3
2024-03-04 02:00:00,63160.34,63346.34,63069.738,63346.34,1830,36422,0,2024-03-04 02:00:00,2024-03-04 02:00:00,184.30951190483756,308.96271195200825,63193.273952380936,0.001920169308321076,0.004840603788810945,62976.00414285714,62789.35608554443,65687.9840684237,63604.74666378603,65012.22737573813,0.004063458915501067,0.0033965629302578973,61562.304577233466,62250.39860260168,83.45915980542101,73.9183276081849,176.31216588555606,62963.987593194586,62703.13567922393,63180.80792982454,260.851913970655,237.03385865406295,372.49342790648234,67.72134296521108,24.85998211218248,7.048925696624792,63685.1740574983,62677.94180215079,True,False,64046.34,62896.34,63816.34,63846.34,,False,2024-03-04 02:45:00,2024-03-04 02:36:06,2024-03-04 02:49:32,0.02,success,True,255.15,10547.740000000018,1,0,10,3
2024-03-04 02:15:00,63342.637,63884.738,63315.449,63842.84,2678,36422,0,2024-03-04 02:00:00,2024-03-04 02:00:00,184.30951190483756,308.96271195200825,63193.273952380936,0.001920169308321076,0.004840603788810945,62976.00414285714,62789.35608554443,65687.9840684237,63604.74666378603,65012.22737573813,0.004063458915501067,0.0033965629302578973,61562.304577233466,62250.39860260168,94.24790078618008,83.45995825463939,176.31216588555606,63099.19565578003,62787.55822150364,63316.271580667264,311.6374342763884,251.95457377852804,416.99466728028665,135.4636508427211,67.72134296521108,24.85998211218248,63880.71438149565,62753.32877983888,True,False,64542.84,63392.84,64312.84,64342.84,,False,2024-03-04 10:15:00,2024-03-04 10:07:40,2024-03-04 02:47:51,0.02,fail,False,-164.06,10383.680000000018,0,1,10,3
2024-03-04 09:15:00,63629.637,63807.039,63629.637,63793.738,901,36422,0,2024-03-04 09:00:00,2024-03-04 09:00:00,20.93572619050974,405.54669018196,63769.23471428575,0.0027806649604432037,-0.00010996000030940399,63632.42590476194,64249.14301946581,64331.554764200526,64082.67919132113,63283.97045870732,-0.0017525943702252033,0.002800809937797976,62078.889248738735,62885.885560361254,82.47852249052126,73.93734549857146,371.8237755826087,63613.48480719521,63517.66959269604,63593.17848400418,95.81521449916909,106.79761709318447,148.81281851042735,50.79901754394086,31.229656002717093,24.112269349840062,63795.57578899326,63392.2811790151,True,False,64493.738,63343.738,64263.738,64293.738,,False,2024-03-04 10:15:00,2024-03-04 10:07:40,2024-03-05 21:11:10,0.02,success,True,255.15,10638.830000000018,1,0,10,3
2024-03-04 09:30:00,63793.738,64181.738,63731.84,64177.539,1927,36422,0,2024-03-04 09:00:00,2024-03-04 09:00:00,20.93572619050974,405.54669018196,63769.23471428575,0.0027806649604432037,-0.00010996000030940399,63632.42590476194,64249.14301946581,64331.554764200526,64082.67919132113,63283.97045870732,-0.0017525943702252033,0.002800809937797976,62078.889248738735,62885.885560361254,87.46154174105328,80.03369458876436,371.8237755826087,63700.26237531902,63566.548808051884,63705.52860749908,133.71356726713566,112.18080712797472,178.87977607414155,112.35012349489989,50.79901754394086,31.229656002717093,63948.51630519917,63464.04090979899,True,False,64877.539,63727.539,64647.539,64677.539,,False,2024-03-04 10:15:00,2024-03-04 10:11:12,2024-03-05 19:10:08,0.02,success,True,255.15,10893.980000000018,2,0,10,3
2024-03-04 10:00:00,64102.34,64969.738,64061.84,64855.84,4232,36422,0,2024-03-04 10:00:00,2024-03-04 10:00:00,136.8088095238054,436.26373221577524,64305.24580952386,0.0026502345635542237,0.0038644788465138444,63769.23471428575,64388.06944794721,66710.27845173723,64249.14301946581,64331.554764200526,-0.00010996000030940399,0.0027806649604432037,62205.722493886235,63080.06567553236,90.04107118805616,89.45644036060757,384.711766909242,63930.38501428167,63698.80022638193,64033.616446508466,231.58478789973742,143.0540224508595,313.9500553417756,224.02225937399635,104.06557963538944,112.35012349489989,64458.949021219865,63609.783871797066,True,False,65555.84,64405.84,65325.84,65355.84,,False,2024-03-04 10:45:00,2024-03-04 10:44:11,2024-03-05 19:07:49,0.02,success,True,255.15,11149.130000000017,3,0,10,3
2024-03-04 10:30:00,64947.309,65664.938,64827.461,65586.734,5222,36421,0,2024-03-04 10:00:00,2024-03-04 10:00:00,136.8088095238054,436.26373221577524,64305.24580952386,0.0026502345635542237,0.0038644788465138444,63769.23471428575,64388.06944794721,66710.27845173723,64249.14301946581,64331.554764200526,-0.00010996000030940399,0.0027806649604432037,62205.722493886235,63080.06567553236,93.79279471519733,90.35646509319372,384.711766909242,64318.17840667504,63924.589543880254,64563.31904643963,393.5888627947861,217.6185785708262,534.5255711658955,316.27039559684636,213.43220433431998,224.02225937399635,65286.42856751359,63841.70952536567,True,False,66286.734,65136.734,66056.734,66086.734,,False,2024-03-04 16:45:00,2024-03-04 16:43:14,2024-03-04 11:04:30,0.02,fail,False,-164.06,10985.070000000018,0,1,10,3
2024-03-04 16:45:00,66177.336,66461.734,65831.836,66205.133,5355,36421,0,2024-03-04 16:00:00,2024-03-04 16:00:00,-30.37133333318343,656.4376429026088,65622.20673809528,0.0022790854178384398,0.0020085438391795954,65359.245321428636,65154.09908637767,67010.7087403492,66165.1051844085,66038.66015174346,0.0006247124211865972,0.004036527253336508,62888.25237688204,64001.44152438365,82.48763895460719,71.2669079423202,597.6726613990331,65514.201030502125,65175.5933065633,65677.02444960442,338.6077239388251,290.77736642646613,314.3682483245185,173.16729790160025,179.4683883729158,54.1448661850809,66102.92158484252,65252.62731436632,True,False,66905.133,66675.133,66675.133,66705.133,2024-03-04 18:15:00,True,2024-03-04 18:15:00,2024-03-04 19:17:37,2024-03-04 18:15:49,0.02,even,True,171.32,11156.390000000018,1,0,10,3
2024-03-04 17:00:00,66205.133,66391.438,65866.234,66351.734,4437,36421,0,2024-03-04 17:00:00,2024-03-04 17:00:00,262.96141666664334,733.7153617681251,65885.55390476191,0.001258671315296835,0.002121066574990802,65622.20673809528,64964.114710516835,67229.96708556039,65154.09908637767,67010.7087403492,0.0020085438391795954,0.0022790854178384398,63029.42047974941,64200.36932243296,90.34130182400948,82.27580477424976,624.8812014728516,65643.05225657873,65262.71483941046,65849.55108737528,380.33741716826626,308.68937657482616,380.3697568307694,172.52663777086127,173.16729790160025,179.4683883729158,66364.55025909682,65336.05191565374,True,False,67051.734,65901.734,66821.734,66851.734,,False,2024-03-04 19:30:00,2024-03-04 19:20:35,2024-03-05 07:03:35,0.02,success,True,255.15,11411.540000000017,2,0,10,3
2024-03-05 00:45:00,67818.164,67971.734,67721.984,67967.117,2988,56421,0,2024-03-05 00:00:00,2024-03-05 00:00:00,13.021726190447225,894.0400374463206,67590.79509523815,0.0029886046804094737,0.0011642232348016957,67328.16846428569,67777.848116096,68338.56766033443,68141.21050427954,68815.4905901904,0.002165920740244672,0.004873049549189025,64054.902175207026,65554.47058398892,87.97586947529784,81.37730876199424,832.1055115218105,67428.5450771009,67062.1345560618,67681.04242862055,366.41052103909897,352.26039954981684,444.85787495269733,67.10258651529148,105.35946267627878,49.050485380212194,68283.1005598067,67080.4842974344,True,False,68667.117,67517.117,68437.117,68467.117,,False,2024-03-05 03:30:00,2024-03-05 03:49:27,2024-03-05 01:31:12,0.02,fail,False,-164.07,11247.470000000018,0,1,10,3
2024-03-05 01:00:00,67966.563,68571.734,67875.273,68412.141,5216,56421,0,2024-03-05 01:00:00,2024-03-05 01:00:00,262.62663095246535,924.695649692163,67892.6625357143,0.0032891943144021094,0.002337080724749266,67590.79509523815,68147.97846441715,69236.38042170393,67777.848116096,68338.56766033443,0.0011642232348016957,0.0029886046804094737,64220.52303108126,65772.37165726982,95.04054861664282,88.58888537567928,850.6235391558811,67579.86752677769,67162.13503339056,67830.5462566219,417.73249338712776,365.35481831727907,499.3293748681007,149.50382800135412,67.10258651529148,105.35946267627878,68506.14091269384,67156.45160054998,True,False,69112.141,67962.141,68882.141,68912.141,,False,,2024-03-05 17:04:14,2024-03-05 01:27:19,0.02,fail,False,-164.07,11083.400000000018,0,2,10,3
2024-03-05 18:00:00,66826.336,67066.898,64581.84,65444.941,7833,36421,0,2024-03-05 18:00:00,2024-03-05 18:00:00,-246.51736904760764,183.45794187903812,67066.12035714286,-0.0033884491287748566,0.005784764548930021,67650.9545238095,63692.6898503954,71395.75888319564,66996.15630932245,70743.89871451333,0.004934615860210079,0.0019190689071320159,65717.92262159412,66844.47900889932,15.379182206574923,22.32056966960739,228.35305201999154,67204.76471637476,67274.36435232034,67378.59077949775,-69.59963594557485,137.40572297262094,702.6828572246732,-470.55961197119905,-183.81908943918825,-176.41303130380402,68327.21263675106,66428.46892224444,False,True,64744.941,65894.94099999999,64974.941,64944.941,,False,2024-03-05 19:15:00,2024-03-05 19:06:58,2024-03-05 18:25:11,0.02,fail,False,-164.07,10919.330000000018,0,3,10,3
2024-03-05 19:00:00,65603.734,65606.734,63481.938,64278.738,6904,36421,0,2024-03-05 19:00:00,2024-03-05 19:00:00,-584.8341666666383,-36.42815067891206,66509.30538095241,-0.0066253674316923954,0.004561729807324649,67066.12035714286,61784.03646629715,71277.13811826805,63692.6898503954,71395.75888319564,0.005784764548930021,-0.0033884491287748566,65714.78655800219,66747.95692818737,16.007763913104597,18.790473933445522,175.39681148021083,66202.85669109775,66724.82243707792,65688.60992466466,-521.9657459801674,-162.68331095182998,1073.000780731583,-552.7748052975076,-343.39990264875814,-439.75122325416305,67137.1609786523,64238.55887067703,False,True,63578.738,64728.738,63808.738,63778.738,,False,2024-03-05 21:15:00,2024-03-05 21:10:41,2024-03-05 19:21:33,0.02,fail,False,-164.07,10755.260000000018,0,4,10,3
2024-03-06 04:45:00,63444.938,63475.238,62810.84,62833.238,3241,36422,0,2024-03-06 04:00:00,2024-03-06 04:00:00,244.19124999994528,-923.4003942057607,63396.909749999984,0.008712420922477792,0.0002657779501694581,63332.72703571425,65066.057833699735,64495.74714202925,65983.49762092359,62950.64628218911,-0.003788189669145854,0.010967577200736735,64910.71882439901,64807.20808156149,15.269783817433025,24.22710627152208,-802.1108631519977,63333.85018621745,63564.880919888106,63276.953177846626,-231.03073367065372,-239.3829250109663,455.71260139884413,-156.53250257992477,-36.45517199860478,-76.23686446512875,63892.16518973507,62660.241165958185,False,True,62133.238,63283.238,62363.238,62333.238,,False,,,2024-03-06 05:26:12,0.02,fail,False,-164.07,10591.190000000019,0,5,10,3
2024-03-06 05:00:00,62834.84,63099.738,62814.938,62830.34,2047,36422,0,2024-03-06 05:00:00,2024-03-06 05:00:00,64.18271428573644,-913.8530978518975,63322.75507142854,0.003658198051346919,-0.0009485475896240035,63396.909749999984,63754.44273644796,63885.60193183433,65066.057833699735,64495.74714202925,0.0002657779501694581,0.008712420922477792,64847.7666352069,64687.06647503657,11.479472607295476,18.911368444289334,-824.4593100919777,63256.38708064554,63510.47048137787,63107.01505228754,-254.08340073233558,-242.32302015524016,359.4327782349981,-169.93812555908517,-156.53250257992477,-36.45517199860478,63592.24930290479,62620.28080167029,False,True,62130.34,63280.34,62360.34,62330.34,,False,,,2024-03-06 05:26:10,0.02,fail,False,-164.07,10427.120000000019,0,6,10,3
2024-03-06 07:00:00,64633.84,65466.938,64275.621,65396.039,4845,36422,0,2024-03-06 07:00:00,2024-03-06 07:00:00,323.5893095238789,-607.9654783263395,64614.37407142862,0.0010783144052593989,0.005343059059238162,63646.34438095242,63229.7647731953,67946.00041974794,63590.44960370146,64857.32674352796,0.0008213158441450565,0.0024152019782967635,64902.398803203294,64823.90730447096,96.42957648250423,85.45780303904858,-782.4025032786691,63846.77271322111,63696.35681149181,63941.05126866184,150.41590172929864,-86.52667856675042,544.6035061755102,406.65694152047945,298.9383137255063,86.64789645677229,64677.766001998774,63205.8365353249,True,False,66096.03899999999,64946.039,65866.03899999999,65896.03899999999,,False,2024-03-06 07:45:00,2024-03-06 07:37:30,2024-03-06 14:46:23,0.02,success,True,255.15,10682.270000000019,1,0,10,3
2024-03-06 07:15:00,65390.785,65911.336,65151.309,65796.609,4895,36421,0,2024-03-06 07:00:00,2024-03-06 07:00:00,323.5893095238789,-607.9654783263395,64614.37407142862,0.0010783144052593989,0.005343059059238162,63646.34438095242,63229.7647731953,67946.00041974794,63590.44960370146,64857.32674352796,0.0008213158441450565,0.0024152019782967635,64902.398803203294,64823.90730447096,97.68991849146244,93.02696012846445,-782.4025032786691,64146.74752657171,63851.9310476776,64369.364442380494,294.8164788941067,-10.258047074579004,701.7088899537289,428.3131737186559,406.65694152047945,298.9383137255063,65318.17144381803,63422.05744094296,True,False,66496.609,66266.609,66266.609,66296.609,2024-03-06 08:00:00,True,2024-03-06 08:00:00,2024-03-06 08:00:12,2024-03-06 08:05:18,0.02,success,True,255.16,10937.430000000018,2,0,10,3
2024-03-08 16:45:00,68399.234,68713.734,68301.438,68487.734,4247,36421,0,2024-03-08 16:00:00,2024-03-08 16:00:00,87.95326190479682,156.4356059989077,67963.2696428571,0.0009173150928020563,0.0021243109061709732,67609.03769047624,67651.77299396829,69319.30517922442,67610.20764882278,68090.935549492,0.0005698601038356332,0.0009905649386635635,66915.58172318303,67338.11807513915,86.48513746816643,80.5858891962583,110.45695883364084,67884.94174876911,67652.65950717016,68037.24883866525,232.28224159895035,145.4419769057339,331.97552449937626,130.16168455446314,126.69476848990598,52.03862951499468,68486.91579673941,67589.0818805911,True,False,69187.734,68037.734,68957.734,68987.734,,False,2024-03-08 17:30:00,2024-03-08 17:27:18,2024-03-08 17:32:37,0.02,success,True,255.16,11192.590000000018,3,0,10,3
2024-03-08 17:00:00,68478.531,68901.641,68394.5,68856.438,4019,36421,0,2024-03-08 17:00:00,2024-03-08 17:00:00,354.2319523808692,249.01986667860183,67944.84183333332,0.0002931939066792741,0.005900827367143029,67963.2696428571,67286.65883885785,72021.42634466628,67651.77299396829,69319.30517922442,0.0021243109061709732,0.0009173150928020563,66944.91585168566,67364.15678912803,91.42446783787257,85.75773828785532,138.16954040263306,68034.40271049694,67741.82828441681,68229.19970794632,292.57442608012934,174.868466740613,412.8157426961329,191.9508692810632,130.16168455446314,126.69476848990598,68788.0009605861,67671.89845530654,True,False,69556.438,68406.438,69326.438,69356.438,,False,2024-03-08 17:30:00,2024-03-08 17:28:09,2024-03-08 17:32:05,0.02,success,True,255.15,11447.740000000018,4,0,10,3
2024-03-11 09:00:00,69375.039,70817.547,69329.258,70759.813,6056,36421,0,2024-03-11 09:00:00,2024-03-11 09:00:00,278.3088571428525,260.31937757150445,69712.24565476194,0.003692671595689862,0.005121773977967373,68803.81589285712,69803.89804284327,73058.4888231133,69541.34365197305,69586.95121635115,0.0007139498874955451,0.0036955796630196757,67822.28096166349,68489.18594748742,91.0749889580017,78.62213049875307,236.11450206998725,69056.72290141773,68798.09144051865,69210.48978500172,258.6314608990797,93.26569650472003,521.7640221215604,372.682804609547,136.12675885800854,30.472158582677366,69916.37121486582,68506.1083551376,True,False,71459.813,70309.813,71229.813,71259.813,,False,2024-03-11 10:15:00,2024-03-11 09:40:00,2024-03-11 09:16:15,0.02,fail,False,-164.07,11283.670000000018,0,1,11,3
2024-03-13 03:30:00,71851.336,72177.836,71816.984,71903.133,3628,36421,0,2024-03-13 03:00:00,2024-03-13 03:00:00,19.951357142839697,-133.58630184925278,71555.67996428566,0.0012669052328330953,0.0010841198579207745,71304.70169047623,71336.56468241783,72506.07214296782,73087.06471072331,71845.55390188188,0.00020496038631434246,0.005690017138476439,71017.78455264571,71534.70542631365,82.11084424794707,78.82958071738027,-138.39403537859408,71518.67410952979,71382.77186610372,71719.91039181284,135.90224342606962,66.09230439094935,287.5647171862158,80.07717234260053,99.00486412110331,29.77684382525331,72109.62276001423,71331.69802361145,True,False,72603.133,72373.133,72373.133,72403.133,2024-03-13 08:30:00,True,2024-03-13 08:30:00,2024-03-13 08:31:25,2024-03-13 15:38:22,0.02,success,True,255.15,11538.820000000018,1,0,11,3
2024-03-13 03:45:00,71903.32,72102.938,71881.867,72058.438,2326,36421,0,2024-03-13 03:00:00,2024-03-13 03:00:00,19.951357142839697,-133.58630184925278,71555.67996428566,0.0012669052328330953,0.0010841198579207745,71304.70169047623,71336.56468241783,72506.07214296782,73087.06471072331,71845.55390188188,0.00020496038631434246,0.005690017138476439,71017.78455264571,71534.70542631365,88.89557291142832,83.66394235252558,-138.39403537859408,71601.71470806366,71432.8212093553,71809.44263157896,168.89349870836304,86.65254325443209,323.43290329223436,89.53223976612207,80.07717234260053,99.00486412110331,72247.57705102347,71372.80821213445,True,False,72758.438,71608.438,72528.438,72558.438,,False,2024-03-13 08:45:00,2024-03-13 08:36:25,2024-03-14 15:52:33,0.02,success,True,255.15,11793.970000000018,2,0,11,3
2024-03-13 06:45:00,72247.141,72276.438,72185.086,72274.539,2063,36421,0,2024-03-13 06:00:00,2024-03-13 06:00:00,216.65576190467982,75.85459799815726,72181.46692857142,0.002997960748360456,0.002750283976511077,72001.66253571429,72881.88194629105,73618.96610757794,72954.49836850607,73163.2637704854,0.002193618128139145,0.0034334407147342694,71144.95384668201,71669.96318079733,92.2839596425647,87.41977259175718,-57.04740233071805,72069.31315128737,71843.98767670445,72267.52800894392,225.3254745829181,210.72495073107513,341.73992944828626,22.796131750932545,33.91497282424825,20.66800378395419,72730.3769136991,71806.17910418873,True,False,72974.539,71824.539,72744.539,72774.539,,False,2024-03-13 09:15:00,2024-03-13 09:10:49,2024-03-13 15:57:17,0.02,success,True,255.15,12049.120000000017,3,0,11,3
2024-03-13 08:00:00,72209.234,72360.641,72161.836,72360.641,1638,36421,0,2024-03-13 08:00:00,2024-03-13 08:00:00,57.64630952384323,153.59230518643744,72451.29569047618,0.002181215965817795,0.001773667657217111,72239.11323809526,72825.17044354127,73364.6339079336,72849.39092414886,73121.3320646527,0.0015862481543465596,0.00269036671301751,71248.77384001673,71797.64205862687,86.73203475483854,77.69333281009166,14.684069273625393,72161.38949965118,71964.94289905,72256.51724871,196.44660060117894,202.9472392155339,281.39744643990025,31.393303061529878,3.8604513244354166,-22.78443515651452,72637.90380140387,71876.63069601615,True,False,73060.641,71910.641,72830.641,72860.641,,False,2024-03-13 09:15:00,2024-03-13 09:10:58,2024-03-13 15:55:13,0.02,success,True,255.15,12304.270000000017,4,0,11,3
2024-03-13 08:15:00,72357.141,72574.234,72309.461,72465.234,2606,36421,0,2024-03-13 08:00:00,2024-03-13 08:00:00,57.64630952384323,153.59230518643744,72451.29569047618,0.002181215965817795,0.001773667657217111,72239.11323809526,72825.17044354127,73364.6339079336,72849.39092414886,73121.3320646527,0.0015862481543465596,0.00269036671301751,71248.77384001673,71797.64205862687,87.81312707825265,83.51286361886037,14.684069273625393,72208.13480739715,72002.00149912038,72314.61225868594,206.1333082767669,203.5844530277805,278.5832701927576,58.09500997593568,31.393303061529878,3.8604513244354166,72692.19967344617,71938.52484392571,True,False,73165.234,72015.234,72935.234,72965.234,,False,2024-03-13 09:15:00,2024-03-13 09:12:15,2024-03-13 15:55:10,0.02,success,True,255.15,12559.420000000016,5,0,11,3
2024-03-13 09:00:00,72770.445,73176.039,72683.195,73115.836,3092,36421,0,2024-03-13 09:00:00,2024-03-13 09:00:00,212.18245238091913,229.7981999428448,72665.67442857145,0.0020630076543297913,0.002526092093885283,72451.29569047618,72939.72709483973,74060.54843266864,72825.17044354127,73364.6339079336,0.001773667657217111,0.002181215965817795,71314.9086306043,71888.64757393672,88.35744958505927,86.36257175684655,57.70689540746928,72465.69814685735,72176.08922988143,72619.81417956656,289.6089169759216,230.1934770484296,322.95242725207396,140.59592707258707,87.61262263500248,76.99337117302639,73057.29995635686,72183.82840277626,True,False,73815.836,73585.836,73585.836,73615.836,2024-03-13 10:45:00,True,2024-03-13 10:45:00,2024-03-14 09:05:48,2024-03-13 10:47:02,0.02,even,True,171.32,12730.740000000016,6,0,11,3
2024-03-13 22:00:00,73376.836,73443.336,73073.25,73435.734,2285,36421,0,2024-03-13 22:00:00,2024-03-13 22:00:00,242.98505952383857,238.31008901864698,73231.47734523809,0.002560444788810502,0.0006902955697449179,73128.59741666669,73737.59373281244,73665.26229815772,73639.09524885249,73487.64238199338,0.00027956273301768525,0.0026794934937270577,71996.5248972141,72621.42169758416,82.11966360841492,69.16944372962662,228.27348579625624,73077.15847419783,72973.81054338244,73216.57525730995,103.34793081539101,52.59090768815669,259.0156224337865,82.41745476442156,75.74355865150574,-14.770839353339397,73567.74634759556,72866.90416702433,True,False,74135.734,72985.734,73905.734,73935.734,,False,,,2024-03-13 22:33:41,0.02,fail,False,-164.07,12566.670000000016,0,1,11,3
2024-03-15 11:00:00,67099.234,67381.836,65561.836,66163.695,7432,36421,0,2024-03-15 11:00:00,2024-03-15 11:00:00,-274.961119047628,-1063.321141521199,67741.79524999995,-0.0027241033733311055,-0.0074882287403344626,67515.47304761906,64829.26378684957,66076.40430722153,66759.43542315232,66552.22643972098,-0.007527416740553015,0.00019375030224353914,70899.61811236705,69952.35632344031,14.980033278366912,26.19860708541454,-831.656259598472,67727.09447961787,68342.37786724893,67748.55881561746,-615.2833876310615,-542.2560013913758,671.979954588258,-423.81814379086427,-158.94531131751137,-55.888862401014194,68655.73175431161,66839.88587692332,False,True,65463.69500000001,66613.695,65693.695,65663.695,,False,2024-03-19 05:30:00,2024-03-19 05:34:16,2024-03-15 11:17:31,0.02,fail,False,-164.07,12402.600000000017,0,2,11,3
2024-03-15 20:45:00,69276.758,70506.641,69212.109,70253.102,6345,36421,0,2024-03-15 20:00:00,2024-03-15 20:00:00,53.40101190477435,-433.1276084830606,68926.07551190478,0.0021287670602829637,0.005246251017461863,68305.47821428571,68388.01096147086,72062.26755141576,68239.82870813149,69027.86451784651,0.000618259628268708,0.0021318325230275607,70132.48324605414,69146.6853651299,85.70413130224883,76.50302413286583,-646.3953566471271,68670.04395424003,68375.61739540487,68746.21644478843,294.42655883515545,121.60689520048189,519.0804553391803,347.92686068105104,178.08919263852295,53.31284932914423,69448.47505949633,68045.45783008053,True,False,70953.102,69803.102,70723.102,70753.102,,False,,,2024-03-15 21:23:11,0.02,fail,False,-164.07,12238.530000000017,0,3,11,3
2024-03-15 21:00:00,70257.734,70684.219,70104.836,70301.336,5445,36421,0,2024-03-15 21:00:00,2024-03-15 21:00:00,620.5972976190678,-154.71186896332074,69022.76651190475,0.0013613240574992052,0.0052466201223402694,68926.07551190478,68208.84937250275,72434.57554413255,68388.01096147086,72062.26755141576,0.005246251017461863,0.0021287670602829637,70087.78782464025,69134.37053591952,91.88918483706952,85.33010801598368,-548.0586591103659,68921.01196128002,68518.26321796747,69072.75672136218,402.7487433125498,177.83526482289545,647.8456463799503,326.54027657375264,347.92686068105104,178.08919263852295,69948.84834397511,68198.16509874925,True,False,71001.336,69851.336,70771.336,70801.336,,False,,,2024-03-15 21:22:29,0.02,fail,False,-164.07,12074.460000000017,0,4,11,3
2024-03-18 17:00:00,67024.68,67171.336,66699.836,66775.336,4762,36421,0,2024-03-18 17:00:00,2024-03-18 17:00:00,-332.0967500000261,-210.02573470685456,67595.66663095242,-0.0016133305889050897,0.0003202882128470384,67721.99554761905,66135.38624245484,68801.76345971553,66241.50469863042,68779.58044971534,0.00032029529160279525,-0.0016163287005421312,68974.32828898031,68202.15649234368,8.981628993648137,13.587103947556342,-128.0108829385719,67529.48268148716,67817.661247671,67261.7995847953,-288.17856618383667,-134.37048616070192,481.93550793077486,-222.18414619885152,-205.26446026835765,-238.8767963535647,67912.41252050185,66609.68664908875,False,True,66075.336,67225.336,66305.336,66275.336,,False,2024-03-19 03:45:00,2024-03-19 03:33:11,2024-03-18 17:34:42,0.02,fail,False,-164.07,11910.390000000018,0,5,12,3
2024-03-19 07:15:00,65110.938,65266.938,64773.84,64794.938,3869,36422,0,2024-03-19 07:00:00,2024-03-19 07:00:00,-436.4800714285666,-555.0687491968711,65392.48178571432,-0.007329875974412466,-0.007489558931185627,65719.11679761903,62044.00176539394,63675.50271418289,62839.828014419465,64938.72827183995,-0.005984828189221375,-0.006262542166476981,67970.60877291216,67035.63842198499,15.77763178245354,23.124409060433326,-353.33848787978354,65549.7959114873,66095.16810405812,65152.499667010605,-545.3721925708232,-477.73688725207546,978.671086749747,-96.92303543172602,-43.898806673591025,6.214160646733944,66473.70563412276,63829.793699898444,False,True,64094.938,65244.938,64324.938,64294.938,,False,2024-03-19 09:15:00,2024-03-19 09:10:01,2024-03-19 07:59:39,0.02,fail,False,-164.07,11746.320000000018,0,6,12,3
2024-03-19 10:30:00,63750.438,64197.844,63507.449,63677.637,5087,36422,0,2024-03-19 10:00:00,2024-03-19 10:00:00,-194.02226190477086,-724.6461260922806,64430.44036904764,-0.005404259222662662,-0.005237343653659244,64929.49936904762,61775.39460625314,63429.4601832073,62339.391657850174,63284.89008260583,-0.006698312651778536,-0.00493554311626113,67564.18150215485,66442.53421659466,18.465796467811106,30.376356390443416,-512.5605339837746,64460.51133275871,65060.360760609336,64071.28607774342,-599.849427850626,-547.7782084605699,676.5230887190062,-160.76171001028706,-150.50722359822976,-97.66005056760332,64984.592247514076,63156.47990797276,False,True,62977.637,64127.637,63207.637,63177.637,,False,2024-03-19 12:30:00,2024-03-19 12:47:44,2024-03-19 11:54:02,0.02,fail,False,-164.06,11582.260000000018,0,7,12,3
2024-03-19 10:45:00,63679.738,63791.84,63145.441,63508.602,6214,36422,0,2024-03-19 10:00:00,2024-03-19 10:00:00,-194.02226190477086,-724.6461260922806,64430.44036904764,-0.005404259222662662,-0.005237343653659244,64929.49936904762,61775.39460625314,63429.4601832073,62339.391657850174,63284.89008260583,-0.006698312651778536,-0.00493554311626113,67564.18150215485,66442.53421659466,10.417686675138915,20.59165770527964,-512.5605339837746,64314.06374310352,64945.41566723087,63912.418215342266,-631.3519241273461,-564.4929515939251,696.8935793132845,-158.8678624011518,-160.76171001028706,-150.50722359822976,64853.2245474152,62970.11188326933,False,True,62808.602,63958.602,63038.602,63008.602,,False,2024-03-19 13:15:00,2024-03-19 12:47:52,2024-03-19 11:17:15,0.02,fail,False,-164.06,11418.200000000019,0,8,12,3
2024-03-20 21:00:00,65437.238,65769.359,65111.859,65605.578,5541,36421,0,2024-03-20 21:00:00,2024-03-20 21:00:00,505.60042857150984,357.4057488181934,64859.428857142884,0.0005811553396470584,0.0036739537944627592,64322.33177380954,62295.95223753331,67039.34860578652,60891.43110805174,66298.69144705399,0.0029397848444219507,-0.0030680969376599117,64521.486068934304,63831.300961576504,93.35193879246043,91.08157995474649,62.295472302143864,64481.7459991268,64057.40842139331,64697.43365187473,424.3375777334877,250.94872896677674,663.6713781061932,313.92026487786643,311.6115438596389,111.40149294800358,65594.8900123181,63801.477291431365,True,False,66305.578,65155.577999999994,66075.578,66105.578,,False,2024-03-20 22:15:00,2024-03-20 22:05:55,2024-03-21 20:16:32,0.02,success,True,255.15,11673.350000000019,1,0,12,3
2024-03-21 01:15:00,67829.656,67990.539,67657.273,67852.227,4085,36421,0,2024-03-21 01:00:00,2024-03-21 01:00:00,724.3755000000965,1100.0586062652146,67851.30754761907,0.011918513679692353,0.011258084519026115,67369.88040476196,70835.96146589251,73477.98404594028,70821.45737542221,72233.16210012691,0.01031113365297335,0.01307828948636492,64974.49839891151,64899.385728974165,87.42653022870415,85.5405132849475,551.5769884131333,67405.93583801345,66495.51815510102,68186.52851427588,910.4176829124335,928.9793572768776,1417.160127744679,32.610268317876034,-7.762586859375006,13.535780873862677,70101.19468673119,66273.36234182057,True,False,68552.227,67402.227,68322.227,68352.227,,False,,,2024-03-21 05:15:03,0.02,fail,False,-164.06,11509.290000000019,0,1,12,3
2024-03-22 16:45:00,62946.34,63117.84,62597.055,62771.738,5366,36422,0,2024-03-22 16:00:00,2024-03-22 16:00:00,-656.4993214286078,-583.8789571935558,63324.09314285714,-0.008552606298346208,-0.00621760302301973,63878.12938095234,60177.27476697352,62474.60128701034,60898.20718110528,62862.36652148855,-0.006217695592093156,-0.007714230760732012,65506.82218729106,65220.07817066928,11.696306532036019,12.518699778111696,-266.446322203981,63608.626077756555,64307.4661998976,63082.53829755759,-698.8401221410459,-568.2352867482873,953.9777371855927,-200.36777468182845,-173.27457069142838,-151.26267045069108,64370.408242758145,61793.16835235704,False,True,62071.738,63221.738,62301.738,62271.738,,False,,,2024-03-22 17:09:07,0.02,fail,False,-164.06,11345.23000000002,0,2,12,3
2024-03-25 01:00:00,66972.742,67643.734,66951.336,67588.336,4284,36421,0,2024-03-25 01:00:00,2024-03-25 01:00:00,1108.8604642857608,-104.38508504796482,65761.11897619045,0.00414743169376704,0.007133390869019047,64837.8689761905,64979.39264787291,69698.13053990608,64098.784552903046,68960.65925533773,0.006790398182222478,0.0022928511217313995,65266.33986770958,64991.138018216865,98.1151698167688,97.62871044982553,-446.0221206415376,65606.80975685337,64807.22528800803,66334.93375060198,799.5844688453435,336.50975630083036,1440.4108584189207,537.8122229102592,452.4284888200127,509.1158875129622,68280.98840946752,64390.37909173644,True,False,68288.336,67138.336,68058.336,68088.336,,False,2024-03-25 16:15:00,2024-03-25 16:00:26,2024-03-25 02:02:20,0.02,fail,False,-164.06,11181.17000000002,0,3,13,3
2024-03-25 06:45:00,67328.336,67566.734,67312.016,67520.734,3186,36421,0,2024-03-25 06:00:00,2024-03-25 06:00:00,303.05054761904466,615.6052086658165,67421.0843928572,0.008118013202361649,0.0005695027187975284,67271.91953571427,69336.95583854648,68034.1856188013,68919.82656507473,70272.16290001512,0.00462655709772283,0.008325545981193217,65578.65772872981,65680.09437637101,86.13823562421736,84.08985491666014,169.42657826820113,67092.89072965216,66642.3864614396,67267.7409889921,450.50426821256406,473.44059250549026,322.2181995124831,127.83669384250243,96.78884072926303,108.85715927068668,67704.23555833395,66832.74641965024,True,False,68220.734,67070.734,67990.734,68020.734,,False,2024-03-25 16:00:00,2024-03-25 16:00:15,2024-03-25 08:36:14,0.02,fail,False,-164.06,11017.11000000002,0,4,13,3
2024-03-25 16:00:00,68028.336,68839.836,67711.75,68616.242,6416,36421,0,2024-03-25 16:00:00,2024-03-25 16:00:00,369.8497500000085,461.96095256783883,68104.33670238098,0.0009108516150209138,0.00461678467636732,67338.23538095239,67179.05111633732,70855.7015867888,67116.60138720111,68457.63062709206,0.0013575536831523741,0.0009106716941868153,66192.31464882629,66711.70458059583,86.6297412566824,66.3239759265783,454.2856967441254,67411.35312544805,67203.34441357196,67488.78552872376,208.00871187608573,70.68230829019039,390.49198691696955,275.2617313381779,176.11364017885353,22.77724355008104,68017.44971106166,66961.62134638586,True,False,69316.242,68166.242,69086.242,69116.242,,False,2024-03-25 16:30:00,2024-03-25 16:21:33,,0.02,success,True,255.15,11272.26000000002,1,0,13,3
2024-03-25 16:15:00,68610.352,69511.734,68610.281,69217.273,6499,36421,0,2024-03-25 16:00:00,2024-03-25 16:00:00,369.8497500000085,461.96095256783883,68104.33670238098,0.0009108516150209138,0.00461678467636732,67338.23538095239,67179.05111633732,70855.7015867888,67116.60138720111,68457.63062709206,0.0013575536831523741,0.0009106716941868153,66192.31464882629,66711.70458059583,91.4874395467178,81.59870661712819,454.2856967441254,67689.18695230219,67352.52430886292,67862.31006707944,336.6626434392674,123.8783753200058,572.34263576377,373.52453835567576,275.2617313381779,176.11364017885353,68636.47262536053,67089.64750879834,True,False,69917.273,68767.273,69687.273,69717.273,,False,2024-03-25 18:00:00,2024-03-25 17:46:25,2024-03-27 16:12:11,0.02,success,True,255.15,11527.41000000002,2,0,13,3
2024-03-25 16:45:00,69140.352,69480.641,69001.836,69416.438,4738,36421,0,2024-03-25 16:00:00,2024-03-25 16:00:00,369.8497500000085,461.96095256783883,68104.33670238098,0.0009108516150209138,0.00461678467636732,67338.23538095239,67179.05111633732,70855.7015867888,67116.60138720111,68457.63062709206,0.0013575536831523741,0.0009106716941868153,66192.31464882629,66711.70458059583,90.7229922992301,90.15720688492821,454.2856967441254,68144.11164040571,67628.17873119249,68563.53791537667,515.9329092132248,250.894595701376,808.5846803539456,352.36520123844093,348.8626470587915,373.52453835567576,69656.6272338545,67471.94859689884,True,False,70116.438,68966.438,69886.438,69916.438,,False,2024-03-25 18:45:00,2024-03-25 18:35:59,2024-03-27 16:11:38,0.02,success,True,255.15,11782.56000000002,3,0,13,3
2024-03-25 20:30:00,70673.305,70713.734,70394.727,70693.938,2997,36421,0,2024-03-25 20:00:00,2024-03-25 20:00:00,640.4768452381104,1069.4679401302128,70676.44911904761,0.010291092823329961,0.008307327654229174,70152.78513095237,73481.16749090742,74392.5799912742,71904.02629492519,73586.83759008718,0.007905853944416653,0.008899353779530252,66813.16726457357,67760.56705168006,87.60180440584448,86.01524159191202,725.5730603331584,70240.98298234682,69453.1425426359,70765.42716443067,787.8404397109116,776.6268217387787,1314.2969429114194,34.58676608178939,17.567076711449772,-23.626622291034437,72541.22803736108,68991.12629150026,True,False,71393.938,70243.938,71163.938,71193.938,,False,2024-03-26 09:30:00,2024-03-26 09:23:57,2024-03-25 23:15:47,0.02,fail,False,-164.06,11618.50000000002,0,1,13,3
2024-03-25 20:45:00,70693.938,70953.734,70661.836,70881.734,2979,36421,0,2024-03-25 20:00:00,2024-03-25 20:00:00,640.4768452381104,1069.4679401302128,70676.44911904761,0.010291092823329961,0.008307327654229174,70152.78513095237,73481.16749090742,74392.5799912742,71904.02629492519,73586.83759008718,0.007905853944416653,0.008899353779530252,66813.16726457357,67760.56705168006,91.31832238277809,88.40187683808124,725.5730603331584,70339.56006198577,69558.96413207028,70857.99086549702,780.5959299154929,777.4206433741217,1268.2108945215086,92.56370106634859,34.58676608178939,17.567076711449772,72571.57557310106,69145.90615789298,True,False,71581.734,70431.734,71351.734,71381.734,,False,2024-03-26 09:30:00,2024-03-26 09:29:20,2024-03-25 23:14:37,0.02,fail,False,-164.06,11454.44000000002,0,2,13,3
2024-03-25 21:45:00,70776.336,71045.336,70750.039,70995.734,3075,36421,0,2024-03-25 21:00:00,2024-03-25 21:00:00,523.6639880952425,1153.7737770251551,70980.40263095242,0.008904403268880945,0.006937337955891408,70676.44911904761,73202.79671483333,74174.48375828368,73481.16749090742,74392.5799912742,0.008307327654229174,0.010291092823329961,66977.18948949226,68019.38040754566,86.96794629489409,83.67645725154803,811.2132036715577,70559.49006748831,69881.68499360033,70953.59828345374,677.8050738879829,731.64897264126,777.1850839158867,50.387440660444554,12.187011351968977,18.845109735091683,72004.29814674018,69904.3984201673,True,False,71695.734,70545.734,71465.734,71495.734,,False,2024-03-26 09:30:00,2024-03-27 15:29:35,2024-03-25 23:11:41,0.02,fail,False,-164.06,11290.380000000021,0,3,13,3
2024-03-27 03:00:00,70646.734,70777.539,70443.367,70708.297,3259,36421,0,2024-03-27 03:00:00,2024-03-27 03:00:00,211.26634523819666,10.77330699772574,70360.41196428573,0.0016979841316337176,0.0006549135729137055,70248.43171428579,70485.55707104469,70976.87136735112,69946.39560651258,70930.58618265948,0.0006549093548391471,0.0009647137503259336,69315.50546635102,70097.45837349653,94.47100765697742,83.44277173927752,10.752137594152089,70286.42300504733,70174.33685646209,70400.29401375988,112.08614858523651,31.970572790494572,286.39250760733756,86.88244994834531,84.73062091505562,65.7826590987097,70788.42389902979,70013.66412848997,True,False,71408.297,70258.297,71178.297,71208.297,,False,2024-03-27 15:15:00,2024-03-27 15:15:45,2024-03-27 03:57:00,0.02,fail,False,-164.06,11126.320000000022,0,4,13,3
2024-03-27 15:15:00,71286.141,71760.539,71181.836,71703.938,4601,36421,0,2024-03-27 15:00:00,2024-03-27 15:00:00,54.40958333337039,-18.109667111668386,70102.33708333338,0.0004807292428604958,0.0024262757516700546,70105.69327380955,69723.56428593988,72568.87515142412,69089.07984207624,70258.4641994026,-0.0005215489636095419,-0.0007292369977607372,69640.24867800644,70130.78279345584,88.85792245118445,78.35977283695522,-19.288092043571936,70547.02881943573,70337.02047287514,70745.47852975571,210.00834656058578,57.44050439395413,457.3121501229455,237.85673065004812,194.81531406953582,19.403499140084023,71364.34993242168,70128.10712708974,True,False,72403.938,71253.938,72173.938,72203.938,,False,,,2024-03-27 15:35:10,0.02,fail,False,-164.06,10962.260000000022,0,5,13,3
2024-03-28 08:15:00,70022.086,70161.438,69916.336,70106.836,2821,36421,0,2024-03-28 08:00:00,2024-03-28 08:00:00,36.25367857146193,3.4542793903383426,69858.91369047621,0.0013536321391076842,0.0009501906265654782,69575.5482142857,69689.44698874735,70729.60318355059,69103.48271030467,69901.97013211402,-0.00023103501298989316,0.00036414292667284547,69516.82240440877,69618.46366043566,90.5294310585203,86.66103944526839,-110.76677267549047,69758.88464317277,69601.42650080626,69916.81066563471,157.45814236650767,103.33726424031845,266.4728664716442,101.45294461651065,95.31182146536594,43.13055108363915,70278.04903537143,69557.07229589799,True,False,70806.836,70576.836,70576.836,70606.836,2024-03-28 10:45:00,True,2024-03-28 10:45:00,2024-03-28 10:46:20,2024-03-28 10:59:42,0.02,success,True,255.15,11217.410000000022,1,0,13,3
2024-03-28 08:30:00,70113.836,70431.336,70046.0,70406.734,3158,36421,0,2024-03-28 08:00:00,2024-03-28 08:00:00,36.25367857146193,3.4542793903383426,69858.91369047621,0.0013536321391076842,0.0009501906265654782,69575.5482142857,69689.44698874735,70729.60318355059,69103.48271030467,69901.97013211402,-0.00023103501298989316,0.00036414292667284547,69516.82240440877,69618.46366043566,97.24433450641283,91.45056798585931,-110.76677267549047,69858.55377499234,69661.07890815396,70075.6823856209,197.4748668383836,122.16478475993148,309.1915389424688,158.87171998618578,101.45294461651065,95.31182146536594,70494.59096319323,69658.27380804856,True,False,71106.734,69956.734,70876.734,70906.734,,False,2024-03-28 15:30:00,2024-03-28 15:28:25,2024-03-29 09:39:51,0.02,success,True,255.15,11472.560000000021,2,0,13,3
2024-03-28 10:30:00,70531.234,70764.938,70515.555,70675.836,3081,36421,0,2024-03-28 10:00:00,2024-03-28 10:00:00,245.26158333331114,173.81087181561452,70382.30941666667,0.0027331535130726697,0.002251230319971287,70104.17527380952,70850.3992089817,71560.98286791754,70534.39337056904,70796.9322992924,0.0009502663055197093,0.0025211484574371177,69594.1227539352,69757.55163259275,84.56782297240282,84.25857340304434,-19.55695331905835,70308.55984721013,70023.88976254834,70575.04625111804,284.6700846617896,241.31347106423135,494.51713673090865,69.24624630206381,37.02962125906197,8.591421396631631,71244.14438570477,69907.4481165313,True,False,71375.836,70225.836,71145.836,71175.836,,False,2024-03-28 16:45:00,2024-03-28 15:35:19,2024-03-29 07:36:23,0.02,success,True,255.15,11727.710000000021,3,0,13,3
2024-04-01 01:00:00,70901.734,71078.438,70881.68,71002.141,1736,56421,0,2024-04-01 01:00:00,2024-04-01 01:00:00,526.4584523809026,-51.73582520158379,70485.92577380955,0.0024068032988194517,0.0020280195460505093,69997.5893571428,70579.72714616677,71773.14659189068,70187.64485208053,71312.01954065808,0.0009689322341123693,0.001858455212086363,70125.09779132955,70145.5770912984,93.1796038363068,92.57964705495097,-168.99846143177226,70355.05292673846,70065.90775486267,70681.73571964225,289.14517187578895,107.44635294542903,594.3322850630544,173.68719470244832,174.2579814241617,192.61188716893957,71485.58430447738,69879.38713480713,True,False,71702.141,70552.141,71472.141,71502.141,,False,,,2024-04-01 07:37:19,0.02,fail,False,-164.06,11563.650000000021,0,1,14,4
2024-04-01 17:30:00,69426.141,69486.836,69036.852,69066.141,3899,36421,0,2024-04-01 17:00:00,2024-04-01 17:00:00,77.51122619042872,-145.33049239318643,69502.12460714283,-0.0013751814619648627,0.0007399656016360663,69731.39346428568,68246.11116740876,70394.00901306105,69932.72233633093,70342.67238816984,0.0007399580432697697,0.001363259987327757,70032.8813362229,69911.79877917083,14.931024706435188,39.69791931716213,-137.17561093895347,69634.02836317591,69699.81924073439,69717.36548503608,-65.79087755848013,-36.33492240127946,222.77601678212588,-131.8692019264272,-72.95053560375527,-11.819185414453386,70018.11310769194,69415.11786238021,False,True,68366.141,69516.141,68596.141,68566.141,,False,2024-04-01 18:15:00,2024-04-01 18:12:41,2024-04-01 22:23:42,0.02,success,True,255.15,11818.800000000021,1,0,14,4
2024-04-01 17:45:00,69046.328,69246.141,68635.844,68931.836,4376,36421,0,2024-04-01 17:00:00,2024-04-01 17:00:00,77.51122619042872,-145.33049239318643,69502.12460714283,-0.0013751814619648627,0.0007399656016360663,69731.39346428568,68246.11116740876,70394.00901306105,69932.72233633093,70342.67238816984,0.0007399580432697697,0.001363259987327757,70032.8813362229,69911.79877917083,8.32054900120321,20.554413711400013,-137.17561093895347,69525.99876884115,69642.93159327257,69552.96952872376,-116.9328244314238,-52.45450280730833,261.7686407804731,-164.39595631232078,-131.8692019264272,-72.95053560375527,69906.3571937774,69198.08186367012,False,True,68231.836,69381.836,68461.836,68431.836,,False,2024-04-01 19:00:00,2024-04-01 18:13:29,2024-04-01 22:21:38,0.02,success,True,255.15,12073.95000000002,2,0,14,4
2024-04-02 01:30:00,69766.734,69869.438,69683.258,69843.641,1261,36421,0,2024-04-02 01:00:00,2024-04-02 01:00:00,282.18757142845425,-103.50955161973252,69727.33352380947,0.003983905400629794,0.0028593885461903816,69521.974547619,70742.27091240164,71288.22627428474,69935.55577013515,69890.7520250752,-0.00010129019677673418,0.0030664781964939375,69807.53494555014,69594.19318657742,86.37888347105901,82.65561783776705,-220.16323931275383,69611.75830915329,69420.34803172479,69897.08447506024,191.41027742849838,139.3930588187107,498.3309837018219,7.570158926740987,28.93831613349903,15.03034640524129,70571.3313030577,69224.33764706278,True,False,70543.641,69393.641,70313.641,70343.641,,False,,,2024-04-02 03:20:05,0.02,fail,False,-164.06,11909.890000000021,0,1,14,4
2024-04-02 16:15:00,65366.539,65483.742,64781.84,64889.762,5351,36422,0,2024-04-02 16:00:00,2024-04-02 16:00:00,-284.73908333333384,-873.6742762387876,65440.11782142854,-0.0035402348635736386,-0.003466853448153391,65676.63094047624,63703.68970794417,64717.87735093344,64219.05719938494,65208.885428828886,-0.002888545815852402,-0.002650480592589208,68404.94642028924,67379.03115324157,18.571201958927812,27.575309156896953,-738.7740148764094,65567.09974992863,65986.79496906498,65291.19890608869,-419.69521913635253,-398.01284607271276,483.4538190734954,-142.11153697974805,-51.22351599587273,-56.84888751299877,65943.86156183791,64637.03625033947,False,True,64189.762,65339.762,64419.762,64389.762,,False,,,2024-04-02 16:54:35,0.02,fail,False,-164.06,11745.830000000022,0,2,14,4
2024-04-03 21:15:00,65767.344,65852.641,65581.836,65641.836,2397,36421,0,2024-04-03 21:00:00,2024-04-03 21:00:00,-16.31285714288242,-14.569014385953778,66062.18864285715,-0.00014229365588476378,-0.00045174665518179336,66070.64472619048,65434.075328464234,66665.85145281901,65999.81728142464,67449.40581598064,0.0011310562336805177,0.000697211133669991,66759.35956511297,66173.49915126115,12.667639639417644,19.16868261874834,-5.022208270018538,66015.09030140619,66093.40127573577,65853.50374785002,-78.31097432957904,-16.33425407213812,321.7321859228543,-144.4377358101192,-129.8112229102262,-89.0140846232971,66287.84219884587,65417.66529685416,False,True,64941.835999999996,66091.836,65171.835999999996,65141.835999999996,,False,,,2024-04-03 21:50:37,0.02,fail,False,-164.06,11581.770000000022,0,3,14,4
2024-04-04 19:15:00,67677.516,68153.734,67650.039,67899.227,2982,36421,0,2024-04-04 19:00:00,2024-04-04 19:00:00,265.86886904761195,397.0174458300171,67627.86188095238,0.0036748349707995706,0.004431260171502505,67379.31148809525,68323.55111630925,69765.50221635471,67794.82220992263,69176.0684464004,0.003641917087568729,0.0031012314182457357,66563.41662938941,66521.1355256169,82.20031530648085,81.54324407174455,176.21381895596784,67522.96200141053,67138.26078138385,67892.86101582393,384.7012200266763,368.02291354370965,602.4584931485826,41.279650498807314,26.44027175786323,18.598574819392525,68707.67998157452,67079.54205007335,True,False,68599.227,67449.227,68369.227,68399.227,,False,2024-04-04 21:00:00,2024-04-04 20:51:25,2024-04-04 23:16:11,0.02,success,True,255.15,11836.920000000022,1,0,14,4
2024-04-04 20:45:00,68035.641,68890.438,68015.688,68824.641,3882,36421,0,2024-04-04 20:00:00,2024-04-04 20:00:00,248.550392857127,447.3618876109831,68140.45217857145,0.004140780960182654,0.005270882284680321,67627.86188095238,68872.30356908694,70501.4418583945,68323.55111630925,69765.50221635471,0.004431260171502505,0.0036748349707995706,66652.09209490355,66705.41596356756,81.69944866601904,74.24187084155103,230.44343268697088,67889.65419448807,67476.89284047575,68096.88716099071,412.7613540123275,371.20180321843617,562.8327909520923,185.0354767802346,28.572408324675052,-17.61145579633012,68858.21142877603,67337.06289320538,True,False,69524.641,68374.641,69294.641,69324.641,,False,,,2024-04-04 22:01:36,0.02,fail,False,-164.06,11672.860000000022,0,1,14,4
2024-04-08 04:15:00,69538.141,69843.938,69533.555,69721.836,2795,36421,0,2024-04-08 04:00:00,2024-04-08 04:00:00,342.98547619041346,482.0495955750521,69450.56329761907,0.005757334399141604,0.0037508030237947587,69226.18483333329,70944.76863350284,71569.47860905588,70539.75933828534,71990.34360272557,0.005096862156079798,0.005762370350189099,67621.6700046159,68070.76966726633,86.55899239539836,77.55337374858031,246.64444738346145,69310.68314374727,68909.41620416021,69445.11886205715,401.26693958706164,408.9235388578129,810.1613020031874,-47.70189198483422,-51.71841623664659,-64.86741933260055,70538.83661976145,68349.90110435284,True,False,70421.836,69271.836,70191.836,70221.836,,False,2024-04-08 10:45:00,2024-04-08 10:34:50,2024-04-08 05:08:49,0.02,fail,False,-164.06,11508.800000000023,0,2,15,4
2024-04-08 10:15:00,69911.734,70157.234,69856.445,70092.039,2577,36421,0,2024-04-08 10:00:00,2024-04-08 10:00:00,104.70779761907761,510.6262292200263,70013.9359404762,0.0018259249386731481,0.0024314824916463807,69611.31723809529,70172.11259273853,71591.34617453875,69459.65249312881,69816.6732619659,-4.2656761121921314e-05,0.0006593243318919926,68074.97961334753,68742.9632626789,92.36963824656254,88.51470579259204,439.41750588367074,69733.39546676776,69520.74409045292,69888.01099277605,212.65137631483958,191.16025612981986,231.30746794950866,76.27826281389571,58.827920536641614,41.492159270797856,70201.77607450788,69575.74591104421,True,False,70792.039,69642.039,70562.039,70592.039,,False,2024-04-08 10:45:00,2024-04-08 10:37:26,2024-04-09 11:09:35,0.02,success,True,255.15,11763.950000000023,1,0,15,4
2024-04-08 10:30:00,70092.039,70869.734,70087.398,70675.836,4062,36421,0,2024-04-08 10:00:00,2024-04-08 10:00:00,104.70779761907761,510.6262292200263,70013.9359404762,0.0018259249386731481,0.0024314824916463807,69611.31723809529,70172.11259273853,71591.34617453875,69459.65249312881,69816.6732619659,-4.2656761121921314e-05,0.0006593243318919926,68074.97961334753,68742.9632626789,91.19903369320345,89.97018421768514,439.41750588367074,69878.38631803426,69606.30645412307,70063.72077880974,272.079863911189,207.3441776860937,322.78447395934325,175.7097860336944,76.27826281389571,58.827920536641614,70500.97981865486,69627.96173896463,True,False,71375.836,71145.836,71145.836,71175.836,2024-04-08 11:15:00,True,2024-04-08 11:15:00,2024-04-08 11:15:06,2024-04-08 11:23:01,0.02,success,True,255.15,12019.100000000022,2,0,15,4
2024-04-08 11:00:00,70720.336,71361.734,70656.25,71357.938,3424,36421,0,2024-04-08 11:00:00,2024-04-08 11:00:00,402.61870238091797,604.7054465979454,70772.61248809518,0.002894968735062643,0.005020461961060853,70013.9359404762,70845.51057746203,73877.69087572495,70172.11259273853,71591.34617453875,0.0024314824916463807,0.0018259249386731481,68230.43292262802,69006.64932166459,92.7645930423497,91.44340702622299,472.4750940265257,70215.61257090027,69812.46500113432,70502.15356965942,403.147569765948,264.3841680101463,523.6125648587675,273.1042665978457,165.32852425183228,175.7097860336944,71210.53053221876,69795.27660710008,True,False,72057.938,70907.938,71827.938,71857.938,,False,2024-04-08 12:00:00,2024-04-08 11:54:14,2024-04-09 04:11:44,0.02,success,True,255.15,12274.250000000022,3,0,15,4
2024-04-10 16:00:00,67992.938,68000.039,67599.641,67633.977,3863,36421,0,2024-04-10 16:00:00,2024-04-10 16:00:00,-397.8090952381608,-246.12639225984458,68471.86391666664,-0.004184210465971702,-0.0008450829723934453,68687.99535714283,66095.71929800842,68952.17860615446,66599.0220439715,69010.7422797778,-0.0008449949920309803,-0.003364235504006304,69498.75007586315,69216.00571794994,19.698105857531417,35.42191139709093,-198.7990845448125,68575.16554156737,68838.58667091712,68416.68745854832,-263.4211293497501,-122.97506193917255,444.3313190141676,-231.8332088063471,-171.69560440313944,-196.4691506708332,69016.53473921744,67815.34017787919,False,True,66933.977,68083.977,67163.977,67133.977,,False,2024-04-12 21:45:00,2024-04-12 21:32:37,2024-04-10 16:51:52,0.02,fail,False,-164.06,12110.190000000022,0,1,15,4
2024-04-10 22:45:00,69761.734,70103.539,69714.719,70097.938,3097,36421,0,2024-04-10 22:00:00,2024-04-10 22:00:00,190.3932857142645,-12.39672527773655,69677.74786904757,0.0041541163044723555,0.002025957495818319,69239.64022619047,70440.66902862044,70835.09565942876,70099.01506024749,70641.61655119367,0.0018920958915118926,0.0040816718725585534,69459.53421035525,69267.40661407213,84.5931611496473,72.98044591203346,-142.8264708256808,69475.81266529392,69216.1620572436,69749.52356415548,259.65060805033136,186.6714077300344,491.63869878673205,114.17621259031876,47.352840729246964,47.658427244532504,70414.73580751756,69085.8113207934,True,False,70797.938,69647.938,70567.938,70597.938,,False,2024-04-11 01:30:00,2024-04-11 01:22:02,2024-04-11 00:29:15,0.02,fail,False,-164.06,11946.130000000023,0,2,15,4
2024-04-11 01:15:00,70501.234,71258.336,70438.578,70955.734,3453,36421,0,2024-04-11 01:00:00,2024-04-11 01:00:00,129.38869047618937,198.94173700430838,70209.6051904762,0.003147676750586054,0.003686486059513806,69940.19721428568,70724.03073503796,72360.70936670105,70521.8014787293,71139.67875113242,0.0020542821949330672,0.0032219723347920027,69537.4456340328,69464.7716551306,88.58385273164367,76.15930298014109,3.5466927883090023,70020.46925482793,69673.60139508336,70261.60315376674,346.8678597445687,268.7458349250707,439.5270535234328,203.2077258341742,131.72082628133649,75.70276126592944,70856.46467602337,69668.24163151011,True,False,71655.734,70505.734,71425.734,71455.734,,False,,,2024-04-11 03:02:49,0.02,fail,False,-164.06,11782.070000000023,0,3,15,4
2024-04-11 05:30:00,70836.922,70961.836,70771.914,70931.734,2343,36421,0,2024-04-11 05:00:00,2024-04-11 05:00:00,81.28009523812216,391.77890917244076,70772.88442857141,0.0025206327496446936,0.0010958466851416016,70627.09077380956,71210.97049932605,71899.23481352814,71030.74500323784,73140.14885430224,0.003638078161344991,0.002520800200488893,69711.11666343041,69820.25497131367,82.83743141314413,63.12029305109684,215.65359422850133,70650.85296099036,70387.89918121339,70659.14751496387,262.95377977697353,275.0006917493455,391.8466170119667,46.27562641892291,-1.7273856209212681,-31.40582456131233,71189.64044793003,70130.15458199772,True,False,71631.734,70481.734,71401.734,71431.734,,False,,,2024-04-11 07:17:49,0.02,fail,False,-164.06,11618.010000000024,0,4,15,4
2024-04-11 05:45:00,70927.641,71110.438,70792.133,71017.445,2295,36421,0,2024-04-11 05:00:00,2024-04-11 05:00:00,81.28009523812216,391.77890917244076,70772.88442857141,0.0025206327496446936,0.0010958466851416016,70627.09077380956,71210.97049932605,71899.23481352814,71030.74500323784,73140.14885430224,0.003638078161344991,0.002520800200488893,69711.11666343041,69820.25497131367,87.94124566953553,77.62141617462238,215.65359422850133,70707.25173622262,70434.5322048272,70756.40456484348,272.7195313954144,274.5444596785593,391.4934711270143,97.25704987961217,46.27562641892291,-1.7273856209212681,71286.42075086496,70227.88837882201,True,False,71717.445,70567.445,71487.445,71517.445,,False,,,2024-04-11 07:06:56,0.02,fail,False,-164.06,11453.950000000024,0,5,15,4
2024-04-12 02:15:00,70074.492,70105.039,69781.844,69999.039,1430,36421,0,2024-04-12 02:00:00,2024-04-12 02:00:00,-63.9089999999851,-15.454327447310789,70216.02610714285,0.0003890094808106999,0.0004279499857552915,70303.22179761909,69895.44555028761,70978.89376590657,70358.3721941468,71369.22638008819,0.001387748537728747,0.0010770285550967332,70075.5073723333,70220.22355314945,15.396796748685206,18.529962001639436,15.42528398771654,70204.9126192354,70246.74066922514,70141.21768868247,-41.82804998973734,-0.6464655089865516,175.6936544631898,-79.34463020296243,-56.36351152390125,-45.817475748219294,70378.40412220778,69902.53125515717,False,True,69299.039,70449.039,69529.039,69499.039,,False,2024-04-12 18:00:00,2024-04-12 17:52:25,2024-04-12 05:06:09,0.02,fail,False,-164.08,11289.870000000024,0,6,15,4
2024-04-12 17:00:00,69908.141,70118.938,69640.141,69793.641,3627,36421,0,2024-04-12 17:00:00,2024-04-12 17:00:00,-278.826869047567,-17.32454239219078,70013.01730952383,-0.00279272457469639,-0.000358967467973441,70449.7302619048,68451.69351759311,70852.85228561264,69009.79106412095,70969.39261000771,-0.00010915172993013485,-0.002220210429648298,70299.81079163612,70435.63856557905,10.88228596688768,13.02448248817604,91.01933397345844,70306.44518230302,70522.75930554175,70134.27183694532,-216.31412323872792,-100.88407412867011,349.4840528699146,-150.76655280351406,-135.8772851738031,-158.6099570002698,70606.0753083197,69660.96836557094,False,True,69093.641,69323.641,69323.641,69293.641,2024-04-12 18:00:00,True,2024-04-12 18:00:00,2024-04-12 19:17:02,2024-04-12 18:00:21,0.02,even,True,171.32,11461.190000000024,1,0,15,4
2024-04-15 07:30:00,64897.844,64939.438,64731.867,64853.836,2621,36422,0,2024-04-15 07:00:00,2024-04-15 07:00:00,42.217392857135565,-1176.1330971093994,65202.2004880953,0.0030377715220137997,0.0006116479705383242,65093.34097619043,65437.70691208796,66148.18618135988,66172.90221038317,64040.87946535085,-0.004694764335137202,0.00444593483494115,68463.6302881549,67257.85717813502,18.212177695562506,21.189030023380568,-1107.69620552305,65066.1780170447,65368.64095424992,64912.819563123485,-302.462937205215,-338.1256128437062,253.25588728487756,-32.65671310629841,-41.70734502923733,-76.59980116964289,65254.71501095807,64569.4241152889,False,True,64153.836,65303.836,64383.836,64353.836,,False,2024-04-15 18:00:00,2024-04-15 17:58:44,2024-04-15 08:42:47,0.02,fail,False,-164.08,11297.110000000024,0,1,16,4
2024-04-17 15:30:00,62378.047,62458.738,62006.637,62217.852,3921,36422,0,2024-04-17 15:00:00,2024-04-17 15:00:00,-283.862964285654,-126.21044966683985,62591.978761904815,-0.003706467911637577,-0.003477552935863996,62863.20517857146,61085.238270729016,62024.73031400106,61824.09763050066,62238.35999971079,-0.0034808014605897117,-0.0025854691901018778,63906.271660208055,63276.50085250381,11.743554560040101,12.975353862046248,43.825592628142665,62760.8319741511,63068.527181027945,62499.44140488471,-307.69520687684417,-235.62797811956355,430.11853967824624,-123.84001479198923,-124.43801616781275,-67.02222428620735,63080.10143345034,61917.28137631908,False,True,61517.852,62667.852,61747.852,61717.852,,False,2024-04-17 17:30:00,2024-04-17 17:19:05,2024-04-17 16:37:31,0.02,fail,False,-164.08,11133.030000000024,0,2,16,4
2024-04-18 14:15:00,62344.176,62981.738,62344.176,62876.438,4739,36422,0,2024-04-18 14:00:00,2024-04-18 14:00:00,148.7533452380885,-68.02154627266282,61864.46640476193,0.0005713476361958852,0.0022879486403168123,61422.717999999986,61049.80493978747,63617.0247085767,60812.114143375446,61718.51114594449,-0.0006690982114273679,0.00013153733892418585,62412.04935738212,61748.057625585665,93.44594468092076,90.28669043188727,-179.6116441054086,61805.707309512814,61588.099324965835,62035.79730994147,217.60798454697942,61.47942079629904,444.3455119845781,254.2612404540123,157.751493636104,81.2066738905778,62637.16375112065,61435.93086876228,True,False,63576.438,62426.438,63346.438,63376.438,,False,2024-04-18 17:15:00,2024-04-18 17:16:20,2024-04-18 15:06:27,0.02,fail,False,-164.08,10968.950000000024,0,3,16,4
2024-04-19 04:00:00,62676.039,62741.738,62071.137,62083.34,3828,36422,0,2024-04-19 04:00:00,2024-04-19 04:00:00,-183.61498809524346,270.6647636292473,62438.25847619046,-0.0039305167102336004,-0.002995148776345488,63244.384964285746,59612.85815427951,62485.05708439068,62830.22635221128,64068.63176648761,0.0006449932778124421,0.0009224781841603984,62657.80586173342,62569.07753556826,7.107257468489622,7.867187159662328,344.00273588612816,62980.967991708625,63117.434153288676,62840.21514585483,-136.46616158005054,6.469536690618025,336.5789456878022,-218.60700722389447,-122.18152253187145,-72.9493464051775,63294.596722533366,62384.3335691763,False,True,61383.34,62533.34,61613.34,61583.34,,False,2024-04-19 04:45:00,2024-04-19 04:35:53,2024-04-19 07:36:31,0.02,success,True,255.16,11224.110000000024,1,0,16,4
2024-04-19 04:15:00,62087.137,62250.938,61819.816,62040.84,5040,36422,0,2024-04-19 04:00:00,2024-04-19 04:00:00,-183.61498809524346,270.6647636292473,62438.25847619046,-0.0039305167102336004,-0.002995148776345488,63244.384964285746,59612.85815427951,62485.05708439068,62830.22635221128,64068.63176648761,0.0006449932778124421,0.0009224781841603984,62657.80586173342,62569.07753556826,6.83879013055686,7.769680535408444,344.00273588612816,62836.33291606115,63037.68643823025,62633.909285517664,-201.35352216910542,-35.09507508132667,414.80372621767054,-206.30586033716827,-218.60700722389447,-122.18152253187145,63193.89431591152,62072.424255123806,False,True,61340.84,62490.84,61570.84,61540.84,,False,2024-04-19 04:45:00,2024-04-19 04:36:20,2024-04-19 07:35:28,0.02,success,True,255.16,11479.270000000024,2,0,16,4
2024-04-19 04:30:00,62038.48,62139.738,60862.105,60977.938,6372,36422,0,2024-04-19 04:00:00,2024-04-19 04:00:00,-183.61498809524346,270.6647636292473,62438.25847619046,-0.0039305167102336004,-0.002995148776345488,63244.384964285746,59612.85815427951,62485.05708439068,62830.22635221128,64068.63176648761,0.0006449932778124421,0.0009224781841603984,62657.80586173342,62569.07753556826,5.7452747865238285,6.56377412852337,344.00273588612816,62550.42600589789,62885.11247984283,62261.88957344328,-334.68647394493746,-95.01335485404884,610.6045120966006,-372.0197120743833,-206.30586033716827,-218.60700722389447,63086.20566477369,61436.07348211287,False,True,60277.938,61427.938,60507.938,60477.938,,False,2024-04-19 05:30:00,2024-04-19 05:18:24,2024-04-19 06:00:36,0.02,success,True,255.16,11734.430000000024,3,0,16,4
2024-04-19 05:00:00,60981.637,61140.039,60577.172,60661.34,5619,36422,0,2024-04-19 05:00:00,2024-04-19 05:00:00,-806.1264880952876,1.2034809372198652,61893.46236904765,-0.008135503448781715,-0.0029952712437029587,62438.25847619046,57629.801707819846,62297.120497651355,59612.85815427951,62485.05708439068,-0.002995148776345488,-0.0039305167102336004,62605.14833774388,62468.7544527228,7.050171876231128,7.616553632698095,275.4428848963465,62055.524394755295,62589.807352402975,61552.925291021675,-534.2829576476797,-237.27670248672308,878.8119450871535,-355.4865916753042,-353.47769074630196,-372.0197120743833,62739.32141688933,60365.02916515402,False,True,59961.34,61111.34,60191.34,60161.34,,False,2024-04-19 05:30:00,2024-04-19 05:21:34,2024-04-19 05:55:33,0.02,success,True,255.16,11989.590000000024,4,0,16,4
2024-04-19 12:00:00,64574.891,64720.938,64431.84,64622.438,3117,36422,0,2024-04-19 12:00:00,2024-04-19 12:00:00,706.2196071429426,425.73348466228344,64627.58714285714,0.00919938404555842,0.010751168501223684,64226.56586904767,65936.05568851897,70075.14216495283,65328.623812834754,67714.89340076545,0.006887134871554279,0.009195260491836839,62846.23817432063,63007.49523081214,81.93117522624857,81.86497297837131,153.6277737559466,64084.89982309588,63428.44583768296,64963.92812521504,656.4539854129252,520.365027673055,1226.7804628564504,146.53228586180194,148.5419645682632,158.5582163742365,66621.58175007124,63307.77450035883,True,False,65322.438,64172.438,65092.438,65122.438,,False,2024-04-19 14:45:00,2024-04-19 14:40:01,2024-04-19 17:25:47,0.02,success,True,255.16,12244.750000000024,5,0,16,4
2024-04-19 12:45:00,64598.34,64898.625,64598.34,64726.637,3236,36422,0,2024-04-19 12:00:00,2024-04-19 12:00:00,706.2196071429426,425.73348466228344,64627.58714285714,0.00919938404555842,0.010751168501223684,64226.56586904767,65936.05568851897,70075.14216495283,65328.623812834754,67714.89340076545,0.006887134871554279,0.009195260491836839,62846.23817432063,63007.49523081214,84.27059785790766,83.7090896894294,153.6277737559466,64302.594157733554,63676.590621846066,65126.043332301306,626.0035358874884,575.5270653500336,1228.6687533158718,19.396794289612444,44.22854110771732,98.48987168893655,66786.24614927774,63467.34051532488,True,False,65426.637,65196.637,65196.637,65226.637,2024-04-19 14:45:00,True,2024-04-19 14:45:00,2024-04-22 04:21:37,2024-04-19 14:46:32,0.02,even,True,171.32,12416.070000000023,6,0,16,4
2024-04-24 23:15:00,63881.77,63968.637,63549.586,63863.938,3961,56422,0,2024-04-24 23:00:00,2024-04-24 23:00:00,-268.18101190475136,-612.112684043168,64042.937738095236,-0.0033291366356069524,-0.004896068512820458,64154.570416666706,62555.05831844092,62979.63367934318,62763.71292966485,63291.399784976806,-0.004891370272182859,-0.0033296580958575147,65750.64882683496,65544.16414529439,16.664188413538525,25.27980156854237,-351.1628921779746,64280.67409840295,64702.236181075925,64081.64197695217,-421.5620826729719,-397.4911306426111,396.1102157925789,-117.35739422086772,-126.91882834531134,-107.07721018236043,64616.39076827215,63545.39318563219,False,True,63163.938,64313.938,63393.938,63363.938,,False,2024-04-25 16:15:00,2024-04-25 16:04:06,2024-04-25 00:20:35,0.02,fail,False,-164.07,12252.000000000024,0,1,17,4
2024-04-29 00:30:00,63612.406,63637.738,63538.613,63604.039,957,56422,0,2024-04-29 00:00:00,2024-04-29 00:00:00,40.49149999998917,-117.64044354184443,63800.37174999993,0.0008386391673416846,-0.0018083937973502342,63803.72994047621,63755.95670082692,63481.40793333562,63717.159002993794,63595.83401385654,-0.0018082708608720892,0.0008666434875826363,64329.1765946681,64052.671676324186,10.91273036732172,24.756828394518454,-104.16303998804871,63766.57484355883,63828.982290467684,63732.86606879942,-62.40744690885185,-44.71156729278509,179.6572136555551,-62.74271276232321,-64.67527003774012,-66.47678740978881,63975.40330723442,63488.82883036442,False,True,62904.039,64054.039,63134.039,63104.039,,False,2024-04-29 02:15:00,2024-04-29 01:32:37,2024-04-30 02:07:19,0.02,success,True,255.15,12507.150000000023,1,0,18,4
2024-04-30 01:15:00,63117.84,63463.738,63117.398,63463.738,2833,36422,0,2024-04-30 01:00:00,2024-04-30 01:00:00,-25.396904761924816,41.00661362289975,63250.87239285719,0.00012381697023491255,0.001893728325766378,62955.28125000002,62547.62170051081,64401.48879501318,63304.6324421766,63148.22044320266,-0.00010547608467584443,0.00213910307674493,63331.4918250564,62966.13386511983,93.54522856995595,84.77653283842822,-74.40837377539113,63019.26527740795,62902.89563470043,63091.75120708637,116.36964270751923,80.29435603821639,178.8045756954373,118.22296250428917,55.598775369813666,53.5409060887323,63334.63738427521,62850.365029897526,True,False,64163.738,63013.738,63933.738,63963.738,,False,2024-04-30 03:45:00,2024-04-30 02:08:12,2024-04-30 11:12:29,0.02,success,True,255.15,12762.300000000023,2,0,18,4
2024-04-30 01:30:00,63463.738,63857.738,63455.84,63702.383,3076,36422,0,2024-04-30 01:00:00,2024-04-30 01:00:00,-25.396904761924816,41.00661362289975,63250.87239285719,0.00012381697023491255,0.001893728325766378,62955.28125000002,62547.62170051081,64401.48879501318,63304.6324421766,63148.22044320266,-0.00010547608467584443,0.00213910307674493,63331.4918250564,62966.13386511983,94.58681204570917,91.12504428940834,-74.40837377539113,63124.36031165288,62962.11692101892,63235.131148606764,162.24339063396474,96.68416295736606,238.84407089056268,143.37994152039755,118.22296250428917,55.598775369813666,63559.070644309024,62912.691652904505,True,False,64402.383,63252.383,64172.383,64202.383,,False,2024-04-30 04:00:00,2024-04-30 03:47:24,2024-04-30 05:02:48,0.02,success,True,255.15,13017.450000000023,3,0,18,4
2024-04-30 01:45:00,63701.371,63907.738,63696.422,63837.75,2509,36422,0,2024-04-30 01:00:00,2024-04-30 01:00:00,-25.396904761924816,41.00661362289975,63250.87239285719,0.00012381697023491255,0.001893728325766378,62955.28125000002,62547.62170051081,64401.48879501318,63304.6324421766,63148.22044320266,-0.00010547608467584443,0.00213910307674493,63331.4918250564,62966.13386511983,94.40314544059625,94.17839535208707,-74.40837377539113,63234.1125713986,63026.97863057307,63394.9250299278,207.13394082552986,118.77411853099882,296.57789857971557,159.79388132103486,143.37994152039755,118.22296250428917,63796.80519301041,62994.544866845186,True,False,64537.75,63387.75,64307.75,64337.75,,False,2024-04-30 04:00:00,2024-04-30 03:53:18,2024-04-30 05:01:12,0.02,success,True,255.15,13272.600000000022,4,0,18,4
2024-04-30 11:00:00,63104.07,63202.137,62806.84,62806.84,2733,36422,0,2024-04-30 11:00:00,2024-04-30 11:00:00,-161.00157142851094,71.92300423669076,62769.97248809523,-0.003405986187519391,-0.0030322143872067047,63191.11864285715,60939.75904629156,62452.66865927894,62981.55696785078,62638.49879606783,-0.003032409440170368,-0.00013350301586401625,63342.69219345173,63153.765882055675,16.3508822080292,30.297003828294944,148.51791216766,63235.52544663663,63357.687451345264,63123.52101823187,-122.1620047086326,-74.90073811368603,216.77508821508462,-84.87685483309178,-27.31188338494394,-20.64212074304669,63416.16738732223,62829.37464914151,False,True,62106.84,62336.84,62336.84,62306.84,2024-04-30 11:45:00,True,2024-04-30 11:45:00,2024-04-30 11:45:21,,0.02,success,True,255.15,13527.750000000022,5,0,18,4
2024-04-30 11:15:00,62806.086,62930.539,62686.676,62713.238,3607,36422,0,2024-04-30 11:00:00,2024-04-30 11:00:00,-161.00157142851094,71.92300423669076,62769.97248809523,-0.003405986187519391,-0.0030322143872067047,63191.11864285715,60939.75904629156,62452.66865927894,62981.55696785078,62638.49879606783,-0.003032409440170368,-0.00013350301586401625,63342.69219345173,63153.765882055675,5.471272038040735,17.617920732876218,148.51791216766,63155.173531769455,63309.950454949314,63035.49247678023,-154.7769231798593,-90.87597512692068,256.835820680863,-88.0285414516402,-84.87685483309178,-27.31188338494394,63382.220834699394,62687.264118861065,False,True,62013.238,62243.238,62243.238,62213.238,2024-04-30 11:45:00,True,2024-04-30 11:45:00,2024-04-30 11:47:47,,0.02,success,True,255.16,13782.910000000022,6,0,18,4
2024-04-30 11:30:00,62713.238,62720.637,62115.137,62166.539,4934,36422,0,2024-04-30 11:00:00,2024-04-30 11:00:00,-161.00157142851094,71.92300423669076,62769.97248809523,-0.003405986187519391,-0.0030322143872067047,63191.11864285715,60939.75904629156,62452.66865927894,62981.55696785078,62638.49879606783,-0.003032409440170368,-0.00013350301586401625,63342.69219345173,63153.765882055675,2.4727304089054414,8.098294884991736,148.51791216766,63003.07591149723,63225.25331013825,62859.33247884413,-222.17739864101895,-117.13625982974034,349.613115832866,-176.15999793609808,-88.0285414516402,-84.87685483309178,63331.3101852185,62385.854772469764,False,True,61466.539,61696.539,61696.539,61666.539,2024-04-30 13:00:00,True,2024-04-30 13:00:00,2024-04-30 13:01:57,2024-04-30 13:04:26,0.02,success,True,255.16,14038.070000000022,7,0,18,4
2024-05-01 11:00:00,57459.238,57552.34,56903.887,57315.539,6246,36422,0,2024-05-01 11:00:00,2024-05-01 11:00:00,-801.8433809524722,-615.2814923076439,58265.97010714291,-0.008098775745034772,-0.0036274695627845606,59048.00489285712,54737.72590233091,58792.11886533356,55377.58244652382,59004.63853485079,-0.003627214537935917,-0.0073798926694545195,61255.40335442572,60177.47658271106,15.198839587879242,19.452738113906282,-465.9477805894979,58639.71824050239,59284.60504071143,58060.33945958035,-644.8868002090385,-358.14589174097046,932.7668190817269,-362.8553914688455,-390.41926659786986,-381.4430309597301,59319.57466534068,56799.60425382001,False,True,56615.539,57765.539,56845.539,56815.539,,False,2024-05-01 20:15:00,2024-05-01 11:21:44,2024-05-01 14:02:08,0.02,success,True,255.16,14293.230000000021,8,0,18,5
2024-05-01 18:30:00,57052.707,57115.738,56896.238,56938.938,3462,36422,0,2024-05-01 18:00:00,2024-05-01 18:00:00,150.75486904761783,-780.5742668881285,57360.78172619045,0.0002919691809240827,0.0008113432692887172,57576.56323809523,56699.50579191519,58568.67723432277,57375.98160564147,56730.55707067678,-0.004403921646662909,0.0015119510185505683,60321.77394387574,58957.74720600932,16.62653778584135,20.587168920307118,-751.7284658357264,57314.170939330834,57596.13066436086,57134.317023047835,-281.9597250300285,-260.72578841897996,353.2503096240321,-119.88510767114349,-94.88738183687383,-138.0070024079978,57611.204941040276,56655.929105055395,False,True,56238.938,57388.938,56468.938,56438.938,,False,,,2024-05-01 19:30:18,0.02,fail,False,-164.07,14129.160000000022,0,1,18,5
2024-05-03 16:00:00,60583.898,61219.852,60464.137,61105.871,5076,36422,0,2024-05-03 16:00:00,2024-05-03 16:00:00,475.787892857159,228.8093257573346,60391.74866666672,0.0023889232680241955,0.00540119906817123,59638.58669047622,59664.858550864745,63172.22256322686,58865.44847067139,61374.041423699826,0.00270406181080077,0.00018429573438297398,59220.73119994085,59365.16370485992,95.4379144467793,77.65819182582473,180.13416082286648,59777.709087521325,59527.89111073823,59897.49890780871,249.81797678309522,45.27208448447662,521.5703327887346,328.8955569314785,249.67877158589545,225.10080632951576,60603.1188570735,59193.378958543915,True,False,61805.871,60655.871,61575.871,61605.871,,False,2024-05-03 17:00:00,2024-05-03 16:36:04,,0.02,success,True,255.16,14384.320000000022,1,0,18,5
2024-05-03 23:15:00,62112.039,62827.84,62112.039,62702.184,4358,56422,0,2024-05-03 23:00:00,2024-05-03 23:00:00,-22.19461904761556,717.0418738593507,62193.302869047664,0.002935177627831447,0.002605052605718329,61909.61219047619,62457.09380298877,63822.21002870588,63080.13608881154,62247.712584998575,0.0001314822045859661,0.006132847496503674,59879.76806866837,60507.978588150145,89.511780033881,72.98646781325301,567.1705636396556,61942.85649638109,61592.06134242274,62013.21429102166,350.7951539583519,349.5500169431893,256.8096033371739,158.99438562097203,43.502102511127305,22.71206467148295,62361.40725552684,61666.52132651647,True,False,63402.184,62252.184,63172.184,63202.184,,False,2024-05-06 00:15:00,2024-05-06 00:00:06,2024-05-08 02:05:35,0.02,success,True,255.16,14639.480000000021,2,0,18,5
2024-05-03 23:30:00,62707.039,62923.207,62640.309,62877.738,3227,56422,0,2024-05-03 23:00:00,2024-05-03 23:00:00,-22.19461904761556,717.0418738593507,62193.302869047664,0.002935177627831447,0.002605052605718329,61909.61219047619,62457.09380298877,63822.21002870588,63080.13608881154,62247.712584998575,0.0001314822045859661,0.006132847496503674,59879.76806866837,60507.978588150145,93.84973950314463,85.96169527574263,567.1705636396556,62086.684420014775,61687.29665039142,62196.34734399722,399.38776962335396,359.51756747922224,338.7226915981905,183.13305297556508,158.99438562097203,43.502102511127305,62655.12297765478,61739.07171033967,True,False,63577.738,62427.738,63347.738,63377.738,,False,2024-05-06 00:15:00,2024-05-06 00:00:06,2024-05-08 02:02:27,0.02,success,True,255.16,14894.640000000021,3,0,18,5
2024-05-07 11:15:00,63783.938,64298.34,63766.637,64208.438,3182,36422,0,2024-05-07 11:00:00,2024-05-07 11:00:00,1.2905714285152499,23.363211270545435,63728.5445357143,0.0019163828519739145,0.0009946857677221674,63517.326761904726,63890.29494148048,64634.17729711203,63371.718966676286,63726.097864432566,-0.00031292159925818156,0.001145173481827608,62777.6552033767,63466.43106564496,86.21776032101256,85.14144886002475,11.166569343765083,63698.30249894449,63576.03751711788,63838.678716890274,122.26498182660725,61.68228448011346,262.50518693170005,106.9759982800606,37.24188888885692,-6.071916064705874,64194.56071924807,63484.29671453248,True,False,64908.438,63758.438,64678.438,64708.438,,False,,,2024-05-07 13:19:12,0.02,fail,False,-164.07,14730.570000000022,0,1,19,5
2024-05-08 02:15:00,62379.938,62403.34,62205.719,62291.039,3047,36422,0,2024-05-08 02:00:00,2024-05-08 02:00:00,-84.79584523811354,-189.07619596484437,62645.20172619047,-0.001744534231263162,-0.0020640907177696876,62877.598642857134,61758.29881777615,62417.60078640107,62015.806413038124,62372.0608247882,-0.002747964322153863,-0.0014424596436038613,62999.688280192546,63268.82028065411,18.032017021798595,31.83429754471146,-86.45193275181776,62783.506300565365,62994.28925608631,62674.3674678362,-210.78295552094642,-162.4826263499664,253.13634884009616,-109.79750498800422,-119.5232972136364,-30.94503061580326,63016.10153877033,62331.13339690207,False,True,61591.039,62741.039,61821.039,61791.039,,False,2024-05-08 23:30:00,2024-05-08 23:19:43,2024-05-08 05:23:34,0.02,fail,False,-164.07,14566.500000000022,0,2,19,5
2024-05-09 00:00:00,61512.121,61602.039,61412.414,61453.738,1748,56422,0,2024-05-09 00:00:00,2024-05-09 00:00:00,-306.3799880952647,-178.95816972754983,61799.38317857142,-0.0014734456638922748,-0.0012332839052201859,62062.336047619036,60919.62921495056,62182.99629736075,61166.35893664176,62638.371439847375,-0.00022702334860785572,-0.0008350436309035918,62577.279534802765,62385.092552096634,8.98709789389253,11.606766629093313,-141.93401632966808,61917.314149654405,62106.92904845672,61710.683372548985,-189.61489880231238,-81.26277286352197,336.3970989414751,-149.74157000340347,-146.52563880293746,-141.2778716890607,62164.81945611998,61255.04728897799,False,True,60753.738,60983.738,60983.738,60953.738,2024-05-09 02:30:00,True,2024-05-09 02:30:00,2024-05-09 13:59:52,2024-05-09 02:30:19,0.02,even,True,171.32,14737.820000000022,1,0,19,5
2024-05-09 18:15:00,61820.34,62235.637,61618.941,62147.688,3031,36422,0,2024-05-09 18:00:00,2024-05-09 18:00:00,139.84609523806284,-135.19429823690007,61566.59748809526,0.001371691811764004,0.0019146559282501624,61264.52819047617,61194.02087450874,62718.49766350025,60193.266899083304,61568.27135730429,-4.736957063454229e-05,-0.0007778157542094413,61961.22940297426,61609.233651809045,89.27126787142079,80.95811841927406,-198.2452394304672,61475.03896431118,61356.30444888124,61615.48049466801,118.73451542994007,19.839534147250543,298.2521921557085,131.6376900584437,107.11636773305509,46.7759356724855,62019.620954078215,61212.8400352578,True,False,62847.688,61697.688,62617.688,62647.688,,False,2024-05-10 01:30:00,2024-05-10 01:38:12,2024-05-09 20:01:14,0.02,fail,False,-164.07,14573.750000000022,0,1,19,5
2024-05-09 18:45:00,62055.82,62149.438,61883.938,62104.34,3041,36422,0,2024-05-09 18:00:00,2024-05-09 18:00:00,139.84609523806284,-135.19429823690007,61566.59748809526,0.001371691811764004,0.0019146559282501624,61264.52819047617,61194.02087450874,62718.49766350025,60193.266899083304,61568.27135730429,-4.736957063454229e-05,-0.0007778157542094413,61961.22940297426,61609.233651809045,90.65821996762112,89.92252473714815,-198.2452394304672,61648.073447820425,61460.0158992466,61822.4901895425,188.05754857382271,75.37215903978154,374.2889632260614,98.60069625044707,108.4089986240433,131.6376900584437,62329.28028989768,61317.20008918732,True,False,62804.34,62574.34,62574.34,62604.34,2024-05-10 00:15:00,True,2024-05-10 00:15:00,2024-05-10 01:37:05,2024-05-10 00:15:08,0.02,even,True,171.32,14745.070000000022,1,0,19,5
2024-05-09 19:00:00,62104.34,62457.738,62042.738,62395.707,3409,36422,0,2024-05-09 19:00:00,2024-05-09 19:00:00,302.06929761909123,-29.535653866150824,61725.56057142862,0.0025215065012673277,0.002989440977416621,61566.59748809526,61917.28764517905,63378.334229946515,61194.02087450874,62718.49766350025,0.0019146559282501624,0.001371691811764004,61955.147347955666,61624.98591966433,91.4725293492615,90.65627856309506,-164.50332231760393,61763.09399430959,61529.32635115426,61974.49103611969,233.76764315532637,107.05125586289051,432.5794320109517,152.0008465771898,98.60069625044707,108.4089986240433,62559.97326933447,61390.50880290491,True,False,63095.707,61945.707,62865.707,62895.707,,False,2024-05-10 01:45:00,2024-05-10 01:47:42,2024-05-09 19:55:03,0.02,fail,False,-164.07,14581.000000000022,0,1,19,5
2024-05-09 23:00:00,62400.047,62561.738,62328.406,62477.324,2354,36422,0,2024-05-09 23:00:00,2024-05-09 23:00:00,164.67623809519137,168.91944236867857,62392.1773452381,0.0032843526666486832,0.0015919477914556593,62196.324559523804,63075.38782323845,63426.04622249899,62868.00140282468,64019.29558600881,0.003140751699353401,0.0032842407276137435,62002.65205160116,61813.001145228256,80.66540580863422,70.75626768023592,-8.741995990644924,62205.10368181156,61993.94965006094,62240.059966288325,211.15403175062238,195.2537358815726,357.5372765341787,57.26945132443507,55.17361369111313,15.643685930466745,62724.23528960947,61757.38464296718,True,False,63177.324,62027.324,62947.324,62977.324,,False,2024-05-10 02:00:00,2024-05-10 01:47:46,2024-05-10 17:32:48,0.02,success,True,255.15,14836.150000000021,1,0,19,5
2024-05-09 23:45:00,62450.34,62593.34,62381.961,62551.84,1514,56422,0,2024-05-09 23:00:00,2024-05-09 23:00:00,164.67623809519137,168.91944236867857,62392.1773452381,0.0032843526666486832,0.0015919477914556593,62196.324559523804,63075.38782323845,63426.04622249899,62868.00140282468,64019.29558600881,0.003140751699353401,0.0032842407276137435,62002.65205160116,61813.001145228256,85.72626323850493,84.60657488923762,-8.741995990644924,62306.56388005971,62089.32238491095,62440.82785036114,217.241495148759,203.48840849330693,255.61217533114464,96.77395906431775,72.6016759545164,31.39224905397714,62787.40428705818,62095.75141366409,True,False,63251.84,62101.84,63021.84,63051.84,,False,2024-05-10 02:00:00,2024-05-10 01:48:23,2024-05-10 17:31:30,0.02,success,True,255.15,15091.300000000021,2,0,19,5
2024-05-10 00:00:00,62550.633,62761.738,62542.324,62607.738,1955,56422,0,2024-05-10 00:00:00,2024-05-10 00:00:00,195.85278571429808,222.81955484128412,62451.591190476174,0.0029613032484020504,0.00045335830533394493,62392.1773452381,63112.24002520206,62876.271541639384,63075.38782323845,63426.04622249899,0.0015919477914556593,0.0032843526666486832,62021.067186832486,61865.74009361,88.14612071638844,86.07265379554458,37.57031417574089,62352.898360050516,62127.723541584215,62529.11398727215,225.17481846630108,207.82569048790577,230.96309256210196,88.28613691101054,96.77395906431775,72.6016759545164,62842.41416223098,62217.31381231331,True,False,63307.738,62157.738,63077.738,63107.738,,False,2024-05-10 02:00:00,2024-05-10 01:52:12,2024-05-10 17:31:24,0.02,success,True,255.15,15346.45000000002,3,0,19,5
2024-05-10 01:30:00,62703.926,62975.039,62611.953,62931.867,2213,36422,0,2024-05-10 01:00:00,2024-05-10 01:00:00,59.4138452380721,245.73744606083346,62733.67330952378,0.0023868222613137656,0.0020727250886451282,62451.591190476174,63032.02706157137,63937.74037411526,63112.24002520206,62876.271541639384,0.00045335830533394493,0.0029613032484020504,62068.65431676062,61975.24400612121,87.0188940778309,76.50519770323575,79.20374055275941,62538.03213164089,62309.8734450879,62701.93794289646,228.15868655298982,210.23699093743357,281.6086928145143,79.9498145854086,33.47793429654848,27.400298589636805,63083.60967819605,62321.76620759687,True,False,63631.867,62481.867,63401.867,63431.867,,False,,,2024-05-10 17:11:25,0.02,fail,False,-164.07,15182.380000000021,0,1,19,5
2024-05-10 01:45:00,62928.895,63403.242,62881.84,63234.539,2898,36422,0,2024-05-10 01:00:00,2024-05-10 01:00:00,59.4138452380721,245.73744606083346,62733.67330952378,0.0023868222613137656,0.0020727250886451282,62451.591190476174,63032.02706157137,63937.74037411526,63112.24002520206,62876.271541639384,0.00045335830533394493,0.0029613032484020504,62068.65431676062,61975.24400612121,90.94164637769661,84.93051764092813,79.20374055275941,62645.18703446537,62378.367189896206,62822.26447884423,266.8198445691669,221.55356166378027,338.0641056381218,120.32653594776639,79.9498145854086,33.47793429654848,63280.15102145569,62365.87793623276,True,False,63934.539,62784.539,63704.539,63734.539,,False,,,2024-05-10 03:16:18,0.02,fail,False,-164.07,15018.310000000021,0,2,19,5
2024-05-10 17:15:00,62515.637,62584.34,62164.039,62171.738,3390,36422,0,2024-05-10 17:00:00,2024-05-10 17:00:00,-68.29349999999249,168.53532825691946,62357.498678571406,-0.005345024571776764,0.0002657026437335487,63027.03661904762,59343.385358288986,63529.255183600755,62796.32876341218,63512.91595342937,0.00026574160300352786,0.00016077855890432965,62418.83457210145,62560.449097369885,13.40172335449342,16.68456282829919,224.68371852466743,62792.271561089685,62883.28771937748,62745.76903061581,-91.01615828779177,-4.115671282435796,223.17117186830043,-141.6823360852286,-81.97803680774814,-24.26128723767033,63047.05011263802,62442.9879485936,False,True,61471.738,62621.738,61701.738,61671.738,,False,2024-05-10 18:00:00,2024-05-10 17:49:07,2024-05-13 11:13:04,0.02,success,True,255.15,15273.460000000021,1,0,19,5
2024-05-10 17:30:00,62168.238,62274.438,61684.609,61779.34,4290,36422,0,2024-05-10 17:00:00,2024-05-10 17:00:00,-68.29349999999249,168.53532825691946,62357.498678571406,-0.005345024571776764,0.0002657026437335487,63027.03661904762,59343.385358288986,63529.255183600755,62796.32876341218,63512.91595342937,0.00026574160300352786,0.00016077855890432965,62418.83457210145,62560.449097369885,5.147447066670607,12.577805046234436,224.68371852466743,62636.435936306654,62801.5138142384,62527.403540419706,-165.07787793174793,-36.30811261229823,322.53769593142783,-218.36549019610538,-141.6823360852286,-81.97803680774814,62962.82942992714,62090.477650912275,False,True,61079.34,62229.34,61309.34,61279.34,,False,2024-05-10 18:00:00,2024-05-10 17:52:24,2024-05-13 10:54:03,0.02,success,True,255.15,15528.61000000002,2,0,19,5
2024-05-10 17:45:00,61764.98,61775.238,60631.938,61016.539,5746,36422,0,2024-05-10 17:00:00,2024-05-10 17:00:00,-68.29349999999249,168.53532825691946,62357.498678571406,-0.005345024571776764,0.0002657026437335487,63027.03661904762,59343.385358288986,63529.255183600755,62796.32876341218,63512.91595342937,0.00026574160300352786,0.00016077855890432965,62418.83457210145,62560.449097369885,6.600055102039654,8.383075174401142,224.68371852466743,62387.22102302871,62669.29345762815,62196.0228403853,-282.07243459943857,-85.46097700972629,495.4811376973497,-331.38070003440225,-218.36549019610538,-141.6823360852286,62864.92237627673,61525.62330449388,False,True,60316.539,61466.539,60546.539,60516.539,,False,2024-05-10 20:30:00,2024-05-10 19:05:50,2024-05-13 02:47:20,0.02,success,True,255.1,15783.710000000021,3,0,19,5
2024-05-13 10:45:00,61692.848,62407.738,61603.969,62278.34,3076,36422,0,2024-05-13 10:00:00,2024-05-13 10:00:00,108.55994047618151,-163.41432596047525,61467.99639285717,8.458062161234234e-05,0.0014702326338301768,61076.181833333336,60773.75025573466,62779.46855486216,59960.581489748976,61359.8873668922,-0.0006623595714837264,-0.0018190226984060344,61786.50708711366,61525.80935636841,93.78490479515536,89.3990153167257,-244.44093618207205,61471.25320847236,61296.2718164436,61635.31021052626,174.9813920287561,48.762306845620664,349.74610082518024,186.18476883383846,94.03476264186611,109.49662469901523,62108.96744664025,61163.15297441227,True,False,62978.34,61828.34,62748.34,62778.34,,False,2024-05-13 11:45:00,2024-05-13 11:44:19,2024-05-14 09:12:34,0.02,success,True,255.09,16038.800000000021,4,0,20,5
2024-05-13 11:00:00,62278.184,62635.539,62278.184,62621.637,3796,36422,0,2024-05-13 11:00:00,2024-05-13 11:00:00,391.8145595238311,-20.624709505049395,61964.986559523764,0.0002644468828900547,0.0036158683971669043,61467.99639285717,60845.066030386144,64012.75519453353,60773.75025573466,62779.46855486216,0.0014702326338301768,8.458062161234234e-05,61823.555358207246,61622.243647858944,96.2846784177021,92.72844652959145,-199.67769084666753,61648.235330245836,61394.44701522555,61872.5732077743,253.78831502028333,89.7675084805532,454.186665630888,237.26299724804267,186.18476883383846,94.03476264186611,62487.225206376,61259.4212091726,True,False,63321.637,62171.637,63091.637,63121.637,,False,2024-05-13 19:30:00,2024-05-13 19:25:53,2024-05-14 09:09:54,0.02,success,True,255.08,16293.880000000021,5,0,20,5
2024-05-15 20:15:00,64943.84,65011.238,64737.242,65006.637,1838,36422,0,2024-05-15 20:00:00,2024-05-15 20:00:00,282.3506190477274,732.4929734190955,64883.17896428574,0.007420509266289179,0.004621869377738188,64592.44233333337,66701.16079431014,67067.46982348445,66262.32521198387,67617.4894211055,0.0064316261405965545,0.007525848587579968,62534.20566710137,62982.76040814725,83.91501968606534,80.73986835716146,434.9273244441191,64656.09931532305,64103.60267687406,64998.001530099704,552.496638448989,571.5019163784364,899.0738092591175,38.025040591666766,38.03738665286073,-66.32103611968341,66213.25117259951,63784.251887599894,True,False,65706.637,64556.637,65476.637,65506.637,,False,2024-05-15 22:00:00,2024-05-15 21:57:45,2024-05-16 20:38:07,0.02,success,True,255.09,16548.97000000002,6,0,20,5
2024-05-15 20:30:00,65000.461,65076.039,64902.602,65047.238,1897,36422,0,2024-05-15 20:00:00,2024-05-15 20:00:00,282.3506190477274,732.4929734190955,64883.17896428574,0.007420509266289179,0.004621869377738188,64592.44233333337,66701.16079431014,67067.46982348445,66262.32521198387,67617.4894211055,0.0064316261405965545,0.007525848587579968,62534.20566710137,62982.76040814725,93.12944745943219,85.87197952193446,434.9273244441191,64716.27449758104,64173.50158969821,65021.0321025112,542.7729078828343,565.7561146793159,853.6021216498197,23.030572411495086,38.025040591666766,38.03738665286073,66174.89496673846,63868.66923828394,True,False,65747.238,64597.238,65517.238,65547.238,,False,2024-05-15 22:00:00,2024-05-15 21:58:18,2024-05-16 20:37:19,0.02,success,True,255.09,16804.06000000002,7,0,20,5
2024-05-15 21:15:00,65151.34,65312.855,65010.039,65273.039,2420,36422,0,2024-05-15 21:00:00,2024-05-15 21:00:00,290.73663095237134,780.558017302792,65262.59751190472,0.006671370679767806,0.0035593240129993134,64883.17896428574,66696.99427163642,66733.5809478466,66701.16079431014,67067.46982348445,0.004621869377738188,0.007420509266289179,62657.053915450335,63197.48645549547,94.93310253733671,94.60696699669222,504.0534630158537,64888.031776185875,64373.47373119111,65185.33822566215,514.5580449947665,542.2823147047819,615.7804392742091,56.38609700718371,66.34229067766864,41.57773546609678,66018.14181868233,64354.03463264197,True,False,65973.03899999999,65743.03899999999,65743.03899999999,65773.03899999999,2024-05-15 22:30:00,True,2024-05-15 22:30:00,2024-05-15 22:39:27,2024-05-15 23:03:47,0.02,success,True,255.09,17059.15000000002,8,0,20,5
2024-05-15 21:30:00,65281.238,65423.738,65233.453,65366.738,2466,36422,0,2024-05-15 21:00:00,2024-05-15 21:00:00,290.73663095237134,780.558017302792,65262.59751190472,0.006671370679767806,0.0035593240129993134,64883.17896428574,66696.99427163642,66733.5809478466,66701.16079431014,67067.46982348445,0.004621869377738188,0.007420509266289179,62657.053915450335,63197.48645549547,96.00635434529242,95.39858819762516,504.0534630158537,64961.67888754189,64447.04886221399,65229.07148847609,514.6300253279041,536.7518568294064,504.6678653996599,43.73326281394111,56.38609700718371,66.34229067766864,65911.87310676563,64547.769870186545,True,False,66066.738,64916.738,65836.738,65866.738,,False,2024-05-15 22:45:00,2024-05-15 22:40:21,2024-05-16 20:23:03,0.02,success,True,255.09,17314.24000000002,9,0,20,5
2024-05-15 22:30:00,65824.516,66364.039,65781.836,66342.734,2795,36421,0,2024-05-15 22:00:00,2024-05-15 22:00:00,379.4185476189814,870.4105780791215,65524.521297619074,0.00646926972067595,0.004466636449755446,65262.59751190472,66994.89893497498,67588.85929587448,66696.99427163642,66733.5809478466,0.0035593240129993134,0.006671370679767806,62785.85329131503,63417.002579055836,90.82659308443219,89.57319543535625,577.3248860285073,65417.47279144641,64823.92514925709,65714.23620536638,593.5476421893181,548.5717939997016,566.8044395712581,219.58994633646216,110.9943839009211,61.80369625039748,66480.92219878758,64949.050211945185,True,False,67042.734,65892.734,66812.734,66842.734,,False,2024-05-17 18:15:00,2024-05-17 18:22:07,2024-05-15 22:55:51,0.02,fail,False,-164.02,17150.22000000002,0,1,20,5
2024-05-17 18:00:00,66758.109,66901.734,66499.633,66844.734,3318,36421,0,2024-05-17 18:00:00,2024-05-17 18:00:00,151.0316428571823,232.9514039085043,66637.82895238097,-0.0007250219219081884,0.002044015546616939,66345.04140476194,65473.92615217785,67951.2505051115,65647.9400586557,67023.45011275311,0.0007630611086164795,-0.00034823300016879487,65372.2978204778,65962.61808838196,87.16072895358957,75.65761717827668,168.69125107278327,66354.4246857148,66225.84721453617,66360.14848366014,128.57747117862164,81.94102796286441,205.45405861629573,123.78570863434288,117.24818163053715,18.833136566943722,66639.01146279214,66082.78550452815,True,False,67544.734,66394.734,67314.734,67344.734,,False,2024-05-20 19:00:00,2024-05-20 19:01:38,2024-05-17 21:04:00,0.02,fail,False,-164.02,16986.20000000002,0,2,20,5
2024-05-20 08:00:00,67075.992,67251.734,67061.836,67088.133,2155,36421,0,2024-05-20 08:00:00,2024-05-20 08:00:00,258.5676666666841,135.46342181027285,66918.42974999997,0.0021306928453446025,0.001797946502022625,66758.45701190479,67143.23232927892,67750.39007974883,66390.79214083134,67593.00078717242,0.001744268168195142,0.000846007344565948,65924.72717165622,66451.43871404293,91.87132484650628,90.92785232846181,129.10254132200433,66757.95925939234,66614.83299536898,66907.80179084968,143.12626402336173,76.95752192928532,278.44098074044695,72.97123942209873,71.98643790853384,70.97478328170837,67285.19711484929,66531.90646685008,True,False,67788.133,66638.133,67558.133,67588.133,,False,2024-05-20 19:30:00,2024-05-20 19:04:11,2024-05-20 09:52:50,0.02,fail,False,-164.02,16822.18000000002,0,3,21,5
2024-05-20 19:30:00,67772.57,68206.102,67605.766,68200.438,2859,36421,0,2024-05-20 19:00:00,2024-05-20 19:00:00,135.00941666669678,161.49683496945363,67476.37504761906,7.511550924103373e-05,0.0022117465356473577,67122.85822619048,66729.25517061312,68831.90126558527,66695.24578389175,67580.45186551928,0.0004438009432589365,-9.647747424619833e-06,66326.39615605057,66842.63149374482,83.88077524584678,80.42832409521749,132.16562891435868,67380.76890472458,67163.00484948931,67545.29106295147,217.76405523526773,101.70565407484236,330.0220732680571,213.58189026487526,141.37875404195802,96.83652975573204,67992.32086186335,67099.76126403958,True,False,68900.438,67750.438,68670.438,68700.438,,False,2024-05-20 22:30:00,2024-05-20 22:22:04,2024-05-23 17:08:13,0.02,success,True,255.1,17077.280000000017,1,0,21,5
2024-05-20 20:00:00,68143.68,68410.961,67985.836,68343.938,2557,36421,0,2024-05-20 20:00:00,2024-05-20 20:00:00,353.51682142858044,270.6774531652336,67804.25804761903,0.0021675744641120945,0.0026759419098587012,67476.37504761906,67738.21837058022,69342.55677952824,66729.25517061312,68831.90126558527,0.0022117465356473577,7.511550924103373e-05,66402.66403228388,66956.91913424522,97.2973608853484,92.0205205159025,159.86799376453368,67628.89516847144,67318.07631403404,67896.63110767114,310.81885443739884,169.31618977762392,457.3771216135598,180.3950853113056,170.94495940837078,213.58189026487526,68515.59022184944,67279.17199349284,True,False,69043.938,67893.938,68813.938,68843.938,,False,2024-05-20 22:30:00,2024-05-20 22:22:46,2024-05-23 16:50:25,0.02,success,True,255.1,17332.380000000016,2,0,21,5
2024-05-22 13:30:00,70140.938,70233.734,70114.102,70219.039,1356,36421,0,2024-05-22 13:00:00,2024-05-22 13:00:00,63.40304761903826,-46.19880458024272,70038.18432142858,0.0015803546048002754,0.0004888817221947874,69921.15888095235,70343.90487745707,70461.90008069956,70080.8812013371,70124.57157147354,-0.0003467026751832861,0.0013443083343034825,69460.32680174829,69985.8624019766,82.96693583204468,72.11075631571688,-61.30962343555121,70026.76432589011,69974.78712343698,70088.4677963536,51.977202453126665,16.941044078147197,176.07966726035346,53.78775782592129,40.08095287242031,29.022530787653523,70327.67534715508,69850.76024555211,True,False,70919.039,69769.039,70689.039,70719.039,,False,,,2024-05-22 14:59:52,0.02,fail,False,-164.03,17168.350000000017,0,1,21,5
2024-05-22 14:00:00,70208.438,70302.336,70164.688,70214.453,1590,36421,0,2024-05-22 14:00:00,2024-05-22 14:00:00,117.0254404762236,-11.528555215729284,69986.36819047618,0.0010764350313997497,0.0007826375358619174,70038.18432142858,70059.58699944342,70645.09850428275,70343.90487745707,70461.90008069956,0.0004888817221947874,0.0015803546048002754,69471.76649579738,69967.15652981847,90.86932728737197,87.76632324266217,-51.35340979158683,70079.28933392132,70008.56558868053,70173.49199724797,70.72374524078623,35.0061414392977,141.43842571810634,40.73462951493275,44.28957137944235,53.78775782592129,70365.93387196741,69982.55012252853,True,False,70914.453,69764.453,70684.453,70714.453,,False,,,2024-05-22 14:59:52,0.02,fail,False,-164.03,17004.320000000018,0,2,21,5
2024-05-22 19:00:00,70469.836,70684.336,70309.445,70684.336,2188,36421,0,2024-05-22 19:00:00,2024-05-22 19:00:00,169.76929761901556,24.265594543190673,70131.3014285714,8.545338318756898e-05,0.0010212046982153017,70035.46334523805,69490.03744215966,70996.99747288888,69484.12628099453,70848.20028669709,0.0007595420253620787,8.547707267386311e-05,69574.75627502396,69997.81202691066,92.62838452189146,88.06692387152843,-40.20296070710266,70167.82176743653,70039.50796242061,70255.43848538009,128.31380501591775,26.56818543498279,302.3893845334955,155.09721947029175,124.29514275879774,151.3829074647074,70665.16415450031,69847.21281625987,True,False,71384.336,70234.336,71154.336,71184.336,,False,,,2024-05-22 19:42:29,0.02,fail,False,-164.03,16840.29000000002,0,3,21,5
2024-05-23 21:00:00,67643.773,67695.734,67053.836,67185.734,3608,36421,0,2024-05-23 21:00:00,2024-05-23 21:00:00,-259.5194761903549,-496.2751720242086,67466.74384523815,-0.003074065158895286,-0.005713584539871847,67701.8643928572,65908.22377217314,66174.33344736327,65821.09470747088,66552.25821225294,-0.00571338058758043,-0.003614045269562645,69193.52294289085,68922.17904532325,19.018810357495603,33.6990845981551,-278.44863645084854,67908.35731087692,68328.02690522357,67784.01831269352,-419.6695943466475,-396.21049740887014,787.6015509506773,-92.4713212934148,18.744087719300296,55.20840488480462,68847.28040647693,66719.2562189101,False,True,66485.734,67635.734,66715.734,66685.734,,False,,2024-05-23 23:00:37,2024-05-23 22:34:58,0.02,fail,False,-164.03,16676.26000000002,0,4,21,5
2024-05-23 21:15:00,67182.734,67255.336,66747.438,67054.195,3578,36421,0,2024-05-23 21:00:00,2024-05-23 21:00:00,-259.5194761903549,-496.2751720242086,67466.74384523815,-0.003074065158895286,-0.005713584539871847,67701.8643928572,65908.22377217314,66174.33344736327,65821.09470747088,66552.25821225294,-0.00571338058758043,-0.003614045269562645,69193.52294289085,68922.17904532325,11.711444685331557,22.437303819315247,-278.44863645084854,67776.94772458817,68233.66898631811,67624.5599291365,-456.7212617299374,-408.3126502730836,759.5298537127006,-159.45838355700835,-92.4713212934148,18.744087719300296,68649.92523164865,66597.69462662436,False,True,66354.195,67504.195,66584.195,66554.195,,False,,2024-05-23 23:00:39,2024-05-23 22:30:56,0.02,fail,False,-164.03,16512.23000000002,0,5,21,5
2024-05-27 04:15:00,68745.648,68816.938,68741.234,68786.734,797,36421,0,2024-05-27 04:00:00,2024-05-27 04:00:00,-9.661059523830772,239.61338346617413,68750.03817857141,7.293064769551893e-05,0.00015813919032269235,68631.77021428567,68166.21169863839,69358.76196851608,67673.56791536909,68460.77781976345,-0.0013087212905743839,-0.0009327716721305582,68435.294751516,68350.42139902232,91.10591171133369,90.72475290303042,194.79261183867874,68669.54892678437,68614.52419408041,68687.12041038868,55.024732703954214,48.0368913465243,202.34400044104717,56.75162263496895,59.74186446508975,68.41951943591994,68961.7848109841,68413.95600979327,True,False,69486.734,68336.734,69256.734,69286.734,,False,2024-05-27 18:00:00,2024-05-27 17:54:29,2024-05-27 08:30:27,0.02,fail,False,-164.03,16348.20000000002,0,6,22,5
2024-05-27 08:15:00,68733.141,68752.141,68351.961,68356.734,1418,36421,0,2024-05-27 08:00:00,2024-05-27 08:00:00,-1.735059523867676,227.01546440311358,68820.69372619041,-6.461761188762631e-05,9.758987880094416e-05,68942.29422619042,68290.89174916121,69368.38512638885,69125.66115144039,70105.6644383411,0.001592259663133231,0.001308160183686776,68491.00328662788,68478.46554719182,1.7613541711364513,6.146840597101199,230.39033013151808,68786.6387196495,68797.08723480382,68751.45700550392,-10.448515154319466,61.85156210226187,246.45788137958667,-121.11822944616142,-60.66160130723438,-66.0061778465606,69084.17514536636,68417.23886564148,False,True,67656.734,68806.734,67886.734,67856.734,,False,2024-05-28 06:45:00,2024-05-28 07:29:18,2024-05-27 11:11:37,0.02,fail,False,-164.02,16184.18000000002,0,7,22,5
2024-05-27 18:00:00,69530.336,69931.734,69524.016,69907.234,2480,36421,0,2024-05-27 18:00:00,2024-05-27 18:00:00,276.5807738095318,152.07538964474224,69511.25061904767,0.00179211151271568,0.003343135550074994,68976.48598809521,69266.19130564835,71555.35716820908,68406.41031262038,69942.94731800987,0.0014310541377739272,0.0003002322836664539,68636.42455648308,68769.46449572229,93.9145832370379,89.60424092834852,98.47458221103294,69106.70660826164,68885.2612065583,69321.67588235295,221.4454017033422,99.3151884281896,362.7593909574907,193.78796525626967,135.74607430344622,85.88820571034739,69812.90106014557,68831.95070456034,True,False,70607.234,69457.234,70377.234,70407.234,,False,2024-05-27 19:15:00,2024-05-27 19:03:52,2024-05-27 22:48:47,0.02,success,True,255.1,16439.28000000002,1,0,22,5
2024-05-27 19:00:00,70403.234,70671.539,70393.852,70583.438,2379,36421,0,2024-05-27 19:00:00,2024-05-27 19:00:00,534.7646309524571,305.8607426538074,69875.93079761903,0.0034616216325448965,0.0045442475325270515,69511.25061904767,70325.35871708626,72240.5988916812,69266.19130564835,71555.35716820908,0.003343135550074994,0.00179211151271568,68698.00167191512,68884.43861606451,93.15503901456651,90.68491203590752,139.95181429958785,69702.52355749304,69260.95981900125,70154.09980976951,441.56373849179363,259.88432356556524,674.694588056075,210.5120381837187,216.92288923282467,247.72475679397758,71066.43750364521,69243.26211589381,True,False,71283.438,70133.438,71053.438,71083.438,,False,,,2024-05-27 20:23:11,0.02,fail,False,-164.02,16275.26000000002,0,1,22,5
2024-05-29 11:00:00,67979.641,68027.836,67658.844,67792.141,2225,36421,0,2024-05-29 11:00:00,2024-05-29 11:00:00,-250.36777380952844,10.450371108061518,68214.59440476193,-0.0014807931973500692,-0.001259929647143719,68451.82441666666,67206.81482114029,68248.24866960528,67767.04519567391,68958.99697056352,1.5796493028931533e-05,-0.0006818700096729304,68497.43721641808,68416.09220196688,9.383222346959606,9.455653055128685,45.715409498248626,68323.42221226126,68470.60435051227,68136.05738871689,-147.18213825100975,-40.86875623179696,299.59556492397144,-130.11309150318266,-118.5013770210935,-74.40321018232498,68540.51140136425,67730.10337606953,False,True,67092.141,68242.141,67322.141,67292.141,,False,2024-05-29 19:15:00,2024-05-31 19:06:34,2024-05-29 16:14:14,0.02,fail,False,-164.02,16111.24000000002,0,2,22,5
2024-05-29 18:45:00,67462.227,67600.438,67302.961,67402.836,2341,36421,0,2024-05-29 18:00:00,2024-05-29 18:00:00,-38.624940476205666,-173.29014814313268,67665.25895238093,-0.0006658421644137982,0.0006857491304327204,67814.34455952374,67119.30240330503,68598.35730170147,67473.75414505102,68094.13975879276,-0.0006193641929044939,-0.00021103271595074562,68325.11387417345,68133.7207113563,17.86893051073137,18.476665517142077,-99.47017635630232,67680.76922119208,67832.56590873316,67594.64634124523,-151.79668754107843,-122.08713726837601,182.8042136242356,-67.61672170623206,-66.6059453044727,-17.320156518777367,67841.43202963794,67346.36065285251,False,True,66702.836,67852.836,66932.836,66902.836,,False,2024-05-31 19:15:00,2024-05-31 19:19:02,2024-05-30 01:24:12,0.02,fail,False,-164.02,15947.22000000002,0,3,22,5
2024-05-29 19:00:00,67402.836,67421.938,67111.227,67231.836,2629,36421,0,2024-05-29 19:00:00,2024-05-29 19:00:00,-149.0856071428134,-214.5100582070736,67597.58432142861,-0.0012572962481391713,-0.00010129722620550954,67665.25895238093,66764.3970882773,68261.88299828328,67119.30240330503,68598.35730170147,0.0006857491304327204,-0.0006658421644137982,68295.86031048038,68089.35489444781,10.065077706893133,15.281952124138977,-122.47815272645659,67611.70257177792,67788.06739697515,67500.1406040591,-176.36482519723359,-132.94267485414753,218.31133150202234,-94.50573718613305,-67.61672170623206,-66.6059453044727,67794.86090158683,67203.92030653136,False,True,66531.836,67681.836,66761.836,66731.836,,False,,,2024-05-29 19:46:01,0.02,fail,False,-164.02,15783.200000000019,0,4,22,5
2024-05-30 14:15:00,67988.039,68135.836,67870.0,68109.109,1711,36421,0,2024-05-30 14:00:00,2024-05-30 14:00:00,15.88260714293574,2.5087294999684673,67777.10351190479,-0.001431264423805146,-0.0006690666776385765,67775.8368452381,66467.56033404764,67947.40053625198,66199.38351379587,67728.63282036976,-0.0010534727448335984,-0.0023243477468007766,68027.9384695795,67871.38059678362,91.77897929704234,86.07304592331354,-10.642959169778685,67848.38235669854,67827.48258487259,67860.53134778123,20.899771825948847,-31.924574615506042,238.4167675674297,84.51013381492521,73.53179738561448,63.87539972482773,68183.89398399726,67538.6687115652,True,False,68809.109,68579.109,68579.109,68609.109,2024-05-30 17:00:00,True,2024-05-30 17:00:00,2024-05-30 17:08:32,2024-05-30 17:03:09,0.02,even,True,171.28,15954.48000000002,1,0,22,5
2024-05-30 15:30:00,68046.336,68303.039,67881.914,68245.234,3022,36421,0,2024-05-30 15:00:00,2024-05-30 15:00:00,1.26666666669189,0.9893794060917571,67911.45511904759,0.0005499097297059743,0.0002921528725332511,67777.10351190479,67449.6994662614,68441.66405396769,66467.56033404764,67947.40053625198,-0.0006690666776385765,-0.001431264423805146,68033.04503939992,67894.32262904094,85.15661141425251,77.71833621253147,-8.316491454604597,67960.3867545541,67892.91777068697,68099.0059325766,67.46898386713292,19.545927490523606,234.26137655146135,38.703976608259836,44.33066838658124,67.8449786722922,68416.75879092109,67782.75307423213,True,False,68945.234,68715.234,68715.234,68745.234,2024-05-30 20:15:00,True,2024-05-30 20:15:00,2024-05-30 20:16:46,2024-05-30 22:37:28,0.02,success,True,255.1,16209.58000000002,2,0,22,5
2024-05-31 17:15:00,67836.039,67981.438,67691.836,67784.688,2951,36421,0,2024-05-31 17:00:00,2024-05-31 17:00:00,-46.08166666665056,-31.81138302803447,68076.4267380952,-0.00174475689280866,0.001782451915294794,68319.0125,66797.6748184965,69819.24748026508,68088.56222118312,69548.33715987977,0.0013689925150260115,0.00035895391804201325,68267.72506589738,68276.9643801446,5.672418158017289,19.013724284545784,-12.149016029520386,68273.41797092685,68327.15066101613,68328.54305366357,-53.73269008928037,18.256187786687654,277.6998842774024,-149.05846130021382,-137.7020856554591,-91.01336016507412,68703.43789743807,67952.14820988907,False,True,67084.688,67314.688,67314.688,67284.688,2024-05-31 19:00:00,True,2024-05-31 19:00:00,2024-05-31 19:06:34,2024-05-31 19:00:55,0.02,even,True,171.28,16380.86000000002,3,0,22,5
2024-05-31 17:30:00,67781.836,67880.836,67362.039,67365.141,2802,36421,0,2024-05-31 17:00:00,2024-05-31 17:00:00,-46.08166666665056,-31.81138302803447,68076.4267380952,-0.00174475689280866,0.001782451915294794,68319.0125,66797.6748184965,69819.24748026508,68088.56222118312,69548.33715987977,0.0013689925150260115,0.00035895391804201325,68267.72506589738,68276.9643801446,3.6976938245468793,8.05609484430647,-12.149016029520386,68133.68305232273,68255.89068612605,68127.66096800825,-122.2076338033221,-9.836576531314297,334.52722508566217,-200.88208565532113,-149.05846130021382,-137.7020856554591,68579.27272187389,67674.54921414261,False,True,66665.141,66895.141,66895.141,66865.141,2024-05-31 19:15:00,True,2024-05-31 19:15:00,,2024-05-31 19:15:23,0.02,even,True,171.28,16552.14000000002,4,0,22,5
2024-06-03 04:45:00,68188.172,68601.438,68175.453,68503.234,1878,36421,0,2024-06-03 04:00:00,2024-06-03 04:00:00,15.993392857097206,-79.4513258827501,68101.16863095232,0.0010580701220644579,0.0013912548430004238,67883.06966666666,67991.64980297213,68996.5545328842,67919.07887979271,68104.7087642911,0.00011941369812639525,0.0010581574625881456,68076.53035564342,67975.44535691295,83.17441925821548,79.24748437820553,-139.84837921271333,68048.71938023056,67914.37149233505,68101.4970732714,134.34788789550657,78.59247655089581,199.35556483236255,104.10298039217014,54.90372205020685,57.3344341244665,68372.12708579509,67832.36706074771,True,False,69203.234,68973.234,68973.234,69003.234,2024-06-03 09:30:00,True,2024-06-03 09:30:00,2024-06-03 09:38:46,2024-06-03 10:25:02,0.02,success,True,255.1,16807.24000000002,5,0,23,6
2024-06-03 05:00:00,68503.234,68762.438,68503.234,68715.734,2066,36421,0,2024-06-03 05:00:00,2024-06-03 05:00:00,218.09896428565844,9.611557821845054,68241.78445238093,0.0007626130357396273,0.0016697370945050146,68101.16863095232,67940.32650961328,69306.4584598483,67991.64980297213,68996.5545328842,0.0013912548430004238,0.0010580701220644579,68090.86802797114,68012.78100835992,87.367591418468,83.73024259958711,-109.95639180580166,68151.33701404124,67973.731678088,68238.44342414863,177.60533595323795,98.39504843136424,253.30991793810065,136.94635087723145,104.10298039217014,54.90372205020685,68581.91181336506,67896.4750349322,True,False,69415.734,68265.734,69185.734,69215.734,,False,2024-06-03 11:30:00,2024-06-03 15:22:33,2024-06-03 06:04:01,0.02,fail,False,-164.03,16643.21000000002,0,1,23,6
2024-06-03 09:15:00,68855.797,69130.336,68767.438,69130.336,1854,36421,0,2024-06-03 09:00:00,2024-06-03 09:00:00,139.35941666668805,172.68307113315677,68820.73459523807,0.0024991208405626395,0.0017922496680148744,68597.37405952379,69359.34205093911,69841.62938801083,69167.00118353742,69989.71922310592,0.002341372303202152,0.0024701232619323862,68181.15886760526,68211.5016958834,93.30379982954891,88.52204824466916,29.515681762977557,68667.06228920267,68445.3569873972,68734.33231888546,221.70530180547212,180.99033851110346,334.7718160961202,109.37084210524336,41.01997007225873,28.365664946759352,69187.77427061522,68282.39036715569,True,False,69830.336,69600.336,69600.336,69630.336,2024-06-03 15:45:00,True,2024-06-03 15:45:00,2024-06-03 16:31:22,2024-06-03 15:46:40,0.02,even,True,171.28,16814.49000000002,1,0,23,6
2024-06-03 09:30:00,69130.336,69236.734,68982.938,69186.789,2049,36421,0,2024-06-03 09:00:00,2024-06-03 09:00:00,139.35941666668805,172.68307113315677,68820.73459523807,0.0024991208405626395,0.0017922496680148744,68597.37405952379,69359.34205093911,69841.62938801083,69167.00118353742,69989.71922310592,0.002341372303202152,0.0024701232619323862,68181.15886760526,68211.5016958834,96.10584809505359,93.40676326610183,29.515681762977557,68747.02024470996,68500.27787721963,68864.00444822838,246.7423674903257,194.1407443069479,332.4156859851988,129.6721293429291,109.37084210524336,41.01997007225873,69314.2656243084,68415.24327214836,True,False,69886.789,69656.789,69656.789,69686.789,2024-06-03 16:00:00,True,2024-06-03 16:00:00,2024-06-03 16:32:44,2024-06-03 16:03:04,0.02,even,True,171.28,16985.77000000002,2,0,23,6
2024-06-03 11:15:00,69059.734,69325.039,69059.734,69294.438,1585,36421,0,2024-06-03 11:00:00,2024-06-03 11:00:00,81.43035714281723,258.18486876359384,68999.5622619048,0.002297954734718304,0.0014715895015152314,68902.16495238089,69594.15033448566,69864.9352166681,69532.48490956442,69761.91336034838,0.0014716730825879705,0.002499082376859927,68247.79478705123,68340.32937779572,80.09879726259021,72.22282620187998,108.38979687013016,68968.57072176135,68732.68191484571,69194.29258617133,235.88880691563827,227.348272925945,309.7396928418769,63.14349088410381,32.50560749915894,7.316216718187206,69613.94117150786,68776.1440008348,True,False,69994.438,68844.438,69764.438,69794.438,,False,2024-06-03 16:45:00,2024-06-03 16:44:42,2024-06-03 17:55:16,0.02,success,True,255.1,17240.870000000017,3,0,23,6
2024-06-03 11:30:00,69294.438,69366.734,69246.719,69318.734,1873,36421,0,2024-06-03 11:00:00,2024-06-03 11:00:00,81.43035714281723,258.18486876359384,68999.5622619048,0.002297954734718304,0.0014715895015152314,68902.16495238089,69594.15033448566,69864.9352166681,69532.48490956442,69761.91336034838,0.0014716730825879705,0.002499082376859927,68247.79478705123,68340.32937779572,89.68790587892151,80.1222424442165,108.38979687013016,69022.44199533653,68776.09318041269,69243.2943147575,246.3488149238401,231.14838132552404,331.40327638342677,49.00172858616861,63.14349088410381,32.50560749915894,69692.18873787513,68795.89989163987,True,False,70018.734,68868.734,69788.734,69818.734,,False,2024-06-03 16:45:00,2024-06-03 16:44:54,2024-06-03 14:02:49,0.02,fail,False,-164.03,17076.84000000002,0,1,23,6
2024-06-04 21:15:00,70776.734,71103.563,70776.734,70960.734,2149,36421,0,2024-06-04 21:00:00,2024-06-04 21:00:00,245.9138214285631,400.5028463396884,70717.41627380946,0.003782798257202032,0.005498500174079878,70511.3521904762,71383.65671254687,73490.5844298354,71067.19411485364,72862.4320328899,0.00490308156670176,0.00367685747471115,69131.14632291303,69517.26264951249,82.59112994051593,75.21977283322612,174.50669824619902,70553.87467089266,70156.14834426626,70921.39501788784,397.72632662640535,384.64595172976334,649.0751863434969,57.15429618152848,43.21389748888032,15.226939112559194,71799.14651945156,70045.14351632413,True,False,71660.734,70510.734,71430.734,71460.734,,False,2024-06-05 18:30:00,2024-06-05 18:36:18,2024-06-04 22:29:12,0.02,fail,False,-164.03,16912.81000000002,0,2,23,6
2024-06-06 23:00:00,70507.555,70518.641,70074.133,70424.641,2021,36421,0,2024-06-06 23:00:00,2024-06-06 23:00:00,-227.42748809524346,-55.49284500509384,70802.3150714286,-0.0018901297540171698,-0.0020541606937807973,70909.6387142857,69524.41614778925,70358.53440091685,70120.857640581,70951.58668859015,-0.0012784165037178137,-0.0012060176575562512,70789.90055016705,71018.98747630615,19.909722382355948,20.40267273892212,11.063209409036931,70854.20959334553,70995.03116863167,70748.5306105951,-140.82157528614334,-70.24481322821259,282.43158447551673,-72.34180839352484,-62.72189955275098,-44.87598658417119,71129.81324963705,70365.74797155315,False,True,69724.641,70874.641,69954.641,69924.641,,False,2024-06-07 21:00:00,2024-06-07 21:00:41,2024-06-07 01:56:00,0.02,fail,False,-164.03,16748.78000000002,0,3,23,6
2024-06-07 07:00:00,71012.539,71230.539,71010.836,71198.836,1233,36421,0,2024-06-07 07:00:00,2024-06-07 07:00:00,33.02452380952309,-38.73213189668604,71033.56444047616,8.839415605653303e-05,0.0008226123075444539,70924.74526190475,70720.41903181018,71525.38445531369,71168.1812910753,71121.77377772845,0.0002619166560402173,0.001386858780667982,70827.76624838656,70980.17439032668,87.00032698044588,84.900083469061,-50.65727221392941,70933.64238115387,70890.6836748783,70963.53787891295,42.958706275574514,2.5763655662376284,99.40758141590464,64.71617750257428,30.941499139968073,26.88222497420793,71099.23811382442,70829.33764400147,True,False,71898.836,71668.836,71668.836,71698.836,2024-06-07 15:00:00,True,2024-06-07 15:00:00,2024-06-07 15:01:48,2024-06-07 15:24:10,0.02,success,True,255.1,17003.88000000002,1,0,23,6
2024-06-07 13:00:00,71313.336,71396.734,71288.0,71376.141,742,36421,0,2024-06-07 13:00:00,2024-06-07 13:00:00,35.07441666669911,69.48107360432914,71296.1431666667,0.0007641914883663439,-4.764415268983897e-06,71264.30648809523,71363.92720225666,71454.61010685349,71322.10947306876,71674.43278027071,0.00037039947290944987,0.0008069688603398929,70920.34853472223,71091.89700752187,81.59158516539928,64.52203856200718,25.644916019218016,71231.06493874882,71173.09632060699,71218.2073904369,57.96861814183649,53.882960835311835,77.26275526776332,43.80010939114436,27.94947712426074,1.7759267285000533,71324.01211004838,71113.90267082542,True,False,72076.141,71846.141,71846.141,71876.141,2024-06-07 15:15:00,True,2024-06-07 15:15:00,,2024-06-07 15:22:10,0.02,even,True,171.28,17175.160000000018,2,0,23,6
2024-06-07 14:45:00,71557.938,71749.305,71557.938,71731.734,1487,36421,0,2024-06-07 14:00:00,2024-06-07 14:00:00,31.836678571475204,86.92001950454141,71434.63255952376,0.00019707394001980242,0.0006803155309827209,71296.1431666667,71168.1647979867,71953.66394417855,71363.92720225666,71454.61010685349,-4.764415268983897e-06,0.0007641914883663439,70952.16757257626,71143.08396692012,91.17960238124897,85.88382894684433,37.899936716282696,71406.11034980514,71292.75179164273,71500.32611592706,113.35855816240655,77.49805734701808,142.63281695557507,89.80949432410125,55.55494530434953,38.086945304399705,71694.38041881709,71307.77181303703,True,False,72431.734,71281.734,72201.734,72231.734,,False,,,2024-06-07 15:30:10,0.02,fail,False,-164.03,17011.13000000002,0,1,23,6
2024-06-07 15:00:00,71731.734,71981.734,71726.641,71905.938,2289,36421,0,2024-06-07 15:00:00,2024-06-07 15:00:00,138.48939285705274,135.21573470706062,71401.08713095236,-0.0010616003953520207,0.001149665451842367,71434.63255952376,70337.47435571242,72380.91241103393,71168.1647979867,71953.66394417855,0.0006803155309827209,0.00019707394001980242,70963.84880502426,71151.6403695665,91.27971930323297,88.7297413509076,57.36309631443828,71483.00691137358,71338.1729922618,71602.15821121431,144.83391911178478,90.96522969997142,189.77724019763886,101.83209528724547,89.80949432410125,55.55494530434953,71859.85748548112,71345.9589369475,True,False,72605.938,71455.938,72375.938,72405.938,,False,,,2024-06-07 15:30:10,0.02,fail,False,-164.03,16847.10000000002,0,2,23,6
2024-06-07 20:30:00,70465.539,70555.641,70261.938,70286.836,1768,36421,0,2024-06-07 20:00:00,2024-06-07 20:00:00,-187.9939285715227,24.407475151499966,70689.42297619041,-0.002400979660956522,-0.0024409425356683085,71200.01963095235,69114.04856000292,70442.75541980505,70595.15137211455,71535.94652922718,-0.0008500240826298222,-9.478719961393528e-05,70959.33576045292,71066.96448147712,4.151619654406411,8.189966270161596,74.290441566507,70889.16169964884,71089.09148442691,70679.3634183007,-199.929784778069,-93.3846708158921,397.2394338703612,-165.88655658751668,-140.92082628136268,-124.99773856210231,71215.63665402569,70141.5901825757,False,True,69586.836,70736.836,69816.836,69786.836,,False,2024-06-07 21:15:00,2024-06-07 21:01:09,,0.02,success,True,255.1,17102.20000000002,1,0,23,6
2024-06-07 20:45:00,70281.938,70415.938,69806.141,69819.438,2038,36421,0,2024-06-07 20:00:00,2024-06-07 20:00:00,-187.9939285715227,24.407475151499966,70689.42297619041,-0.002400979660956522,-0.0024409425356683085,71200.01963095235,69114.04856000292,70442.75541980505,70595.15137211455,71535.94652922718,-0.0008500240826298222,-9.478719961393528e-05,70959.33576045292,71066.96448147712,3.413212361460871,5.062152597081595,74.290441566507,70724.5888227798,70995.04307817307,70456.76288269692,-270.4542553932697,-128.7985877313676,482.85580993881723,-222.60053560377855,-165.88655658751668,-140.92082628136268,71108.61822611433,69803.4075392795,False,True,69119.438,70269.438,69349.438,69319.438,,False,2024-06-07 21:15:00,2024-06-07 21:04:59,,0.02,success,True,255.1,17357.300000000017,2,0,23,6
2024-06-07 21:00:00,69814.359,69906.539,68385.008,68530.594,6368,36421,0,2024-06-07 21:00:00,2024-06-07 21:00:00,-510.59665476193186,-135.30893049958104,70061.13339285717,-0.005431412620531923,-0.0029204422151777295,70689.42297619041,66862.89799866456,69969.5668726861,69114.04856000292,70442.75541980505,-0.0024409425356683085,-0.002400979660956522,70889.10047572928,70915.07420295896,2.4013478413290668,3.3220599523986927,32.3705671532894,70387.05115773674,70812.4912946047,70033.14157619535,-425.4401368679537,-188.12689755868485,703.0407955416608,-423.6213065015618,-222.60053560377855,-165.88655658751668,70982.2466501766,69082.5365022141,False,True,67830.594,68980.594,68060.594,68030.594,,False,2024-06-11 07:30:00,2024-06-11 07:26:26,2024-06-07 21:15:44,0.02,fail,False,-164.03,17193.27000000002,0,1,23,6
2024-06-11 04:45:00,69389.117,69453.438,68481.836,68723.234,2935,36421,0,2024-06-11 04:00:00,2024-06-11 04:00:00,-52.159976190450834,-62.85158267999941,69217.31329761907,-0.0022175293524732804,-0.0012247113307703268,69464.50908333335,67856.3353473811,69196.6785407575,68797.68990950701,69192.00048758708,-0.0013517956194359438,-0.0009504115902258844,69939.22028066432,69636.13354787562,18.44935312652835,27.869001470099686,-48.29178991180699,69371.09709009975,69486.56217457484,69309.45438906089,-115.46508447508677,-65.87510622038602,176.48392543106985,-142.61662229101057,-11.539972824219149,-6.847174406633712,69547.70768839284,69069.70108972894,False,True,68023.234,69173.234,68253.234,68223.234,,False,2024-06-11 05:30:00,2024-06-11 05:18:16,2024-06-12 15:31:00,0.02,success,True,255.1,17448.370000000017,1,0,24,6
2024-06-11 05:00:00,68721.836,68956.242,68521.422,68551.836,2442,36421,0,2024-06-11 05:00:00,2024-06-11 05:00:00,-247.19578571428428,-151.31487400707556,68870.62501190482,-0.003198029014858077,-0.0007361664303004536,69217.31329761907,66971.99737962922,69286.01732020144,67856.3353473811,69196.6785407575,-0.0012247113307703268,-0.0022175293524732804,69873.66815201082,69526.65414404558,9.722957484135183,19.37942706002794,-68.8964067308607,69245.05692239209,69417.3231986804,69151.7280894393,-172.26627628831193,-87.15334023397119,257.9140994131576,-157.7262996215868,-142.61662229101057,-11.539972824219149,69499.91212364707,68802.04405523154,False,True,67851.836,68081.836,68081.836,68051.836,2024-06-11 07:15:00,True,2024-06-11 07:15:00,2024-06-11 07:26:26,2024-06-11 07:15:40,0.02,even,True,171.28,17619.650000000016,2,0,24,6
2024-06-11 12:30:00,67385.836,67440.336,67160.406,67205.688,1962,36421,0,2024-06-11 12:00:00,2024-06-11 12:00:00,-78.40727380960016,-539.5584986022732,67381.2255714286,-0.0021041897842277568,-0.002685751318367547,67593.09497619045,66294.10487850805,66928.41205201118,66452.10904303589,66552.58852520953,-0.003959301021253795,-0.0020755318987062898,69347.22670690548,68712.32534859203,19.29294877842872,28.874654215433925,-377.167177130609,67544.16854399719,67845.19051859392,67397.5791320949,-301.02197459673334,-312.1212625016122,293.13453733297627,-68.81281286549347,-33.9985565875686,-7.725299277633894,67793.31075749443,67000.34750669538,False,True,66505.688,67655.688,66735.688,66705.688,,False,2024-06-11 18:45:00,2024-06-11 18:38:19,2024-06-12 12:54:30,0.02,success,True,255.1,17874.750000000015,3,0,24,6
2024-06-11 12:45:00,67205.844,67261.938,66869.836,67082.039,2488,36421,0,2024-06-11 12:00:00,2024-06-11 12:00:00,-78.40727380960016,-539.5584986022732,67381.2255714286,-0.0021041897842277568,-0.002685751318367547,67593.09497619045,66294.10487850805,66928.41205201118,66452.10904303589,66552.58852520953,-0.003959301021253795,-0.0020755318987062898,69347.22670690548,68712.32534859203,14.176575723144035,20.661702634175104,-377.167177130609,67473.07169107454,67788.66077647585,67313.23104987961,-315.58908540131233,-312.8148270815522,300.58789505824063,-84.34808221529238,-68.81281286549347,-33.9985565875686,67719.02470820824,66905.937391551,False,True,66382.039,67532.039,66612.039,66582.039,,False,2024-06-11 18:45:00,2024-06-11 18:40:58,2024-06-11 22:54:08,0.02,success,True,255.1,18129.850000000013,4,0,24,6
2024-06-12 16:00:00,69316.203,69641.039,69314.758,69361.539,2264,36421,0,2024-06-12 16:00:00,2024-06-12 16:00:00,587.3636428571481,290.294898885797,68774.16185714286,0.0019461681690745877,0.005097564121653589,68336.28533333335,68403.78480152713,71316.2888500545,68270.7749317464,70667.92949416437,0.004124108894412777,0.0019460162441316629,68117.83485975498,67806.41860604023,92.19762306022471,89.79681337522523,62.996131272477086,68400.92833876997,68000.86259240091,68710.14643412453,400.0657463690586,225.3998671600619,612.6178875933318,229.62223907806037,247.97597110428615,305.1081974544795,69538.68058237553,67883.11228587353,True,False,70061.539,69831.539,69831.539,69861.539,2024-06-12 18:00:00,True,2024-06-12 18:00:00,,2024-06-12 18:05:42,0.02,even,True,171.28,18301.130000000012,5,0,24,6
2024-06-13 05:00:00,67963.734,67987.039,67826.914,67898.234,1735,36421,0,2024-06-13 05:00:00,2024-06-13 05:00:00,28.830595238134265,-23.676673737558303,68091.87236904757,0.0010023386880995805,-0.0020651030907267525,68171.65545238099,67950.70938433068,67632.20427606712,68337.4045577577,67520.97855655532,-0.002962739364574353,0.0016613402393698116,68296.99347106724,68241.56712269303,19.395007563988695,24.67587133377883,145.67113940652828,68131.9834806573,68282.4942050624,68044.41103921572,-150.5107244050887,-144.3339763276341,187.98164182905768,-37.0598290333146,-45.87491159274941,-37.92871138625196,68298.18625568494,67789.1358227465,False,True,67198.234,68348.234,67428.234,67398.234,,False,2024-06-13 06:45:00,2024-06-13 06:37:18,2024-06-13 15:30:06,0.02,success,True,255.1,18556.23000000001,6,0,24,6
2024-06-13 06:15:00,67823.539,67837.734,67401.859,67419.141,2362,36421,0,2024-06-13 06:00:00,2024-06-13 06:00:00,-79.78308333341556,-88.07191684603458,67799.63284523813,-0.0009417316379855204,-0.001066225404567347,68091.87236904757,66680.29788021625,67907.63383082542,67950.70938433068,67632.20427606712,-0.0020651030907267525,0.0010023386880995805,68263.89325651558,68178.4767928776,12.176444547089416,17.769098916730645,98.92252815601572,67908.01294869372,68115.92648072948,67789.79382524939,-207.91353203576,-166.1585697827286,256.36074778229556,-106.22973099420778,-43.33565015481145,-67.94781286544458,68135.88083475549,67442.2068157433,False,True,66719.141,67869.141,66949.141,66919.141,,False,2024-06-13 18:45:00,2024-06-13 18:38:55,2024-06-13 13:55:17,0.02,fail,False,-164.03,18392.20000000001,0,1,24,6
2024-06-13 18:30:00,66957.039,67025.641,66496.039,66587.141,2874,36421,0,2024-06-13 18:00:00,2024-06-13 18:00:00,-111.7354642857099,-149.685643864781,67180.57990476192,-0.002031092857486006,0.001034451927676432,67551.42866666667,65786.59803898288,69079.6302752569,67099.84599267821,69646.77733022171,0.002537866907845472,-8.192344401007054e-05,67953.62518429046,67701.99286247145,6.233828652041346,11.195091214899582,-146.23392774260248,67312.86236078292,67479.60521714167,67150.01988132099,-166.74285635874548,-56.505783091445586,344.2722826514705,-180.77707911928883,-126.14027382187487,-91.34011799101427,67614.78746290047,66683.7522997415,False,True,65887.141,67037.141,66117.141,66087.141,,False,2024-06-14 19:15:00,2024-06-14 19:08:34,2024-06-13 20:02:37,0.02,fail,False,-164.03,18228.170000000013,0,2,24,6
2024-06-13 18:45:00,66586.039,66666.641,66337.273,66442.289,3263,36421,0,2024-06-13 18:00:00,2024-06-13 18:00:00,-111.7354642857099,-149.685643864781,67180.57990476192,-0.002031092857486006,0.001034451927676432,67551.42866666667,65786.59803898288,69079.6302752569,67099.84599267821,69646.77733022171,0.002537866907845472,-8.192344401007054e-05,67953.62518429046,67701.99286247145,4.125690021448306,6.701557830558284,-146.23392774260248,67178.92799758555,67402.76697883487,66969.29433677325,-223.83898124932603,-89.97242272302168,403.41790131790316,-180.7255445477349,-180.77707911928883,-126.14027382187487,67513.90850355242,66423.18016999408,False,True,65742.289,66892.289,65972.289,65942.289,,False,2024-06-14 19:15:00,2024-06-14 19:09:22,2024-06-13 19:57:31,0.02,fail,False,-164.03,18064.140000000014,0,3,24,6
2024-06-14 19:15:00,65827.336,65954.234,65269.738,65289.184,3589,36421,0,2024-06-14 19:00:00,2024-06-14 19:00:00,-218.52940476190997,-72.55714899518352,66264.38654761907,-0.0036579319895231562,-0.002224338242125839,66782.31570238095,64214.79146653539,66293.75919934524,66008.8061894453,67502.20751352858,0.000375630282483123,-0.0011290112576679344,67203.47729202782,66844.19059518924,8.484790655545718,13.15196537881551,-53.39068311061689,66446.72328098779,66702.02440818104,66232.59384107329,-255.30112719324825,-90.21676411080486,435.46445541503044,-285.7682855176972,-205.86579394564615,-111.34973787410127,66820.47085588358,65643.216826263,False,True,64589.184,65739.18400000001,64819.184,64789.184,,False,2024-06-18 04:45:00,2024-06-18 04:44:08,2024-06-14 23:27:59,0.02,fail,False,-164.03,17900.110000000015,0,4,24,6
2024-06-14 19:30:00,65291.539,65513.738,65181.84,65271.563,3418,36421,0,2024-06-14 19:00:00,2024-06-14 19:00:00,-218.52940476190997,-72.55714899518352,66264.38654761907,-0.0036579319895231562,-0.002224338242125839,66782.31570238095,64214.79146653539,66293.75919934524,66008.8061894453,67502.20751352858,0.000375630282483123,-0.0011290112576679344,67203.47729202782,66844.19059518924,8.365799549717394,9.451062645219963,-53.39068311061689,66265.92939160505,66596.06430387133,65981.39421878227,-330.13491226627957,-138.2003937418998,534.6505485086345,-251.19962229102384,-285.7682855176972,-205.86579394564615,66703.17245926893,65258.11597829561,False,True,64571.563,65721.563,64801.563,64771.563,,False,2024-06-18 04:45:00,2024-06-18 04:45:26,2024-06-14 20:40:07,0.02,fail,False,-164.03,17736.080000000016,0,5,24,6
2024-06-14 19:45:00,65266.633,65569.734,65181.84,65269.266,2863,36421,0,2024-06-14 19:00:00,2024-06-14 19:00:00,-218.52940476190997,-72.55714899518352,66264.38654761907,-0.0036579319895231562,-0.002224338242125839,66782.31570238095,64214.79146653539,66293.75919934524,66008.8061894453,67502.20751352858,0.000375630282483123,-0.0011290112576679344,67203.47729202782,66844.19059518924,3.0384076699091316,6.629665958390661,-53.39068311061689,66112.59656212735,66497.78294802901,65761.39650292402,-385.1863859016594,-187.59759217385175,611.7093417266196,-219.99771585824783,-251.19962229102384,-285.7682855176972,66587.20411425496,64934.088891593085,False,True,64569.266,65719.266,64799.266,64769.266,,False,2024-06-18 04:45:00,2024-06-18 04:45:26,2024-06-14 20:40:07,0.02,fail,False,-164.03,17572.050000000017,0,6,24,6
2024-06-17 21:00:00,66566.891,66966.938,66504.117,66833.336,2402,36421,0,2024-06-17 21:00:00,2024-06-17 21:00:00,344.2999285714104,-77.2450153879181,66313.07646428568,0.0002527967872746784,0.0026871782291680527,65837.84051190478,65211.34038641784,68009.3840600501,65194.70474060331,66973.70403113075,0.0014291926261306214,0.00025269471562855276,66438.4446777406,66109.98779738284,95.05833178622787,91.79368335731498,-167.35932422149008,66080.48265561943,65896.1203431563,66319.15792948059,184.36231246312673,31.207983177766284,399.4469388891446,189.4974447884888,181.47553147572035,165.19604334364703,66859.91129698094,65779.90456198023,True,False,67533.336,66383.336,67303.336,67333.336,,False,,,2024-06-17 23:05:08,0.02,fail,False,-164.03,17408.02000000002,0,7,25,6
2024-06-18 01:00:00,66521.734,66637.234,66445.75,66614.734,1034,56421,0,2024-06-18 01:00:00,2024-06-18 01:00:00,32.24765476191533,131.8772044123907,66701.91644047615,-0.010528712798280273,0.0008287491621695576,66682.01721428573,58021.26878651238,67715.752616822,59074.699054741286,69054.79166757093,0.0037014474036973764,-0.008714041954741097,66452.31225525594,66229.94308505961,89.1280804137097,88.03507721551266,-2.2550541427812725,66518.21831553042,66382.56402354849,66451.92579394564,135.65429198193306,170.7803019308173,408.5279584142258,-21.106005503985216,-74.40329721361923,-60.5579129687103,67003.43853780485,65898.91305008644,True,False,67314.734,66164.734,67084.734,67114.734,,False,,,2024-06-18 03:38:06,0.02,fail,False,-164.03,17243.99000000002,0,8,25,6
2024-06-18 14:15:00,65265.32,65305.637,65146.535,65148.738,1741,36422,0,2024-06-18 14:00:00,2024-06-18 14:00:00,-55.28438095240563,-151.1979106351937,65434.28278571432,-0.0005023796502550515,-0.0006135770523052831,65507.336499999976,64934.37583808011,65436.22987998831,65354.95524178135,65591.4075610419,-0.00036448247844357047,0.00019176443934352283,66078.12966427696,65755.53085143314,10.018324030611195,20.707509244083536,-132.1911589133356,65417.203893826256,65509.443223805654,65347.21196663223,-92.23932997939846,-57.89139743190029,145.4626931792419,-80.328596491192,-56.39167973860458,-34.04445132440742,65543.58660242421,65149.33733084026,False,True,64448.738,65598.738,64678.738,64648.738,,False,2024-06-18 18:00:00,2024-06-18 17:08:23,2024-06-19 07:12:54,0.02,success,True,255.1,17499.09000000002,1,0,25,6
2024-06-20 08:15:00,65264.152,65336.738,65216.34,65314.039,1128,36422,0,2024-06-20 08:00:00,2024-06-20 08:00:00,66.0753095238033,32.25050249819469,65313.8729285714,0.00094997303408497,0.0008407943486494292,65186.5272142857,65347.911671997426,65805.79585903794,68281.36328145734,65823.5811711241,0.0009979634659104415,0.01192722979663269,65254.035943642135,65105.78879599326,83.48031338263431,68.89554282541724,-22.308851544063522,65166.65797096917,65097.97002363506,65183.44287994496,68.6879473341105,52.16664084485117,127.89376329567506,27.572887512942543,16.434942208397842,10.243526659796771,65357.59946039412,65010.7862994958,True,False,66014.03899999999,64864.039,65784.03899999999,65814.03899999999,,False,2024-06-20 14:00:00,2024-06-20 13:56:33,2024-06-20 17:08:24,0.02,success,True,255.1,17754.190000000017,2,0,25,6
2024-06-20 08:30:00,65314.039,65409.738,65302.738,65349.84,778,36422,0,2024-06-20 08:00:00,2024-06-20 08:00:00,66.0753095238033,32.25050249819469,65313.8729285714,0.00094997303408497,0.0008407943486494292,65186.5272142857,65347.911671997426,65805.79585903794,68281.36328145734,65823.5811711241,0.0009979634659104415,0.01192722979663269,65254.035943642135,65105.78879599326,86.6253342669728,79.28420018741002,-22.308851544063522,65194.8398215893,65116.62705892135,65220.4051375989,78.2127626679503,57.375865209471,131.01620135196117,36.96225765394047,27.572887512942543,16.434942208397842,65398.77700942405,65043.53326577375,True,False,66049.84,64899.84,65819.84,65849.84,,False,2024-06-20 14:00:00,2024-06-20 13:56:33,2024-06-20 17:05:15,0.02,success,True,255.1,18009.290000000015,3,0,25,6
2024-06-20 08:45:00,65343.574,65575.539,65343.484,65469.84,1163,36421,0,2024-06-20 08:00:00,2024-06-20 08:00:00,66.0753095238033,32.25050249819469,65313.8729285714,0.00094997303408497,0.0008407943486494292,65186.5272142857,65347.911671997426,65805.79585903794,68281.36328145734,65823.5811711241,0.0009979634659104415,0.01192722979663269,65254.035943642135,65105.78879599326,86.60542588815672,85.5703578459212,-22.308851544063522,65237.1475413448,65142.790980482736,65285.650278637775,94.3565608620629,64.7720043399894,139.00134885478582,65.24514103887486,36.96225765394047,27.572887512942543,65474.80209959174,65097.99845768381,True,False,66169.84,65019.84,65939.84,65969.84,,False,2024-06-20 14:00:00,2024-06-20 13:59:05,2024-06-20 17:02:08,0.02,success,True,255.1,18264.390000000014,4,0,25,6
2024-06-20 17:00:00,65096.887,65150.938,64733.039,64786.184,3098,36422,0,2024-06-20 17:00:00,2024-06-20 17:00:00,-272.17045238093124,147.45105897912435,65426.188857142886,-0.0017872291283296212,0.00012134642313421214,65748.0059642857,64137.760744354666,66505.85254968985,64935.63282113073,67230.48394988886,0.0019225248912437402,-0.0005507374258286516,65367.447497466375,65371.49378380507,7.622835940863382,11.666091256831217,161.41634671105965,65532.97009085315,65631.81648767194,65466.52053594768,-98.84639681878616,55.17353296799271,372.07387370534497,-216.79937495701597,-168.15482284146128,-124.6222813896893,65968.8202654499,64962.72080644547,False,True,64086.184,64316.184,64316.184,64286.184,2024-06-21 11:00:00,True,2024-06-21 11:00:00,2024-06-21 11:42:04,2024-06-21 11:12:22,0.02,even,True,171.28,18435.670000000013,5,0,25,6
2024-06-21 02:15:00,64939.398,64975.84,64911.84,64917.34,816,36422,0,2024-06-21 02:00:00,2024-06-21 02:00:00,-5.547821428568568,-101.71490886705578,64951.8187857143,0.000675338511626545,-0.00016204997338232038,65017.88352380952,64992.25489655142,65075.02631332813,65198.88588782641,65239.450723427886,0.00013019714815010517,0.0010570717545611528,65238.5104879498,65145.06425281085,19.491592255163454,33.10785188774635,-56.75384843895726,64980.687484801274,65013.87534415538,64975.60426418982,-33.18785935410415,-32.15191446765128,99.74593655262558,-13.288905056760996,-15.001312349508225,-6.37329824565677,65110.26127853586,64839.447249843775,False,True,64217.34,65367.34,64447.34,64417.34,,False,2024-06-21 11:00:00,2024-06-21 10:52:07,,0.02,success,True,255.1,18690.77000000001,6,0,25,6
2024-06-21 02:30:00,64916.438,64926.34,64883.801,64893.84,906,36422,0,2024-06-21 02:00:00,2024-06-21 02:00:00,-5.547821428568568,-101.71490886705578,64951.8187857143,0.000675338511626545,-0.00016204997338232038,65017.88352380952,64992.25489655142,65075.02631332813,65198.88588782641,65239.450723427886,0.00013019714815010517,0.0010570717545611528,65238.5104879498,65145.06425281085,11.000538096205425,21.604678836066174,-56.75384843895726,64967.326333293386,65004.98383718091,64954.634144822805,-37.65750388752349,-33.25303235162573,85.83775213792691,-20.970119367011648,-13.288905056760996,-15.001312349508225,65070.51511020901,64837.2531794366,False,True,64193.84,65343.84,64423.84,64393.84,,False,2024-06-21 11:00:00,2024-06-21 10:52:09,,0.02,success,True,255.1,18945.87000000001,7,0,25,6
2024-06-21 02:45:00,64889.262,64909.438,64812.84,64829.676,734,36422,0,2024-06-21 02:00:00,2024-06-21 02:00:00,-5.547821428568568,-101.71490886705578,64951.8187857143,0.000675338511626545,-0.00016204997338232038,65017.88352380952,64992.25489655142,65075.02631332813,65198.88588782641,65239.450723427886,0.00013019714815010517,0.0010570717545611528,65238.5104879498,65145.06425281085,3.9141922546131163,11.468774201993918,-56.75384843895726,64946.14935894056,64991.99807146381,64926.60275748194,-45.84871252324956,-35.77216838595049,69.22936247911197,-28.031387340866786,-20.970119367011648,-13.288905056760996,65020.06239682874,64831.643118135136,False,True,64129.676,64359.676,64359.676,64329.676,2024-06-21 11:00:00,True,2024-06-21 11:00:00,2024-06-21 11:37:18,2024-06-21 23:19:48,0.02,success,True,255.1,19200.97000000001,8,0,25,6
2024-06-21 03:00:00,64829.664,64888.738,64657.504,64679.84,1108,36422,0,2024-06-21 03:00:00,2024-06-21 03:00:00,-66.0647380952214,-114.0537838322416,64879.98277380954,-0.0001313110392260117,-0.0001880944090479085,64951.8187857143,64547.96611595103,65046.76995692907,64992.25489655142,65075.02631332813,-0.00016204997338232038,0.000675338511626545,65221.005645285106,65116.83007258599,4.655321068305571,6.52335047304129,-68.21383551761414,64905.17868833432,64968.87525135538,64868.78217371862,-63.69656302105432,-41.35704731297126,93.27867439481132,-57.82058376332134,-28.031387340866786,-20.970119367011648,64994.708384151614,64741.35596328562,False,True,63979.84,64209.84,64209.84,64179.84,2024-06-21 11:00:00,True,2024-06-21 11:00:00,2024-06-21 11:49:47,2024-06-21 11:00:12,0.02,even,True,171.28,19372.250000000007,9,0,25,6
2024-06-24 08:15:00,62698.438,62717.238,62447.738,62591.84,2357,36422,0,2024-06-24 08:00:00,2024-06-24 08:00:00,-61.997690476157004,-340.90183471881755,62615.635345238115,-0.002060534964662271,-0.0018781422638511932,62824.63698809528,61710.15976269038,62506.75255814453,61877.678929856025,62662.09584723434,-0.0017756637743437027,-0.0019775681221809683,64112.83097252622,63570.59911905305,18.29562635582194,22.237846953678613,-267.5934432203618,62822.06284740836,63034.694334533844,62672.205835225286,-212.63148712548718,-206.68778050065418,231.15263871697272,-60.3967715858671,-33.02914138282358,-30.514808393549174,62984.2618974932,62358.649772957375,False,True,61891.84,63041.84,62121.84,62091.84,,False,2024-06-24 12:45:00,2024-06-24 12:30:36,,0.02,success,True,255.11,19627.360000000008,10,0,26,6
2024-06-24 19:45:00,60502.172,60511.738,59950.973,60126.238,4153,36422,0,2024-06-24 19:00:00,2024-06-24 19:00:00,-147.4487142857397,-595.32948383443,60785.006142857135,-0.0012581799634865873,-0.0037739451598897194,61023.307345238136,59650.22310219531,60275.82279264543,60733.346111665596,60501.05097931575,-0.0037741364371244243,0.0004143359518076562,63141.34486883869,62208.15916939837,15.487987697386153,18.719721813269114,-534.7845997848581,60851.828245776145,61151.2893952448,60735.13215514273,-299.4611494686542,-242.1173315815783,294.43971866410766,-168.73359236329998,-105.53147058819013,-63.297373925066495,61132.62577533928,60336.138534946185,False,True,59426.238,60576.238,59656.238,59626.238,,False,2024-06-24 23:00:00,2024-06-24 22:55:35,2024-06-25 03:54:10,0.02,success,True,255.11,19882.47000000001,11,0,26,6
2024-06-26 05:00:00,62047.039,62344.969,61952.863,62302.238,1757,36422,0,2024-06-26 05:00:00,2024-06-26 05:00:00,9.61490476191102,194.250331503521,61899.167630952354,-0.0005458535995506741,0.00016091928295589665,61840.895,61386.89577156476,62487.39642593772,62019.75959259633,61992.944658656364,-0.0006156303101545963,0.001380840802242756,61790.50121182306,61574.93028794137,81.71465265733735,72.80523759414592,189.59199176511416,61929.94525251762,61852.10851688044,61914.13798004817,77.83673563717457,40.52252252110939,155.9872719223912,89.56854798763379,41.72709184728592,21.09238321294106,62126.2207971434,61703.555162952944,True,False,63002.238,61852.238,62772.238,62802.238,,False,,,2024-06-26 06:34:21,0.02,fail,False,-164.03,19718.44000000001,0,1,26,6
2024-06-26 08:15:00,61722.34,61756.34,61537.938,61557.238,1295,36422,0,2024-06-26 08:00:00,2024-06-26 08:00:00,-69.99845238100534,135.075633986482,61734.664857142874,-0.00022778277674138738,0.00037844839058329095,61841.86945238091,61462.926642903265,62613.132091524785,61732.17038197084,62938.903546575646,0.001301733180374633,0.00028828598579438535,61778.96290826132,61598.8745323125,4.038419032956351,4.444228553204906,176.73839169859085,61776.11052916863,61821.19068430631,61702.03326487783,-45.08015513767896,2.8654629167443737,180.7184210665811,-82.44857241145655,-59.448656002750795,-55.6188734090174,61946.00313331771,61456.563396437945,False,True,60857.238,62007.238,61087.238,61057.238,,False,2024-06-26 20:15:00,2024-06-26 20:08:02,2024-06-27 17:00:39,0.02,success,True,255.12,19973.56000000001,1,0,26,6
2024-06-26 08:45:00,61600.637,61645.039,61518.738,61519.637,1133,36422,0,2024-06-26 08:00:00,2024-06-26 08:00:00,-69.99845238100534,135.075633986482,61734.664857142874,-0.00022778277674138738,0.00037844839058329095,61841.86945238091,61462.926642903265,62613.132091524785,61732.17038197084,62938.903546575646,0.001301733180374633,0.00028828598579438535,61778.96290826132,61598.8745323125,2.9257612728267404,4.338131195506146,176.73839169859085,61713.302793073395,61783.45881439155,61581.921343653274,-70.15602131815831,-21.16527665171547,192.56077613100288,-61.17285483315209,-58.939066391401866,-82.44857241145655,61841.87839143013,61320.464295876416,False,True,60819.637,61969.637,61049.637,61019.637,,False,2024-06-26 20:15:00,2024-06-26 20:10:25,2024-06-27 16:59:52,0.02,success,True,255.12,20228.680000000008,2,0,26,6
2024-06-26 13:30:00,61270.273,61300.637,61203.137,61203.137,779,36422,0,2024-06-26 13:00:00,2024-06-26 13:00:00,-80.22959523817553,-21.83364647012786,61354.047035714284,-0.0012637876033990037,-0.001008392915095821,61437.396452380955,60821.85980785889,61349.32819830057,60862.0047318724,61122.33315100885,-0.0019446507783490309,-0.0013375364206377558,61718.09793130907,61542.91300988681,12.492384030960096,12.723670684004468,74.3955344301546,61387.69933693916,61509.12196241205,61307.23238424494,-121.42262547289283,-99.13298331663376,138.3990495573715,-46.12487581698224,-41.30936119710532,-33.78738734088256,61494.07110114739,61118.89366734249,False,True,60503.137,61653.137,60733.137,60703.137,,False,2024-06-27 09:45:00,2024-06-28 22:17:51,2024-06-26 16:33:13,0.02,fail,False,-164.03,20064.65000000001,0,1,26,6
2024-06-27 17:00:00,61945.137,62329.738,61938.156,62329.738,2462,36422,0,2024-06-27 17:00:00,2024-06-27 17:00:00,289.4360714285067,112.03428208229161,61631.45957142851,0.0017761235687731587,0.0033473011823083564,61504.65278571427,61777.95997322503,63206.35630016827,61668.782729322265,62631.754874616236,0.0026256539192557435,0.0017761275149726242,61339.66544739174,61218.863752059944,91.56732408462243,81.38127593474121,-25.764396605071525,61593.67627090903,61344.92802595338,61753.47552356383,248.74824495565554,153.61925977079807,367.0291945483957,165.58260061922192,103.6520880632961,52.48944272445078,62250.46493620417,61257.98611092349,True,False,63029.738,61879.738,62799.738,62829.738,,False,,,2024-06-27 17:49:32,0.02,fail,False,-164.03,19900.62000000001,0,2,26,6
2024-06-28 10:30:00,61461.617,61487.539,61331.844,61371.738,637,36422,0,2024-06-28 10:00:00,2024-06-28 10:00:00,-47.99313095240359,57.449704727187054,61520.09592857148,-0.000617433504919956,-0.0014389189843900805,61655.08909523807,61023.221132014,61295.26715327723,61458.41065396358,61422.0222110332,-0.0013687371646371332,2.9908957141923267e-05,61480.77489448678,61521.55960348911,15.332618204287948,22.179665458380857,93.04296684102128,61544.48981436092,61597.221917570925,61472.28578362574,-52.73210321000806,-29.03440628798451,161.09518794729524,-36.46249329204147,-26.617849673173623,-10.002192638465203,61689.764287354585,61253.30727989689,False,True,60671.738,61821.738,60901.738,60871.738,,False,2024-06-28 17:45:00,2024-06-28 19:41:24,2024-06-28 15:30:07,0.02,fail,False,-164.03,19736.59000000001,0,3,26,6
2024-06-28 10:45:00,61371.738,61376.34,61174.41,61299.738,1403,36422,0,2024-06-28 10:00:00,2024-06-28 10:00:00,-47.99313095240359,57.449704727187054,61520.09592857148,-0.000617433504919956,-0.0014389189843900805,61655.08909523807,61023.221132014,61295.26715327723,61458.41065396358,61422.0222110332,-0.0013687371646371332,2.9908957141923267e-05,61480.77489448678,61521.55960348911,13.907917316761436,17.307178085330815,93.04296684102128,61506.83568907462,61575.18607182493,61436.159234606166,-68.3503827503082,-36.89760158044925,161.47791053212313,-36.12654901957285,-36.46249329204147,-26.617849673173623,61654.15441382453,61216.6640553878,False,True,60599.738,61749.738,60829.738,60799.738,,False,2024-06-28 18:15:00,2024-06-28 19:47:01,2024-06-28 14:36:44,0.02,fail,False,-164.03,19572.560000000012,0,4,26,6
2024-06-28 17:30:00,61043.137,61144.34,60831.84,60860.238,2251,36422,0,2024-06-28 17:00:00,2024-06-28 17:00:00,-65.1363571428883,-43.98886003813095,61241.99024999998,-0.0010146826071251297,-0.00016805713228027386,61409.08985714286,60494.92666643333,61761.643848549305,61140.73486358577,61771.973632800415,-0.0001680070225471823,-5.493705120271765e-05,61451.07713237243,61442.93560952929,8.783497059383796,19.117985834861173,7.239222142414155,61314.95758306187,61416.41336818141,61247.78860577916,-101.45578511954227,-36.521982345337186,203.2545125385267,-120.3111658066482,-88.86701547988196,-54.94295493645768,61522.18219770617,60971.895013852154,False,True,60160.238,61310.238,60390.238,60360.238,,False,2024-06-28 23:00:00,2024-06-28 22:17:54,2024-07-01 00:00:02,0.02,success,True,255.12,19827.68000000001,1,0,26,6
2024-06-28 18:00:00,60887.055,60944.738,60702.84,60779.84,1969,36422,0,2024-06-28 18:00:00,2024-06-28 18:00:00,-167.09960714288172,-101.7824487617545,61118.92072619043,-0.0011698610645915664,-0.00016804140176853306,61241.99024999998,60386.96990171496,61751.24879739396,60494.92666643333,61761.643848549305,-0.00016805713228027386,-0.0010146826071251297,61434.240303651946,61409.23980076695,7.823448218379437,8.18888603514257,-14.565112038419574,61177.421228109386,61333.212229236466,61031.90672067424,-155.79100112707965,-74.97599427780867,264.77330753643366,-112.33971379431023,-103.5421713106116,-120.3111658066482,61389.350685848425,60672.962755500055,False,True,60079.84,61229.84,60309.84,60279.84,,False,2024-06-28 23:00:00,2024-06-28 22:59:49,2024-07-01 00:00:02,0.02,success,True,255.12,20082.80000000001,2,0,26,6
2024-07-01 01:00:00,61903.34,62097.637,61894.398,62076.938,754,56422,0,2024-07-01 01:00:00,2024-07-01 01:00:00,457.1354523809714,-139.4345681730556,61541.70841666663,-0.0007508380238369546,0.00409064115330291,60851.34673809524,59742.285378196364,63988.12793752727,59787.867623070844,62278.86573092344,0.0011829050314933628,-0.0007508102003177723,61360.51384996529,61309.901759496635,96.57462869445892,95.79448523689443,-165.20382499794474,61286.38800788102,61080.74514164111,61439.88523391815,205.64286623990483,-7.373625521003049,590.7402524140728,237.83103027181642,227.70428173364053,237.55782387348881,62238.88457467715,60642.385893159146,True,False,62776.938,61626.938,62546.938,62576.938,,False,2024-07-01 01:30:00,2024-07-01 01:27:40,2024-07-03 04:55:09,0.02,success,True,255.12,20337.92000000001,3,0,27,7
2024-07-02 11:00:00,62591.84,62671.738,62368.297,62449.621,1167,36422,0,2024-07-02 11:00:00,2024-07-02 11:00:00,-126.05884523809073,-43.583353567053564,62748.00251190475,-0.0009361724284408231,-0.0009096454786417724,62840.68158333332,62132.55714031883,62747.23017396318,62432.39339958424,63062.35866083519,-0.0004000571308068009,-0.00045677624708746447,62584.2447817464,62865.37865449032,8.585317065961242,8.894400981499794,30.3088811037341,62738.42148575826,62856.55476618111,62604.880920880605,-118.13328042284411,-65.57877818246095,195.28653095573532,-65.34152528379491,-50.25481492947438,-71.73042174061993,62868.517737670845,62339.744104090365,False,True,61749.621,62899.621,61979.621,61949.621,,False,2024-07-02 17:45:00,2024-07-03 04:55:09,2024-07-02 15:45:16,0.02,fail,False,-164.06,20173.860000000008,0,1,27,7
2024-07-02 17:15:00,62345.41,62421.637,62194.344,62341.238,2335,36422,0,2024-07-02 17:00:00,2024-07-02 17:00:00,-21.084785714221653,-69.30823163026798,62498.878321428565,-0.0013605060357291794,0.0007993068260453134,62711.07894047623,61523.16083575338,63402.49739314945,62619.15894419889,63222.51072154845,0.0002921986015220348,0.0004438312173042715,62585.07405842701,62750.946934236505,11.13262149953024,28.67820524700649,-42.711807093720665,62654.49591983156,62711.74383940608,62679.05462882697,-57.247919574518164,-20.270697091558695,141.9302745026633,-79.6321365668773,-81.36412039914285,-35.33363742686197,62870.66049940557,62485.94875824837,False,True,61641.238,62791.238,61871.238,61841.238,,False,2024-07-03 05:00:00,2024-07-03 04:55:09,,0.02,success,True,255.15,20429.01000000001,1,0,27,7
2024-07-02 17:30:00,62316.438,62392.34,61869.84,61878.137,2350,36422,0,2024-07-02 17:00:00,2024-07-02 17:00:00,-21.084785714221653,-69.30823163026798,62498.878321428565,-0.0013605060357291794,0.0007993068260453134,62711.07894047623,61523.16083575338,63402.49739314945,62619.15894419889,63222.51072154845,0.0002921986015220348,0.0004438312173042715,62585.07405842701,62750.946934236505,6.779764170097654,14.68534243769813,-42.711807093720665,62535.05608601132,62649.995184635256,62509.710421052594,-114.93909862393775,-39.20437739803451,216.51361319866012,-169.3442077743748,-79.6321365668773,-81.36412039914285,62802.003798870785,62215.9170432344,False,True,61178.137,62328.137,61408.137,61378.137,,False,2024-07-03 05:45:00,2024-07-03 04:55:14,2024-07-02 21:39:12,0.02,fail,False,-164.06,20264.950000000008,0,1,27,7
2024-07-02 18:00:00,62012.848,62130.438,61972.469,62005.277,1601,36422,0,2024-07-02 18:00:00,2024-07-02 18:00:00,-212.20061904766771,-143.2843728808075,62272.186642857145,-0.0013573987609684442,0.0007843424950983707,62498.878321428565,61441.15837922432,63447.39505799523,61523.16083575338,63402.49739314945,0.0007993068260453134,-0.0013605060357291794,62559.260958096536,62685.01837949759,7.889682151431029,7.99216508509869,-62.826320251138036,62385.77884264716,62558.64725431692,62271.99764981084,-172.86841166976228,-83.33742447774104,282.10991897482603,-111.70030718948692,-126.01246405226993,-169.3442077743748,62652.846040426855,61889.64925919482,False,True,61305.277,62455.277,61535.277,61505.277,,False,2024-07-03 05:45:00,2024-07-03 04:55:12,,0.02,success,True,255.15,20520.10000000001,1,0,27,7
2024-07-03 11:00:00,60839.008,60879.938,60732.938,60821.039,755,36422,0,2024-07-03 11:00:00,2024-07-03 11:00:00,-72.36826190473948,-382.7211733166405,60722.97328571432,-0.0009910051619498135,-0.0028674897454511283,60844.93584523815,60043.303635498654,60264.052092529135,60012.91548680228,60220.995316291104,-0.0032234672131455965,-0.0011770641372771053,62017.07173524263,61675.10813713644,18.37236757479003,22.952577733265702,-313.1194642532279,60939.68210422349,61119.01849168482,60926.35939731684,-179.3363874613351,-200.837645718683,198.66171485472466,-22.15199655997276,-20.71490161685506,-33.69580908145872,61194.552712370714,60656.666082262964,False,True,60121.039,60351.039,60351.039,60321.039,2024-07-03 13:15:00,True,2024-07-03 13:15:00,2024-07-03 13:16:41,2024-07-03 13:59:36,0.02,success,True,255.15,20775.25000000001,2,0,27,7
2024-07-04 11:15:00,58292.438,58305.137,58039.863,58039.863,1499,36422,0,2024-07-04 11:00:00,2024-07-04 11:00:00,-199.54482142858615,-510.77290270310914,58296.352392857116,-0.001906059264252484,-0.004623473331204245,58526.75483333333,56553.53860307393,57491.63761172854,58411.91221914674,57755.60210725852,-0.0046234369670037825,0.00148729800460321,60459.78556647801,59600.6130789146,11.92174716377537,12.889725121466256,-416.60414048545783,58510.127626065325,58825.18078110221,58340.00599896799,-315.05315503688325,-279.40422932400816,279.1874255954059,-101.9365706913959,-73.48431475752295,-109.9082063983733,58716.90902352179,57961.602974414185,False,True,57339.863,58489.863,57569.863,57539.863,,False,2024-07-04 12:15:00,2024-07-04 11:40:19,2024-07-04 22:30:41,0.02,success,True,255.15,21030.400000000012,3,0,27,7
