time,open,high,low,close,tick_volume,spread,real_volume,support_trendline_15,resistance_trendline_15,support_gradient_15,resistance_gradient_15,fixed_resistance_gradient_15,fixed_support_gradient_15,fixed_support_trendline_15,fixed_resistance_trendline_15,hourly_time,time2,prev_hour_lsma_slope,prev_hour_macd_line,hour_lsma,fixed_support_gradient,fixed_resistance_gradient,prev_hour_lsma,fixed_support_trendline,fixed_resistance_trendline,prev_fixed_support_trendline,prev_fixed_resistance_trendline,prev_fixed_resistance_gradient,prev_fixed_support_gradient,ema_50,ema_24,stoch_k,stoch_d,prev_hour_macd_signal,prev_psar,prev_psar_direction,prev_nadaraya_watson,prev_nadaraya_watson_trend,ema_short,ema_long,lsma,macd_line,macd_signal,lsma_stddev,lsma_slope,prev_lsma_slope_1,prev_lsma_slope_2,lsma_upper_band,lsma_lower_band,ticket,is_buy2,is_sell2,signal,tp,sl,be,be_condition,sl_updated,time_to_trail,time_tp_hit,time_sl_hit,lot_size,type,success,profit,account_balance,win_streak,losing_streak,Week,Month
2024-02-02 11:30:00,1.08945,1.08956,1.08934,1.08939,299,12,0,1.0890633359980857,1.0895491159134485,2.4483126578034345e-05,6.464829202041063e-05,0.0001575867314943629,0.00029721650282135627,1.0884076964178617,1.0891430491851528,2024-02-02 11:00:00,2024-02-02 11:00:00,7.059523809416213e-05,0.0009586427691605781,1.0882030952380952,4.1687756355880395e-05,0.00034686463486700603,1.0878041666666667,1.0871478945775206,1.0882113374780438,1.0871339911467066,1.0879439773486606,0.0002360382618070153,3.429642501039609e-05,1.0886358185329772,1.0857383838514867,95.39362796733631,93.82580487110515,0.0011917158925219685,,-1.0,1.0845172737867395,bearish,1.0886174622552014,1.0883053758041379,1.0887633264533885,0.0003120864510635091,0.0001375078363734474,0.0005452772995284066,0.00021334021327690245,0.00024543859649250876,0.0002097695218443718,1.089308603752917,1.08821804915386,,False,True,1.0,1.0843900000000002,1.0885900000000002,1.0877900000000003,1.0873900000000003,True,2024-02-02 15:35:00,2024-02-02 15:30:20,2024-02-02 12:58:04,0.01,even,True,0.0,700.0,1,0,5,2
2024-02-02 11:35:00,1.08934,1.08938,1.0890900000000001,1.08919,292,12,0,1.0890900000000001,1.089720891661528,3.699560977653041e-05,-2.8348634622418056e-05,6.731043724854388e-05,7.678993668164185e-05,1.0888571434179155,1.0894195971727287,2024-02-02 11:00:00,2024-02-02 11:00:00,7.059523809416213e-05,0.0009586427691605781,1.0882030952380952,4.1687756355880395e-05,0.00034686463486700603,1.0878041666666667,1.0871478945775206,1.0882113374780438,1.0871339911467066,1.0879439773486606,0.0002360382618070153,3.429642501039609e-05,1.0886358185329772,1.0857383838514867,91.79945276033966,94.82442880558592,0.0011917158925219685,,-1.0,1.0845172737867395,bearish,1.0887055449851704,1.0883709035223499,1.0889482284141723,0.000334641462820473,0.00017693456166285252,0.0005778263868855103,0.00018490196078380094,0.00021334021327690245,0.00024543859649250876,1.0895260548010577,1.0883704020272869,,False,True,1.0,1.0841900000000002,1.0883900000000002,1.0875900000000003,1.0871900000000003,True,2024-02-02 15:35:00,2024-02-02 15:30:24,2024-02-02 12:52:40,0.01,even,True,14.68,714.68,2,0,5,2
2024-02-02 11:45:00,1.08965,1.08967,1.08926,1.08934,252,12,0,1.0891966437893406,1.08967,-0.00020507563712613135,-8.286960129363295e-05,6.464829202041063e-05,2.4483126578034345e-05,1.0890656176647366,1.089555143407547,2024-02-02 11:00:00,2024-02-02 11:00:00,7.059523809416213e-05,0.0009586427691605781,1.0882030952380952,4.1687756355880395e-05,0.00034686463486700603,1.0878041666666667,1.0871478945775206,1.0882113374780438,1.0871339911467066,1.0879439773486606,0.0002360382618070153,3.429642501039609e-05,1.0886358185329772,1.0857383838514867,88.82661657450888,90.67992318683845,0.0011917158925219685,,-1.0,1.0845172737867395,bearish,1.0889247984805066,1.08852973210078,1.089400271757826,0.00039506637972652747,0.0002537548556177743,0.0006725555739478763,0.00016665290677608802,0.00028539043687758614,0.00018490196078380094,1.090072827331774,1.088727716183878,,False,True,1.0,1.08434,1.08854,1.0877400000000002,1.0873400000000002,True,2024-02-02 15:35:00,2024-02-02 15:30:22,2024-02-02 12:57:56,0.01,even,True,14.68,729.3599999999999,3,0,5,2
2024-02-02 11:50:00,1.08933,1.08935,1.0892,1.08927,226,12,0,1.0886500159393488,1.0893391165118758,9.18380269952025e-05,2.780881721643868e-05,-2.8348634622418056e-05,3.699560977653041e-05,1.089093445245002,1.0897182501509066,2024-02-02 11:00:00,2024-02-02 11:00:00,7.059523809416213e-05,0.0009586427691605781,1.0882030952380952,4.1687756355880395e-05,0.00034686463486700603,1.0878041666666667,1.0871478945775206,1.0882113374780438,1.0871339911467066,1.0879439773486606,0.0002360382618070153,3.429642501039609e-05,1.0886358185329772,1.0857383838514867,88.1490167779142,89.46311119269664,0.0011917158925219685,,-1.0,1.0845172737867395,bearish,1.0889779064065825,1.0885845667599814,1.0895308290333678,0.00039333964660115406,0.0002816718138144503,0.0006955170738727984,0.00013055727554189822,0.00016665290677608802,0.00028539043687758614,1.0902263461072406,1.0888353119594951,,False,True,1.0,1.08427,1.08847,1.0876700000000001,1.0872700000000002,True,2024-02-02 15:35:00,2024-02-02 15:30:22,2024-02-02 12:57:49,0.01,even,True,14.68,744.0399999999998,4,0,5,2
2024-02-02 11:55:00,1.08926,1.08926,1.08875,1.08902,320,12,0,1.08875,1.089368216526845,3.393955567721533e-05,2.8356675116952726e-05,-0.0001774503083164367,-0.0001221779941763631,1.089148651969776,1.089846887044261,2024-02-02 11:00:00,2024-02-02 11:00:00,7.059523809416213e-05,0.0009586427691605781,1.0882030952380952,4.1687756355880395e-05,0.00034686463486700603,1.0878041666666667,1.0871478945775206,1.0882113374780438,1.0871339911467066,1.0879439773486606,0.0002360382618070153,3.429642501039609e-05,1.0886358185329772,1.0857383838514867,78.35544668979882,85.11036001407395,0.0011917158925219685,,-1.0,1.0845172737867395,bearish,1.0889843823440313,1.0886168210740568,1.0895553147574817,0.00036756126997450345,0.00029884970504646095,0.0006994397758555041,2.4485724113842977e-05,0.00013055727554189822,0.00016665290677608802,1.0902547545333372,1.0888558749816262,,False,True,1.0,1.0840200000000002,1.0882200000000002,1.0874200000000003,1.0870200000000003,True,2024-02-02 15:35:00,2024-02-02 15:30:28,2024-02-02 13:27:59,0.01,even,True,14.68,758.7199999999998,5,0,5,2
2024-02-05 00:10:00,1.07808,1.07808,1.07798,1.07807,6,62,0,1.07798,1.0780692228143343,4.210435032859563e-05,4.043316559372109e-05,-0.0003523481364348979,-0.0002218877393107284,1.0785012942838412,1.0792016127267265,2024-02-05 00:00:00,2024-02-05 00:00:00,-0.0001402380952379989,-0.002007662358227691,1.0784870238095239,-9.113165116708272e-06,-0.00011401771924732977,1.0786564285714293,1.0779792622498636,1.0798969821303812,1.077884271115458,1.0791816160163354,0.0001515480337553088,9.607171203860676e-05,1.0782445650071024,1.0821977556322848,10.431061313422942,14.481393697086162,-0.0014479381564652075,,-1.0,1.0798370835190303,bearish,1.078693883868886,1.078901876133951,1.0784714069487447,-0.00020799226506507118,-7.79364577570763e-05,0.00039547945586648867,-0.0001581802545571609,-0.00017858617131150112,-8.672858617075896e-05,1.0788668864046111,1.0780759274928782,,False,True,1.0,1.0730700000000002,1.0772700000000002,1.0764700000000003,1.0760700000000003,True,2024-02-05 11:40:00,2024-02-05 17:00:00,2024-02-05 01:26:29,0.01,even,True,14.68,773.3999999999997,6,0,6,2
2024-02-05 08:10:00,1.07829,1.07836,1.07813,1.07818,120,12,0,1.078019995204652,1.07836,-3.710421569366602e-05,1.2124952765131326e-05,0.00011901929261519127,0.00011169388283221683,1.077699060925686,1.0781629866969689,2024-02-05 08:00:00,2024-02-05 08:00:00,0.00018892857142827069,-0.00130330230958986,1.0778859523809525,-4.703106834065184e-05,8.364854090632491e-05,1.0778811904761905,1.0774082111851213,1.0780559819208904,1.0768088514568959,1.0780355754381774,2.4499325306331176e-05,0.00010926927737415457,1.0778353093377544,1.0800536431270538,85.73522227650204,87.19387789719974,-0.0015867618702185488,,-1.0,1.0772605388575354,bearish,1.077918382092903,1.0778111104366441,1.0780180151358798,0.00010727165625890045,4.343603321040355e-05,0.00021998105980515766,6.375644994838225e-05,0.00011982800137722016,6.109047127567102e-05,1.078237996195685,1.0777980340760747,,False,True,1.0,1.07318,1.0757800000000002,1.0749800000000003,1.0741800000000004,True,2024-02-05 15:55:00,2024-02-05 17:00:00,2024-02-05 13:48:18,0.01,even,True,44.03,817.4299999999997,7,0,6,2
2024-02-05 08:15:00,1.07818,1.07819,1.07799,1.07799,132,12,0,1.077961157318693,1.0782066595816437,-9.634784078099261e-06,9.428676999942395e-05,-2.9363625770270803e-05,2.8551813459010985e-05,1.0779023112245378,1.0784392883638263,2024-02-05 08:00:00,2024-02-05 08:00:00,0.00018892857142827069,-0.00130330230958986,1.0778859523809525,-4.703106834065184e-05,8.364854090632491e-05,1.0778811904761905,1.0774082111851213,1.0780559819208904,1.0768088514568959,1.0780355754381774,2.4499325306331176e-05,0.00010926927737415457,1.0778353093377544,1.0800536431270538,77.46569193278621,84.95124649401743,-0.0015867618702185488,,-1.0,1.0772605388575354,bearish,1.0779294002324564,1.0778243615154113,1.0780469797041619,0.00010503871704514722,5.575656997735229e-05,0.00022491702175034037,2.896456828205274e-05,6.375644994838225e-05,0.00011982800137722016,1.0782718967259122,1.0778220626824115,,False,True,1.0,1.07299,1.07719,1.0763900000000002,1.0759900000000002,True,2024-02-05 11:40:00,2024-02-05 17:00:01,2024-02-05 11:05:46,0.01,even,True,14.68,832.1099999999997,8,0,6,2
2024-02-05 08:30:00,1.07839,1.07839,1.07793,1.07809,231,12,0,1.077863333378997,1.07839,-3.401909661900369e-05,-0.00010844291663138546,9.428676999942395e-05,-9.634784078099261e-06,1.077960376391487,1.078214303568291,2024-02-05 08:00:00,2024-02-05 08:00:00,0.00018892857142827069,-0.00130330230958986,1.0778859523809525,-4.703106834065184e-05,8.364854090632491e-05,1.0778811904761905,1.0774082111851213,1.0780559819208904,1.0768088514568959,1.0780355754381774,2.4499325306331176e-05,0.00010926927737415457,1.0778353093377544,1.0800536431270538,77.65567765567418,75.23247647141092,-0.0015867618702185488,,-1.0,1.0772605388575354,bearish,1.0780372652295855,1.0779028790671292,1.0782164740282076,0.00013438616245631252,9.238685859908368e-05,0.0002716204459779821,1.1816305468759225e-05,0.0001069762641900951,5.0701754386928144e-05,1.0784880944741857,1.0779448535822296,,False,True,1.0,1.07309,1.0756900000000003,1.0748900000000003,1.0740900000000004,True,2024-02-05 15:55:00,2024-02-05 17:00:00,2024-02-05 13:48:14,0.01,even,True,44.03,876.1399999999996,9,0,6,2
2024-02-05 08:35:00,1.07808,1.07809,1.07783,1.07794,215,12,0,1.077836166304498,1.07809,-3.283477793236058e-05,-1.879244115635684e-05,-8.551773945656295e-06,-3.068725477850698e-05,1.077937517362502,1.078407752302243,2024-02-05 08:00:00,2024-02-05 08:00:00,0.00018892857142827069,-0.00130330230958986,1.0778859523809525,-4.703106834065184e-05,8.364854090632491e-05,1.0778811904761905,1.0774082111851213,1.0780559819208904,1.0768088514568959,1.0780355754381774,2.4499325306331176e-05,0.00010926927737415457,1.0778353093377544,1.0800536431270538,70.32967032966104,74.99108561054904,-0.0015867618702185488,,-1.0,1.0772605388575354,bearish,1.0780223013481107,1.0779056287658604,1.078175376676986,0.00011667258225034338,9.724400332933563e-05,0.00026971157435304603,-4.109735122170832e-05,1.1816305468759225e-05,0.0001069762641900951,1.078445088251339,1.0779056651026329,,False,True,1.0,1.07294,1.07714,1.07634,1.0759400000000001,True,2024-02-05 11:40:00,2024-02-05 17:00:01,2024-02-05 11:05:40,0.01,even,True,14.68,890.8199999999996,10,0,6,2
2024-02-05 08:40:00,1.07794,1.07803,1.07779,1.0779,222,12,0,1.07779,1.078048830311798,-3.6881278731298724e-05,-8.914468590413e-06,-0.00016075702584726143,-8.967644101162295e-05,1.0780194173437687,1.0785503662351514,2024-02-05 08:00:00,2024-02-05 08:00:00,0.00018892857142827069,-0.00130330230958986,1.0778859523809525,-4.703106834065184e-05,8.364854090632491e-05,1.0778811904761905,1.0774082111851213,1.0780559819208904,1.0768088514568959,1.0780355754381774,2.4499325306331176e-05,0.00010926927737415457,1.0778353093377544,1.0800536431270538,52.380952380951236,66.78876678876216,-0.0015867618702185488,,-1.0,1.0772605388575354,bearish,1.0780034857560938,1.077905211820241,1.0781391572067422,9.827393585282174e-05,9.744998983403286e-05,0.0002700617213527516,-3.621947024368133e-05,-4.109735122170832e-05,1.1816305468759225e-05,1.078409218928095,1.0778690954853896,,False,True,1.0,1.0729000000000002,1.0771000000000002,1.0763000000000003,1.0759000000000003,True,2024-02-05 11:50:00,2024-02-05 17:00:01,2024-02-05 11:03:43,0.01,even,True,14.68,905.4999999999995,11,0,6,2
2024-02-05 08:50:00,1.07803,1.07804,1.07773,1.07802,175,12,0,1.0777066673777582,1.0781566902027786,-0.00013765722483741714,-0.00012678942647220606,-1.879244115635684e-05,-3.283477793236058e-05,1.0778335075593437,1.0780884779520947,2024-02-05 08:00:00,2024-02-05 08:00:00,0.00018892857142827069,-0.00130330230958986,1.0778859523809525,-4.703106834065184e-05,8.364854090632491e-05,1.0778811904761905,1.0774082111851213,1.0780559819208904,1.0768088514568959,1.0780355754381774,2.4499325306331176e-05,0.00010926927737415457,1.0778353093377544,1.0800536431270538,53.479853479859294,52.13675213675486,-0.0015867618702185488,,-1.0,1.0772605388575354,bearish,1.0780107797425287,1.0779229593794932,1.0781420123839016,8.782036303545127e-05,9.495721845712298e-05,0.00026290048815759496,-7.481940143883037e-06,1.0337117303249599e-05,-3.621947024368133e-05,1.0784049128720592,1.077879111895744,,False,True,1.0,1.07302,1.0756200000000002,1.0748200000000003,1.0740200000000004,True,2024-02-05 15:55:00,2024-02-05 17:00:00,2024-02-05 13:28:14,0.01,even,True,44.03,949.5299999999995,12,0,6,2
2024-02-05 08:55:00,1.07802,1.07802,1.07766,1.07774,178,12,0,1.0774616596712125,1.07802,-4.7946865875295676e-05,-0.00012084875814291823,-8.914468590413e-06,-3.6881278731298724e-05,1.0777870240499634,1.0780481108299163,2024-02-05 08:00:00,2024-02-05 08:00:00,0.00018892857142827069,-0.00130330230958986,1.0778859523809525,-4.703106834065184e-05,8.364854090632491e-05,1.0778811904761905,1.0774082111851213,1.0780559819208904,1.0768088514568959,1.0780355754381774,2.4499325306331176e-05,0.00010926927737415457,1.0778353093377544,1.0800536431270538,47.619047619048786,50.549450549454036,-0.0015867618702185488,,-1.0,1.0772605388575354,bearish,1.0779691213206013,1.077909406832864,1.0780875541795667,5.9714487737227984e-05,8.790867231314399e-05,0.00025961638367700055,-5.4458204334917326e-05,-7.481940143883037e-06,1.0337117303249599e-05,1.0783471705632437,1.0778279377958897,,False,True,1.0,1.07274,1.07694,1.07614,1.0757400000000001,True,2024-02-05 11:55:00,2024-02-05 17:00:58,2024-02-05 11:01:07,0.01,even,True,14.68,964.2099999999995,13,0,6,2
2024-02-05 21:10:00,1.07443,1.07447,1.07431,1.07432,227,12,0,1.0741614790038447,1.07447,8.621067151888733e-06,1.5283932135346817e-05,3.722811921158612e-05,1.9307292814559346e-05,1.074231486842063,1.074472863583031,2024-02-05 21:00:00,2024-02-05 21:00:00,0.00019119047619087226,-0.0012779339771293863,1.0738430952380957,0.0005437360422776407,0.00013940085285019563,1.0735803571428564,1.071858781204319,1.0741407202774809,1.0721012985416287,1.0744326759759895,3.473320838843812e-05,0.00014446674741548383,1.0741859223854322,1.076327209213765,75.87991718427388,74.68944099380259,-0.001429160535516051,,-1.0,1.0748822893548087,bearish,1.074286896772598,1.0740653742033115,1.0744477124183012,0.00022152256928653635,0.00023460926506416123,0.0002858134589587992,-1.3006535948267839e-05,3.087375301080719e-05,4.140694874510409e-05,1.07473352587726,1.0741618989593424,,False,True,1.0,1.06932,1.07352,1.0727200000000001,1.0723200000000002,True,2024-02-13 15:45:00,,2024-02-06 12:24:13,0.01,even,True,14.68,978.8899999999994,14,0,6,2
2024-02-05 21:15:00,1.07431,1.07436,1.07416,1.0742099999999999,214,12,0,1.074055020353529,1.07436,0.00011635565515658348,7.411575764301047e-05,-4.653526953507836e-05,-2.1493976869625805e-05,1.074238347114111,1.074596425881114,2024-02-05 21:00:00,2024-02-05 21:00:00,0.00019119047619087226,-0.0012779339771293863,1.0738430952380957,0.0005437360422776407,0.00013940085285019563,1.0735803571428564,1.071858781204319,1.0741407202774809,1.0721012985416287,1.0744326759759895,3.473320838843812e-05,0.00014446674741548383,1.0741859223854322,1.076327209213765,67.24929659712286,73.5551485551564,-0.001429160535516051,,-1.0,1.0748822893548087,bearish,1.0742750664998906,1.0740760872252884,1.0744329033367732,0.00019897927460221787,0.00022748326697177257,0.00025895816905852927,-1.480908152795557e-05,-1.3006535948267839e-05,3.087375301080719e-05,1.0746918615058318,1.0741739451677146,,False,True,1.0,1.06921,1.07341,1.07261,1.07221,True,2024-02-13 15:45:00,,2024-02-06 12:23:49,0.01,even,True,14.68,993.5699999999994,15,0,6,2
2024-02-05 21:35:00,1.07453,1.07453,1.07435,1.0743800000000001,181,12,0,1.074306665751179,1.07453,-2.637386860473068e-05,-2.194354615135166e-05,4.653513936433868e-05,5.607910325572438e-05,1.0741843217841798,1.0744735813618145,2024-02-05 21:00:00,2024-02-05 21:00:00,0.00019119047619087226,-0.0012779339771293863,1.0738430952380957,0.0005437360422776407,0.00013940085285019563,1.0735803571428564,1.071858781204319,1.0741407202774809,1.0721012985416287,1.0744326759759895,3.473320838843812e-05,0.00014446674741548383,1.0741859223854322,1.076327209213765,74.21383647799611,72.44558744062401,-0.001429160535516051,,-1.0,1.0748822893548087,bearish,1.0743569737973073,1.0741736498545995,1.0744347918816655,0.00018332394270781371,0.00020606206752340776,0.00023172037744376313,-2.900584795217931e-05,1.3491572066426372e-05,3.4709322320747305e-06,1.0746665122591093,1.0742030715042217,,False,True,1.0,1.0693800000000002,1.0735800000000002,1.0727800000000003,1.0723800000000003,True,2024-02-13 15:45:00,,2024-02-06 13:40:27,0.01,even,True,14.68,1008.2499999999993,16,0,6,2
2024-02-05 21:40:00,1.0743800000000001,1.07442,1.07427,1.07428,214,12,0,1.0742807299137567,1.0744666689754654,-4.366925962509027e-05,1.5500803642788645e-06,-2.7228767334617647e-05,-4.010840536610548e-05,1.0744069123713105,1.0745864213715406,2024-02-05 21:00:00,2024-02-05 21:00:00,0.00019119047619087226,-0.0012779339771293863,1.0738430952380957,0.0005437360422776407,0.00013940085285019563,1.0735803571428564,1.071858781204319,1.0741407202774809,1.0721012985416287,1.0744326759759895,3.473320838843812e-05,0.00014446674741548383,1.0741859223854322,1.076327209213765,58.35892935498149,70.01754300431288,-0.001429160535516051,,-1.0,1.0748822893548087,bearish,1.0743451316746446,1.0741815276431477,1.074411049191607,0.00016360403149695557,0.00019757046031811733,0.00022383252665648617,-2.374269005844809e-05,-2.900584795217931e-05,1.3491572066426372e-05,1.0746348817182636,1.0741872166649504,,False,True,1.0,1.06928,1.07348,1.07268,1.0722800000000001,True,2024-02-13 15:45:00,,2024-02-06 12:23:58,0.01,even,True,14.68,1022.9299999999993,17,0,6,2
2024-02-05 21:50:00,1.07441,1.07447,1.0743,1.07432,215,12,0,1.0742500039988083,1.0744800085934911,-0.00014430939552990575,-0.00010704397176468261,-2.194354615135166e-05,-2.637386860473068e-05,1.074304634575085,1.0745283096723548,2024-02-05 21:00:00,2024-02-05 21:00:00,0.00019119047619087226,-0.0012779339771293863,1.0738430952380957,0.0005437360422776407,0.00013940085285019563,1.0735803571428564,1.071858781204319,1.0741407202774809,1.0721012985416287,1.0744326759759895,3.473320838843812e-05,0.00014446674741548383,1.0741859223854322,1.076327209213765,41.08527131782986,49.41738579299382,-0.001429160535516051,,-1.0,1.0748822893548087,bearish,1.0743497096605443,1.0742074551124379,1.0743924217406255,0.00014225454810645743,0.00017996158751672778,0.00019901172492169342,-2.636394908939188e-05,7.736498107924206e-06,-2.374269005844809e-05,1.0745914334655473,1.0741934100157038,,False,True,1.0,1.06932,1.07352,1.0727200000000001,1.0723200000000002,True,2024-02-13 15:45:00,,2024-02-06 12:24:13,0.01,even,True,14.68,1037.6099999999992,18,0,6,2
2024-02-05 21:55:00,1.07431,1.07433,1.07414,1.07422,330,12,0,1.0740946803189277,1.0743589096234747,-0.00014402031830533786,-0.00011137481892366984,1.5500803642788645e-06,-4.366925962509027e-05,1.0742773711882079,1.0744667882173329,2024-02-05 21:00:00,2024-02-05 21:00:00,0.00019119047619087226,-0.0012779339771293863,1.0738430952380957,0.0005437360422776407,0.00013940085285019563,1.0735803571428564,1.071858781204319,1.0741407202774809,1.0721012985416287,1.0744326759759895,3.473320838843812e-05,0.00014446674741548383,1.0741859223854322,1.076327209213765,37.84355179703627,42.578926607012086,-0.001429160535516051,,-1.0,1.0748822893548087,bearish,1.074329754328153,1.0742083843633683,1.074339828001376,0.00012136996478462336,0.0001682432629703069,0.0001892678877227583,-5.259373924948463e-05,-2.636394908939188e-05,7.736498107924206e-06,1.0745290958890987,1.0741505601136534,,False,True,1.0,1.06922,1.07342,1.0726200000000001,1.0722200000000002,True,2024-02-13 15:45:00,,2024-02-06 12:23:50,0.01,even,True,14.68,1052.2899999999993,19,0,6,2
2024-02-05 22:00:00,1.07423,1.07425,1.07394,1.07398,235,12,0,1.073929989153961,1.07425,-0.00014434549029339748,-8.711763092308082e-05,-9.739028490622216e-05,-9.287362732885949e-05,1.0742428793377243,1.0745564412590218,2024-02-05 22:00:00,2024-02-05 22:00:00,0.00026273809523935654,-0.00114079277001089,1.0740954761904766,0.0002867376885260737,0.00017970548587797148,1.0738430952380957,1.0724220097277513,1.074217667142764,1.071858781204319,1.0741407202774809,0.00013940085285019563,0.0005437360422776407,1.0741953074618107,1.0761570324766638,20.580108952190148,33.169644022352095,-0.001371486982415019,,-1.0,1.0747904871666507,bearish,1.0742759459699756,1.0741914670031187,1.0742639456484344,8.447896685681577e-05,0.0001514904037476087,0.0001783890878288174,-7.588235294164747e-05,-5.259373924948463e-05,-2.636394908939188e-05,1.0744423347362633,1.0740855565606056,,False,True,1.0,1.06898,1.07318,1.07238,1.0719800000000002,True,2024-02-13 15:45:00,,2024-02-06 12:10:15,0.01,even,True,14.68,1066.9699999999993,20,0,6,2
2024-02-05 22:10:00,1.07399,1.074,1.07362,1.07366,211,12,0,1.0735833336605303,1.074,1.7076323838744775e-05,-2.8619715033515583e-05,-0.00011137481892366984,-0.00014402031830533786,1.0740836859316119,1.0743504052640858,2024-02-05 22:00:00,2024-02-05 22:00:00,0.00026273809523935654,-0.00114079277001089,1.0740954761904766,0.0002867376885260737,0.00017970548587797148,1.0738430952380957,1.0724220097277513,1.074217667142764,1.071858781204319,1.0741407202774809,0.00013940085285019563,0.0005437360422776407,1.0741953074618107,1.0761570324766638,6.124077554995718,12.495120450281911,-0.001371486982415019,,-1.0,1.0747904871666507,bearish,1.0741426595406334,1.074137595167283,1.074083374613004,5.064373350460727e-06,0.00010670481948186414,0.00019867225940316442,-0.00011941176470431358,-6.115927072603e-05,-7.588235294164747e-05,1.0742820468724072,1.073884702353601,,False,True,1.0,1.0686600000000002,1.0728600000000001,1.0720600000000002,1.0716600000000003,True,2024-02-13 15:50:00,,2024-02-06 13:20:22,0.01,even,True,14.68,1081.6499999999994,21,0,6,2
2024-02-05 23:00:00,1.0742099999999999,1.07422,1.07403,1.07403,133,11,0,1.0740200025841702,1.07422,-5.121330030965717e-05,-7.470582713559642e-05,-3.5681045540928246e-05,-1.2184416042089469e-05,1.0740790653512902,1.0743639285473792,2024-02-05 23:00:00,2024-02-05 23:00:00,0.00025238095238089286,-0.0010200335954595463,1.0742119047619048,9.026288418119218e-05,-2.8607395568299947e-05,1.0740954761904766,1.0733469336204384,1.074618541546663,1.0724220097277513,1.074217667142764,0.00017970548587797148,0.0002867376885260737,1.0741917691539369,1.0759996698785308,64.21165726565062,64.66755019535009,-0.0013011963050239246,,-1.0,1.0747105670699033,bearish,1.0740695092725754,1.0740761875706608,1.0739658513931887,-6.678298085427414e-06,-1.2135942573466278e-05,0.0002450829791227004,2.7499140006437273e-05,4.979704162377807e-05,4.27313381492489e-05,1.0742109343723114,1.073720768414066,,False,True,1.0,1.0690300000000001,1.0732300000000001,1.0724300000000002,1.0720300000000003,True,2024-02-13 15:45:00,,2024-02-06 12:10:23,0.01,even,True,14.68,1096.3299999999995,22,0,6,2
2024-02-05 23:05:00,1.07403,1.07406,1.074,1.07401,109,11,0,1.0739249986196748,1.07406,-1.3966268065013375e-05,-2.7268384044412496e-05,-6.981489575790094e-05,-5.551996606607032e-05,1.0741557419446366,1.0743646481502804,2024-02-05 23:00:00,2024-02-05 23:00:00,0.00025238095238089286,-0.0010200335954595463,1.0742119047619048,9.026288418119218e-05,-2.8607395568299947e-05,1.0740954761904766,1.0733469336204384,1.074618541546663,1.0724220097277513,1.074217667142764,0.00017970548587797148,0.0002867376885260737,1.0741917691539369,1.0759996698785308,59.27477840451411,63.77652430835522,-0.0013011963050239246,,-1.0,1.0747105670699033,bearish,1.0740603539998714,1.0740712847876488,1.0739843825249382,-1.0930787777363449e-05,-1.1894911614245712e-05,0.00024217211507984284,1.8531131749544016e-05,2.7499140006437273e-05,4.979704162377807e-05,1.074226554640018,1.0737422104098584,,False,True,1.0,1.06901,1.07321,1.07241,1.0720100000000001,True,2024-02-13 15:45:00,,2024-02-06 12:10:17,0.01,even,True,14.68,1111.0099999999995,23,0,6,2
2024-02-05 23:10:00,1.07402,1.07403,1.07391,1.07392,142,11,0,1.073920736493213,1.07403,-1.885248098101753e-05,-1.574686018679576e-05,-9.34401339712023e-05,-6.0518921832866536e-05,1.074090365387607,1.074313220992898,2024-02-05 23:00:00,2024-02-05 23:00:00,0.00025238095238089286,-0.0010200335954595463,1.0742119047619048,9.026288418119218e-05,-2.8607395568299947e-05,1.0740954761904766,1.0733469336204384,1.074618541546663,1.0724220097277513,1.074217667142764,0.00017970548587797148,0.0002867376885260737,1.0741917691539369,1.0759996698785308,50.228310502284636,57.904915390816456,-0.0013011963050239246,,-1.0,1.0747105670699033,bearish,1.0740387610768143,1.0740600785070822,1.073982648778809,-2.1317430267897564e-05,-1.3779415344976082e-05,0.00023831561703366224,-1.7337461293287504e-06,1.8531131749544016e-05,2.7499140006437273e-05,1.0742209643958425,1.0737443331617753,,False,True,1.0,1.06892,1.07312,1.0723200000000002,1.0719200000000002,True,2024-02-13 15:45:00,,2024-02-06 12:03:12,0.01,even,True,14.68,1125.6899999999996,24,0,6,2
2024-02-06 11:25:00,1.07396,1.074,1.07383,1.074,248,12,0,1.07383,1.0742199719537222,-2.7714295644897645e-05,0.00011170953813932145,-0.0001677739845531736,-8.346422063004365e-05,1.0740236004001582,1.0745171300185368,2024-02-06 11:00:00,2024-02-06 11:00:00,-0.0001265476190484005,-7.686417342345209e-05,1.0742705952380953,-0.0005473373215710432,-0.00022234070776701697,1.074953809523809,1.0747992597509974,1.0766310755810504,1.0742930689144892,1.0750302403482601,0.0003650636838180225,3.973030041647868e-05,1.0734783660872407,1.0750229936982283,5.8403584719395125,8.351672048566067,-0.00031852172530993694,1.0739774534074713,1.0,1.074484803883599,bullish,1.0745169619067247,1.0748527170315756,1.0741302373581003,-0.000335755124850845,-0.00019740727116381577,0.0005865401378674643,-0.0001671895424850689,-0.00017454076367218185,-0.00016496044031732993,1.0747167774959678,1.0735436972202328,,True,False,0.0,1.079,1.0748,1.0756,1.0759999999999998,True,2024-02-07 03:05:00,2024-02-09 15:31:18,2024-02-06 19:00:14,0.01,even,True,14.68,1140.3699999999997,25,0,6,2
2024-02-06 11:30:00,1.07401,1.07435,1.07379,1.07434,425,12,0,1.07379,1.074720111055447,-8.982440468264785e-05,-0.00024205608025025974,5.977316029320369e-06,-2.8275855937629973e-05,1.0738789134979039,1.0743204604671104,2024-02-06 11:00:00,2024-02-06 11:00:00,-0.0001265476190484005,-7.686417342345209e-05,1.0742705952380953,-0.0005473373215710432,-0.00022234070776701697,1.074953809523809,1.0747992597509974,1.0766310755810504,1.0742930689144892,1.0750302403482601,0.0003650636838180225,3.973030041647868e-05,1.0734783660872407,1.0750229936982283,13.468971066227661,9.121185337816426,-0.00031852172530993694,1.0739774534074713,1.0,1.074484803883599,bullish,1.0744897369979978,1.0748147379921997,1.0740533161334713,-0.0003250009942019627,-0.00022292601577144516,0.0005864605698559728,-7.692122462898965e-05,-0.0001671895424850689,-0.00017454076367218185,1.0746397767033273,1.0734668555636153,,True,False,0.0,1.07934,1.07514,1.07594,1.0763399999999999,True,2024-02-07 03:50:00,2024-02-09 15:31:19,2024-02-06 19:57:58,0.01,even,True,14.68,1155.0499999999997,26,0,6,2
2024-02-07 08:40:00,1.07578,1.076,1.07575,1.07595,177,12,0,1.07575,1.076046663273823,7.458943429674355e-05,8.053682636524303e-05,-3.430817287057639e-05,-4.183315252380194e-05,1.0756967019102412,1.0760972973833862,2024-02-07 08:00:00,2024-02-07 08:00:00,7.964285714323616e-05,0.00039687681708122646,1.0760874999999999,-9.387551538414386e-05,-3.4294718720774655e-05,1.076118214285714,1.0758045634377462,1.0766242156732675,1.075825344878558,1.0767095034022822,-5.7613816620685196e-05,-6.840392538124463e-05,1.0760685002733859,1.0753955678065306,20.52300109528997,14.583446822405707,0.0003337773444388159,1.0750825037241352,1.0,1.0760739882738144,bullish,1.0759993748268004,1.0760245803536912,1.076000677674579,-2.520552689078137e-05,1.986546819092174e-05,0.0002165640782813274,-5.287581699242594e-05,-8.104231166194964e-05,-9.564499483971645e-05,1.0762172417528604,1.0757841135962976,,True,False,0.0,1.0809499999999999,1.0767499999999999,1.0775499999999998,1.0779499999999997,True,2024-02-07 15:30:00,,2024-02-07 09:48:00,0.01,even,True,14.68,1169.7299999999998,27,0,6,2
2024-02-07 08:45:00,1.07594,1.07609,1.07589,1.0760399999999999,215,12,0,1.075900756192254,1.0760792662206307,4.0039642703689884e-05,0.00013030376823734016,7.102476790863951e-05,0.00010070385782786803,1.075509624982968,1.0758556000691468,2024-02-07 08:00:00,2024-02-07 08:00:00,7.964285714323616e-05,0.00039687681708122646,1.0760874999999999,-9.387551538414386e-05,-3.4294718720774655e-05,1.076118214285714,1.0758045634377462,1.0766242156732675,1.075825344878558,1.0767095034022822,-5.7613816620685196e-05,-6.840392538124463e-05,1.0760685002733859,1.0753955678065306,35.6060606060587,21.41648846468132,0.0003337773444388159,1.0750825037241352,1.0,1.0760739882738144,bullish,1.0760056248534464,1.076025722549714,1.0759795528035765,-2.0097696267651344e-05,1.1872835299207121e-05,0.00021130546609568162,-2.1124871002475842e-05,-5.287581699242594e-05,-8.104231166194964e-05,1.0761908582696722,1.0757682473374808,,True,False,0.0,1.0810399999999998,1.0768399999999998,1.0776399999999997,1.0780399999999997,True,2024-02-07 15:30:00,,2024-02-07 09:45:07,0.01,even,True,14.68,1184.4099999999999,28,0,6,2
2024-02-07 08:50:00,1.07603,1.07622,1.07603,1.07609,200,12,0,1.0759433510089829,1.0762092656368696,4.02648996668425e-05,0.00014576825606586876,0.00010721771071452675,0.0001301378990911597,1.0756202651823705,1.0758823454558373,2024-02-07 08:00:00,2024-02-07 08:00:00,7.964285714323616e-05,0.00039687681708122646,1.0760874999999999,-9.387551538414386e-05,-3.4294718720774655e-05,1.076118214285714,1.0758045634377462,1.0766242156732675,1.075825344878558,1.0767095034022822,-5.7613816620685196e-05,-6.840392538124463e-05,1.0760685002733859,1.0753955678065306,47.34848484848428,34.49251551661096,0.0003337773444388159,1.0750825037241352,1.0,1.0760739882738144,bullish,1.076018605645224,1.0760304838423278,1.0759677708978324,-1.1878197103909471e-05,7.122628818583803e-06,0.0002022226495772021,-1.1781905744134846e-05,-2.1124871002475842e-05,-5.287581699242594e-05,1.0761699935474096,1.075765548248255,,True,False,0.0,1.0810899999999999,1.07689,1.0776899999999998,1.0780899999999998,True,2024-02-07 15:30:00,,2024-02-07 09:45:06,0.01,even,True,14.68,1199.09,29,0,6,2
2024-02-09 03:05:00,1.07734,1.07749,1.07734,1.0774,142,12,0,1.0772316904568013,1.0774914467940087,0.00010982135775277291,9.54405210668379e-05,5.068779509390571e-05,5.879077512936876e-05,1.0771013956024238,1.0773840712243699,2024-02-09 03:00:00,2024-02-09 03:00:00,-0.00013261904761963095,0.0001309372374995732,1.0774461904761907,-0.00010581443106034993,7.202723211892671e-07,1.0775289285714287,1.0774934947835202,1.077796952619102,1.077405550156025,1.0779073913895232,-2.3017168959131872e-05,-5.5517896806390255e-05,1.0773703503066614,1.07718957972497,25.641025641007246,17.13776963775872,5.882727654660652e-05,1.0750420033738344,1.0,1.0773114611204544,bullish,1.0774204441515005,1.077481614233009,1.077371640866873,-6.117008150852143e-05,-3.4251322871940604e-05,0.00015437832321772222,-2.241486068133014e-05,-3.3938768490227034e-05,-5.737874096922724e-05,1.0775260191900906,1.0772172625436554,,True,False,0.0,1.0823999999999998,1.0781999999999998,1.0789999999999997,1.0793999999999997,True,2024-02-12 01:25:00,,2024-02-09 15:41:12,0.01,even,True,14.68,1213.77,30,0,6,2
2024-02-09 03:10:00,1.07739,1.0776,1.07735,1.07758,154,12,0,1.07735,1.077673325496611,6.211270825022246e-05,5.876876416720061e-05,6.18740686285731e-05,5.546319953987638e-05,1.0771752189776798,1.0774383138400365,2024-02-09 03:00:00,2024-02-09 03:00:00,-0.00013261904761963095,0.0001309372374995732,1.0774461904761907,-0.00010581443106034993,7.202723211892671e-07,1.0775289285714287,1.0774934947835202,1.077796952619102,1.077405550156025,1.0779073913895232,-2.3017168959131872e-05,-5.5517896806390255e-05,1.0773703503066614,1.07718957972497,43.92628205126715,27.818732193718528,5.882727654660652e-05,1.0750420033738344,1.0,1.0773114611204544,bullish,1.0774449912051158,1.0774889020676008,1.0773778981768145,-4.3910862485008195e-05,-3.6183230794554125e-05,0.00015513435041788863,6.257309941526401e-06,-2.241486068133014e-05,-3.3938768490227034e-05,1.0775330325272323,1.0772227638263967,,True,False,0.0,1.0825799999999999,1.07838,1.0791799999999998,1.0795799999999998,True,2024-02-12 01:55:00,,2024-02-09 15:40:48,0.01,even,True,14.68,1228.45,31,0,6,2
2024-02-09 03:15:00,1.07758,1.07769,1.07747,1.07769,161,12,0,1.07747,1.0778733416469122,2.3592991856955516e-07,-6.80452325716964e-05,5.544055188917531e-05,5.723872435312346e-05,1.0772312881135098,1.0775044695379041,2024-02-09 03:00:00,2024-02-09 03:00:00,-0.00013261904761963095,0.0001309372374995732,1.0774461904761907,-0.00010581443106034993,7.202723211892671e-07,1.0775289285714287,1.0774934947835202,1.077796952619102,1.077405550156025,1.0779073913895232,-2.3017168959131872e-05,-5.5517896806390255e-05,1.0773703503066614,1.07718957972497,61.78685897434275,43.78472222220571,5.882727654660652e-05,1.0750420033738344,1.0,1.0773114611204544,bullish,1.0774826848658674,1.0775037982107416,1.0774004334365321,-2.11133448742018e-05,-3.316925361048366e-05,0.00015784169288583837,2.2535259717626488e-05,6.257309941526401e-06,-2.241486068133014e-05,1.077558275129418,1.0772425917436463,,True,False,0.0,1.08269,1.07849,1.0792899999999999,1.0796899999999998,True,2024-02-12 01:55:00,,2024-02-09 15:40:08,0.01,even,True,14.68,1243.13,32,0,6,2
2024-02-09 04:10:00,1.0774,1.07753,1.07736,1.07749,101,12,0,1.07736,1.0776749972519462,8.375957946961439e-05,4.1758237462567095e-05,2.141670906434009e-05,4.0224523486028946e-05,1.0772099029203268,1.0774517222193072,2024-02-09 04:00:00,2024-02-09 04:00:00,-8.273809523795528e-05,0.0001158177032722918,1.0774632142857141,-3.620038724433432e-05,7.216639456061742e-07,1.0774461904761907,1.0772350774040063,1.077797724668742,1.0774934947835202,1.077796952619102,7.202723211892671e-07,-0.00010581443106034993,1.077490116768887,1.0772184133469724,35.88134635832419,35.39185716816772,7.022536189174358e-05,1.075169123238881,1.0,1.0773387310649591,bullish,1.0774697552201065,1.07749244464294,1.0775090264877876,-2.2689422833455097e-05,-1.491802376124494e-05,0.00014614718612725408,-1.2418300654459813e-06,-1.9040247678736577e-05,-9.917440660922594e-06,1.0776551736739148,1.0773628793016603,,True,False,0.0,1.08249,1.07829,1.0790899999999999,1.0794899999999998,True,2024-02-12 01:50:00,,2024-02-09 15:40:49,0.01,even,True,14.68,1257.8100000000002,33,0,6,2
2024-02-09 04:15:00,1.07749,1.07772,1.07749,1.07769,134,12,0,1.07749,1.077759998887336,1.5704512857771395e-05,-9.278073461818299e-06,0.00010232069781416642,5.723645473045812e-05,1.0772412917185552,1.077397479696536,2024-02-09 04:00:00,2024-02-09 04:00:00,-8.273809523795528e-05,0.0001158177032722918,1.0774632142857141,-3.620038724433432e-05,7.216639456061742e-07,1.0774461904761907,1.0772350774040063,1.077797724668742,1.0774934947835202,1.077796952619102,7.202723211892671e-07,-0.00010581443106034993,1.077490116768887,1.0772184133469724,50.56884635832349,39.574528176502895,7.022536189174358e-05,1.075169123238881,1.0,1.0773387310649591,bullish,1.0775036390323978,1.0775070783730925,1.0775435087719285,-3.439340694688653e-06,-1.2622287147933683e-05,0.00014926709844978448,3.448228414093535e-05,-1.2418300654459813e-06,-1.9040247678736577e-05,1.0776927758703783,1.0773942416734787,,True,False,0.0,1.08269,1.07849,1.0792899999999999,1.0796899999999998,True,2024-02-12 01:55:00,,2024-02-09 15:40:08,0.01,even,True,14.68,1272.4900000000002,34,0,6,2
2024-02-09 05:55:00,1.07696,1.07707,1.07696,1.07702,50,12,0,1.07696,1.0771216736976525,-3.67870424962205e-05,-6.654409075569454e-05,-8.97377820190246e-05,-8.820065156255115e-05,1.0771529464237464,1.0773495018548218,2024-02-09 05:00:00,2024-02-09 05:00:00,1.702380952339766e-05,0.00012250499557753258,1.0772816666666667,-5.856634220978125e-05,-6.423366719062719e-05,1.0774632142857141,1.077218406101926,1.077951791389968,1.0772350774040063,1.077797724668742,7.216639456061742e-07,-3.620038724433432e-05,1.077176705589629,1.0772025402792147,4.263193001366738,9.202177240741822,8.068128862890139e-05,1.0752911583093256,1.0,1.0773690971114593,bullish,1.0772416143946353,1.0773637513616903,1.0771015961472308,-0.00012213696705498656,-6.985621991986435e-05,0.00020597491759585245,-5.580667354609936e-05,-6.996216030419333e-05,-5.37392500852274e-05,1.0773075710648266,1.076895621229635,,True,False,0.0,1.08202,1.07782,1.07862,1.0790199999999999,True,2024-02-09 16:15:00,,2024-02-09 09:53:29,0.01,even,True,14.68,1287.1700000000003,35,0,6,2
2024-02-09 06:15:00,1.07689,1.07706,1.07688,1.07704,37,12,0,1.07688,1.0771566677540347,4.356916794025601e-05,-1.5473963530229997e-05,-2.3621937111172113e-07,-3.5557020258147556e-07,1.0768811203019117,1.0770499811178231,2024-02-09 06:00:00,2024-02-09 06:00:00,-0.00018154761904742855,6.521460518160715e-05,1.0771753571428568,-6.981558781718556e-05,-8.422693014183149e-05,1.0772816666666667,1.0771651892301908,1.0779348290567468,1.077218406101926,1.077951791389968,-6.423366719062719e-05,-5.856634220978125e-05,1.077092235196543,1.0771903370568776,9.693039727767998,5.174338334065166,7.758795193944254e-05,1.0754083119769526,1.0,1.0774025762244583,bullish,1.0770974432390972,1.077252127735083,1.0769044650842796,-0.00015468449598587952,-0.00011854023452025859,0.00027597524045519344,-1.6969384244447383e-05,-4.907464740333545e-05,-6.3584451323484e-05,1.0771804403247347,1.0766284898438245,,True,False,0.0,1.08204,1.07784,1.0786399999999998,1.0790399999999998,True,2024-02-09 16:15:00,,2024-02-09 10:07:22,0.01,even,True,14.68,1301.8500000000004,36,0,6,2
2024-02-09 06:20:00,1.07704,1.07714,1.07704,1.0771,59,12,0,1.077026666780364,1.07714,-7.737463628857054e-06,-1.880614957412325e-05,5.2379363378118314e-05,2.7854993438046325e-05,1.076822236484886,1.076964189741045,2024-02-09 06:00:00,2024-02-09 06:00:00,-0.00018154761904742855,6.521460518160715e-05,1.0771753571428568,-6.981558781718556e-05,-8.422693014183149e-05,1.0772816666666667,1.0771651892301908,1.0779348290567468,1.077218406101926,1.077951791389968,-6.423366719062719e-05,-5.856634220978125e-05,1.077092235196543,1.0771903370568776,21.260683760685115,10.897832483483574,7.758795193944254e-05,1.0754083119769526,1.0,1.0774025762244583,bullish,1.0770978365869284,1.077240859013966,1.0769131785345714,-0.00014302242703756463,-0.0001234366730237198,0.0002709046572947767,8.713450291741864e-06,-1.6969384244447383e-05,-4.907464740333545e-05,1.0771840831918662,1.0766422738772765,,True,False,0.0,1.0820999999999998,1.0778999999999999,1.0786999999999998,1.0790999999999997,True,2024-02-09 16:15:00,,2024-02-09 10:06:48,0.01,even,True,14.68,1316.5300000000004,37,0,6,2
2024-02-09 06:30:00,1.07704,1.07707,1.07701,1.07705,49,12,0,1.0770178603748706,1.0770833344227944,1.9231446038966103e-05,5.4155168661163715e-05,-1.5473963530229997e-05,4.356916794025601e-05,1.0768834825895897,1.0771554305674231,2024-02-09 06:00:00,2024-02-09 06:00:00,-0.00018154761904742855,6.521460518160715e-05,1.0771753571428568,-6.981558781718556e-05,-8.422693014183149e-05,1.0772816666666667,1.0771651892301908,1.0779348290567468,1.077218406101926,1.077951791389968,-6.423366719062719e-05,-5.856634220978125e-05,1.077092235196543,1.0771903370568776,33.68539301685906,28.573643526237735,7.758795193944254e-05,1.0754083119769526,1.0,1.0774025762244583,bullish,1.077082948088866,1.0772129449708212,1.0769270037839693,-0.00012999688195525216,-0.00012692555400768994,0.00026240363312406026,1.5455796354313378e-05,-1.6305469563437924e-06,8.713450291741864e-06,1.0771894074170933,1.0766646001508453,,True,False,0.0,1.08205,1.07785,1.0786499999999999,1.0790499999999998,True,2024-02-09 16:15:00,,2024-02-09 10:07:22,0.01,even,True,14.68,1331.2100000000005,38,0,6,2
2024-02-09 06:35:00,1.07705,1.07709,1.07703,1.07709,58,12,0,1.07703,1.0772049979992016,9.521906317031843e-06,-4.639795401855413e-06,-1.880614957412325e-05,-7.737463628857054e-06,1.0770260479135305,1.0771384956669643,2024-02-09 06:00:00,2024-02-09 06:00:00,-0.00018154761904742855,6.521460518160715e-05,1.0771753571428568,-6.981558781718556e-05,-8.422693014183149e-05,1.0772816666666667,1.0771651892301908,1.0779348290567468,1.077218406101926,1.077951791389968,-6.423366719062719e-05,-5.856634220978125e-05,1.077092235196543,1.0771903370568776,37.648255335712825,34.0361673845803,7.758795193944254e-05,1.0754083119769526,1.0,1.0774025762244583,bullish,1.0770840329982712,1.0772038379359457,1.0769451977984188,-0.00011980493767449474,-0.0001255014307410509,0.00025956566287384594,1.8194014449468554e-05,1.5455796354313378e-05,-1.6305469563437924e-06,1.0772047634612927,1.076685632135545,,True,False,0.0,1.08209,1.07789,1.07869,1.0790899999999999,True,2024-02-09 16:15:00,,2024-02-09 10:06:48,0.01,even,True,14.68,1345.8900000000006,39,0,6,2
2024-02-09 06:40:00,1.0771,1.0772,1.0771,1.0771600000000001,27,12,0,1.0771,1.0772014276108866,-2.1883954849342315e-05,-2.5198224022840797e-05,2.7615831905782955e-05,1.702178738999801e-05,1.0769946972797024,1.0771022108880135,2024-02-09 06:00:00,2024-02-09 06:00:00,-0.00018154761904742855,6.521460518160715e-05,1.0771753571428568,-6.981558781718556e-05,-8.422693014183149e-05,1.0772816666666667,1.0771651892301908,1.0779348290567468,1.077218406101926,1.077951791389968,-6.423366719062719e-05,-5.856634220978125e-05,1.077092235196543,1.0771903370568776,48.72122762151213,40.01829199136133,7.758795193944254e-05,1.0754083119769526,1.0,1.0774025762244583,bullish,1.0770957202293063,1.077200590681431,1.076979783281734,-0.00010487045212470569,-0.00012137523501778187,0.00024783529478846655,3.4585483315252574e-05,1.8194014449468554e-05,1.5455796354313378e-05,1.0772276185765226,1.0767319479869455,,True,False,0.0,1.08216,1.07796,1.07876,1.07916,True,2024-02-09 16:15:00,,2024-02-09 10:36:07,0.01,even,True,14.68,1360.5700000000006,40,0,6,2
2024-02-09 07:00:00,1.07705,1.07714,1.07704,1.07714,40,12,0,1.07704,1.0771899972559569,1.8806412243560895e-05,9.284600848999355e-06,-1.5710021850077337e-05,-1.7022390445893425e-05,1.0770653054686863,1.077178742498658,2024-02-09 07:00:00,2024-02-09 07:00:00,-0.00010630952380985548,2.7329530212005793e-05,1.0771007142857136,-9.656186976268626e-05,-0.0001410573303250516,1.0771753571428568,1.0771602871438295,1.0779727870908704,1.0771651892301908,1.0779348290567468,-8.422693014183149e-05,-6.981558781718556e-05,1.077057411732181,1.0771783100923273,64.25796425799312,60.35370426677273,6.75362675939552e-05,1.0755207794978745,1.0,1.0774391782465051,bullish,1.077100077724074,1.0771751877911828,1.0770676642586863,-7.511006710880785e-05,-9.916600824562131e-05,0.00018986837548286175,2.4220846233546922e-05,1.1138630890528134e-05,2.176470588244328e-05,1.0772575326341691,1.0768777958832034,,True,False,0.0,1.0821399999999999,1.07794,1.0787399999999998,1.0791399999999998,True,2024-02-09 16:15:00,,2024-02-09 10:36:12,0.01,even,True,14.68,1375.2500000000007,41,0,6,2
2024-02-09 07:05:00,1.07714,1.07721,1.07713,1.07719,38,12,0,1.077140757925413,1.077256669740027,-4.9752062450533684e-05,-4.332370575949908e-05,1.8330520012663737e-05,1.2378765157759312e-05,1.0770143267986623,1.0771414681217668,2024-02-09 07:00:00,2024-02-09 07:00:00,-0.00010630952380985548,2.7329530212005793e-05,1.0771007142857136,-9.656186976268626e-05,-0.0001410573303250516,1.0771753571428568,1.0771602871438295,1.0779727870908704,1.0771651892301908,1.0779348290567468,-8.422693014183149e-05,-6.981558781718556e-05,1.077057411732181,1.0771783100923273,76.82709447417653,66.02343190580937,6.75362675939552e-05,1.0755207794978745,1.0,1.0774391782465051,bullish,1.0771139119203703,1.077176284991836,1.0771140660474714,-6.237307146572668e-05,-9.180742088964239e-05,0.00016319926472955652,4.640178878512202e-05,2.4220846233546922e-05,1.1138630890528134e-05,1.077277265312201,1.0769508667827419,,True,False,0.0,1.08219,1.07799,1.07879,1.0791899999999999,True,2024-02-09 16:15:00,,2024-02-09 15:41:26,0.01,even,True,14.68,1389.9300000000007,42,0,6,2
2024-02-09 07:15:00,1.0771,1.07713,1.07709,1.07712,58,13,0,1.07692833634165,1.0771192318931062,4.797201207520401e-05,5.903129069126475e-05,9.284600848999355e-06,1.8806412243560895e-05,1.077041504780645,1.077190740259369,2024-02-09 07:00:00,2024-02-09 07:00:00,-0.00010630952380985548,2.7329530212005793e-05,1.0771007142857136,-9.656186976268626e-05,-0.0001410573303250516,1.0771753571428568,1.0771602871438295,1.0779727870908704,1.0771651892301908,1.0779348290567468,-8.422693014183149e-05,-6.981558781718556e-05,1.077057411732181,1.0771783100923273,79.14438502675434,79.38205585266205,6.75362675939552e-05,1.0755207794978745,1.0,1.0774391782465051,bullish,1.0771143393039337,1.0771675694374452,1.077150361197111,-5.323013351143935e-05,-7.869316102743474e-05,0.00013155733860651712,1.6422428621654106e-05,1.9872721017888395e-05,4.640178878512202e-05,1.0772819185357174,1.0770188038585045,,True,False,0.0,1.08212,1.07792,1.07872,1.0791199999999999,True,2024-02-09 16:15:00,,2024-02-09 10:36:27,0.01,even,True,14.68,1404.6100000000008,43,0,6,2
2024-02-09 07:25:00,1.07711,1.07717,1.07708,1.07714,83,12,0,1.07708,1.0772784570958351,3.33238206757842e-06,1.9281042383175597e-05,-1.5711180702154865e-05,-4.178058105630493e-05,1.0770666534981836,1.0772087423708736,2024-02-09 07:00:00,2024-02-09 07:00:00,-0.00010630952380985548,2.7329530212005793e-05,1.0771007142857136,-9.656186976268626e-05,-0.0001410573303250516,1.0771753571428568,1.0771602871438295,1.0779727870908704,1.0771651892301908,1.0779348290567468,-8.422693014183149e-05,-6.981558781718556e-05,1.077057411732181,1.0771783100923273,70.66315327185016,73.60389917935485,6.75362675939552e-05,1.0755207794978745,1.0,1.0774391782465051,bullish,1.0771177222235264,1.0771615787358069,1.0771636945304424,-4.385651228044907e-05,-6.70762560669774e-05,0.00010523782593544738,9.917440659368282e-06,3.4158926720539995e-06,1.6422428621654106e-05,1.0772689323563778,1.077058456704507,,True,False,0.0,1.0821399999999999,1.07794,1.0787399999999998,1.0791399999999998,True,2024-02-09 16:15:00,,2024-02-09 10:36:12,0.01,even,True,14.68,1419.2900000000009,44,0,6,2
2024-02-09 07:30:00,1.07714,1.07731,1.07714,1.07729,44,12,0,1.07714,1.077390009167065,-2.851701463384574e-05,-6.498244941701448e-05,5.903129069126475e-05,4.797201207520401e-05,1.0769321825447646,1.0771239656256275,2024-02-09 07:00:00,2024-02-09 07:00:00,-0.00010630952380985548,2.7329530212005793e-05,1.0771007142857136,-9.656186976268626e-05,-0.0001410573303250516,1.0771753571428568,1.0771602871438295,1.0779727870908704,1.0771651892301908,1.0779348290567468,-8.422693014183149e-05,-6.981558781718556e-05,1.077057411732181,1.0771783100923273,77.73386034255995,73.1337242846234,6.75362675939552e-05,1.0755207794978745,1.0,1.0774391782465051,bullish,1.07714422649683,1.0771710914220434,1.077194334365325,-2.6864925213310187e-05,-5.903398989624396e-05,0.00010598270302723609,3.0639834882606465e-05,9.917440659368282e-06,3.4158926720539995e-06,1.0773003170683522,1.0770883516622978,,True,False,0.0,1.08229,1.07809,1.07889,1.0792899999999999,True,2024-02-09 16:15:00,,2024-02-09 15:41:15,0.01,even,True,14.68,1433.970000000001,45,0,6,2
2024-02-09 07:50:00,1.07705,1.07712,1.07704,1.07706,27,12,0,1.076879999854595,1.0771450014314818,1.8572134021942342e-05,-2.3211101202818666e-05,-6.521576749392394e-05,-3.4043643022691516e-05,1.0771106131136894,1.0773147843838766,2024-02-09 07:00:00,2024-02-09 07:00:00,-0.00010630952380985548,2.7329530212005793e-05,1.0771007142857136,-9.656186976268626e-05,-0.0001410573303250516,1.0771753571428568,1.0771602871438295,1.0779727870908704,1.0771651892301908,1.0779348290567468,-8.422693014183149e-05,-6.981558781718556e-05,1.077057411732181,1.0771783100923273,27.450980392118442,40.503069914808954,6.75362675939552e-05,1.0755207794978745,1.0,1.0774391782465051,bullish,1.0771150386940265,1.0771488999658207,1.0771330478156167,-3.386127179427767e-05,-4.1921940662117414e-05,8.972179226572452e-05,-1.243894048963412e-05,-1.7619539042001975e-05,-2.1369109048263724e-05,1.0772227696078824,1.077043326023351,,True,False,0.0,1.0820599999999998,1.0778599999999998,1.0786599999999997,1.0790599999999997,True,2024-02-09 16:15:00,,2024-02-09 10:07:22,0.01,even,True,14.68,1448.650000000001,46,0,6,2
2024-02-09 08:05:00,1.077,1.07707,1.07699,1.07704,47,12,0,1.07699,1.0771700010058012,1.5712655924693088e-05,-9.284562528873505e-06,-2.3211101202818666e-05,1.8572134021942342e-05,1.0768814841833796,1.0771431458918639,2024-02-09 08:00:00,2024-02-09 08:00:00,-7.46428571432034e-05,-6.485347106011119e-07,1.077153214285714,-6.68489669777286e-05,-6.744762484036304e-05,1.0771007142857136,1.077008618819748,1.0777545820950238,1.0771602871438295,1.0779727870908704,-0.0001410573303250516,-9.656186976268626e-05,1.0772724705773937,1.0771944452849413,29.365079365071818,27.419856831602413,5.389930713304394e-05,1.0756287483179596,1.0,1.0774788925296057,bullish,1.0770789515256025,1.0771230189486334,1.0770669521843823,-4.406742303086908e-05,-4.203720799434913e-05,8.621678108559387e-05,-1.554867561104345e-05,-2.9494324044865294e-05,-2.1052631578477587e-05,1.0771531689654679,1.0769807354032968,,True,False,0.0,1.08204,1.07784,1.0786399999999998,1.0790399999999998,True,2024-02-09 16:15:00,,2024-02-09 10:07:22,0.01,even,True,14.68,1463.330000000001,47,0,6,2
2024-02-09 08:10:00,1.07706,1.0771600000000001,1.07706,1.07712,124,12,0,1.0770707639224812,1.0771600000000001,-4.666189080365594e-05,-2.3873624826518426e-05,9.04727676439454e-06,4.678297467772554e-05,1.076903742821134,1.077120723964416,2024-02-09 08:00:00,2024-02-09 08:00:00,-7.46428571432034e-05,-6.485347106011119e-07,1.077153214285714,-6.68489669777286e-05,-6.744762484036304e-05,1.0771007142857136,1.077008618819748,1.0777545820950238,1.0771602871438295,1.0779727870908704,-0.0001410573303250516,-9.656186976268626e-05,1.0772724705773937,1.0771944452849413,35.7142857142832,30.39215686273452,5.389930713304394e-05,1.0756287483179596,1.0,1.0774788925296057,bullish,1.0770852666755097,1.0771227953228086,1.0770735534915727,-3.752864729889005e-05,-4.113549585525732e-05,7.548068190536777e-05,6.601307190434724e-06,-1.554867561104345e-05,-2.9494324044865294e-05,1.0771490341734782,1.0769980728096673,,True,False,0.0,1.08212,1.07792,1.07872,1.0791199999999999,True,2024-02-09 16:15:00,,2024-02-09 10:36:27,0.01,even,True,14.68,1478.0100000000011,48,0,6,2
2024-02-09 08:30:00,1.07708,1.07723,1.07708,1.07714,123,12,0,1.0770433396624226,1.07723,3.094502901501366e-05,6.164353541096283e-05,3.4274659875743014e-05,-3.2497572163574505e-05,1.0769873960530423,1.077121983968328,2024-02-09 08:00:00,2024-02-09 08:00:00,-7.46428571432034e-05,-6.485347106011119e-07,1.077153214285714,-6.68489669777286e-05,-6.744762484036304e-05,1.0771007142857136,1.077008618819748,1.0777545820950238,1.0771602871438295,1.0779727870908704,-0.0001410573303250516,-9.656186976268626e-05,1.0772724705773937,1.0771944452849413,47.61904761905013,45.50264550265221,5.389930713304394e-05,1.0756287483179596,1.0,1.0774788925296057,bullish,1.0770919305835278,1.077115900284269,1.077066222910216,-2.396970074114435e-05,-3.4383058862768934e-05,5.958747078388628e-05,9.752321981526535e-06,-9.246646028859828e-06,-5.741314067941872e-06,1.0771258103809997,1.077006635439432,,True,False,0.0,1.0821399999999999,1.07794,1.0787399999999998,1.0791399999999998,True,2024-02-09 16:15:00,,2024-02-09 10:36:12,0.01,even,True,14.68,1492.6900000000012,49,0,6,2
2024-02-09 08:40:00,1.07712,1.07724,1.07711,1.07723,61,12,0,1.077120766483365,1.0774033301878492,3.380245483631696e-05,3.403478261320787e-05,3.0944099059277275e-05,6.21336924454241e-05,1.0769249778669288,1.07719914633745,2024-02-09 08:00:00,2024-02-09 08:00:00,-7.46428571432034e-05,-6.485347106011119e-07,1.077153214285714,-6.68489669777286e-05,-6.744762484036304e-05,1.0771007142857136,1.077008618819748,1.0777545820950238,1.0771602871438295,1.0779727870908704,-0.0001410573303250516,-9.656186976268626e-05,1.0772724705773937,1.0771944452849413,61.111111111093486,52.645502645495924,5.389930713304394e-05,1.0756287483179596,1.0,1.0774788925296057,bullish,1.077114222488798,1.0771232615605872,1.0770983075335387,-9.039071789285202e-06,-2.7261044544971324e-05,6.337717786815033e-05,2.524251805890998e-05,6.842105263915599e-06,9.752321981526535e-06,1.077161684711407,1.0770349303556706,,True,False,0.0,1.0822299999999998,1.0780299999999998,1.0788299999999997,1.0792299999999997,True,2024-02-09 16:15:00,,2024-02-09 15:41:17,0.01,even,True,14.68,1507.3700000000013,50,0,6,2
2024-02-09 08:45:00,1.07723,1.07744,1.07723,1.07741,131,12,0,1.0772233312609871,1.0774292291614294,3.0953276713284048e-06,6.210837469795778e-05,6.164353541096283e-05,3.094502901501366e-05,1.0770458246862011,1.0772349511142765,2024-02-09 08:00:00,2024-02-09 08:00:00,-7.46428571432034e-05,-6.485347106011119e-07,1.077153214285714,-6.68489669777286e-05,-6.744762484036304e-05,1.0771007142857136,1.077008618819748,1.0777545820950238,1.0771602871438295,1.0779727870908704,-0.0001410573303250516,-9.656186976268626e-05,1.0772724705773937,1.0771944452849413,73.54497354495997,61.287477954132534,5.389930713304394e-05,1.0756287483179596,1.0,1.0774788925296057,bullish,1.0771597267212905,1.077144501444988,1.0771562917096666,1.5225276302377466e-05,-1.8763780375501567e-05,8.669871207045578e-05,5.7984176127900966e-05,2.524251805890998e-05,6.842105263915599e-06,1.077242990421737,1.0770695929975962,,True,False,0.0,1.0824099999999999,1.07821,1.0790099999999998,1.0794099999999998,True,2024-02-12 01:50:00,,2024-02-09 15:41:12,0.01,even,True,14.68,1522.0500000000013,51,0,6,2
2024-02-09 08:50:00,1.07741,1.07748,1.07735,1.07743,122,12,0,1.0771566754812494,1.0774692291216326,6.806997055211535e-05,7.460022095186922e-05,7.390218934272078e-05,9.592364084046003e-05,1.0770143894127102,1.0772759374115355,2024-02-09 08:00:00,2024-02-09 08:00:00,-7.46428571432034e-05,-6.485347106011119e-07,1.077153214285714,-6.68489669777286e-05,-6.744762484036304e-05,1.0771007142857136,1.077008618819748,1.0777545820950238,1.0771602871438295,1.0779727870908704,-0.0001410573303250516,-9.656186976268626e-05,1.0772724705773937,1.0771944452849413,88.13172778689847,74.26260414765063,5.389930713304394e-05,1.0756287483179596,1.0,1.0774788925296057,bullish,1.0772013072257074,1.0771656494861002,1.0772126143790846,3.5657739607231065e-05,-7.879476378955042e-06,0.00010637512244340256,5.6322669417907534e-05,5.7984176127900966e-05,2.524251805890998e-05,1.077318989501528,1.077106239256641,,True,False,0.0,1.08243,1.07823,1.07903,1.07943,True,2024-02-12 01:50:00,,2024-02-09 15:41:11,0.01,even,True,14.68,1536.7300000000014,52,0,6,2
2024-02-09 11:50:00,1.07669,1.07684,1.07666,1.07683,430,12,0,1.0765899798829774,1.0770588633835791,-0.0001346933133791117,-7.393278195878467e-05,-0.0002261174085920258,-4.715416995057776e-05,1.076637773558622,1.0775419644271078,2024-02-09 11:00:00,2024-02-09 11:00:00,-5.190476190386484e-05,6.196462872520847e-05,1.0771613095238088,-8.109661705339256e-05,0.00018618371520433068,1.0773820238095246,1.0768935509108197,1.0778126451088155,1.0767140169999154,1.0776120307209744,0.0001861998127321696,9.933850392012106e-05,1.076887869280644,1.0772030717300407,17.166777200622548,15.018631030714028,5.739823376965863e-05,1.0759274263518384,1.0,1.077615945191254,bullish,1.0771211391415687,1.0773118076798003,1.076845517715858,-0.00019066853823157537,-0.00011170752340673434,0.00043672951203197917,-6.39422084618424e-05,-0.00013242518059874975,-0.000128211214310614,1.07728224722789,1.076408788203826,,True,False,0.0,1.0818299999999998,1.0776299999999999,1.0784299999999998,1.0788299999999997,True,2024-02-09 16:10:00,,2024-02-09 15:35:27,0.01,even,True,14.68,1551.4100000000014,53,0,6,2
2024-02-09 12:00:00,1.07663,1.07676,1.0763,1.07673,462,12,0,1.0763,1.0769450225032249,-4.6228668238790954e-05,-0.00011609669769814285,3.4047438124661125e-05,-7.764543490908363e-05,1.0765445589223044,1.0769193756869069,2024-02-09 12:00:00,2024-02-09 12:00:00,-0.0002207142857157951,-2.543616945827054e-05,1.076996428571429,-0.00017866274334210904,-0.00015312836927280476,1.0771613095238088,1.076905799043867,1.0787181260097294,1.0768935509108197,1.0778126451088155,0.00018618371520433068,-8.109661705339256e-05,1.0766959564268814,1.0771548259916375,22.895622895618192,18.428050169689495,4.083135312407279e-05,1.076075780770728,1.0,1.0776670031947773,bullish,1.0769983303913007,1.0772226334703363,1.0767633092535258,-0.00022430307903564817,-0.0001507416568337998,0.0004662695929876689,-2.6866185070861803e-05,-5.534227726133878e-05,-6.39422084618424e-05,1.0772295788465134,1.0762970396605382,,True,False,0.0,1.0817299999999999,1.0783299999999998,1.0791299999999997,1.0797299999999996,True,2024-02-12 01:55:00,,2024-02-09 15:40:48,0.01,even,True,29.36,1580.7700000000013,54,0,6,2
2024-02-09 12:15:00,1.07632,1.07658,1.07614,1.07657,276,12,0,1.07614,1.0766133330314056,0.00010255553259941812,0.00011454377720383738,-0.00011609669769814285,-4.6228668238790954e-05,1.0762963290117578,1.0769357978393284,2024-02-09 12:00:00,2024-02-09 12:00:00,-0.0002207142857157951,-2.543616945827054e-05,1.076996428571429,-0.00017866274334210904,-0.00015312836927280476,1.0771613095238088,1.076905799043867,1.0787181260097294,1.0768935509108197,1.0778126451088155,0.00018618371520433068,-8.109661705339256e-05,1.0766959564268814,1.0771548259916375,15.689993244742537,17.014782606837446,4.083135312407279e-05,1.076075780770728,1.0,1.0776670031947773,bullish,1.076785734069559,1.077064533250724,1.0765427175782594,-0.00027879918116502367,-0.0002094782090940377,0.0005152530122917622,-6.379772961784269e-05,-0.00010967320261379143,-4.712074303481195e-05,1.0770579705905512,1.0760274645659675,,True,False,0.0,1.08157,1.0781699999999999,1.0789699999999998,1.0795699999999997,True,2024-02-12 01:50:00,,2024-02-09 15:41:13,0.01,even,True,29.36,1610.1300000000012,55,0,6,2
2024-02-09 12:25:00,1.07641,1.07686,1.07635,1.07679,520,12,0,1.07635,1.0768492368427405,9.313011232613195e-05,2.4998896796766896e-05,0.00011122074146466822,9.256276643435335e-05,1.0760585207331383,1.0764988580410426,2024-02-09 12:00:00,2024-02-09 12:00:00,-0.0002207142857157951,-2.543616945827054e-05,1.076996428571429,-0.00017866274334210904,-0.00015312836927280476,1.0771613095238088,1.076905799043867,1.0787181260097294,1.0768935509108197,1.0778126451088155,0.00018618371520433068,-8.109661705339256e-05,1.0766959564268814,1.0771548259916375,30.40540540540108,21.10700614350367,4.083135312407279e-05,1.076075780770728,1.0,1.0776670031947773,bullish,1.0767374782391517,1.0769993049131723,1.0764851805985551,-0.00026182667402063764,-0.00023253066512631684,0.0005194346285539815,8.152734771726955e-07,-5.8352253181404024e-05,-6.379772961784269e-05,1.077004615227109,1.0759657459700012,,True,False,0.0,1.0817899999999998,1.0775899999999998,1.0783899999999997,1.0787899999999997,True,2024-02-09 16:10:00,,2024-02-09 15:35:28,0.01,even,True,14.68,1624.8100000000013,56,0,6,2
2024-02-09 12:40:00,1.07673,1.07693,1.07664,1.07687,221,12,0,1.07664,1.0769866706999334,-4.001443133021078e-05,-1.7024966627733733e-05,2.4998896796766896e-05,9.313011232613195e-05,1.0763574237123765,1.0768512305075721,2024-02-09 12:00:00,2024-02-09 12:00:00,-0.0002207142857157951,-2.543616945827054e-05,1.076996428571429,-0.00017866274334210904,-0.00015312836927280476,1.0771613095238088,1.076905799043867,1.0787181260097294,1.0768935509108197,1.0778126451088155,0.00018618371520433068,-8.109661705339256e-05,1.0766959564268814,1.0771548259916375,43.48750158608493,39.4958338620233,4.083135312407279e-05,1.076075780770728,1.0,1.0776670031947773,bullish,1.0767547671990492,1.0769534674220553,1.076501764705883,-0.0001987002230061652,-0.00022611605927987287,0.0003737610645030846,2.660474716220662e-05,-1.434468524230681e-05,4.324045407955168e-06,1.0768755257703861,1.0761280036413798,,True,False,0.0,1.0818699999999999,1.07767,1.0784699999999998,1.0788699999999998,True,2024-02-09 16:10:00,,2024-02-09 15:35:24,0.01,even,True,14.68,1639.4900000000014,57,0,6,2
2024-02-09 12:45:00,1.07687,1.07692,1.07678,1.07691,182,12,0,1.076750028105172,1.0770838969005647,-0.00013934390921736963,-0.00013430842348087122,4.607712363183263e-05,7.501821065262113e-05,1.0764952243955992,1.0768236764018642,2024-02-09 12:00:00,2024-02-09 12:00:00,-0.0002207142857157951,-2.543616945827054e-05,1.076996428571429,-0.00017866274334210904,-0.00015312836927280476,1.0771613095238088,1.076905799043867,1.0787181260097294,1.0768935509108197,1.0778126451088155,0.00018618371520433068,-8.109661705339256e-05,1.0766959564268814,1.0771548259916375,58.09776402244012,47.525418866502186,4.083135312407279e-05,1.076075780770728,1.0,1.0776670031947773,bullish,1.0767786491684261,1.0769502476130142,1.0765542105263157,-0.0001715984445880281,-0.00021521253634150392,0.0003572310176969213,5.2445820432733825e-05,2.660474716220662e-05,-1.434468524230681e-05,1.0769114415440126,1.0761969795086188,,True,False,0.0,1.08191,1.07771,1.0785099999999999,1.0789099999999998,True,2024-02-09 16:15:00,,2024-02-09 15:35:23,0.01,even,True,14.68,1654.1700000000014,58,0,6,2
2024-02-12 00:20:00,1.078,1.07816,1.078,1.07816,16,41,0,1.0780107694950576,1.0781492391476275,4.614059556935337e-05,8.061015247804393e-05,4.947148944565798e-05,9.920088921788941e-05,1.0776980454715523,1.0780006819913832,2024-02-12 00:00:00,2024-02-12 00:00:00,3.0952380942750324e-06,0.0003164276814497935,1.0784041666666666,-9.777461081850084e-05,-7.438528902905296e-05,1.0784478571428564,1.0781036129211437,1.0790139448502427,1.0778610249642984,1.0790915022687235,-7.167426710233018e-05,1.2597077083277002e-05,1.0783834905774232,1.0778243024619496,32.72727272727543,28.857323232328923,0.00024879760844561045,1.0766369591348028,1.0,1.0782454416821607,bullish,1.0782861434150977,1.0783872583184608,1.0781704265565868,-0.0001011149033631753,-3.391906306344527e-05,0.0002354449688680062,-4.619883040923867e-05,-0.00010080151358726752,-0.00011390436876612675,1.0784058715254548,1.0779349815877188,,True,False,0.0,1.08316,1.07896,1.0797599999999998,1.0801599999999998,True,2024-02-12 10:00:00,,2024-02-12 06:50:11,0.01,even,True,14.68,1668.8500000000015,59,0,7,2
2024-02-12 18:45:00,1.07745,1.07751,1.07722,1.07738,397,12,0,1.0771466667997303,1.07751,-2.630481627970731e-05,-1.5707021068145354e-05,-3.783515620357478e-05,-6.211583006229751e-05,1.077415767902795,1.077717735862939,2024-02-12 18:00:00,2024-02-12 18:00:00,0.00015190476190451996,-0.0005021442399302245,1.076910238095239,-0.00022184050033539196,8.799582004927772e-05,1.076752380952381,1.0762182541195893,1.077297054011088,1.0762470143174396,1.0777006213001206,-0.00011778842269948932,-0.00017211329052845584,1.0770896959692895,1.0777865167248122,87.19514104129814,90.29103977682142,-0.00025344084374052657,,-1.0,1.0774602437440248,bearish,1.0771688408095388,1.0769474051070465,1.0775843343653257,0.00022143570249233413,0.0001231416147326661,0.0005417404052390051,5.15032679753169e-05,0.00011569659442600688,0.00018397316821539,1.0781260747705648,1.0770425939600867,,False,True,1.0,1.07238,1.07658,1.0757800000000002,1.0753800000000002,True,2024-02-13 15:35:00,2024-02-13 15:32:13,2024-02-13 07:13:17,0.01,even,True,14.68,1683.5300000000016,60,0,7,2
2024-02-12 18:50:00,1.07739,1.07747,1.07713,1.07724,392,12,0,1.0769815484061291,1.07747,0.00011069140444226597,9.874403038806808e-05,-7.852525129053357e-05,-0.00010710150655288943,1.0774421827561214,1.0777175591753299,2024-02-12 18:00:00,2024-02-12 18:00:00,0.00015190476190451996,-0.0005021442399302245,1.076910238095239,-0.00022184050033539196,8.799582004927772e-05,1.076752380952381,1.0762182541195893,1.077297054011088,1.0762470143174396,1.0777006213001206,-0.00011778842269948932,-0.00017211329052845584,1.0770896959692895,1.0777865167248122,80.26359134245224,85.86115656266009,-0.00025344084374052657,,-1.0,1.0774602437440248,bearish,1.077179788377302,1.0769690788028208,1.0776058032335734,0.00021070957448121597,0.00014065520668237608,0.0005464582936223263,2.1468868247609407e-05,5.15032679753169e-05,0.00011569659442600688,1.0781522615271957,1.077059344939951,,False,True,1.0,1.07224,1.07644,1.0756400000000002,1.0752400000000002,True,2024-02-13 15:35:00,2024-02-13 15:40:46,2024-02-13 07:02:59,0.01,even,True,14.68,1698.2100000000016,61,0,7,2
2024-02-12 19:10:00,1.07771,1.07788,1.07763,1.0777,356,12,0,1.0775499991718986,1.07788,-0.0001113757612946131,-4.3532946540404544e-05,0.00020879371888493387,0.00018718196006120262,1.0770334682606924,1.0773668507109593,2024-02-12 19:00:00,2024-02-12 19:00:00,0.0001578571428579867,-0.0004418177188929562,1.0772984523809526,0.0002396581735003959,0.00020395748761529967,1.076910238095239,1.0750240002219353,1.0773065374902757,1.0762182541195893,1.077297054011088,8.799582004927772e-05,-0.00022184050033539196,1.07780989865643,1.0778171953868272,87.10545632493229,81.32637614440121,-0.0002911162187710125,,-1.0,1.077372766166087,bearish,1.0773673534411288,1.0771223693831524,1.0776815135878912,0.0002449840579763496,0.00019071519344501914,0.0006111191918684503,2.776057791442632e-05,4.2363261093081306e-05,2.8400412799056696e-05,1.0782926327797597,1.0770703943960227,,False,True,1.0,1.0727000000000002,1.0769000000000002,1.0761000000000003,1.0757000000000003,True,2024-02-13 15:35:00,2024-02-13 15:31:59,2024-02-13 02:53:06,0.01,even,True,14.68,1712.8900000000017,62,0,7,2
2024-02-12 19:15:00,1.07769,1.07772,1.07754,1.07758,324,12,0,1.0772461485354727,1.07772,6.925938264446754e-05,4.615708073670344e-05,8.422014675483488e-05,0.00010233756706127072,1.0772282369257684,1.0777052385671193,2024-02-12 19:00:00,2024-02-12 19:00:00,0.0001578571428579867,-0.0004418177188929562,1.0772984523809526,0.0002396581735003959,0.00020395748761529967,1.076910238095239,1.0750240002219353,1.0773065374902757,1.0762182541195893,1.077297054011088,8.799582004927772e-05,-0.00022184050033539196,1.07780989865643,1.0778171953868272,84.43979989842956,84.49161620718723,-0.0002911162187710125,,-1.0,1.077372766166087,bearish,1.0774000682963398,1.0771562679473634,1.077684643962849,0.00024380034897641956,0.00020133222455129922,0.000613331612319728,3.13037495769386e-06,2.776057791442632e-05,4.2363261093081306e-05,1.0782979755751687,1.077071312350529,,False,True,1.0,1.07258,1.07678,1.0759800000000002,1.0755800000000002,True,2024-02-13 15:35:00,2024-02-13 15:32:05,2024-02-13 08:25:10,0.01,even,True,14.68,1727.5700000000018,63,0,7,2
2024-02-12 19:20:00,1.07758,1.0776,1.07731,1.07744,371,12,0,1.0772700129105142,1.0776466589027591,9.281263115820948e-05,0.00010825247611225744,-9.897405873653144e-05,-4.927085732804508e-05,1.0774760402600223,1.077978729486191,2024-02-12 19:00:00,2024-02-12 19:00:00,0.0001578571428579867,-0.0004418177188929562,1.0772984523809526,0.0002396581735003959,0.00020395748761529967,1.076910238095239,1.0750240002219353,1.0773065374902757,1.0762182541195893,1.077297054011088,8.799582004927772e-05,-0.00022184050033539196,1.07780989865643,1.0778171953868272,69.62434230268815,80.38986617535001,-0.0002911162187710125,,-1.0,1.077372766166087,bearish,1.0774062116353644,1.0771772851364476,1.0776474337805302,0.00022892649891681494,0.0002068510794244024,0.0005853212793030366,-3.7210182318725415e-05,3.13037495769386e-06,2.776057791442632e-05,1.0782327550598332,1.0770621125012272,,False,True,1.0,1.07244,1.07664,1.0758400000000001,1.0754400000000002,True,2024-02-13 15:35:00,2024-02-13 15:32:05,2024-02-13 07:14:01,0.01,even,True,14.68,1742.2500000000018,64,0,7,2
2024-02-12 19:35:00,1.07783,1.07789,1.07774,1.07774,270,12,0,1.077710001039489,1.07789,-1.3919077047075825e-05,2.711036555385587e-05,0.00010825247611225744,9.281263115820948e-05,1.0772774983840538,1.0776553926797952,2024-02-12 19:00:00,2024-02-12 19:00:00,0.0001578571428579867,-0.0004418177188929562,1.0772984523809526,0.0002396581735003959,0.00020395748761529967,1.076910238095239,1.0750240002219353,1.0773065374902757,1.0762182541195893,1.077297054011088,8.799582004927772e-05,-0.00022184050033539196,1.07780989865643,1.0778171953868272,84.62920714355388,75.46912617465489,-0.0002911162187710125,,-1.0,1.077372766166087,bearish,1.0775448919830088,1.0772968805698824,1.0776946646026837,0.0002480114131264699,0.0002254218802085559,0.0005077440300072552,-1.5927072580801394e-06,3.130718954302836e-05,1.7516339868572928e-05,1.078202408632691,1.0771869205726765,,False,True,1.0,1.07274,1.07694,1.07614,1.0757400000000001,True,2024-02-13 15:35:00,2024-02-13 15:31:57,2024-02-13 02:53:09,0.01,even,True,14.68,1756.9300000000019,65,0,7,2
2024-02-12 19:45:00,1.07775,1.07778,1.07768,1.07774,198,12,0,1.0776033673255268,1.0777692257140516,0.00012370028777664675,0.00018575618690145793,-1.5471588689741062e-06,6.829304127466429e-05,1.077475508950444,1.0779332106060775,2024-02-12 19:00:00,2024-02-12 19:00:00,0.0001578571428579867,-0.0004418177188929562,1.0772984523809526,0.0002396581735003959,0.00020395748761529967,1.076910238095239,1.0750240002219353,1.0773065374902757,1.0762182541195893,1.077297054011088,8.799582004927772e-05,-0.00022184050033539196,1.07780989865643,1.0778171953868272,79.46428571427481,82.85527184739108,-0.0002911162187710125,,-1.0,1.077372766166087,bearish,1.0776029108280714,1.0773614682526427,1.0777414654282773,0.0002414425754286853,0.00023204648821606485,0.00041208736938901254,1.8644650843890886e-05,2.81561747497161e-05,-1.5927072580801394e-06,1.0781535527976662,1.0773293780588884,,False,True,1.0,1.07274,1.07694,1.07614,1.0757400000000001,True,2024-02-13 15:35:00,2024-02-13 15:31:57,2024-02-13 02:53:09,0.01,even,True,14.68,1771.610000000002,66,0,7,2
2024-02-12 20:10:00,1.07841,1.07853,1.07831,1.07831,244,12,0,1.0783207763621734,1.078620012094241,-0.00010845054514067302,-3.245552917634527e-05,7.917231458667398e-05,0.00013936754956767958,1.0778813259041007,1.0782802977184958,2024-02-12 20:00:00,2024-02-12 20:00:00,0.0003882142857136728,-0.00028697919277131945,1.0776852380952384,0.0006793116806352849,0.00027813805306783337,1.0772984523809526,1.0748445276389333,1.0773625283699464,1.0750240002219353,1.0773065374902757,0.00020395748761529967,0.0002396581735003959,1.07798996621881,1.0778382197558811,89.00643214936777,92.60287284793846,-0.0002902888135710739,,-1.0,1.077282463520034,bearish,1.0779582999188557,1.0776336213500244,1.0781947781217744,0.00032467856883133805,0.0002763680635433157,0.00034853263837807043,9.095287237692595e-05,0.0001291881664930994,9.270037839770318e-05,1.0785433107601525,1.0778462454833964,,False,True,1.0,1.0733100000000002,1.0767100000000003,1.0759100000000004,1.0753100000000004,True,2024-02-13 15:35:00,2024-02-13 15:31:33,2024-02-13 07:37:38,0.01,even,True,29.35,1800.9600000000019,67,0,7,2
2024-02-12 20:20:00,1.07847,1.07855,1.07819,1.07819,304,12,0,1.0779649983501445,1.07855,4.639889291248641e-06,-8.060518105161149e-05,1.4271132317451025e-05,2.411078213966617e-07,1.078200019570938,1.0785049833268212,2024-02-12 20:00:00,2024-02-12 20:00:00,0.0003882142857136728,-0.00028697919277131945,1.0776852380952384,0.0006793116806352849,0.00027813805306783337,1.0772984523809526,1.0748445276389333,1.0773625283699464,1.0750240002219353,1.0773065374902757,0.00020395748761529967,0.0002396581735003959,1.07798996621881,1.0778382197558811,82.12585933368833,87.4600048720095,-0.0002902888135710739,,-1.0,1.077282463520034,bearish,1.0780579543797724,1.0777308276320512,1.07831009631923,0.00032712674772117367,0.00029667726902321795,0.0003719171054811141,1.8644650843002708e-05,9.66735466125801e-05,9.095287237692595e-05,1.078682013424711,1.077938179213749,,False,True,1.0,1.07319,1.07739,1.0765900000000002,1.0761900000000002,True,2024-02-13 05:10:00,2024-02-13 15:31:35,2024-02-12 22:11:09,0.01,even,True,14.68,1815.640000000002,68,0,7,2
2024-02-12 20:25:00,1.07818,1.07823,1.07797,1.07817,346,12,0,1.07797,1.078273334650888,1.8792626195080752e-05,1.2364684606403311e-05,-3.245552917634527e-05,-0.00010845054514067302,1.078311974553455,1.0786173772762266,2024-02-12 20:00:00,2024-02-12 20:00:00,0.0003882142857136728,-0.00028697919277131945,1.0776852380952384,0.0006793116806352849,0.00027813805306783337,1.0772984523809526,1.0748445276389333,1.0773625283699464,1.0750240002219353,1.0773065374902757,0.00020395748761529967,0.0002396581735003959,1.07798996621881,1.0778382197558811,77.92173453199696,83.76510566621924,-0.0002902888135710739,,-1.0,1.077282463520034,bearish,1.0780751921674998,1.077763358918566,1.0783112074303396,0.0003118332489338016,0.0002997084650053347,0.00036052646692038377,1.111111109564078e-06,1.8644650843002708e-05,9.66735466125801e-05,1.07867173389726,1.0779506809634192,,False,True,1.0,1.0731700000000002,1.0773700000000002,1.0765700000000002,1.0761700000000003,True,2024-02-13 05:10:00,2024-02-13 15:31:35,2024-02-12 22:11:08,0.01,even,True,14.68,1830.320000000002,69,0,7,2
2024-02-12 20:35:00,1.07819,1.0783,1.07803,1.07808,364,12,0,1.0779833335812965,1.0783,2.1644772777612817e-05,1.830825557182957e-05,-8.060518105161149e-05,4.639889291248641e-06,1.0779653743817827,1.0785434639711822,2024-02-12 20:00:00,2024-02-12 20:00:00,0.0003882142857136728,-0.00028697919277131945,1.0776852380952384,0.0006793116806352849,0.00027813805306783337,1.0772984523809526,1.0748445276389333,1.0773625283699464,1.0750240002219353,1.0773065374902757,0.00020395748761529967,0.0002396581735003959,1.07798996621881,1.0778382197558811,63.65797829002717,70.0221481989066,-0.0002902888135710739,,-1.0,1.077282463520034,bearish,1.078088273682056,1.0778147041482904,1.0783194908840736,0.00027356953376567184,0.0002939349255934681,0.00036138622001615834,1.2831097357945964e-06,7.000343998253555e-06,1.111111109564078e-06,1.0786808771040899,1.0779581046640574,,False,True,1.0,1.07308,1.07728,1.07648,1.0760800000000001,True,2024-02-13 05:20:00,2024-02-13 15:31:38,2024-02-12 22:05:03,0.01,even,True,14.68,1845.000000000002,70,0,7,2
2024-02-12 20:55:00,1.07826,1.07827,1.07808,1.07808,275,12,0,1.0779999998209724,1.07827,1.8552869667165706e-05,-1.5697803428884083e-05,6.955568009286676e-05,1.9272873272437976e-05,1.078021562016553,1.0782256352808806,2024-02-12 20:00:00,2024-02-12 20:00:00,0.0003882142857136728,-0.00028697919277131945,1.0776852380952384,0.0006793116806352849,0.00027813805306783337,1.0772984523809526,1.0748445276389333,1.0773625283699464,1.0750240002219353,1.0773065374902757,0.00020395748761529967,0.0002396581735003959,1.07798996621881,1.0778382197558811,56.37323614615905,55.84585379698444,-0.0002902888135710739,,-1.0,1.077282463520034,bearish,1.0781210915226702,1.0779050169029598,1.0782709563123498,0.00021607461971040465,0.00025848347338561944,0.000322424151317461,-3.261781905727901e-05,-8.919848641930628e-06,-1.6374268998475827e-06,1.0785933804636674,1.0779485321610323,,False,True,1.0,1.07308,1.07728,1.07648,1.0760800000000001,True,2024-02-13 05:20:00,2024-02-13 15:31:38,2024-02-12 22:05:03,0.01,even,True,14.68,1859.680000000002,71,0,7,2
2024-02-13 09:20:00,1.07754,1.0777,1.07721,1.07728,271,12,0,1.0770450072284297,1.077689232605035,-0.00012535751968200683,-9.2443636514463e-05,7.138485321222325e-05,-1.5233947299294086e-05,1.0772687783710497,1.0774749558583676,2024-02-13 09:00:00,2024-02-13 09:00:00,0.00015714285714252263,-0.0002601269952440255,1.0767076190476186,0.00013294850597016513,0.00030422978366825647,1.076512142857143,1.0759482895712553,1.076413633925774,1.0758659322932846,1.0766401817200522,0.0001275199259116972,9.848156182638422e-05,1.0769802038796192,1.0771440547890305,83.9618309657102,90.32299396372782,-0.0002922321643234738,,-1.0,1.075515592301672,bearish,1.0771753396934372,1.076938765064177,1.0773991056071561,0.00023657462926007788,0.0001947071927557632,0.00030588559953788184,2.9418644651890702e-05,9.46508427925874e-05,8.808049535691254e-05,1.077704991206694,1.0770932200076182,,False,True,1.0,1.0722800000000001,1.07648,1.0756800000000002,1.0752800000000002,True,2024-02-13 15:35:00,2024-02-13 15:40:45,2024-02-13 11:52:50,0.01,even,True,14.68,1874.3600000000022,72,0,7,2
2024-02-13 09:25:00,1.07728,1.0773,1.07691,1.07709,261,12,0,1.07691,1.07762850871345,-0.00012050897039315178,-0.0001385217924858204,2.009732045347473e-05,-0.00010189569973562369,1.0772418483979105,1.077658291495314,2024-02-13 09:00:00,2024-02-13 09:00:00,0.00015714285714252263,-0.0002601269952440255,1.0767076190476186,0.00013294850597016513,0.00030422978366825647,1.076512142857143,1.0759482895712553,1.076413633925774,1.0758659322932846,1.0766401817200522,0.0001275199259116972,9.848156182638422e-05,1.0769802038796192,1.0771440547890305,64.7518281239909,81.16662093842238,-0.0002922321643234738,,-1.0,1.075515592301672,bearish,1.0771622105098315,1.0769499676520158,1.0773833574131408,0.00021224285781573649,0.00019821432576775787,0.00030374495881398773,-1.5748194015285932e-05,2.9418644651890702e-05,9.46508427925874e-05,1.0776871023719548,1.077079612454327,,False,True,1.0,1.0720900000000002,1.0762900000000002,1.0754900000000003,1.0750900000000003,True,2024-02-13 15:35:00,2024-02-13 15:40:46,2024-02-13 11:25:23,0.01,even,True,14.68,1889.0400000000022,73,0,7,2
2024-02-13 09:35:00,1.07733,1.07733,1.07667,1.07678,582,12,0,1.0764966904844426,1.07733,1.5471018407340025e-05,-6.520928554012879e-05,-9.2443636514463e-05,-0.00012535751968200683,1.077035019474684,1.0776818628224278,2024-02-13 09:00:00,2024-02-13 09:00:00,0.00015714285714252263,-0.0002601269952440255,1.0767076190476186,0.00013294850597016513,0.00030422978366825647,1.076512142857143,1.0759482895712553,1.076413633925774,1.0758659322932846,1.0766401817200522,0.0001275199259116972,9.848156182638422e-05,1.0769802038796192,1.0771440547890305,38.011194939566145,52.40478248431998,-0.0002922321643234738,,-1.0,1.075515592301672,bearish,1.0771278548620686,1.0769648145164745,1.0773189336085305,0.00016304034559411207,0.00019330548126364545,0.0003100446204532739,-8.99002408001337e-05,2.5476436189775242e-05,-1.5748194015285932e-05,1.0776289782289838,1.0770088889880771,,False,True,1.0,1.0717800000000002,1.0751800000000002,1.0743800000000003,1.0737800000000004,True,2024-02-13 15:45:00,2024-02-13 15:42:25,2024-02-15 15:30:03,0.01,success,True,91.72,1980.7600000000023,74,0,7,2
2024-02-13 09:40:00,1.07674,1.07678,1.07651,1.07654,404,12,0,1.0763467110525993,1.076995002641836,0.0001702735199860688,8.820205155244021e-05,-0.0001385217924858204,-0.00012050897039315178,1.0769004286807227,1.0776174994084315,2024-02-13 09:00:00,2024-02-13 09:00:00,0.00015714285714252263,-0.0002601269952440255,1.0767076190476186,0.00013294850597016513,0.00030422978366825647,1.076512142857143,1.0759482895712553,1.076413633925774,1.0758659322932846,1.0766401817200522,0.0001275199259116972,9.848156182638422e-05,1.0769802038796192,1.0771440547890305,25.452838263561258,39.3051191975101,-0.0002922321643234738,,-1.0,1.075515592301672,bearish,1.0770374156525198,1.0769333467745135,1.0771846990024068,0.0001040688780062915,0.00017545816061217468,0.00031644536127414807,-0.00013423460612371763,-8.99002408001337e-05,2.5476436189775242e-05,1.0775011443636808,1.0768682536411327,,False,True,1.0,1.0715400000000002,1.0749400000000002,1.0741400000000003,1.0735400000000004,True,2024-02-13 15:45:00,2024-02-13 15:43:18,2024-02-15 15:22:01,0.01,success,True,91.72,2072.4800000000023,75,0,7,2
2024-02-13 10:05:00,1.0773,1.07739,1.07685,1.0769,430,12,0,1.0767416751466636,1.07739,-7.585686186243373e-05,-0.0001487683085298978,5.64043257327044e-05,-1.4592160181145451e-05,1.0768959775206666,1.0772122085007105,2024-02-13 10:00:00,2024-02-13 10:00:00,0.000195476190475663,-0.0001934579782529866,1.0767976190476185,1.8411255483589878e-05,0.0003843692922824591,1.0767076190476186,1.0760822130310637,1.0764885854496384,1.0759482895712553,1.076413633925774,0.00030422978366825647,0.00013294850597016513,1.0767867346265398,1.0771077304059082,47.89915966385495,46.591970121371055,-0.0002724773271093764,,-1.0,1.0753114490557996,bearish,1.077039171512132,1.0769669775122843,1.0770252115583077,7.219399984759178e-05,0.0001120773568825036,0.0002725790405366048,-4.985552115566172e-05,2.0718954248488686e-05,-3.410732714148601e-05,1.0772977905988443,1.076752632517771,,False,True,1.0,1.0719,1.0753000000000001,1.0745000000000002,1.0739000000000003,True,2024-02-13 15:45:00,2024-02-13 15:42:07,2024-02-15 15:30:03,0.01,success,True,91.72,2164.200000000002,76,0,7,2
2024-02-13 10:10:00,1.07689,1.07715,1.07666,1.07688,473,12,0,1.07666,1.0772133650939133,-8.027704641189934e-05,-0.00013618706273284904,2.9391600413017824e-05,-6.787290387257392e-05,1.0768845862632621,1.0773290147457577,2024-02-13 10:00:00,2024-02-13 10:00:00,0.000195476190475663,-0.0001934579782529866,1.0767976190476185,1.8411255483589878e-05,0.0003843692922824591,1.0767076190476186,1.0760822130310637,1.0764885854496384,1.0759482895712553,1.076413633925774,0.00030422978366825647,0.00013294850597016513,1.0767867346265398,1.0771077304059082,42.85714285713666,47.1521942110085,-0.0002724773271093764,,-1.0,1.0753114490557996,bearish,1.0770146835871885,1.0769605347335967,1.076971640866872,5.4148853591895474e-05,0.00010049165622438197,0.0002626543990493814,-5.357069143574478e-05,-4.985552115566172e-05,2.0718954248488686e-05,1.0772342952659213,1.0767089864678225,,False,True,1.0,1.0718800000000002,1.0752800000000002,1.0744800000000003,1.0738800000000004,True,2024-02-13 15:45:00,2024-02-13 15:42:07,2024-02-15 15:30:03,0.01,success,True,91.72,2255.920000000002,77,0,7,2
2024-02-13 10:20:00,1.07689,1.07692,1.07649,1.07653,421,12,0,1.076456667856834,1.07692,-7.277546015755395e-05,-0.00011787442216698758,-0.0001487683085298978,-7.585686186243373e-05,1.0767356519724418,1.0773781804422125,2024-02-13 10:00:00,2024-02-13 10:00:00,0.000195476190475663,-0.0001934579782529866,1.0767976190476185,1.8411255483589878e-05,0.0003843692922824591,1.0767076190476186,1.0760822130310637,1.0764885854496384,1.0759482895712553,1.076413633925774,0.00030422978366825647,0.00013294850597016513,1.0767867346265398,1.0771077304059082,22.110331735995313,32.300082567455526,-0.0002724773271093764,,-1.0,1.0753114490557996,bearish,1.0769238858819514,1.0769238054986254,1.076813766769867,8.038332599547005e-08,7.076138598261868e-05,0.00026509872376158963,-0.00010894736842015362,-4.892672858480829e-05,-5.357069143574478e-05,1.0770788654936285,1.0765486680461054,,False,True,1.0,1.07153,1.0749300000000002,1.0741300000000003,1.0735300000000003,True,2024-02-13 15:45:00,2024-02-13 15:43:19,2024-02-15 15:22:01,0.01,success,True,91.72,2347.6400000000017,78,0,7,2
2024-02-13 10:25:00,1.07652,1.07663,1.07639,1.07644,384,12,0,1.0763283339691816,1.076686671026865,-2.63249988268036e-05,-5.2636035972491745e-05,-0.00013618706273284904,-8.027704641189934e-05,1.0766536335656114,1.077202559142865,2024-02-13 10:00:00,2024-02-13 10:00:00,0.000195476190475663,-0.0001934579782529866,1.0767976190476185,1.8411255483589878e-05,0.0003843692922824591,1.0767076190476186,1.0760822130310637,1.0764885854496384,1.0759482895712553,1.076413633925774,0.00030422978366825647,0.00013294850597016513,1.0767867346265398,1.0771077304059082,13.01845070877854,22.35385185133615,-0.0002724773271093764,,-1.0,1.0753114490557996,bearish,1.076849441900113,1.0768879680542827,1.07668810113519,-3.852615416977123e-05,4.89038779521407e-05,0.00028572247608445303,-0.00012566563467686365,-0.00010894736842015362,-4.892672858480829e-05,1.0769738236112745,1.0764023786591057,,False,True,1.0,1.0714400000000002,1.0748400000000002,1.0740400000000003,1.0734400000000004,True,2024-02-13 15:45:00,2024-02-13 15:43:23,2024-02-15 15:20:36,0.01,success,True,91.72,2439.3600000000015,79,0,7,2
2024-02-13 10:35:00,1.07649,1.0765500000000001,1.0763,1.0763,289,12,0,1.0762466688129373,1.0765500000000001,-4.02660028143833e-05,-1.571854472628975e-05,-0.00011787442216698758,-7.277546015755395e-05,1.0764509076193642,1.0769106661423173,2024-02-13 10:00:00,2024-02-13 10:00:00,0.000195476190475663,-0.0001934579782529866,1.0767976190476185,1.8411255483589878e-05,0.0003843692922824591,1.0767076190476186,1.0760822130310637,1.0764885854496384,1.0759482895712553,1.076413633925774,0.00030422978366825647,0.00013294850597016513,1.0767867346265398,1.0771077304059082,6.314281437770339,8.916313986325285,-0.0002724773271093764,,-1.0,1.0753114490557996,bearish,1.0767168193486016,1.0768164335170463,1.0765171654626762,-9.961416844461723e-05,9.526860086215658e-07,0.000333041538959622,-9.131062951484026e-05,-7.962504299907636e-05,-0.00012566563467686365,1.0768502070016357,1.0761841239237167,,False,True,1.0,1.0713000000000001,1.0747000000000002,1.0739000000000003,1.0733000000000004,True,2024-02-13 15:45:00,2024-02-13 15:43:40,2024-02-15 14:48:04,0.01,success,True,91.72,2531.0800000000013,80,0,7,2
2024-02-13 10:50:00,1.07646,1.07651,1.07628,1.07636,279,12,0,1.07628,1.0767366556295017,-8.340009024247958e-05,6.655983567700748e-05,-1.571854472628975e-05,-4.02660028143833e-05,1.0762434799279026,1.0765487548104846,2024-02-13 10:00:00,2024-02-13 10:00:00,0.000195476190475663,-0.0001934579782529866,1.0767976190476185,1.8411255483589878e-05,0.0003843692922824591,1.0767076190476186,1.0760822130310637,1.0764885854496384,1.0759482895712553,1.076413633925774,0.00030422978366825647,0.00013294850597016513,1.0767867346265398,1.0771077304059082,14.459073794274923,9.906683732561413,-0.0002724773271093764,,-1.0,1.0753114490557996,bearish,1.0765812774478785,1.0767246940864628,1.0763925111799104,-0.00014341663858430387,-6.543533043793477e-05,0.0003898196164100974,-3.9810801513828764e-05,-1.5290677675139364e-05,-6.955280357678895e-05,1.0767823307963205,1.0760026915635004,,False,True,1.0,1.07136,1.0747600000000002,1.0739600000000002,1.0733600000000003,True,2024-02-13 15:45:00,2024-02-13 15:43:24,2024-02-15 14:48:05,0.01,success,True,91.72,2622.800000000001,81,0,7,2
2024-02-13 11:00:00,1.07669,1.07688,1.07634,1.07638,354,12,0,1.0761066278557536,1.07688,-0.00022615691870445285,-0.00019530095084270007,0.00010285545258198941,5.908161334554047e-05,1.0761646798178763,1.0765559123871715,2024-02-13 11:00:00,2024-02-13 11:00:00,8.999999999992347e-05,-0.00018370018926527898,1.0768001190476195,-0.00015585184315696402,4.829129586373947e-05,1.0767976190476185,1.0762783794417634,1.0775997583447738,1.0760822130310637,1.0764885854496384,0.0003843692922824591,1.8411255483589878e-05,1.0766555782088467,1.0770663119734356,25.745257452567355,22.61553588986655,-0.0002547218995405569,,-1.0,1.0750977537930664,bearish,1.0765644649183035,1.0766967816241966,1.0764020811833501,-0.00013231670589308742,-8.820117822265215e-05,0.00040300951188633797,-9.229446164882305e-06,1.879944960458957e-05,-3.9810801513828764e-05,1.0768050906952364,1.0759990716714638,,False,True,1.0,1.07138,1.07478,1.0739800000000002,1.0733800000000002,True,2024-02-13 15:45:00,2024-02-13 15:43:24,2024-02-15 14:48:22,0.01,success,True,91.72,2714.520000000001,82,0,7,2
2024-02-13 11:05:00,1.07638,1.07647,1.076,1.07601,354,12,0,1.0755100213818982,1.07647,0.00010225194860797153,-9.00452782627559e-05,6.655983567700748e-05,-8.340009024247958e-05,1.0762734240889797,1.0767419059795842,2024-02-13 11:00:00,2024-02-13 11:00:00,8.999999999992347e-05,-0.00018370018926527898,1.0768001190476195,-0.00015585184315696402,4.829129586373947e-05,1.0767976190476185,1.0762783794417634,1.0775997583447738,1.0760822130310637,1.0764885854496384,0.0003843692922824591,1.8411255483589878e-05,1.0766555782088467,1.0770663119734356,20.565011405499693,24.650848426941476,-0.0002547218995405569,,-1.0,1.0750977537930664,bearish,1.0764791626231798,1.0766459089112932,1.0762864705882356,-0.0001667462881134174,-0.0001039102002008052,0.0004265169008023937,-0.00011561059511455696,-9.229446164882305e-06,1.879944960458957e-05,1.076712987489038,1.0758599536874331,,False,True,1.0,1.07101,1.0736100000000002,1.0728100000000003,1.0720100000000004,True,2024-02-13 15:50:00,2024-02-13 15:46:48,2024-02-15 09:28:41,0.01,success,True,91.73,2806.250000000001,83,0,7,2
2024-02-13 11:15:00,1.07605,1.07626,1.07598,1.07601,322,12,0,1.0759350005852708,1.0762966718829259,2.323479047408445e-05,2.477327922947865e-05,-0.00019530095084270007,-0.00022615691870445285,1.0760887988530374,1.0768645924343732,2024-02-13 11:00:00,2024-02-13 11:00:00,8.999999999992347e-05,-0.00018370018926527898,1.0768001190476195,-0.00015585184315696402,4.829129586373947e-05,1.0767976190476185,1.0762783794417634,1.0775997583447738,1.0760822130310637,1.0764885854496384,0.0003843692922824591,1.8411255483589878e-05,1.0766555782088467,1.0770663119734356,16.834468616524664,17.233092077666882,-0.0002547218995405569,,-1.0,1.0750977537930664,bearish,1.0763511164343476,1.0765579328800525,1.0760868386652904,-0.00020681644570497149,-0.0001380466022659416,0.00043338474054240673,-8.146542827569547e-05,-0.00011816649466944718,-0.00011561059511455696,1.0765202234058329,1.075653453924748,,False,True,1.0,1.07101,1.0736100000000002,1.0728100000000003,1.0720100000000004,True,2024-02-13 15:50:00,2024-02-13 15:46:48,2024-02-15 09:28:41,0.01,success,True,91.72,2897.9700000000007,84,0,7,2
2024-02-13 13:25:00,1.0781,1.07811,1.0778699999999999,1.07804,319,12,0,1.0778807367570136,1.0781288623549752,-0.00020130033712938692,-9.241436594110707e-05,0.00015925311465642087,0.00016202762055546473,1.0773593104882708,1.077779567647962,2024-02-13 13:00:00,2024-02-13 13:00:00,0.00015380952380872337,-0.00011665745698219432,1.07722119047619,0.0001541599450154479,9.259317578884229e-05,1.0769539285714282,1.075300824922942,1.0777074698289018,1.0764333391719376,1.0777465152142136,-4.662579640394972e-05,-0.0002583578448988942,1.077481730912094,1.077125566454316,89.42768199234577,82.08032401260905,-0.00021571820590464975,,-1.0,1.0746466559122856,bearish,1.0775446913433617,1.0772217128037092,1.0777477433780533,0.00032297853965257417,0.0002440225004924225,0.0006011031525515813,7.258341933269463e-05,9.375644994902288e-05,3.166494668094266e-05,1.078348846530605,1.0771466402255017,,False,True,1.0,1.0730400000000002,1.08704,1.0772400000000002,1.0770400000000002,False,2024-02-13 15:35:00,2024-02-13 15:31:38,,0.01,success,True,91.72,2989.6900000000005,85,0,7,2
2024-02-13 13:30:00,1.07804,1.07804,1.07773,1.07773,253,12,0,1.0776799851361432,1.078093392395085,-0.00020881853339011036,-0.00012217150077062678,2.3196484315023486e-05,7.138438884274582e-05,1.0775157578189116,1.078086863936911,2024-02-13 13:00:00,2024-02-13 13:00:00,0.00015380952380872337,-0.00011665745698219432,1.07722119047619,0.0001541599450154479,9.259317578884229e-05,1.0769539285714282,1.075300824922942,1.0777074698289018,1.0764333391719376,1.0777465152142136,-4.662579640394972e-05,-0.0002583578448988942,1.077481730912094,1.077125566454316,86.49425287357485,85.37999633297413,-0.00021571820590464975,,-1.0,1.0746466559122856,bearish,1.0775732003674598,1.0772593637071382,1.0777691503267977,0.000313836660321698,0.0002579853324582776,0.0005816834763641846,2.140694874430693e-05,7.258341933269463e-05,9.375644994902288e-05,1.0783508338031618,1.0771874668504335,,False,True,1.0,1.0727300000000002,1.08673,1.0769300000000002,1.0767300000000002,False,2024-02-13 15:35:00,2024-02-13 15:31:57,,0.01,success,True,91.72,3081.4100000000003,86,0,7,2
2024-02-13 13:40:00,1.07775,1.07783,1.07723,1.07733,241,12,0,1.07696234796809,1.07783,0.00011067940576845793,-1.8785604819918246e-05,-9.241436594110707e-05,-0.00020130033712938692,1.0778645751255918,1.0781214410221773,2024-02-13 13:00:00,2024-02-13 13:00:00,0.00015380952380872337,-0.00011665745698219432,1.07722119047619,0.0001541599450154479,9.259317578884229e-05,1.0769539285714282,1.075300824922942,1.0777074698289018,1.0764333391719376,1.0777465152142136,-4.662579640394972e-05,-0.0002583578448988942,1.077481730912094,1.077125566454316,56.32183908046068,73.18007662836,-0.00021571820590464975,,-1.0,1.0746466559122856,bearish,1.0775588002630925,1.0772982473483694,1.077747199862402,0.00026055291472304454,0.0002659721036680502,0.0004973000435789719,-5.5452356380047974e-05,3.3501891984366594e-05,2.140694874430693e-05,1.078244499905981,1.077249899818823,,False,True,1.0,1.07233,1.0863299999999998,1.07653,1.07633,False,2024-02-13 15:35:00,2024-02-13 15:32:18,,0.01,success,True,91.73,3173.1400000000003,87,0,7,2
2024-02-13 13:45:00,1.07733,1.07741,1.07723,1.07725,248,12,0,1.077081544271167,1.0773992450320176,0.000110683048125793,0.00017666974699277703,-0.00012217150077062678,-0.00020881853339011036,1.0776632397360326,1.0780835915310645,2024-02-13 13:00:00,2024-02-13 13:00:00,0.00015380952380872337,-0.00011665745698219432,1.07722119047619,0.0001541599450154479,9.259317578884229e-05,1.0769539285714282,1.075300824922942,1.0777074698289018,1.0764333391719376,1.0777465152142136,-4.662579640394972e-05,-0.0002583578448988942,1.077481730912094,1.077125566454316,42.52873563218173,58.5249042145623,-0.00021571820590464975,,-1.0,1.0746466559122856,bearish,1.077511292530309,1.0772946734707125,1.0776718507051948,0.00021661905959646788,0.00025610149485373373,0.00042799065411653194,-7.534915720719404e-05,-5.5452356380047974e-05,3.3501891984366594e-05,1.0780998413593113,1.0772438600510783,,False,True,1.0,1.0722500000000001,1.0756500000000002,1.0748500000000003,1.0742500000000004,True,2024-02-13 15:45:00,2024-02-13 15:40:46,2024-02-15 15:30:09,0.01,success,True,91.72,3264.86,88,0,7,2
2024-02-14 02:35:00,1.07112,1.07113,1.07101,1.07106,136,12,0,1.0709214115550587,1.07113,4.6027610502858856e-05,5.8900477864185344e-05,3.2675885508931766e-05,1.8454646002241626e-05,1.0709520630872327,1.0711623982965497,2024-02-14 02:00:00,2024-02-14 02:00:00,4.8809523818249545e-06,-0.0013816779240072297,1.0707020238095235,0.00012863018498590913,0.00010519044710101677,1.0706334523809526,1.0700094047745008,1.0709369967161166,1.069766988762146,1.070892182139867,4.792910492022256e-05,0.0002337787361927691,1.0707487487928926,1.0732543551528544,84.13166298207193,83.8880700892518,-0.0013505810496019298,,-1.0,1.0719676726530305,bearish,1.0709382558059775,1.0708945766886646,1.0709345958032324,4.3679117312844795e-05,1.452055587834545e-05,0.00012234241532263506,3.581011351849739e-05,4.4712762297560715e-05,4.789817681483122e-05,1.071056938218555,1.0708122533879096,,False,True,1.0,1.06606,1.07026,1.06946,1.0690600000000001,True,,,2024-02-14 10:16:43,0.01,even,True,14.68,3279.54,89,0,7,2
2024-02-14 02:55:00,1.07131,1.07138,1.07071,1.0707200000000001,254,12,0,1.0702366666757865,1.07138,2.180178514415753e-05,-0.00015581461794474734,5.666494547120978e-05,-7.449549145810738e-05,1.0709545484256309,1.0712020340878416,2024-02-14 02:00:00,2024-02-14 02:00:00,4.8809523818249545e-06,-0.0013816779240072297,1.0707020238095235,0.00012863018498590913,0.00010519044710101677,1.0706334523809526,1.0700094047745008,1.0709369967161166,1.069766988762146,1.070892182139867,4.792910492022256e-05,0.0002337787361927691,1.0707487487928926,1.0732543551528544,73.80952380952697,83.37934207499563,-0.0013505810496019298,,-1.0,1.0719676726530305,bearish,1.0710011905484864,1.0709437614693063,1.0710652356381147,5.742907918016016e-05,4.606862232959012e-05,0.00016895068290489202,-5.199518403853354e-05,7.005159958817231e-05,6.807361541039114e-05,1.0712341863210195,1.07089628495521,,False,True,1.0,1.0657200000000002,1.0699200000000002,1.0691200000000003,1.0687200000000003,True,,,2024-02-14 10:39:23,0.01,even,True,14.68,3294.22,90,0,7,2
2024-02-14 03:00:00,1.07071,1.0707200000000001,1.07026,1.07036,338,12,0,1.07026,1.0708600112675828,4.69329066846253e-05,1.4001976076244078e-05,-5.135565495986817e-05,-0.00023329841897892382,1.0710030103994317,1.0714863069331986,2024-02-14 03:00:00,2024-02-14 03:00:00,6.857142857086274e-05,-0.0012896406255196169,1.0709102380952376,-9.123737223688688e-05,0.00012945221112035124,1.0707020238095235,1.070643952648502,1.0709735258520177,1.0700094047745008,1.0709369967161166,0.00010519044710101677,0.00012863018498590913,1.0709829162642976,1.0730820067406261,43.45238095238377,69.84414538762613,-0.0013383929647854673,,-1.0,1.0718498623637267,bearish,1.0709025458487194,1.0709005198789874,1.0709565703474373,2.0259697319779946e-06,3.72600918100677e-05,0.00020284065976451814,-0.00010866529067743436,-5.199518403853354e-05,7.005159958817231e-05,1.0711594110072018,1.0707537296876728,,False,True,1.0,1.06536,1.0793599999999999,1.06956,1.06936,False,,,2024-02-20 11:35:26,0.01,fail,False,-165.11,3129.1099999999997,0,1,7,2
2024-02-14 03:10:00,1.07083,1.07089,1.07049,1.07054,224,12,0,1.0704299993485582,1.07089,-2.3355341474640664e-05,-7.18148456340648e-05,-0.00015581461794474734,2.180178514415753e-05,1.0702382571335374,1.071368621124108,2024-02-14 03:00:00,2024-02-14 03:00:00,6.857142857086274e-05,-0.0012896406255196169,1.0709102380952376,-9.123737223688688e-05,0.00012945221112035124,1.0707020238095235,1.070643952648502,1.0709735258520177,1.0700094047745008,1.0709369967161166,0.00010519044710101677,0.00012863018498590913,1.0709829162642976,1.0730820067406261,28.273809523809486,32.93650793650936,-0.0013383929647854673,,-1.0,1.0718498623637267,bearish,1.0708373257260062,1.0708689779483773,1.0708805228758174,-3.165222237111465e-05,1.6890216631233754e-05,0.00021486662511156817,-6.400412796669919e-05,-1.2043343653234118e-05,-0.00010866529067743436,1.071095389500929,1.0706656562507058,,False,True,1.0,1.0655400000000002,1.07954,1.0697400000000001,1.0695400000000002,False,,,2024-02-20 11:39:46,0.01,fail,False,-165.11,2963.9999999999995,0,2,7,2
2024-02-14 03:20:00,1.07057,1.07064,1.07038,1.07047,225,12,0,1.0703906952696436,1.07064,5.583310681408933e-05,3.7139251770689717e-05,-0.00011673866848210258,2.1626158115039432e-07,1.0703900157635682,1.0710065074124546,2024-02-14 03:00:00,2024-02-14 03:00:00,6.857142857086274e-05,-0.0012896406255196169,1.0709102380952376,-9.123737223688688e-05,0.00012945221112035124,1.0707020238095235,1.070643952648502,1.0709735258520177,1.0700094047745008,1.0709369967161166,0.00010519044710101677,0.00012863018498590913,1.0709829162642976,1.0730820067406261,23.511904761906607,28.67063492063529,-0.0013383929647854673,,-1.0,1.0718498623637267,bearish,1.0707447125020515,1.0708182321230946,1.070741265909872,-7.351962104307219e-05,-1.2123059683765365e-05,0.00023582620702469113,-7.67973856223847e-05,-6.245958032291554e-05,-6.400412796669919e-05,1.0709770921168968,1.0705054397028473,,False,True,1.0,1.0654700000000001,1.07947,1.0696700000000001,1.0694700000000001,False,,,2024-02-20 11:39:16,0.01,fail,False,-165.11,2798.8899999999994,0,3,7,2
2024-02-14 04:05:00,1.07122,1.07125,1.07108,1.07117,155,12,0,1.07108,1.071246664452569,2.822751317018391e-05,3.422789529781697e-05,7.779768546085863e-05,7.491458869749615e-05,1.0708555154175137,1.071119055846203,2024-02-14 04:00:00,2024-02-14 04:00:00,0.00020821428571404788,-0.001151944700009233,1.0709723809523808,-0.0001438628501866315,6.255018353484414e-05,1.0709102380952376,1.0707114602535583,1.0712505682770421,1.070643952648502,1.0709735258520177,0.00012945221112035124,-9.123737223688688e-05,1.070927638754766,1.0729074462013761,84.20284780578676,76.38110799875102,-0.0013011033118302206,,-1.0,1.0717500940025855,bearish,1.070957333567521,1.0708962956455133,1.0709345270037853,6.103792200784497e-05,3.180806009744199e-06,0.0002680130592344147,7.724114207174892e-05,0.00010047471620300286,6.813897488755494e-05,1.0712025400630198,1.0706665139445508,,False,True,1.0,1.06617,1.07037,1.0695700000000001,1.0691700000000002,True,,,2024-02-14 10:43:56,0.01,even,True,14.68,2813.5699999999993,1,0,7,2
2024-02-14 04:10:00,1.07118,1.07124,1.07114,1.07116,183,12,0,1.07114,1.07129857572982,6.0016155804378614e-06,9.999105964791217e-06,3.110845817339228e-06,3.734632906607115e-05,1.070992751229785,1.0712768965068553,2024-02-14 04:00:00,2024-02-14 04:00:00,0.00020821428571404788,-0.001151944700009233,1.0709723809523808,-0.0001438628501866315,6.255018353484414e-05,1.0709102380952376,1.0707114602535583,1.0712505682770421,1.070643952648502,1.0709735258520177,0.00012945221112035124,-9.123737223688688e-05,1.070927638754766,1.0729074462013761,88.09173669467236,83.52279800808844,-0.0013011033118302206,,-1.0,1.0717500940025855,bearish,1.0709885130186716,1.0709158293014012,1.071009109047128,7.268371727042755e-05,1.708138826188087e-05,0.00027099077460398786,7.458204334276353e-05,7.724114207174892e-05,0.00010047471620300286,1.071280099821732,1.0707381182725242,,False,True,1.0,1.06616,1.07036,1.06956,1.06916,True,,,2024-02-14 10:43:55,0.01,even,True,14.68,2828.249999999999,2,0,7,2
2024-02-14 04:20:00,1.0713,1.07132,1.07116,1.07117,213,12,0,1.0711707087088518,1.07132,-7.491359887556077e-05,-7.178589743886783e-05,3.422789529781697e-05,2.822751317018391e-05,1.0710820786299713,1.0712491853340247,2024-02-14 04:00:00,2024-02-14 04:00:00,0.00020821428571404788,-0.001151944700009233,1.0709723809523808,-0.0001438628501866315,6.255018353484414e-05,1.0709102380952376,1.0707114602535583,1.0712505682770421,1.070643952648502,1.0709735258520177,0.00012945221112035124,-9.123737223688688e-05,1.070927638754766,1.0729074462013761,89.17257683214353,89.38708935110054,-0.0013011033118302206,,-1.0,1.0717500940025855,bearish,1.071055680918694,1.070960320045783,1.071220257997936,9.536087291106554e-05,4.462026014791256e-05,0.0002796742150926112,9.807705538422695e-05,0.00011307189542364426,7.458204334276353e-05,1.0714999322130285,1.0709405837828434,,False,True,1.0,1.06617,1.07037,1.0695700000000001,1.0691700000000002,True,,,2024-02-14 10:43:56,0.01,even,True,14.68,2842.929999999999,3,0,7,2
2024-02-14 04:30:00,1.07115,1.07115,1.07102,1.0711,159,12,0,1.0709666669390998,1.0711733395259129,-7.314812127588952e-05,-6.846887797978695e-05,-6.53470161847102e-05,-4.023989026592564e-05,1.0711570393998462,1.071385200998697,2024-02-14 04:00:00,2024-02-14 04:00:00,0.00020821428571404788,-0.001151944700009233,1.0709723809523808,-0.0001438628501866315,6.255018353484414e-05,1.0709102380952376,1.0707114602535583,1.0712505682770421,1.070643952648502,1.0709735258520177,0.00012945221112035124,-9.123737223688688e-05,1.070927638754766,1.0729074462013761,80.3796412181756,85.83182682055262,-0.0013011033118302206,,-1.0,1.0717500940025855,bearish,1.0710760792376448,1.070984362179169,1.071255008599932,9.171705847577094e-05,6.235939492949444e-05,0.00028368115891108165,-8.11489507968055e-06,4.286549707566145e-05,9.807705538422695e-05,1.071538689758843,1.0709713274410209,,False,True,1.0,1.0661,1.0703,1.0695000000000001,1.0691000000000002,True,,,2024-02-14 10:42:46,0.01,even,True,14.68,2857.6099999999988,4,0,7,2
2024-02-14 04:35:00,1.07109,1.0711,1.07093,1.07096,163,12,0,1.0708083315284267,1.0711,1.558140914954698e-06,-4.690239678287632e-05,-7.178589743886783e-05,-7.491359887556077e-05,1.0711652074741642,1.0713147277108976,2024-02-14 04:00:00,2024-02-14 04:00:00,0.00020821428571404788,-0.001151944700009233,1.0709723809523808,-0.0001438628501866315,6.255018353484414e-05,1.0709102380952376,1.0707114602535583,1.0712505682770421,1.070643952648502,1.0709735258520177,0.00012945221112035124,-9.123737223688688e-05,1.070927638754766,1.0729074462013761,70.31417476972828,79.54569279974753,-0.0013011033118302206,,-1.0,1.0717500940025855,bearish,1.0710582208933919,1.0709825575733045,1.0712522463020293,7.56633200873491e-05,6.502017996106537e-05,0.00028106227053987696,-2.7622979026364902e-06,-8.11489507968055e-06,4.286549707566145e-05,1.0715333085725691,1.0709711840314895,,False,True,1.0,1.06596,1.07016,1.06936,1.0689600000000001,True,,,2024-02-14 10:40:39,0.01,even,True,14.68,2872.2899999999986,5,0,7,2
2024-02-14 04:40:00,1.07097,1.07099,1.07081,1.0709,161,12,0,1.07081,1.07099,1.9007115290682484e-05,-9.557802959097928e-06,-6.846187747207111e-05,-0.00010304691417371675,1.071133521384308,1.0712416453697737,2024-02-14 04:00:00,2024-02-14 04:00:00,0.00020821428571404788,-0.001151944700009233,1.0709723809523808,-0.0001438628501866315,6.255018353484414e-05,1.0709102380952376,1.0707114602535583,1.0712505682770421,1.070643952648502,1.0709735258520177,0.00012945221112035124,-9.123737223688688e-05,1.070927638754766,1.0729074462013761,57.321266968312706,69.33836098540554,-0.0013011033118302206,,-1.0,1.0717500940025855,bearish,1.0710338792174854,1.0709764421975043,1.0712097076023392,5.743701998106587e-05,6.350354796506547e-05,0.0002799690457668486,-4.253869969006452e-05,-2.7622979026364902e-06,-8.11489507968055e-06,1.0714896766481061,1.0709297385565724,,False,True,1.0,1.0659,1.0701,1.0693000000000001,1.0689000000000002,True,,,2024-02-14 10:40:20,0.01,even,True,14.68,2886.9699999999984,6,0,7,2
2024-02-14 04:55:00,1.07091,1.07097,1.07087,1.0709,104,12,0,1.0707433340623016,1.07097,1.5564708617096125e-05,-1.667376203648277e-05,-9.557802959097928e-06,1.9007115290682484e-05,1.0708113941701551,1.070989298818873,2024-02-14 04:00:00,2024-02-14 04:00:00,0.00020821428571404788,-0.001151944700009233,1.0709723809523808,-0.0001438628501866315,6.255018353484414e-05,1.0709102380952376,1.0707114602535583,1.0712505682770421,1.070643952648502,1.0709735258520177,0.00012945221112035124,-9.123737223688688e-05,1.070927638754766,1.0729074462013761,26.934984520115318,35.46025949740176,-0.0013011033118302206,,-1.0,1.0717500940025855,bearish,1.0709881170862419,1.0709645942862371,1.071062445820434,2.3522800004727173e-05,4.8567389982940585e-05,0.00025633766777513687,-5.180942552329704e-05,-5.665634674900666e-05,-3.8796009632857675e-05,1.0713187834882092,1.070806108152659,,False,True,1.0,1.0659,1.0701,1.0693000000000001,1.0689000000000002,True,,,2024-02-14 10:40:20,0.01,even,True,14.68,2901.6499999999983,7,0,7,2
2024-02-14 05:55:00,1.07122,1.07126,1.07118,1.07119,101,12,0,1.0710950014538587,1.0713783449155483,-4.2015320003818206e-05,-8.246251997696319e-05,3.733865965040875e-05,3.734342768475228e-05,1.0710627528094194,1.071262748958266,2024-02-14 05:00:00,2024-02-14 05:00:00,6.214285714323253e-05,-0.0010505266601499308,1.0710228571428573,2.8953821074093023e-05,-1.0578123325567646e-05,1.0709723809523808,1.0702001564984025,1.0713905538562492,1.0707114602535583,1.0712505682770421,6.255018353484414e-05,-0.0001438628501866315,1.0711025462515886,1.0727700505052662,83.29076202641399,87.2030055938294,-0.0012509879814941627,,-1.0,1.071668399719861,bearish,1.071085871141035,1.0710237187909342,1.0711201926384586,6.21523501007637e-05,3.372457150381528e-05,0.0001448562503176279,4.988648090931136e-05,5.5163398691826515e-05,8.11145510835054e-05,1.0712650488887763,1.070975336388141,,False,True,1.0,1.0661900000000002,1.0703900000000002,1.0695900000000003,1.0691900000000003,True,,,2024-02-14 10:44:16,0.01,even,True,14.68,2916.329999999998,8,0,7,2
2024-02-14 06:00:00,1.07119,1.07129,1.07105,1.07107,137,12,0,1.0710607048259142,1.07129,-6.246880072000705e-05,-9.368063904645731e-05,-1.8335968280648874e-05,-1.223072389798901e-05,1.071099100556083,1.0713475823042677,2024-02-14 06:00:00,2024-02-14 06:00:00,5.0476190476489435e-05,-0.0009222493323424175,1.0711517857142858,0.00019014826716198257,2.167948805827059e-06,1.0710228571428573,1.0700705381689248,1.0713801601225694,1.0702001564984025,1.0713905538562492,-1.0578123325567646e-05,2.8953821074093023e-05,1.0712808487505294,1.072658046464845,68.39080459771239,79.17747074836994,-0.0011852402516638137,,-1.0,1.071604571590344,bearish,1.0710834294270295,1.0710271470286428,1.0711416683866533,5.62823983867311e-05,3.8236136880398446e-05,0.00014458330905075514,2.147574819466591e-05,4.988648090931136e-05,5.5163398691826515e-05,1.071286251695704,1.0709970850776025,,False,True,1.0,1.06607,1.07027,1.0694700000000001,1.0690700000000002,True,,,2024-02-14 10:16:52,0.01,even,True,14.68,2931.009999999998,9,0,7,2
2024-02-14 07:10:00,1.0712,1.07122,1.07111,1.07111,148,12,0,1.0710710604145863,1.0712800003465668,2.767818003950369e-05,9.334260660482301e-06,-3.266897182656316e-05,-1.845187171575188e-05,1.0711786422154668,1.0714576001266096,2024-02-14 07:00:00,2024-02-14 07:00:00,0.00012892857142854375,-0.0007907921839236387,1.0712479761904765,0.00019013801425869163,4.417998080013943e-05,1.0711517857142858,1.070274021219285,1.0712759311492357,1.0700705381689248,1.0713801601225694,2.167948805827059e-06,0.00019014826716198257,1.0713136162501766,1.0725518027476575,67.87878787879572,81.18546576880449,-0.0011063506381157786,,-1.0,1.0715581882644978,bearish,1.0711810108610642,1.071116880661809,1.071208995528035,6.413019925521901e-05,5.602806460202921e-05,0.00015130763339432415,-8.837289301455442e-06,1.2789817681158056e-05,3.7674578601487596e-05,1.0713603031614294,1.0710576878946407,,False,True,1.0,1.0661100000000001,1.07031,1.0695100000000002,1.0691100000000002,True,,,2024-02-14 10:43:28,0.01,even,True,14.68,2945.689999999998,10,0,7,2
2024-02-14 07:20:00,1.07123,1.07126,1.07118,1.07118,58,12,0,1.0711160607753456,1.07126,5.1014291265135725e-05,5.4671702208543244e-05,-4.378087585384486e-05,-2.333955075558401e-05,1.0711382796711038,1.0713867746816852,2024-02-14 07:00:00,2024-02-14 07:00:00,0.00012892857142854375,-0.0007907921839236387,1.0712479761904765,0.00019013801425869163,4.417998080013943e-05,1.0711517857142858,1.070274021219285,1.0712759311492357,1.0700705381689248,1.0713801601225694,2.167948805827059e-06,0.00019014826716198257,1.0713136162501766,1.0725518027476575,56.96969696970163,61.21212121212637,-0.0011063506381157786,,-1.0,1.0715581882644978,bearish,1.0711872326283358,1.0711293146963383,1.0712519057447538,5.791793199749762e-05,5.7567592484682545e-05,0.00013629380001962404,1.3581011352181704e-05,2.932920536657946e-05,-8.837289301455442e-06,1.0713881995447734,1.0711156119447343,,False,True,1.0,1.0661800000000001,1.07038,1.0695800000000002,1.0691800000000002,True,,,2024-02-14 10:44:15,0.01,even,True,14.68,2960.3699999999976,11,0,7,2
2024-02-14 07:45:00,1.07137,1.07137,1.0713,1.07131,129,12,0,1.0712599968887087,1.0713592958242482,-2.3336097490484647e-05,4.066367030375789e-05,-1.711048735610223e-05,2.8224820906104292e-05,1.071222082654796,1.0714570701888078,2024-02-14 07:00:00,2024-02-14 07:00:00,0.00012892857142854375,-0.0007907921839236387,1.0712479761904765,0.00019013801425869163,4.417998080013943e-05,1.0711517857142858,1.070274021219285,1.0712759311492357,1.0700705381689248,1.0713801601225694,2.167948805827059e-06,0.00019014826716198257,1.0713136162501766,1.0725518027476575,78.03473329790006,82.12161849091898,-0.0011063506381157786,,-1.0,1.0715581882644978,bearish,1.071273801612274,1.0711963550430308,1.0713535466116266,7.744656924324467e-05,6.877691643176669e-05,0.00014203872684843673,-9.61128311005588e-06,1.9239766081646792e-05,3.130030959730412e-05,1.071495585338475,1.0712115078847781,,False,True,1.0,1.06631,1.07051,1.0697100000000002,1.0693100000000002,True,,,2024-02-14 10:44:49,0.01,even,True,14.68,2975.0499999999975,12,0,7,2
2024-02-14 08:10:00,1.07153,1.07154,1.07142,1.07151,152,12,0,1.07142,1.071586668107794,9.55444388425534e-06,1.0886491451856123e-05,4.044283887571413e-05,6.567349355940853e-05,1.0712148590130428,1.071449659699055,2024-02-14 08:00:00,2024-02-14 08:00:00,9.619047619069399e-05,-0.0006848269409693852,1.071408095238095,0.00012791956181117795,0.00011182225094291298,1.0712479761904765,1.0705955337747555,1.0713282810118003,1.070274021219285,1.0712759311492357,4.417998080013943e-05,0.00019013801425869163,1.071484538750059,1.072473258527845,92.03703703703468,82.97178130511706,-0.0010220458986864999,,-1.0,1.0715286440789136,bearish,1.0713695777282586,1.071271900433747,1.0714166907464735,9.767729451160001e-05,8.057242760178811e-05,0.0001683825008489802,2.1448228412213055e-05,3.169246646139712e-05,1.4131406948392211e-05,1.0715850732473224,1.0712483082456246,,False,True,1.0,1.06651,1.07071,1.0699100000000001,1.0695100000000002,True,,,2024-02-14 09:43:40,0.01,even,True,14.68,2989.7299999999973,13,0,7,2
2024-02-14 08:20:00,1.07153,1.07161,1.07147,1.07148,151,12,0,1.071423333002943,1.07161,-6.222137175942755e-06,3.399527752234826e-05,2.510688276189788e-05,4.377505064880138e-05,1.0713432378810588,1.0715311460713335,2024-02-14 08:00:00,2024-02-14 08:00:00,9.619047619069399e-05,-0.0006848269409693852,1.071408095238095,0.00012791956181117795,0.00011182225094291298,1.0712479761904765,1.0705955337747555,1.0713282810118003,1.070274021219285,1.0712759311492357,4.417998080013943e-05,0.00019013801425869163,1.071484538750059,1.072473258527845,86.66666666667935,90.98765432099911,-0.0010220458986864999,,-1.0,1.0715286440789136,bearish,1.0714074491427175,1.0713050175186445,1.0714705882352937,0.0001024316240729739,8.857094369909992e-05,0.00015450782049079002,2.02579979364792e-05,3.363949088375229e-05,2.1448228412213055e-05,1.0716250960557845,1.071316080414803,,False,True,1.0,1.06648,1.07068,1.0698800000000002,1.0694800000000002,True,,,2024-02-14 09:43:18,0.01,even,True,14.68,3004.409999999997,14,0,7,2
2024-02-14 08:45:00,1.07177,1.07181,1.07169,1.07169,76,12,0,1.0717006704037955,1.0718189304334884,-0.00036431511523708033,-4.6320255919734085e-05,8.464140266608637e-05,9.043015775454735e-05,1.0714167082245651,1.0716348564397928,2024-02-14 08:00:00,2024-02-14 08:00:00,9.619047619069399e-05,-0.0006848269409693852,1.071408095238095,0.00012791956181117795,0.00011182225094291298,1.0712479761904765,1.0705955337747555,1.0713282810118003,1.070274021219285,1.0712759311492357,4.417998080013943e-05,0.00019013801425869163,1.071484538750059,1.072473258527845,89.74358974359784,87.83000949669105,-0.0010220458986864999,,-1.0,1.0715286440789136,bearish,1.0715495733878198,1.0714144975840678,1.0716589473684204,0.0001350758037519384,0.00011076925613365963,0.00016679128652634338,3.050911592672456e-05,4.674234605994698e-05,4.850705194425764e-05,1.0718257386549468,1.071492156081894,,False,True,1.0,1.0666900000000001,1.0708900000000001,1.0700900000000002,1.0696900000000003,True,2024-02-14 10:35:00,,2024-02-14 09:44:54,0.01,even,True,14.68,3019.089999999997,15,0,7,2
2024-02-14 08:50:00,1.07169,1.07178,1.07166,1.07167,98,12,0,1.0715599640050375,1.0720168279087974,-0.00048082204842801534,-0.00016179038248888573,9.99958384821601e-06,4.687752067147081e-05,1.0715234768487032,1.0717893067483295,2024-02-14 08:00:00,2024-02-14 08:00:00,9.619047619069399e-05,-0.0006848269409693852,1.071408095238095,0.00012791956181117795,0.00011182225094291298,1.0712479761904765,1.0705955337747555,1.0713282810118003,1.070274021219285,1.0712759311492357,4.417998080013943e-05,0.00019013801425869163,1.071484538750059,1.072473258527845,83.88888888889261,88.03893637227849,-0.0010220458986864999,,-1.0,1.0715286440789136,bearish,1.0715681005589244,1.0714334236889516,1.0716740178878568,0.00013467686997281625,0.00011555077890149096,0.00017275994885389205,1.5070519436388707e-05,3.050911592672456e-05,4.674234605994698e-05,1.0718467778367107,1.0715012579390029,,False,True,1.0,1.06667,1.07087,1.07007,1.0696700000000001,True,2024-02-14 10:35:00,,2024-02-14 09:44:46,0.01,even,True,14.68,3033.769999999997,16,0,7,2
2024-02-14 08:55:00,1.07166,1.07171,1.07135,1.07157,239,12,0,1.070561639580766,1.071865389068114,-2.9554625484954218e-05,-0.0001823054283607345,-2.4880489031566895e-05,-0.00010287241292077152,1.0716730673654746,1.071831490745926,2024-02-14 08:00:00,2024-02-14 08:00:00,9.619047619069399e-05,-0.0006848269409693852,1.071408095238095,0.00012791956181117795,0.00011182225094291298,1.0712479761904765,1.0705955337747555,1.0713282810118003,1.070274021219285,1.0712759311492357,4.417998080013943e-05,0.00019013801425869163,1.071484538750059,1.072473258527845,72.22222222222224,81.95156695157091,-0.0010220458986864999,,-1.0,1.0715286440789136,bearish,1.0715683927806283,1.071443540452733,1.0716719401444788,0.00012485232789538614,0.00011741108870027001,0.0001725282583467606,-2.077743378015029e-06,1.5070519436388707e-05,3.050911592672456e-05,1.0718444684028254,1.071499411886132,,False,True,1.0,1.06657,1.07077,1.06997,1.0695700000000001,True,,,2024-02-14 09:43:55,0.01,even,True,14.68,3048.4499999999966,17,0,7,2
2024-02-14 09:00:00,1.07151,1.07167,1.07053,1.07086,633,12,0,1.070340050794106,1.07167,0.00016810926641462785,-0.00011530527565137749,-4.6320255919734085e-05,-0.00036431511523708033,1.0716739406311655,1.0718155315077749,2024-02-14 09:00:00,2024-02-14 09:00:00,0.00016011904761858986,-0.0005679910460634208,1.0712161904761905,-6.989504890386371e-05,0.00014952986327052814,1.071408095238095,1.0707548881370124,1.0713402469697664,1.0705955337747555,1.0713282810118003,0.00011182225094291298,0.00012791956181117795,1.0709548462500196,1.0723305978456175,54.14930555554946,70.08680555555479,-0.0009312349281618841,,-1.0,1.071515179315596,bearish,1.0714594092759162,1.071400315234012,1.0715379979360165,5.9094041904295125e-05,0.00010574767934107504,0.00020660590487177414,-0.00013394220846230098,-2.077743378015029e-06,1.5070519436388707e-05,1.0717446038408882,1.0713313920311447,,False,True,1.0,1.06586,1.07006,1.06926,1.0688600000000001,True,,,2024-02-14 10:40:12,0.01,even,True,14.68,3063.1299999999965,18,0,7,2
2024-02-14 09:05:00,1.07089,1.07089,1.07052,1.07086,408,12,0,1.07052,1.071248593902372,5.003076397570196e-05,2.866017191764836e-05,-0.00016179038248888573,-0.00048082204842801534,1.0715246908998732,1.072004953776397,2024-02-14 09:00:00,2024-02-14 09:00:00,0.00016011904761858986,-0.0005679910460634208,1.0712161904761905,-6.989504890386371e-05,0.00014952986327052814,1.071408095238095,1.0707548881370124,1.0713402469697664,1.0705955337747555,1.0713282810118003,0.00011182225094291298,0.00012791956181117795,1.0709548462500196,1.0723305978456175,37.37927971575874,54.58360249784349,-0.0009312349281618841,,-1.0,1.071515179315596,bearish,1.0713671924642367,1.0713602918833445,1.0714160612315102,6.900580892255093e-06,8.597825965131105e-05,0.00023398717898124292,-0.0001219367045062203,-0.00013394220846230098,-2.077743378015029e-06,1.0716500484104914,1.071182074052529,,False,True,1.0,1.06586,1.07006,1.06926,1.0688600000000001,True,,,2024-02-14 10:40:12,0.01,even,True,14.68,3077.8099999999963,19,0,7,2
2024-02-14 09:15:00,1.07121,1.07131,1.0709,1.071,307,12,0,1.070775004407073,1.07131,-9.806874044481342e-05,-0.00015903390037439708,-0.00011530527565137749,0.00016810926641462785,1.0703523930461443,1.071661524076825,2024-02-14 09:00:00,2024-02-14 09:00:00,0.00016011904761858986,-0.0005679910460634208,1.0712161904761905,-6.989504890386371e-05,0.00014952986327052814,1.071408095238095,1.0707548881370124,1.0713402469697664,1.0705955337747555,1.0713282810118003,0.00011182225094291298,0.00012791956181117795,1.0709548462500196,1.0723305978456175,39.27648578811816,37.37430017226644,-0.0009312349281618841,,-1.0,1.071515179315596,bearish,1.071291540166702,1.0713239813814681,1.0712753353973166,-3.244121476608797e-05,4.7681455664105704e-05,0.00024008678971199155,-9.253181974666624e-05,-4.8194014447000555e-05,-0.0001219367045062203,1.0715154221870287,1.0710352486076045,,False,True,1.0,1.066,1.0702,1.0694000000000001,1.0690000000000002,True,,,2024-02-14 10:41:13,0.01,even,True,14.68,3092.489999999996,20,0,7,2
2024-02-14 09:25:00,1.0708199999999999,1.07098,1.07069,1.07069,338,12,0,1.0704810472477706,1.07098,-9.667833631802046e-06,-2.5115620551957702e-05,-0.0001490491560650647,-7.905831560026752e-05,1.0708442174857047,1.0714480850922123,2024-02-14 09:00:00,2024-02-14 09:00:00,0.00016011904761858986,-0.0005679910460634208,1.0712161904761905,-6.989504890386371e-05,0.00014952986327052814,1.071408095238095,1.0707548881370124,1.0713402469697664,1.0705955337747555,1.0713282810118003,0.00011182225094291298,0.00012791956181117795,1.0709548462500196,1.0723305978456175,24.289405684758503,33.85012919897173,-0.0009312349281618841,,-1.0,1.071515179315596,bearish,1.0711363098234967,1.071241767302356,1.0710169418644653,-0.00010545747885926104,-1.5276237327236233e-06,0.00029552608445565796,-0.00013601995183964988,-0.00012237358101163665,-9.253181974666624e-05,1.071312467948921,1.0707214157800096,,False,True,1.0,1.06569,1.06989,1.06909,1.0686900000000001,True,,,2024-02-14 10:39:13,0.01,even,True,14.68,3107.169999999996,21,0,7,2
2024-02-15 00:10:00,1.07257,1.0726,1.07253,1.0726,15,38,0,1.0724900019695567,1.0725966671598153,3.729385312137381e-05,4.8167156480662976e-05,1.2427955318196077e-05,-4.973118139574662e-05,1.0724929296315202,1.0727542697984498,2024-02-15 00:00:00,2024-02-15 00:00:00,-0.00014333333333294007,0.0003639619583555298,1.0726944047619047,-3.130639189458175e-05,-0.00012597259090242133,1.0728221428571436,1.0725219448634935,1.0733005201505335,1.0725665268503746,1.0734807702734248,-0.00017108064273938298,-3.662213876752363e-05,1.0726282434358831,1.072128859008317,40.48840048838065,38.28689828688833,0.00012403539415245431,1.0706091893976704,1.0,1.072582251618397,bullish,1.0726167012211831,1.0726421567564453,1.07260123495012,-2.5455535262119966e-05,-2.058578888643734e-05,5.972994725392906e-05,1.214310284769482e-06,-1.5486756106408706e-05,-1.2466460267646085e-05,1.072660964897374,1.072541505002866,,True,False,0.0,1.0776,1.0734,1.0741999999999998,1.0745999999999998,True,2024-02-15 15:20:00,2024-02-15 16:32:08,2024-02-15 09:40:00,0.01,even,True,14.68,3121.849999999996,22,0,7,2
2024-02-15 00:20:00,1.0726,1.0727,1.07257,1.0727,5,23,0,1.07257,1.0727166671523463,2.5086002958279912e-05,-3.10761138955883e-06,-2.8190005103525217e-05,5.927712730395508e-05,1.0723944611513723,1.0727778776766839,2024-02-15 00:00:00,2024-02-15 00:00:00,-0.00014333333333294007,0.0003639619583555298,1.0726944047619047,-3.130639189458175e-05,-0.00012597259090242133,1.0728221428571436,1.0725219448634935,1.0733005201505335,1.0725665268503746,1.0734807702734248,-0.00017108064273938298,-3.662213876752363e-05,1.0726282434358831,1.072128859008317,62.39316239315465,49.9633699633577,0.00012403539415245431,1.0706091893976704,1.0,1.072582251618397,bullish,1.0726273422944566,1.072643550031246,1.0726223047815617,-1.6207736789342064e-05,-2.040080923814705e-05,5.975505500798915e-05,2.1503267973788098e-05,-4.334365319991207e-07,1.214310284769482e-06,1.0726820598365696,1.0725625497265538,,True,False,0.0,1.0776999999999999,1.0735,1.0742999999999998,1.0746999999999998,True,2024-02-15 15:20:00,2024-02-15 16:32:17,2024-02-15 09:38:14,0.01,even,True,14.68,3136.5299999999957,23,0,7,2
2024-02-15 01:05:00,1.07292,1.0729899999999999,1.0729,1.07296,39,11,0,1.0729,1.0730033323684707,9.658883423150024e-06,7.766752242826352e-06,7.889199957474012e-05,0.00011652994421001101,1.072433823635577,1.0727559598594472,2024-02-15 01:00:00,2024-02-15 01:00:00,-0.00012773809523891622,0.000350613665850652,1.072744642857142,-2.362557858320131e-05,7.005764358513874e-05,1.0726944047619047,1.0724642216415856,1.0728746127555817,1.0725219448634935,1.0733005201505335,-0.00012597259090242133,-3.130639189458175e-05,1.0729694144786277,1.0722097502876515,85.51282051281738,80.07122507121171,0.00016935104849209384,1.0707754380338101,1.0,1.0727022337057555,bullish,1.0727423698377165,1.072698932149045,1.0727741864465083,4.343768867154374e-05,1.0498386992962481e-05,9.721111012962218e-05,5.291709666388478e-05,5.255245957846988e-05,-8.458892326812517e-06,1.072871397556638,1.0726769753363787,,True,False,0.0,1.0779599999999998,1.0761599999999996,1.0769599999999995,1.0779599999999994,True,2024-02-15 16:35:00,2024-02-15 16:33:06,2024-02-15 15:49:28,0.01,even,True,58.71,3195.2399999999957,24,0,7,2
2024-02-15 06:05:00,1.0725,1.07259,1.0725,1.07254,130,12,0,1.072510715016915,1.072610001328909,-3.1303415641069903e-05,-6.194744100534798e-10,2.508683267405515e-05,-1.4179038612715036e-11,1.0724500000293475,1.0725111635901354,2024-02-15 06:00:00,2024-02-15 06:00:00,-0.00013035714285591915,0.00028108279762806276,1.072725714285714,-6.961667310744865e-05,-0.00021929310580347467,1.072838333333334,1.0726394426711066,1.0736689397069796,1.0726759874440268,1.0735947846880676,-6.9879936589095e-05,-5.3444254322207125e-05,1.0725631663147268,1.0724017394355894,13.333333333330676,11.361231361226158,0.000292943585231089,1.071610065681337,1.0,1.0733628257790464,bullish,1.072632766329388,1.0727302934940763,1.0725123082215342,-9.75271646883602e-05,-6.453047313623326e-05,0.00018318933720838155,-2.0853113175345328e-05,-5.5407636738502575e-05,-6.735810113478458e-05,1.0726954975587426,1.0723291188843258,,True,False,0.0,1.07754,1.07334,1.0741399999999999,1.0745399999999998,True,2024-02-15 14:40:00,2024-02-15 16:32:08,2024-02-15 09:45:18,0.01,even,True,14.68,3209.9199999999955,25,0,7,2
2024-02-15 06:10:00,1.07254,1.07261,1.07253,1.07259,73,12,0,1.072509998345744,1.0726339168532417,-4.662101425388868e-05,-3.2294922393124445e-05,2.3308041544240986e-05,3.1079532628799036e-05,1.072419004932925,1.0725317518085973,2024-02-15 06:00:00,2024-02-15 06:00:00,-0.00013035714285591915,0.00028108279762806276,1.072725714285714,-6.961667310744865e-05,-0.00021929310580347467,1.072838333333334,1.0726394426711066,1.0736689397069796,1.0726759874440268,1.0735947846880676,-6.9879936589095e-05,-5.3444254322207125e-05,1.0725631663147268,1.0724017394355894,18.787878787873193,14.242424242419384,0.000292943585231089,1.071610065681337,1.0,1.0733628257790464,bullish,1.0726261868940974,1.072719901383404,1.072498950808393,-9.371448930650672e-05,-7.036727637028795e-05,0.00018419916738908237,-1.3357413141124042e-05,-2.0853113175345328e-05,-5.5407636738502575e-05,1.072683149975782,1.072314751641004,,True,False,0.0,1.0775899999999998,1.0733899999999998,1.0741899999999998,1.0745899999999997,True,2024-02-15 15:20:00,2024-02-15 16:32:08,2024-02-15 09:45:14,0.01,even,True,14.68,3224.5999999999954,26,0,7,2
2024-02-15 06:35:00,1.07243,1.07253,1.0724,1.07249,128,12,0,1.0723866683385195,1.07253,1.0878262646496496e-05,1.9976778534631567e-06,-1.5762604243428587e-05,-6.441572212807261e-06,1.072420240578294,1.0725688168325052,2024-02-15 06:00:00,2024-02-15 06:00:00,-0.00013035714285591915,0.00028108279762806276,1.072725714285714,-6.961667310744865e-05,-0.00021929310580347467,1.072838333333334,1.0726394426711066,1.0736689397069796,1.0726759874440268,1.0735947846880676,-6.9879936589095e-05,-5.3444254322207125e-05,1.0725631663147268,1.0724017394355894,10.405967229135827,9.86364006906089,0.000292943585231089,1.071610065681337,1.0,1.0733628257790464,bullish,1.0725386021430008,1.0726409475040366,1.072405761953905,-0.00010234536103581604,-9.150791727083324e-05,0.00021455380040051836,-1.8300653594760519e-06,-2.0643274853293647e-05,-2.59511523912348e-05,1.0726203157543055,1.0721912081535043,,True,False,0.0,1.0774899999999998,1.0732899999999999,1.0740899999999998,1.0744899999999997,True,2024-02-15 14:40:00,2024-02-15 16:32:08,2024-02-15 09:46:51,0.01,even,True,14.68,3239.279999999995,27,0,7,2
2024-02-15 06:45:00,1.07241,1.07254,1.07241,1.07253,53,12,0,1.0723999990674382,1.07252928935298,3.263644538695047e-05,6.237339191017127e-05,1.0878562176093736e-05,1.998145026294128e-06,1.0724037215679978,1.0725191494388553,2024-02-15 06:00:00,2024-02-15 06:00:00,-0.00013035714285591915,0.00028108279762806276,1.072725714285714,-6.961667310744865e-05,-0.00021929310580347467,1.072838333333334,1.0726394426711066,1.0736689397069796,1.0726759874440268,1.0735947846880676,-6.9879936589095e-05,-5.3444254322207125e-05,1.0725631663147268,1.0724017394355894,21.088861076327635,13.662672209976924,0.000292943585231089,1.071610065681337,1.0,1.0733628257790464,bullish,1.0725218394041602,1.0726175750206075,1.072411895424837,-9.57356164472678e-05,-9.438824838980505e-05,0.00020188940850327574,1.5321637427012647e-05,-9.188166494977779e-06,-1.8300653594760519e-06,1.0726137848333401,1.0722100060163338,,True,False,0.0,1.0775299999999999,1.07333,1.0741299999999998,1.0745299999999998,True,2024-02-15 14:40:00,2024-02-15 16:32:08,2024-02-15 09:45:18,0.01,even,True,14.68,3253.959999999995,28,0,7,2
2024-02-15 06:55:00,1.07249,1.07257,1.07247,1.07253,120,12,0,1.072480712390497,1.0726933335949476,4.328859989160575e-05,3.418104434861828e-05,1.7980722240499602e-05,2.331180218643032e-05,1.0723967494693807,1.0725113503084722,2024-02-15 06:00:00,2024-02-15 06:00:00,-0.00013035714285591915,0.00028108279762806276,1.072725714285714,-6.961667310744865e-05,-0.00021929310580347467,1.072838333333334,1.0726394426711066,1.0736689397069796,1.0726759874440268,1.0735947846880676,-6.9879936589095e-05,-5.3444254322207125e-05,1.0725631663147268,1.0724017394355894,50.84033613444493,34.6984656746745,0.000292943585231089,1.071610065681337,1.0,1.0733628257790464,bullish,1.0725215536562331,1.0726037097227432,1.0724620880632951,-8.215606651007512e-05,-9.117385918287971e-05,0.00018502252096808035,2.3285173717635388e-05,2.6907464740544285e-05,1.5321637427012647e-05,1.0726471105842632,1.072277065542327,,True,False,0.0,1.0775299999999999,1.07333,1.0741299999999998,1.0745299999999998,True,2024-02-15 14:40:00,2024-02-15 16:32:08,2024-02-15 09:45:18,0.01,even,True,14.68,3268.639999999995,29,0,7,2
2024-02-15 07:00:00,1.07254,1.07273,1.07254,1.07272,123,12,0,1.07254,1.07273,4.2293103249441674e-05,1.3983344308469205e-05,6.237339191017127e-05,3.263644538695047e-05,1.0724024559345637,1.0725339853843487,2024-02-15 07:00:00,2024-02-15 07:00:00,-0.00011261904761994401,0.00022824144699429283,1.0727094047619055,-3.916297558353262e-05,-7.23611615670008e-05,1.072725714285714,1.072523049306028,1.0734445386595128,1.0726394426711066,1.0736689397069796,-0.00021929310580347467,-6.961667310744865e-05,1.0727477221049089,1.0724368002807423,70.41847041845863,51.141668788718164,0.0002800031575837298,1.07175966042683,1.0,1.073507058966341,bullish,1.0725520838629665,1.0726123238173548,1.0725135225318203,-6.023995438830809e-05,-8.49870782239654e-05,0.00017925772860691416,5.1434468525179966e-05,2.3285173717635388e-05,2.6907464740544285e-05,1.0726927802604271,1.0723342648032135,,True,False,0.0,1.0777199999999998,1.0735199999999998,1.0743199999999997,1.0747199999999997,True,2024-02-15 15:20:00,2024-02-15 16:32:17,2024-02-15 09:38:08,0.01,even,True,14.68,3283.3199999999947,30,0,7,2
2024-02-15 07:10:00,1.07264,1.07276,1.07262,1.07274,118,12,0,1.0725421860736182,1.0727492871090112,6.457983622030079e-05,9.032042257954086e-05,3.418104434861828e-05,4.328859989160575e-05,1.0724839722624102,1.072695908126844,2024-02-15 07:00:00,2024-02-15 07:00:00,-0.00011261904761994401,0.00022824144699429283,1.0727094047619055,-3.916297558353262e-05,-7.23611615670008e-05,1.072725714285714,1.072523049306028,1.0734445386595128,1.0726394426711066,1.0736689397069796,-0.00021929310580347467,-6.961667310744865e-05,1.0727477221049089,1.0724368002807423,87.03703703703759,77.88199454865165,0.0002800031575837298,1.07175966042683,1.0,1.073507058966341,bullish,1.072591136966976,1.0726229936705718,1.0725947609219129,-3.1856703595734004e-05,-6.869302330183235e-05,0.00015819608064598012,4.345029239760656e-05,3.778809769494629e-05,5.1434468525179966e-05,1.072752957002559,1.0724365648412668,,True,False,0.0,1.07774,1.07354,1.0743399999999999,1.0747399999999998,True,2024-02-15 15:35:00,2024-02-15 16:32:17,2024-02-15 09:38:05,0.01,even,True,14.68,3297.9999999999945,31,0,7,2
2024-02-15 07:15:00,1.07275,1.07278,1.07269,1.07276,100,12,0,1.0725933489138062,1.072769282508334,7.30191214155213e-05,0.00012616102246789485,1.3983344308469205e-05,4.2293103249441674e-05,1.072543185927141,1.0727310535468062,2024-02-15 07:00:00,2024-02-15 07:00:00,-0.00011261904761994401,0.00022824144699429283,1.0727094047619055,-3.916297558353262e-05,-7.23611615670008e-05,1.072725714285714,1.072523049306028,1.0734445386595128,1.0726394426711066,1.0736689397069796,-0.00021929310580347467,-6.961667310744865e-05,1.0727477221049089,1.0724368002807423,86.29275208222184,83.17342176990606,0.0002800031575837298,1.07175966042683,1.0,1.073507058966341,bullish,1.0726171158951336,1.0726331422875663,1.0726344375644992,-1.6026392432699765e-05,-5.815969712800584e-05,0.00014871449133046252,3.967664258630599e-05,4.345029239760656e-05,3.778809769494629e-05,1.0727831520558295,1.0724857230731688,,True,False,0.0,1.0777599999999998,1.0735599999999998,1.0743599999999998,1.0747599999999997,True,2024-02-15 15:35:00,2024-02-15 16:32:17,2024-02-15 09:38:01,0.01,even,True,14.68,3312.6799999999944,32,0,7,2
2024-02-15 07:20:00,1.07275,1.07278,1.07267,1.07276,101,12,0,1.0725896805266142,1.0729085733884756,0.0001494583586362515,0.00011249768088189144,1.8643579868376797e-05,1.8308221930505228e-05,1.072612464819955,1.0727314046630625,2024-02-15 07:00:00,2024-02-15 07:00:00,-0.00011261904761994401,0.00022824144699429283,1.0727094047619055,-3.916297558353262e-05,-7.23611615670008e-05,1.072725714285714,1.072523049306028,1.0734445386595128,1.0726394426711066,1.0736689397069796,-0.00021929310580347467,-6.961667310744865e-05,1.0727477221049089,1.0724368002807423,94.63937621830907,89.32305511252285,0.0002800031575837298,1.07175966042683,1.0,1.073507058966341,bullish,1.072639098065113,1.072642539155154,1.0726700894392847,-3.441090040912087e-06,-4.7215975710587095e-05,0.00014183676039127358,3.56518747854917e-05,3.967664258630599e-05,4.345029239760656e-05,1.072811926199676,1.0725282526788933,,True,False,0.0,1.0777599999999998,1.0735599999999998,1.0743599999999998,1.0747599999999997,True,2024-02-15 15:35:00,2024-02-15 16:32:17,2024-02-15 09:38:01,0.01,even,True,14.68,3327.359999999994,33,0,7,2
2024-02-15 07:25:00,1.07276,1.07304,1.07275,1.07303,135,12,0,1.07275,1.0731416645444827,9.03238014515684e-05,7.767309220034773e-06,9.032042257954086e-05,6.457983622030079e-05,1.0725470682984821,1.0727561166425967,2024-02-15 07:00:00,2024-02-15 07:00:00,-0.00011261904761994401,0.00022824144699429283,1.0727094047619055,-3.916297558353262e-05,-7.23611615670008e-05,1.072725714285714,1.072523049306028,1.0734445386595128,1.0726394426711066,1.0736689397069796,-0.00021929310580347467,-6.961667310744865e-05,1.0727477221049089,1.0724368002807423,95.97039473681616,92.30084101244904,0.0002800031575837298,1.07175966042683,1.0,1.073507058966341,bullish,1.0726992368243264,1.072671239958476,1.072752242862057,2.7996865850532515e-05,-3.217340739836318e-05,0.0001477249694476559,8.21534227724019e-05,3.56518747854917e-05,3.967664258630599e-05,1.0728999678315048,1.0726045178926094,,True,False,0.0,1.0780299999999998,1.0754299999999997,1.0762299999999996,1.0770299999999995,True,2024-02-15 16:35:00,2024-02-15 16:33:11,2024-02-16 15:30:01,0.01,success,True,91.74,3419.099999999994,34,0,7,2
2024-02-15 07:30:00,1.07303,1.07315,1.07302,1.07306,124,12,0,1.07302,1.0731633329480257,-3.08402611428104e-05,-1.5530471775069462e-05,0.00012616102246789485,7.30191214155213e-05,1.0725988716018588,1.072778826084711,2024-02-15 07:00:00,2024-02-15 07:00:00,-0.00011261904761994401,0.00022824144699429283,1.0727094047619055,-3.916297558353262e-05,-7.23611615670008e-05,1.072725714285714,1.072523049306028,1.0734445386595128,1.0726394426711066,1.0736689397069796,-0.00021929310580347467,-6.961667310744865e-05,1.0727477221049089,1.0724368002807423,93.7247807017334,94.77818388561955,0.0002800031575837298,1.07175966042683,1.0,1.073507058966341,bullish,1.0727547388513532,1.0727000369985888,1.0728318059855526,5.470185276434947e-05,-1.479835536582065e-05,0.00016908774822093554,7.956312349555184e-05,8.21534227724019e-05,3.56518747854917e-05,1.0730008937337736,1.0726627182373316,,True,False,0.0,1.0780599999999998,1.0754599999999996,1.0762599999999996,1.0770599999999995,True,2024-02-15 16:35:00,2024-02-15 16:33:11,2024-02-15 18:30:02,0.01,success,True,91.74,3510.839999999994,35,0,7,2
2024-02-15 07:35:00,1.07306,1.07313,1.07306,1.07308,124,12,0,1.07306,1.073170001597397,-9.298112538848908e-05,-4.659385595044814e-05,0.00011249768088189144,0.0001494583586362515,1.072600987557541,1.0729170867382418,2024-02-15 07:00:00,2024-02-15 07:00:00,-0.00011261904761994401,0.00022824144699429283,1.0727094047619055,-3.916297558353262e-05,-7.23611615670008e-05,1.072725714285714,1.072523049306028,1.0734445386595128,1.0726394426711066,1.0736689397069796,-0.00021929310580347467,-6.961667310744865e-05,1.0727477221049089,1.0724368002807423,92.36805555554531,94.02107699803163,0.0002800031575837298,1.07175966042683,1.0,1.073507058966341,bullish,1.0728047790280681,1.0727281824061008,1.0729101031991735,7.659662196735084e-05,3.4806401008136475e-06,0.00019336924936148444,7.829721362084818e-05,7.956312349555184e-05,8.21534227724019e-05,1.0731034724485349,1.072716733949812,,True,False,0.0,1.07808,1.0754799999999998,1.0762799999999997,1.0770799999999996,True,2024-02-15 16:35:00,2024-02-15 16:33:19,2024-02-15 18:15:36,0.01,success,True,91.74,3602.5799999999936,36,0,7,2
2024-02-16 15:40:00,1.07347,1.07424,1.07339,1.07404,941,12,0,1.0733601075465722,1.074481679106906,0.0002141843894901921,0.00011941872419308345,-0.0011297729965604078,-0.0008668734490938582,1.0749356066138231,1.0777900913019134,2024-02-16 15:00:00,2024-02-16 15:00:00,-6.666666666266252e-06,0.00032523269836981505,1.0762796428571437,-0.0007467881959328327,-0.00017556231495802164,1.0770410714285719,1.0762926021800399,1.0782941623584443,1.0759018555057323,1.077090718036481,0.00026936733133261625,0.0001490329749242498,1.075375193240075,1.075972574708317,11.455938697318876,15.764449335616275,0.00033829899680522756,1.07582476288,1.0,1.0768252283950275,bullish,1.0756666749120645,1.0763413085534639,1.0750750257997939,-0.0006746336413994136,-0.00030416422899468085,0.0011619698791191491,-0.0004167973856206153,-0.0005669556243546037,-0.0004608840729289909,1.076236995678913,1.0739130559206747,,True,False,0.0,1.07904,1.07484,1.07564,1.0760399999999999,True,2024-02-16 17:10:00,2024-02-20 11:27:33,2024-02-16 16:59:59,0.01,even,True,14.68,3617.2599999999934,37,0,7,2
2024-02-16 15:50:00,1.07383,1.07453,1.07382,1.07435,861,12,0,1.07382,1.074713282226281,0.00020813747846676735,0.00025429050212996966,0.0001578775003764723,0.00020781818425380391,1.0731667248833243,1.0742721631796028,2024-02-16 15:00:00,2024-02-16 15:00:00,-6.666666666266252e-06,0.00032523269836981505,1.0762796428571437,-0.0007467881959328327,-0.00017556231495802164,1.0770410714285719,1.0762926021800399,1.0782941623584443,1.0759018555057323,1.077090718036481,0.00026936733133261625,0.0001490329749242498,1.075375193240075,1.075972574708317,22.466136212938704,16.334196736054665,0.00033829899680522756,1.07582476288,1.0,1.0768252283950275,bullish,1.0752263175405905,1.0760222467022151,1.0744247953216381,-0.0007959291616246311,-0.00047711148862173824,0.0013342773324820582,-0.0002528895768829642,-0.0003973409012727469,-0.0004167973856206153,1.0757590726541202,1.0730905179891561,,True,False,0.0,1.0793499999999998,1.0751499999999998,1.0759499999999997,1.0763499999999997,True,2024-02-16 17:15:00,2024-02-20 11:35:22,2024-02-16 16:51:50,0.01,even,True,14.68,3631.9399999999932,38,0,7,2
2024-02-16 15:55:00,1.07433,1.07485,1.07433,1.07459,737,12,0,1.07433,1.0753333443008173,-2.149592874897591e-05,-6.820843284006398e-05,0.00011941872419308345,0.0002141843894901921,1.0733766462772656,1.0744909098969282,2024-02-16 15:00:00,2024-02-16 15:00:00,-6.666666666266252e-06,0.00032523269836981505,1.0762796428571437,-0.0007467881959328327,-0.00017556231495802164,1.0770410714285719,1.0762926021800399,1.0782941623584443,1.0759018555057323,1.077090718036481,0.00026936733133261625,0.0001490329749242498,1.075375193240075,1.075972574708317,27.635309145268526,21.72732021870455,0.00033829899680522756,1.07582476288,1.0,1.0768252283950275,bullish,1.0751284225343458,1.0759161543539029,1.0742568524251812,-0.0007877318195570471,-0.0005392355548088,0.0013599561267335501,-0.00016794289645694072,-0.0002528895768829642,-0.0003973409012727469,1.0756168085519147,1.0728968962984478,,True,False,0.0,1.0795899999999998,1.0769899999999997,1.0777899999999996,1.0785899999999995,True,2024-02-19 02:15:00,2024-02-20 11:39:55,2024-02-19 00:00:03,0.01,even,True,44.04,3675.979999999993,39,0,7,2
2024-02-19 01:10:00,1.07771,1.07796,1.07766,1.07794,86,11,0,1.07766,1.077949291261452,0.0001022928526793703,4.969212102128977e-05,0.00011136192317751914,0.00022775035513523083,1.0769531080920933,1.0778389725467108,2024-02-19 01:00:00,2024-02-19 01:00:00,-0.00036119047619043165,0.0003502826861145891,1.0778135714285721,-0.00018938853285153492,-5.811138902557307e-05,1.0775929761904757,1.0774165957550979,1.0786752722368973,1.077310908964961,1.079050781247057,-0.000371265539921487,-0.00011356037062974155,1.0779913403307972,1.0767993672429903,86.43585364590881,68.38020007558195,0.0003221743009711683,1.0743308362571522,1.0,1.0773560121157444,bullish,1.077488704925211,1.0774698595404542,1.0774641348469207,1.884538475693809e-05,-5.5687448188922895e-05,0.00024101728843907926,0.00013135878912917676,8.671138630966801e-05,9.581699346350447e-05,1.0777051521353598,1.0772231175584817,,True,False,0.0,1.0829399999999998,1.0795399999999997,1.0803399999999996,1.0809399999999996,True,2024-02-20 15:35:00,2024-02-20 16:22:23,2024-02-20 13:15:18,0.01,even,True,29.36,3705.3399999999933,40,0,8,2
2024-02-19 01:15:00,1.07794,1.07801,1.07788,1.07797,69,12,0,1.07788,1.0780099978201596,3.425486323085574e-05,4.63806188955194e-05,1.522124582723541e-05,0.00021987354641719048,1.0771977822636465,1.0779512318881075,2024-02-19 01:00:00,2024-02-19 01:00:00,-0.00036119047619043165,0.0003502826861145891,1.0778135714285721,-0.00018938853285153492,-5.811138902557307e-05,1.0775929761904757,1.0774165957550979,1.0786752722368973,1.077310908964961,1.079050781247057,-0.000371265539921487,-0.00011356037062974155,1.0779913403307972,1.0767993672429903,91.51009573213082,81.25149237782135,0.0003221743009711683,1.0743308362571522,1.0,1.0773560121157444,bullish,1.0775627503213325,1.077506906981902,1.0775874681802537,5.5843339430428074e-05,-3.338129066505271e-05,0.00026165307819103344,0.0001233333333330311,0.00013135878912917676,8.671138630966801e-05,1.0778491212584447,1.0773258151020628,,True,False,0.0,1.08297,1.07957,1.0803699999999998,1.0809699999999998,True,2024-02-20 15:35:00,2024-02-20 16:22:23,2024-02-20 13:15:15,0.01,even,True,29.36,3734.6999999999935,41,0,8,2
2024-02-19 07:05:00,1.07773,1.0777700000000001,1.07772,1.07774,92,12,0,1.0775783425032928,1.0777700000000001,5.7216937614098154e-05,4.3737063388223556e-05,-8.99145346787512e-05,8.685326956471123e-05,1.077457006011155,1.0780427430612378,2024-02-19 07:00:00,2024-02-19 07:00:00,-8.345238095319729e-05,0.0003072768467071718,1.0779385714285714,-1.9280492444767762e-05,-0.0001276661867426969,1.0778964285714276,1.0774807589363704,1.0787496421078544,1.0779223359565335,1.0789823741995423,-0.0002227907806564632,-0.00015276647345532348,1.0779734586287115,1.0772589947218885,49.206349206338054,47.51826656587625,0.0003772627142609743,1.0759694994461741,1.0,1.0775215753704959,bullish,1.0777104582843366,1.0777647818963259,1.0777189955280362,-5.4323611989204323e-05,-7.879203224125841e-05,0.00021988027044674862,3.448228414182353e-05,3.3835569315687763e-05,4.3525971792135465e-05,1.077938875798483,1.0774991152575895,,True,False,0.0,1.0827399999999998,1.0785399999999998,1.0793399999999997,1.0797399999999997,True,2024-02-20 12:15:00,2024-02-20 16:21:12,2024-02-19 09:41:12,0.01,even,True,14.68,3749.3799999999933,42,0,8,2
2024-02-19 07:15:00,1.07774,1.0778699999999999,1.07773,1.07786,57,12,0,1.0777314325563465,1.0778592231462287,7.687097045273487e-05,9.609543710794054e-05,1.2130077503368561e-05,-1.0826594097820223e-05,1.0776624597993743,1.0778209802605179,2024-02-19 07:00:00,2024-02-19 07:00:00,-8.345238095319729e-05,0.0003072768467071718,1.0779385714285714,-1.9280492444767762e-05,-0.0001276661867426969,1.0778964285714276,1.0774807589363704,1.0787496421078544,1.0779223359565335,1.0789823741995423,-0.0002227907806564632,-0.00015276647345532348,1.0779734586287115,1.0772589947218885,56.931216931220284,52.407407407403355,0.0003772627142609743,1.0759694994461741,1.0,1.0775215753704959,bullish,1.0777399139195545,1.0777715071127623,1.0777996009631918,-3.1593193207779535e-05,-6.41611544818759e-05,0.00018593188716438353,4.3873409012462616e-05,3.6732026143182495e-05,3.448228414182353e-05,1.0779855328503563,1.0776136690760274,,True,False,0.0,1.08286,1.07866,1.0794599999999999,1.0798599999999998,True,2024-02-20 12:25:00,2024-02-20 16:22:07,2024-02-19 09:23:01,0.01,even,True,14.68,3764.059999999993,43,0,8,2
2024-02-19 07:20:00,1.07786,1.07792,1.07782,1.07789,122,12,0,1.0778066656899365,1.0779266729632568,8.04042038090078e-05,0.00011285534680678941,4.3737063388223556e-05,5.7216937614098154e-05,1.0775829670277486,1.0777735356487055,2024-02-19 07:00:00,2024-02-19 07:00:00,-8.345238095319729e-05,0.0003072768467071718,1.0779385714285714,-1.9280492444767762e-05,-0.0001276661867426969,1.0778964285714276,1.0774807589363704,1.0787496421078544,1.0779223359565335,1.0789823741995423,-0.0002227907806564632,-0.00015276647345532348,1.0779734586287115,1.0772589947218885,64.44444444445436,57.48677248677546,0.0003772627142609743,1.0759694994461741,1.0,1.0775215753704959,bullish,1.0777630040857769,1.0777802843636688,1.0778347162022694,-1.7280277891940088e-05,-5.478497916388874e-05,0.00017332532032088827,3.511523907762104e-05,4.3873409012462616e-05,3.6732026143182495e-05,1.0780080415225903,1.0776613908819486,,True,False,0.0,1.08289,1.0794899999999998,1.0802899999999998,1.0808899999999997,True,2024-02-20 15:35:00,2024-02-20 16:22:12,2024-02-20 13:15:22,0.01,even,True,29.36,3793.4199999999933,44,0,8,2
2024-02-19 07:25:00,1.07789,1.07797,1.07789,1.07797,96,12,0,1.07789,1.0781183351164951,8.063026447731137e-05,4.792019942175502e-05,5.2571269874193985e-05,7.953109825000813e-05,1.0776464347870214,1.0778175906670904,2024-02-19 07:00:00,2024-02-19 07:00:00,-8.345238095319729e-05,0.0003072768467071718,1.0779385714285714,-1.9280492444767762e-05,-0.0001276661867426969,1.0778964285714276,1.0774807589363704,1.0787496421078544,1.0779223359565335,1.0789823741995423,-0.0002227907806564632,-0.00015276647345532348,1.0779734586287115,1.0772589947218885,76.11111111112473,65.82892416226649,0.0003772627142609743,1.0759694994461741,1.0,1.0775215753704959,bullish,1.0777948496110419,1.0777943373737675,1.0778716133470934,5.122372743748826e-07,-4.3725535876236017e-05,0.00016443134331460015,3.689714482391082e-05,3.511523907762104e-05,4.3873409012462616e-05,1.078036044690408,1.0777071820037787,,True,False,0.0,1.08297,1.07957,1.0803699999999998,1.0809699999999998,True,2024-02-20 15:35:00,2024-02-20 16:22:23,2024-02-20 13:15:15,0.01,even,True,29.36,3822.7799999999934,45,0,8,2
2024-02-19 07:30:00,1.07798,1.07817,1.07798,1.07814,92,12,0,1.07798,1.0781866664108208,4.970963133021093e-05,1.2366603250700166e-05,9.609543710794054e-05,7.687097045273487e-05,1.0777376657062043,1.077867016058336,2024-02-19 07:00:00,2024-02-19 07:00:00,-8.345238095319729e-05,0.0003072768467071718,1.0779385714285714,-1.9280492444767762e-05,-0.0001276661867426969,1.0778964285714276,1.0774807589363704,1.0787496421078544,1.0779223359565335,1.0789823741995423,-0.0002227907806564632,-0.00015276647345532348,1.0779734586287115,1.0772589947218885,85.27777777778897,75.27777777778938,0.0003772627142609743,1.0759694994461741,1.0,1.0775215753704959,bullish,1.0778479496708817,1.0778199420127477,1.0779290780873747,2.8007658134043822e-05,-2.9378897074180048e-05,0.00016443134331460015,5.7464740281343296e-05,3.689714482391082e-05,3.511523907762104e-05,1.0780935094306894,1.07776464674406,,True,False,0.0,1.08314,1.07974,1.0805399999999998,1.0811399999999998,True,2024-02-20 15:35:00,2024-02-20 16:31:43,2024-02-20 13:10:51,0.01,even,True,29.36,3852.1399999999935,46,0,8,2
2024-02-19 07:35:00,1.07814,1.0782,1.07809,1.07819,99,13,0,1.07809,1.0782,2.3548976033451813e-05,5.299720699735297e-06,0.00011285534680678941,8.04042038090078e-05,1.077813189809992,1.0779358312494736,2024-02-19 07:00:00,2024-02-19 07:00:00,-8.345238095319729e-05,0.0003072768467071718,1.0779385714285714,-1.9280492444767762e-05,-0.0001276661867426969,1.0778964285714276,1.0774807589363704,1.0787496421078544,1.0779223359565335,1.0789823741995423,-0.0002227907806564632,-0.00015276647345532348,1.0779734586287115,1.0772589947218885,93.72222222222807,85.0370370370473,0.0003772627142609743,1.0759694994461741,1.0,1.0775215753704959,bullish,1.0779005727984383,1.077847353715507,1.0779887237702106,5.321908293121069e-05,-1.2859301073101901e-05,0.0001859507103091445,5.9645682835896e-05,5.7464740281343296e-05,3.689714482391082e-05,1.0781746744805198,1.0778027730599014,,True,False,0.0,1.0831899999999999,1.0797899999999998,1.0805899999999997,1.0811899999999997,True,2024-02-20 15:35:00,2024-02-20 16:31:58,2024-02-20 13:10:44,0.01,even,True,29.36,3881.4999999999936,47,0,8,2
2024-02-19 11:35:00,1.07743,1.0777700000000001,1.07735,1.07749,335,12,0,1.0773607668548493,1.0777700000000001,-8.390041072986701e-05,-8.993515584353644e-05,-9.04425523198753e-06,-0.00011292792013944426,1.0774042318954875,1.0777985157511674,2024-02-19 11:00:00,2024-02-19 11:00:00,-3.821428571515462e-05,0.00026980586679292706,1.0778774999999996,-0.00010656126575777516,-0.00019394010999984937,1.0780682142857136,1.077631436892792,1.079272160401634,1.0774228221217887,1.0781272355755211,0.000238612476039509,3.4982449310306054e-05,1.0775865859089966,1.0774540225586382,15.445603921660739,11.641474131258677,0.00034089017019219936,1.0768303062902682,1.0,1.077543546908073,bullish,1.077756707183083,1.0779918596709726,1.0774667836257306,-0.00023515248788963383,-0.000154872302955731,0.00039338276526297306,-7.312005503989916e-05,-9.9828001376423e-05,-0.0001327932576526969,1.0778601663909935,1.0770734008604677,,True,False,0.0,1.08249,1.0798899999999998,1.0806899999999997,1.0814899999999996,True,2024-02-20 15:50:00,2024-02-20 16:19:34,2024-02-20 13:10:34,0.01,even,True,44.04,3925.5399999999936,48,0,8,2
2024-02-19 11:50:00,1.0772,1.07749,1.07719,1.07741,263,12,0,1.0771900008524367,1.0774933339365529,-1.8567567062486062e-05,-1.5468518983922577e-05,-8.993515584353644e-05,-8.390041072986701e-05,1.0773540273210014,1.077762772965961,2024-02-19 11:00:00,2024-02-19 11:00:00,-3.821428571515462e-05,0.00026980586679292706,1.0778774999999996,-0.00010656126575777516,-0.00019394010999984937,1.0780682142857136,1.077631436892792,1.079272160401634,1.0774228221217887,1.0781272355755211,0.000238612476039509,3.4982449310306054e-05,1.0775865859089966,1.0774540225586382,16.183443977782332,18.25148718361204,0.00034089017019219936,1.0768303062902682,1.0,1.077543546908073,bullish,1.0776017192811485,1.0778626270059923,1.0772826900584793,-0.000260907724843884,-0.0002041330710033144,0.0004350969240714949,-4.06811145505781e-05,-9.120743034141121e-05,-5.220502235925295e-05,1.0777177869825507,1.076847593134408,,True,False,0.0,1.0824099999999999,1.0798099999999997,1.0806099999999996,1.0814099999999995,True,2024-02-20 15:45:00,2024-02-20 15:57:44,2024-02-20 13:10:44,0.01,even,True,44.04,3969.5799999999936,49,0,8,2
2024-02-19 11:55:00,1.07739,1.07745,1.07727,1.07742,291,12,0,1.0771200014688964,1.0774766676011032,2.7850298323955416e-05,-1.5469225944315494e-05,-5.2827330605627775e-05,-9.281223085671655e-06,1.0771892520775266,1.0776057549827764,2024-02-19 11:00:00,2024-02-19 11:00:00,-3.821428571515462e-05,0.00026980586679292706,1.0778774999999996,-0.00010656126575777516,-0.00019394010999984937,1.0780682142857136,1.077631436892792,1.079272160401634,1.0774228221217887,1.0781272355755211,0.000238612476039509,3.4982449310306054e-05,1.0775865859089966,1.0774540225586382,15.221006130100571,16.110881892271586,0.00034089017019219936,1.0768303062902682,1.0,1.077543546908073,bullish,1.077573762468664,1.0778298398203632,1.0772775060199522,-0.00025607735169907997,-0.00021452192714246752,0.00044373866182969115,-5.184038527117352e-06,-4.06811145505781e-05,-9.120743034141121e-05,1.0777212446817819,1.0768337673581225,,True,False,0.0,1.08242,1.0798199999999998,1.0806199999999997,1.0814199999999996,True,2024-02-20 15:45:00,2024-02-20 15:57:47,2024-02-20 13:10:43,0.01,even,True,44.04,4013.6199999999935,50,0,8,2
2024-02-20 00:15:00,1.0774,1.07747,1.07731,1.07747,23,53,0,1.0771400732555807,1.077813323087567,0.0002134376145614483,5.258370915521451e-05,-8.196179743036e-05,4.026405412312101e-05,1.07686987537866,1.0779000877907623,2024-02-20 00:00:00,2024-02-20 00:00:00,0.00014416666666616784,8.635438617532465e-05,1.077917857142857,-0.0001440588982511211,-4.6609037754026726e-05,1.0779011904761904,1.0775191071103047,1.0782962359399613,1.076886309144126,1.0783357663845707,-3.585608876364074e-05,0.0002020665160674147,1.0777892403650866,1.0774557025779885,38.13333333332939,28.47338501292117,3.818421438598774e-06,1.0762764371999998,1.0,1.0777278336356961,bullish,1.0777088958573102,1.0777800567629587,1.0776619091847264,-7.116090564851518e-05,1.9067478086090697e-06,0.00019973482420532725,-7.969728242196439e-05,-0.00010111455108341438,-0.00013201582387289967,1.0778616440089317,1.077462174360521,,True,False,0.0,1.0824699999999998,1.0798699999999997,1.0806699999999996,1.0814699999999995,True,2024-02-20 15:50:00,2024-02-20 16:19:09,2024-02-20 13:10:42,0.01,even,True,44.04,4057.6599999999935,51,0,8,2
2024-02-20 01:05:00,1.07761,1.0777700000000001,1.07759,1.07769,64,11,0,1.07759,1.0777614343846236,-3.688510264242932e-05,-5.302596512421113e-05,4.483908826623488e-05,7.179293069405777e-07,1.0775100578788512,1.077886949201467,2024-02-20 01:00:00,2024-02-20 01:00:00,1.666666666655381e-05,9.673047126468326e-05,1.0777773809523818,-0.00026012741985968453,-3.153654643743176e-05,1.077917857142857,1.0777298109653128,1.0782254678319199,1.0775191071103047,1.0782962359399613,-4.6609037754026726e-05,-0.0001440588982511211,1.0775764134550287,1.0774568463717495,72.58566978193623,73.01748009692778,2.2400831403815672e-05,1.0763169084559998,1.0,1.0777899688606862,bullish,1.0777413299341803,1.0777718907212497,1.0776950189198493,-3.0560787069422446e-05,-2.1712938827077194e-05,0.00020384389452085931,1.3240454076912656e-05,-9.511523908711794e-06,1.4912280702272795e-05,1.0778988628143702,1.0774911750253284,,True,False,0.0,1.08269,1.0808899999999997,1.0816899999999996,1.0826899999999995,True,2024-02-20 16:25:00,2024-02-20 16:20:59,2024-02-20 19:13:15,0.01,success,True,91.74,4149.399999999993,52,0,8,2
2024-02-20 01:35:00,1.07748,1.07753,1.07747,1.07752,102,12,0,1.0774533297054538,1.0775600032129538,-6.651760946981559e-05,-2.784294306413857e-05,-2.1892393471483565e-05,-4.641006664055835e-06,1.0774296273358919,1.077588238645924,2024-02-20 01:00:00,2024-02-20 01:00:00,1.666666666655381e-05,9.673047126468326e-05,1.0777773809523818,-0.00026012741985968453,-3.153654643743176e-05,1.077917857142857,1.0777298109653128,1.0782254678319199,1.0775191071103047,1.0782962359399613,-4.6609037754026726e-05,-0.0001440588982511211,1.0775764134550287,1.0774568463717495,14.393052302881904,20.10824617479449,2.2400831403815672e-05,1.0763169084559998,1.0,1.0777899688606862,bullish,1.077594103615769,1.0776760283847497,1.077562297901617,-8.192476898072343e-05,-5.751898767065369e-05,0.00021069092686752566,-5.448228414239864e-05,-2.4561403507483703e-05,-2.4643962848847067e-05,1.0777729888284846,1.0773516069747495,,True,False,0.0,1.08252,1.0799199999999998,1.0807199999999997,1.0815199999999996,True,2024-02-20 15:50:00,2024-02-20 16:20:36,2024-02-20 13:10:31,0.01,even,True,44.04,4193.439999999993,53,0,8,2
2024-02-20 01:50:00,1.07735,1.07742,1.07735,1.07742,26,12,0,1.07735,1.0774799974296592,-2.451450063768563e-05,6.032349955381412e-05,-2.784294306413857e-05,-6.651760946981559e-05,1.0774479853657366,1.0775577659543625,2024-02-20 01:00:00,2024-02-20 01:00:00,1.666666666655381e-05,9.673047126468326e-05,1.0777773809523818,-0.00026012741985968453,-3.153654643743176e-05,1.077917857142857,1.0777298109653128,1.0782254678319199,1.0775191071103047,1.0782962359399613,-4.6609037754026726e-05,-0.0001440588982511211,1.0775764134550287,1.0774568463717495,11.53162757640994,12.014333096423206,2.2400831403815672e-05,1.0763169084559998,1.0,1.0777899688606862,bullish,1.0775242748805591,1.07762293875485,1.0774026281389755,-9.866387429080525e-05,-7.540757586356006e-05,0.00018697147731462028,-3.1455108359113026e-05,-7.275197798328747e-05,-5.546267629918944e-05,1.07758959961629,1.0772156566616609,,True,False,0.0,1.08242,1.0798199999999998,1.0806199999999997,1.0814199999999996,True,2024-02-20 15:45:00,2024-02-20 15:57:47,2024-02-20 13:10:43,0.01,even,True,44.04,4237.479999999993,54,0,8,2
2024-02-20 01:55:00,1.07742,1.07752,1.07741,1.07747,36,12,0,1.07741,1.0776684680178437,-6.462086403551446e-05,-6.424838365880511e-05,-9.51882973220379e-06,1.3925185739786412e-05,1.0772961177130704,1.077539234673018,2024-02-20 01:00:00,2024-02-20 01:00:00,1.666666666655381e-05,9.673047126468326e-05,1.0777773809523818,-0.00026012741985968453,-3.153654643743176e-05,1.077917857142857,1.0777298109653128,1.0782254678319199,1.0775191071103047,1.0782962359399613,-4.6609037754026726e-05,-0.0001440588982511211,1.0775764134550287,1.0774568463717495,15.920398009956381,13.15446576641141,2.2400831403815672e-05,1.0763169084559998,1.0,1.0777899688606862,bullish,1.0775159248989346,1.0776116099581945,1.0773906776745787,-9.56850592599423e-05,-7.94630725428365e-05,0.00018097237356977074,-1.195046439672609e-05,-3.1455108359113026e-05,-7.275197798328747e-05,1.0775716500481485,1.077209705301009,,True,False,0.0,1.0824699999999998,1.0798699999999997,1.0806699999999996,1.0814699999999995,True,2024-02-20 15:50:00,2024-02-20 16:19:09,2024-02-20 13:10:42,0.01,even,True,44.04,4281.519999999993,55,0,8,2
2024-02-20 02:15:00,1.07723,1.07732,1.07723,1.0772599999999999,106,12,0,1.0768916637432135,1.0773092428592708,-1.5449506714160134e-06,-1.833100651777041e-05,-8.423562704172641e-05,-3.5582497128413283e-05,1.0772954795174534,1.077603244612213,2024-02-20 02:00:00,2024-02-20 02:00:00,-0.00014047619047508064,6.818232092475895e-05,1.0774335714285712,-0.00021722569656943775,-7.849482232506972e-05,1.0777773809523818,1.0773606280529668,1.0782276070827306,1.0777298109653128,1.0782254678319199,-3.153654643743176e-05,-0.00026012741985968453,1.0771254711516762,1.0774122986620096,3.9351851851850044,9.511470425648954,3.155712930800433e-05,1.0763565702868798,1.0,1.0778627504952898,bullish,1.0774097719423446,1.0775301967667525,1.0772938252493982,-0.00012042482440799418,-9.799884296758e-05,0.0001953526725211808,-2.7313381493421218e-05,-3.226350189167171e-05,-2.8028895768139606e-05,1.0774891779219193,1.077098472576877,,True,False,0.0,1.0822599999999998,1.0796599999999996,1.0804599999999995,1.0812599999999994,True,2024-02-20 15:40:00,2024-02-20 15:53:45,2024-02-20 13:15:10,0.01,even,True,44.04,4325.559999999993,56,0,8,2
2024-02-20 02:25:00,1.07697,1.07714,1.07696,1.0771,83,12,0,1.07696,1.077361684660078,-2.7621233714722433e-05,-0.00010367033741904506,-4.6416444385604125e-05,-0.0001500984300975429,1.0772013186594118,1.0773662965515447,2024-02-20 02:00:00,2024-02-20 02:00:00,-0.00014047619047508064,6.818232092475895e-05,1.0774335714285712,-0.00021722569656943775,-7.849482232506972e-05,1.0777773809523818,1.0773606280529668,1.0782276070827306,1.0777298109653128,1.0782254678319199,-3.153654643743176e-05,-0.00026012741985968453,1.0771254711516762,1.0774122986620096,14.120370370374474,7.484567901236839,3.155712930800433e-05,1.0763565702868798,1.0,1.0778627504952898,bullish,1.0773009609764714,1.0774578504516055,1.0771795321637427,-0.00015688947513403662,-0.00011793381883066915,0.00024391050269867217,-3.575163398616965e-05,-7.85414516693006e-05,-2.7313381493421218e-05,1.0774234426664413,1.0769356216610442,,True,False,0.0,1.0820999999999998,1.0794999999999997,1.0802999999999996,1.0810999999999995,True,2024-02-20 15:35:00,2024-02-20 15:52:52,2024-02-20 13:15:19,0.01,even,True,44.04,4369.599999999993,57,0,8,2
2024-02-20 02:55:00,1.07678,1.07694,1.07675,1.0769,203,12,0,1.07675,1.077028481956464,-9.575461020342894e-05,-9.215180973519822e-05,-2.3570389563027e-05,-5.262506987810995e-05,1.0768291325345611,1.0770035044197204,2024-02-20 02:00:00,2024-02-20 02:00:00,-0.00014047619047508064,6.818232092475895e-05,1.0774335714285712,-0.00021722569656943775,-7.849482232506972e-05,1.0777773809523818,1.0773606280529668,1.0782276070827306,1.0777298109653128,1.0782254678319199,-3.153654643743176e-05,-0.00026012741985968453,1.0771254711516762,1.0774122986620096,9.405430711621705,5.976799833550909,3.155712930800433e-05,1.0763565702868798,1.0,1.0778627504952898,bullish,1.077034415852883,1.0772469175049528,1.0768419435844518,-0.00021250165206976313,-0.0001793809281373036,0.0002927268351008282,-3.669762641766994e-05,-6.907464740257829e-05,-6.496388029009204e-05,1.0771346704195526,1.0765492167493511,,True,False,0.0,1.0818999999999999,1.0792999999999997,1.0800999999999996,1.0808999999999995,True,2024-02-20 15:35:00,2024-02-20 15:47:03,2024-02-20 13:30:57,0.01,even,True,44.04,4413.639999999993,58,0,8,2
2024-02-20 03:15:00,1.07643,1.07689,1.07643,1.07677,371,12,0,1.07643,1.0770149993843365,0.00012717418913960721,1.3927857280592025e-05,-1.2151127454462263e-05,-0.00013003891206308228,1.0766996357656007,1.0769282890892309,2024-02-20 03:00:00,2024-02-20 03:00:00,-0.00034380952381063423,-1.6571519332986284e-05,1.0770536904761907,-0.00014529596402622176,-0.0002301439879433681,1.0774335714285712,1.0770549432809906,1.0784579945580477,1.0773606280529668,1.0782276070827306,-7.849482232506972e-05,-0.00021722569656943775,1.0767218237172254,1.077340914769049,13.874643874646921,10.473339948999252,2.1931399579806208e-05,1.0763954388811423,1.0,1.0779463964916856,bullish,1.0768492532650138,1.0770905960781578,1.0766203715170277,-0.00024134281314402983,-0.0002132389906520405,0.0003300166662221188,-2.2019263845818315e-05,-9.091847265230157e-05,-6.766081871378837e-05,1.0769503881832498,1.0762903548508056,,True,False,0.0,1.08177,1.0799699999999997,1.0807699999999996,1.0817699999999995,True,2024-02-20 15:50:00,2024-02-20 15:46:36,2024-02-21 10:55:50,0.01,success,True,91.74,4505.379999999993,59,0,8,2
2024-02-20 03:20:00,1.07677,1.07703,1.07677,1.0768,280,12,0,1.0767033354939062,1.0770192327716805,3.405198130192187e-05,1.571189269739213e-05,5.8573770306571455e-05,9.288099651491865e-06,1.0764107439820254,1.0768346670869682,2024-02-20 03:00:00,2024-02-20 03:00:00,-0.00034380952381063423,-1.6571519332986284e-05,1.0770536904761907,-0.00014529596402622176,-0.0002301439879433681,1.0774335714285712,1.0770549432809906,1.0784579945580477,1.0773606280529668,1.0782276070827306,-7.849482232506972e-05,-0.00021722569656943775,1.0767218237172254,1.077340914769049,26.4502704952144,15.242271946393922,2.1931399579806208e-05,1.0763954388811423,1.0,1.0779463964916856,bullish,1.076841675839627,1.0770690704427388,1.0766185896112836,-0.0002273946031117191,-0.00021607011314397624,0.00032421032265641424,-1.7819057440693342e-06,-2.2019263845818315e-05,-9.091847265230157e-05,1.07694279993394,1.0762943792886273,,True,False,0.0,1.0817999999999999,1.0799999999999996,1.0807999999999995,1.0817999999999994,True,2024-02-20 15:50:00,2024-02-20 15:46:36,2024-02-21 10:55:16,0.01,success,True,91.75,4597.129999999993,60,0,8,2
2024-02-20 03:25:00,1.07681,1.07702,1.07674,1.077,295,12,0,1.07674,1.077103336276278,-7.40697883927476e-05,-1.54752060660482e-05,0.00012000453511758949,0.00013898273034510103,1.076302245033077,1.0767703612909212,2024-02-20 03:00:00,2024-02-20 03:00:00,-0.00034380952381063423,-1.6571519332986284e-05,1.0770536904761907,-0.00014529596402622176,-0.0002301439879433681,1.0774335714285712,1.0770549432809906,1.0784579945580477,1.0773606280529668,1.0782276070827306,-7.849482232506972e-05,-0.00021722569656943775,1.0767218237172254,1.077340914769049,49.069318114261705,29.798077494707698,2.1931399579806208e-05,1.0763954388811423,1.0,1.0779463964916856,bullish,1.0768660334027613,1.077063954113647,1.0766684072927415,-0.00019792071088575725,-0.00021244023269233246,0.0003155064711167153,4.9817681457842156e-05,-1.7819057440693342e-06,-2.2019263845818315e-05,1.0769839137638582,1.0763529008216248,,True,False,0.0,1.0819999999999999,1.0793999999999997,1.0801999999999996,1.0809999999999995,True,2024-02-20 15:35:00,2024-02-20 15:52:47,2024-02-20 13:27:31,0.01,even,True,44.04,4641.169999999993,61,0,8,2
2024-02-20 03:45:00,1.07661,1.07667,1.07656,1.07662,224,12,0,1.07656,1.0766699960194692,-8.647686723252463e-05,-3.7152425921820416e-05,-0.00015477233415836375,-0.00014551204542790464,1.076791762460237,1.0772244047790336,2024-02-20 03:00:00,2024-02-20 03:00:00,-0.00034380952381063423,-1.6571519332986284e-05,1.0770536904761907,-0.00014529596402622176,-0.0002301439879433681,1.0774335714285712,1.0770549432809906,1.0784579945580477,1.0773606280529668,1.0782276070827306,-7.849482232506972e-05,-0.00021722569656943775,1.0767218237172254,1.077340914769049,35.64532520324749,44.94229094076359,2.1931399579806208e-05,1.0763954388811423,1.0,1.0779463964916856,bullish,1.07679052116697,1.0769731334158323,1.0766875060199514,-0.00018261224886240157,-0.0001933678189970119,0.00028674146307602774,-7.227382180952091e-06,-1.8654970760811906e-05,1.6831785345949868e-05,1.0769742474830275,1.0764007645568754,,True,False,0.0,1.0816199999999998,1.0774199999999998,1.0782199999999997,1.0786199999999997,True,2024-02-20 11:20:00,2024-02-20 15:46:12,2024-02-20 11:00:01,0.01,even,True,14.68,4655.849999999993,62,0,8,2
2024-02-20 03:55:00,1.0765,1.07659,1.07646,1.07652,130,12,0,1.076373329505007,1.0767000304926655,-0.00011769119221154703,-0.00013935259796448246,-7.143817009892479e-05,-8.935906058578183e-06,1.076489290726088,1.076804328031728,2024-02-20 03:00:00,2024-02-20 03:00:00,-0.00034380952381063423,-1.6571519332986284e-05,1.0770536904761907,-0.00014529596402622176,-0.0002301439879433681,1.0774335714285712,1.0770549432809906,1.0784579945580477,1.0773606280529668,1.0782276070827306,-7.849482232506972e-05,-0.00021722569656943775,1.0767218237172254,1.077340914769049,18.749999999996415,26.117886178857788,2.1931399579806208e-05,1.0763954388811423,1.0,1.0779463964916856,bullish,1.0767123849775346,1.0769078029971129,1.0766163020295842,-0.00019541801957823068,-0.0001934731156773514,0.000282230402293347,-2.4017887856997433e-05,-4.718610251019939e-05,-7.227382180952091e-06,1.0768985324318776,1.076334071627291,,True,False,0.0,1.0815199999999998,1.0797199999999996,1.0805199999999995,1.0815199999999994,True,2024-02-20 15:50:00,2024-02-20 15:42:17,2024-02-20 13:10:57,0.01,even,True,58.72,4714.569999999993,63,0,8,2
2024-02-20 21:05:00,1.08073,1.08088,1.08072,1.08076,214,12,0,1.0806300099121675,1.080880000090916,7.401897665536232e-05,8.325851295235176e-05,-8.349904966038642e-05,-8.018837242680158e-05,1.0808866046995205,1.0811329889252743,2024-02-20 21:00:00,2024-02-20 21:00:00,-0.00021107142857124117,0.0009865748621589177,1.0811544047619048,-0.00018477811846573895,-0.0004229900254045467,1.0815939285714287,1.0812345166947293,1.0828545025238299,1.081448624453035,1.083769544791672,-0.0005982867896780459,-0.00019918080820949252,1.0807316780540275,1.0795013180203645,26.666666666659285,41.66666666666053,0.0009006760924509434,1.0789824101212755,1.0,1.0803263520686799,bullish,1.0809004836427776,1.0810439134781384,1.0808360749913997,-0.0001434298353608643,-0.0001548235852086117,0.00014433987697980266,-3.433092535320981e-05,-1.8163054695374825e-05,-5.173718610196332e-06,1.0809804148683795,1.0806917351144198,,True,False,0.0,1.0857599999999998,1.0815599999999999,1.0823599999999998,1.0827599999999997,True,2024-02-22 02:35:00,2024-02-22 10:07:01,2024-02-21 06:17:46,0.01,even,True,14.68,4729.249999999994,64,0,8,2
2024-02-20 21:10:00,1.08077,1.08089,1.08071,1.08088,187,12,0,1.08071,1.0810283900092326,1.5668270948356714e-05,1.924518836178888e-05,-4.3419875504466544e-05,-1.8504898223677756e-05,1.080738443368326,1.0810163493977576,2024-02-20 21:00:00,2024-02-20 21:00:00,-0.00021107142857124117,0.0009865748621589177,1.0811544047619048,-0.00018477811846573895,-0.0004229900254045467,1.0815939285714287,1.0812345166947293,1.0828545025238299,1.081448624453035,1.083769544791672,-0.0005982867896780459,-0.00019918080820949252,1.0807316780540275,1.0795013180203645,24.4444444444346,29.629629629621444,0.0009006760924509434,1.0789824101212755,1.0,1.0803263520686799,bullish,1.0808973323131195,1.0810317717390172,1.0808382765737872,-0.0001344394258977477,-0.0001507467533464389,0.00014444376098108328,2.201582387506562e-06,-3.433092535320981e-05,-1.8163054695374825e-05,1.0809827203347682,1.0806938328128062,,True,False,0.0,1.08588,1.08168,1.0824799999999999,1.0828799999999998,True,2024-02-22 02:40:00,2024-02-22 10:09:05,2024-02-21 22:57:46,0.01,even,True,14.68,4743.929999999994,65,0,8,2
2024-02-20 21:15:00,1.08087,1.08106,1.0808200000000001,1.08105,236,12,0,1.0808200000000001,1.0811187957487776,-2.738468425533377e-05,-5.513132499346355e-05,3.675416933962802e-05,9.178266451569857e-05,1.0805301682239996,1.0809330961716839,2024-02-20 21:00:00,2024-02-20 21:00:00,-0.00021107142857124117,0.0009865748621589177,1.0811544047619048,-0.00018477811846573895,-0.0004229900254045467,1.0815939285714287,1.0812345166947293,1.0828545025238299,1.081448624453035,1.083769544791672,-0.0005982867896780459,-0.00019918080820949252,1.0807316780540275,1.0795013180203645,42.77777777777904,31.29629629629099,0.0009006760924509434,1.0789824101212755,1.0,1.0803263520686799,bullish,1.0809208196495628,1.0810331219805713,1.080870811833504,-0.00011230233100856246,-0.00014305786887886362,0.000143497967766866,3.253525971680382e-05,2.201582387506562e-06,-3.433092535320981e-05,1.0810143098012708,1.0807273138657372,,True,False,0.0,1.08605,1.08185,1.08265,1.0830499999999998,True,2024-02-22 07:15:00,2024-02-22 10:14:09,2024-02-22 01:49:59,0.01,even,True,14.68,4758.609999999994,66,0,8,2
2024-02-20 21:35:00,1.08084,1.08089,1.08079,1.08085,278,12,0,1.0808008067156982,1.0808975734196924,-6.19372139438944e-05,1.9250907519658523e-05,-5.8836888439405056e-05,-4.626244266481225e-06,1.0807546110989854,1.0810650547249316,2024-02-20 21:00:00,2024-02-20 21:00:00,-0.00021107142857124117,0.0009865748621589177,1.0811544047619048,-0.00018477811846573895,-0.0004229900254045467,1.0815939285714287,1.0812345166947293,1.0828545025238299,1.081448624453035,1.083769544791672,-0.0005982867896780459,-0.00019918080820949252,1.0807316780540275,1.0795013180203645,35.55555555555805,41.66666666666877,0.0009006760924509434,1.0789824101212755,1.0,1.0803263520686799,bullish,1.0808927971880973,1.0809887125262463,1.0808663811489503,-9.591533814901076e-05,-0.00011732103786315647,0.00011584760140822371,-6.019951840574578e-06,-1.6436188510882133e-05,8.33849329251457e-06,1.0809822287503585,1.080750533547542,,True,False,0.0,1.08585,1.08165,1.08245,1.0828499999999999,True,2024-02-22 02:40:00,2024-02-22 10:08:28,2024-02-21 22:57:51,0.01,even,True,14.68,4773.2899999999945,67,0,8,2
2024-02-20 21:45:00,1.08083,1.08095,1.08081,1.08092,254,12,0,1.0807183397298843,1.08111836667248,-0.00010950698731162806,-0.00014649484977464125,-2.495482671427731e-07,7.269491356535693e-06,1.0807870407953017,1.0809399790103267,2024-02-20 21:00:00,2024-02-20 21:00:00,-0.00021107142857124117,0.0009865748621589177,1.0811544047619048,-0.00018477811846573895,-0.0004229900254045467,1.0815939285714287,1.0812345166947293,1.0828545025238299,1.081448624453035,1.083769544791672,-0.0005982867896780459,-0.00019918080820949252,1.0807316780540275,1.0795013180203645,37.619047619058826,35.87301587302293,0.0009006760924509434,1.0789824101212755,1.0,1.0803263520686799,bullish,1.0808914110044958,1.0809741088187983,1.0808804884760916,-8.269781430247924e-05,-0.00010638095013114593,0.00011218734369391454,1.2174062608005798e-05,1.9332645333491882e-06,-6.019951840574578e-06,1.0809926758197856,1.0807683011323976,,True,False,0.0,1.08592,1.08172,1.08252,1.0829199999999999,True,2024-02-22 02:45:00,2024-02-22 10:12:25,2024-02-21 22:57:32,0.01,even,True,14.68,4787.969999999995,68,0,8,2
2024-02-20 22:05:00,1.08046,1.08064,1.08046,1.08062,235,12,0,1.08046,1.0807850010946556,0.0001189744369228533,6.013864998594125e-05,-0.0001020181319931368,-8.638191716275637e-05,1.0805494278565277,1.0809514496717658,2024-02-20 22:00:00,2024-02-20 22:00:00,-0.0004395238095238341,0.0008401981126637814,1.080795714285714,-0.000129939995114292,-0.00028672255797896734,1.0811544047619048,1.08092074204888,1.0824058333717248,1.0812345166947293,1.0828545025238299,-0.0004229900254045467,-0.00018477811846573895,1.0808972260180092,1.0796196125787354,17.33990147783156,15.167282430218966,0.000888580496493511,1.0793694173115735,1.0,1.0804213740431081,bullish,1.0807385570714199,1.0808697064722952,1.0806609735122117,-0.00013114940087533,-0.00011418482001106398,0.00015574872952935857,-5.334709322335485e-05,-7.620571035382717e-05,-4.773649810885239e-05,1.080816722241741,1.0805052247826823,,True,False,0.0,1.0856199999999998,1.0814199999999998,1.0822199999999997,1.0826199999999997,True,2024-02-22 02:30:00,2024-02-22 10:01:40,2024-02-21 04:53:16,0.01,even,True,14.68,4802.649999999995,69,0,8,2
2024-02-20 22:10:00,1.08062,1.08085,1.08062,1.08077,241,12,0,1.0806228740921522,1.08085,8.855626269615171e-05,0.00010459244532682086,3.67656777520197e-05,6.169863968059104e-05,1.0803085219169792,1.0807230862468407,2024-02-20 22:00:00,2024-02-20 22:00:00,-0.0004395238095238341,0.0008401981126637814,1.080795714285714,-0.000129939995114292,-0.00028672255797896734,1.0811544047619048,1.08092074204888,1.0824058333717248,1.0812345166947293,1.0828545025238299,-0.0004229900254045467,-0.00018477811846573895,1.0808972260180092,1.0796196125787354,35.23809523808681,20.552989874109198,0.000888580496493511,1.0793694173115735,1.0,1.0804213740431081,bullish,1.0807433944450475,1.0808623208076806,1.0806614860681112,-0.0001189263626331094,-0.00011513312853547306,0.0001550537543880405,5.125558995011659e-07,-5.334709322335485e-05,-7.620571035382717e-05,1.0808165398224991,1.0805064323137232,,True,False,0.0,1.08577,1.08157,1.0823699999999998,1.0827699999999998,True,2024-02-22 02:40:00,2024-02-22 10:07:05,2024-02-21 06:12:00,0.01,even,True,14.68,4817.329999999995,70,0,8,2
2024-02-20 22:15:00,1.08076,1.08085,1.08071,1.08084,203,12,0,1.08071,1.080883339996133,6.501141136035517e-05,0.0001464605920933965,0.0001106676407073614,0.0001106816839836203,1.0803605107918168,1.0806092965911551,2024-02-20 22:00:00,2024-02-20 22:00:00,-0.0004395238095238341,0.0008401981126637814,1.080795714285714,-0.000129939995114292,-0.00028672255797896734,1.0811544047619048,1.08092074204888,1.0824058333717248,1.0812345166947293,1.0828545025238299,-0.0004229900254045467,-0.00018477811846573895,1.0808972260180092,1.0796196125787354,53.33333333332913,35.30377668308251,0.000888580496493511,1.0793694173115735,1.0,1.0804213740431081,bullish,1.080758256838117,1.0808606674145191,1.0806935947712422,-0.00010241057640203444,-0.00011258861810878535,0.00015055785183657077,3.2108703130973026e-05,5.125558995011659e-07,-5.334709322335485e-05,1.0808441526230788,1.0805430369194056,,True,False,0.0,1.08584,1.08164,1.0824399999999998,1.0828399999999998,True,2024-02-22 02:40:00,2024-02-22 10:08:28,2024-02-21 22:57:57,0.01,even,True,14.68,4832.009999999996,71,0,8,2
2024-02-20 22:20:00,1.08086,1.08094,1.08084,1.08094,220,12,0,1.08084,1.0811883853083113,2.4860081597534714e-07,7.467202316694925e-07,6.013864998594125e-05,0.0001189744369228533,1.0804700050014646,1.0807900598863214,2024-02-20 22:00:00,2024-02-20 22:00:00,-0.0004395238095238341,0.0008401981126637814,1.080795714285714,-0.000129939995114292,-0.00028672255797896734,1.0811544047619048,1.08092074204888,1.0824058333717248,1.0812345166947293,1.0828545025238299,-0.0004229900254045467,-0.00018477811846573895,1.0808972260180092,1.0796196125787354,68.57142857143072,52.380952380948905,0.000888580496493511,1.0793694173115735,1.0,1.0804213740431081,bullish,1.0807862173245606,1.0808665439023326,1.080733350533195,-8.032657777201635e-05,-0.00010613621004143156,0.00014991664378232678,3.9755761952919855e-05,3.2108703130973026e-05,5.125558995011659e-07,1.0808832671769775,1.0805834338894127,,True,False,0.0,1.08594,1.0825399999999998,1.0833399999999997,1.0839399999999997,True,2024-02-22 09:05:00,2024-02-22 10:12:56,2024-02-22 04:00:17,0.01,even,True,29.36,4861.369999999995,72,0,8,2
2024-02-20 22:25:00,1.08094,1.0812,1.08091,1.08117,183,12,0,1.0808733360236913,1.0811892062281898,-2.0047165110492627e-05,-9.00447473439269e-06,0.00010459244532682086,8.855626269615171e-05,1.0806303425903048,1.0808588227882712,2024-02-20 22:00:00,2024-02-20 22:00:00,-0.0004395238095238341,0.0008401981126637814,1.080795714285714,-0.000129939995114292,-0.00028672255797896734,1.0811544047619048,1.08092074204888,1.0824058333717248,1.0812345166947293,1.0828545025238299,-0.0004229900254045467,-0.00018477811846573895,1.0808972260180092,1.0796196125787354,81.65232358003742,67.85236182826577,0.000888580496493511,1.0793694173115735,1.0,1.0804213740431081,bullish,1.0808452608130898,1.0808890221317895,1.0808127966976273,-4.376131869965327e-05,-9.366123177307591e-05,0.0001642406773100287,7.944616443222863e-05,3.9755761952919855e-05,3.2108703130973026e-05,1.0809770373749374,1.0806485560203172,,True,False,0.0,1.0861699999999999,1.0819699999999999,1.0827699999999998,1.0831699999999997,True,2024-02-22 07:15:00,2024-02-22 10:15:00,2024-02-22 04:11:54,0.01,even,True,14.68,4876.049999999996,73,0,8,2
2024-02-20 22:35:00,1.08095,1.08098,1.08083,1.08097,252,12,0,1.08083,1.081141666905574,5.2674047759801374e-05,1.695701826148972e-05,7.467202316694925e-07,2.4860081597534714e-07,1.0808400209204774,1.0811884481672336,2024-02-20 22:00:00,2024-02-20 22:00:00,-0.0004395238095238341,0.0008401981126637814,1.080795714285714,-0.000129939995114292,-0.00028672255797896734,1.0811544047619048,1.08092074204888,1.0824058333717248,1.0812345166947293,1.0828545025238299,-0.0004229900254045467,-0.00018477811846573895,1.0808972260180092,1.0796196125787354,79.91967871485893,81.51271753681473,0.000888580496493511,1.0793694173115735,1.0,1.0804213740431081,bullish,1.0808793879194312,1.0808998886589418,1.0808505675954594,-2.0500739510653787e-05,-6.906201719137767e-05,0.00016604918975029968,1.9793601651940662e-05,1.7977296180138325e-05,7.944616443222863e-05,1.0810166167852098,1.080684518405709,,True,False,0.0,1.0859699999999999,1.0825699999999998,1.0833699999999997,1.0839699999999997,True,2024-02-22 09:05:00,2024-02-22 10:12:56,2024-02-22 04:00:01,0.01,even,True,29.36,4905.409999999995,74,0,8,2
2024-02-20 22:40:00,1.08098,1.08116,1.08094,1.08111,188,12,0,1.08094,1.081149190975682,6.416109711307001e-06,1.2581752358154923e-05,-9.00447473439269e-06,-2.0047165110492627e-05,1.0808716461399197,1.0811884469702593,2024-02-20 22:00:00,2024-02-20 22:00:00,-0.0004395238095238341,0.0008401981126637814,1.080795714285714,-0.000129939995114292,-0.00028672255797896734,1.0811544047619048,1.08092074204888,1.0824058333717248,1.0812345166947293,1.0828545025238299,-0.0004229900254045467,-0.00018477811846573895,1.0808972260180092,1.0796196125787354,77.51004016064378,80.13195639701685,0.000888580496493511,1.0793694173115735,1.0,1.0804213740431081,bullish,1.080914866701057,1.080915452461983,1.0809042896456829,-5.857609259862784e-07,-5.5366765938299396e-05,0.0001702126123915368,5.372205022347032e-05,1.9793601651940662e-05,1.7977296180138325e-05,1.0810745022580743,1.0807340770332914,,True,False,0.0,1.08611,1.08191,1.0827099999999998,1.0831099999999998,True,2024-02-22 07:15:00,2024-02-22 10:14:11,2024-02-22 01:48:28,0.01,even,True,14.68,4920.089999999996,75,0,8,2
2024-02-20 23:20:00,1.08061,1.08076,1.0806,1.08071,50,12,0,1.0806,1.080756666840311,6.417569741199068e-06,-3.0843487152663974e-06,-2.1837886981129333e-05,-3.238798766101613e-05,1.0806672824949195,1.0808181679919926,2024-02-20 23:00:00,2024-02-20 23:00:00,-0.00035869047619074834,0.0007626981843051883,1.0806236904761903,-0.00011783333077041356,-6.756975577506058e-05,1.080795714285714,1.080742096125675,1.0814135211825395,1.08092074204888,1.0824058333717248,-0.00028672255797896734,-0.000129939995114292,1.0807590753393364,1.0797052435724366,14.774774774785714,25.374953266528077,0.0008634040340558466,1.0797254639266476,1.0,1.0805063943748987,bullish,1.0808057438756713,1.0808605710712662,1.0808644616443064,-5.482719559490867e-05,-2.9805911326674474e-05,0.0001803404190682916,-3.7561059512913886e-05,-3.819745441990818e-05,-4.223942208447795e-05,1.0810448020633747,1.080684121225238,,True,False,0.0,1.08571,1.08151,1.0823099999999999,1.0827099999999998,True,2024-02-22 02:35:00,2024-02-22 10:05:32,2024-02-21 06:17:55,0.01,even,True,14.68,4934.769999999996,76,0,8,2
2024-02-20 23:25:00,1.08068,1.08072,1.08063,1.08071,81,11,0,1.0806133340253141,1.080766667384179,-1.5426565416152562e-06,-1.542193445070795e-05,2.2760401480072222e-05,1.7762592246655025e-05,1.0805739069513818,1.0807019091902277,2024-02-20 23:00:00,2024-02-20 23:00:00,-0.00035869047619074834,0.0007626981843051883,1.0806236904761903,-0.00011783333077041356,-6.756975577506058e-05,1.080795714285714,1.080742096125675,1.0814135211825395,1.08092074204888,1.0824058333717248,-0.00028672255797896734,-0.000129939995114292,1.0807590753393364,1.0797052435724366,12.777777777788904,16.4897427548126,0.0008634040340558466,1.0797254639266476,1.0,1.0805063943748987,bullish,1.080791014048645,1.08084941765858,1.0808180460956318,-5.840360993492055e-05,-3.552545104832369e-05,0.00018139092245626735,-4.6415548674572094e-05,-3.7561059512913886e-05,-3.819745441990818e-05,1.080999437018088,1.0806366551731756,,True,False,0.0,1.08571,1.08151,1.0823099999999999,1.0827099999999998,True,2024-02-22 02:35:00,2024-02-22 10:05:32,2024-02-21 06:17:55,0.01,even,True,14.68,4949.449999999996,77,0,8,2
2024-02-20 23:35:00,1.08063,1.08072,1.08061,1.0807,86,11,0,1.0806066684995073,1.0807091963123812,2.0049215407856327e-05,2.8006261497619076e-05,-3.0843487152663974e-06,6.417569741199068e-06,1.080600538204891,1.080756408136208,2024-02-20 23:00:00,2024-02-20 23:00:00,-0.00035869047619074834,0.0007626981843051883,1.0806236904761903,-0.00011783333077041356,-6.756975577506058e-05,1.080795714285714,1.080742096125675,1.0814135211825395,1.08092074204888,1.0824058333717248,-0.00028672255797896734,-0.000129939995114292,1.0807590753393364,1.0797052435724366,13.427495291903073,13.364720652862367,0.0008634040340558466,1.0797254639266476,1.0,1.0805063943748987,bullish,1.0807560514786156,1.0808233004617454,1.08069439628483,-6.72489831297085e-05,-4.6893580039139156e-05,0.0001868796406313782,-4.9270725834382745e-05,-7.437908496732426e-05,-4.6415548674572094e-05,1.0808812759254616,1.0805075166441986,,True,False,0.0,1.0856999999999999,1.0815,1.0822999999999998,1.0826999999999998,True,2024-02-22 02:35:00,2024-02-22 10:05:32,2024-02-21 06:18:08,0.01,even,True,14.68,4964.1299999999965,78,0,8,2
2024-02-20 23:45:00,1.08066,1.08074,1.0806499999999999,1.08071,130,11,0,1.0806607807681703,1.0807999985707997,-8.661899465269998e-05,6.611770521767418e-10,-6.416693040403717e-06,1.3508691379790583e-05,1.0806073394240017,1.0807494617300324,2024-02-20 23:00:00,2024-02-20 23:00:00,-0.00035869047619074834,0.0007626981843051883,1.0806236904761903,-0.00011783333077041356,-6.756975577506058e-05,1.080795714285714,1.080742096125675,1.0814135211825395,1.08092074204888,1.0824058333717248,-0.00028672255797896734,-0.000129939995114292,1.0807590753393364,1.0797052435724366,15.819209039548896,13.505963590709163,0.0008634040340558466,1.0797254639266476,1.0,1.0805063943748987,bullish,1.080737764668121,1.0808043933999874,1.080625039559683,-6.662873186624729e-05,-5.439877078048712e-05,0.00018960309442503246,-2.695906432736983e-05,-4.2397660819704086e-05,-4.9270725834382745e-05,1.080814642654108,1.080435436465258,,True,False,0.0,1.08571,1.08151,1.0823099999999999,1.0827099999999998,True,2024-02-22 02:35:00,2024-02-22 10:05:32,2024-02-21 06:17:55,0.01,even,True,14.68,4978.809999999997,79,0,8,2
2024-02-20 23:50:00,1.0807,1.0808,1.0807,1.08076,161,12,0,1.0806166530885006,1.080866671819974,-0.00010951108559498389,-6.168556962484656e-05,2.8006261497619076e-05,2.0049215407856327e-05,1.0806083511266842,1.080711546957105,2024-02-20 23:00:00,2024-02-20 23:00:00,-0.00035869047619074834,0.0007626981843051883,1.0806236904761903,-0.00011783333077041356,-6.756975577506058e-05,1.080795714285714,1.080742096125675,1.0814135211825395,1.08092074204888,1.0824058333717248,-0.00028672255797896734,-0.000129939995114292,1.0807590753393364,1.0797052435724366,19.209039548020073,15.43314500941483,0.0008634040340558466,1.0797254639266476,1.0,1.0805063943748987,bullish,1.0807411854884101,1.0808011049999884,1.0806185999312008,-5.99195115782436e-05,-5.550291894003842e-05,0.00018810635311457765,-6.439628482235449e-06,-2.695906432736983e-05,-4.2397660819704086e-05,1.0808067062843154,1.0804304935780862,,True,False,0.0,1.0857599999999998,1.0815599999999999,1.0823599999999998,1.0827599999999997,True,2024-02-22 02:35:00,2024-02-22 10:07:01,2024-02-21 06:17:46,0.01,even,True,14.68,4993.489999999997,80,0,8,2
2024-02-21 00:15:00,1.08058,1.0807,1.08058,1.08066,8,16,0,1.08058,1.0807600012422465,4.034618422712827e-05,9.251555840329088e-06,2.836804220386114e-06,6.503186783984044e-05,1.0803854501525136,1.0806802378106624,2024-02-21 00:00:00,2024-02-21 00:00:00,-0.00017202380952374696,0.0006580637107658216,1.0806858333333333,-4.4422375554510724e-05,-2.3489979596232417e-05,1.0806236904761903,1.0804622578249878,1.0812380253402207,1.080742096125675,1.0814135211825395,-6.756975577506058e-05,-0.00011783333077041356,1.0808196917797788,1.0797968240866418,49.739328771602594,38.15328630043234,0.0008223359693978417,1.0800530268125157,1.0,1.0805816975969058,bullish,1.0806779308634795,1.0807466526987393,1.0805994152046778,-6.872183525974407e-05,-6.365618927335761e-05,0.0001807558207881251,1.691434468620301e-05,-3.5156518767287537e-06,-1.6284829720492056e-05,1.0807801710254659,1.0804186593838898,,True,False,0.0,1.0856599999999998,1.0814599999999999,1.0822599999999998,1.0826599999999997,True,2024-02-22 02:35:00,2024-02-22 10:01:40,2024-02-21 06:18:32,0.01,even,True,14.68,5008.169999999997,81,0,8,2
2024-02-21 00:20:00,1.08066,1.08077,1.08066,1.0807,30,24,0,1.0806708028854453,1.08077,1.209014610995391e-05,1.2090184862004232e-05,3.725861799972592e-05,1.5422262822906368e-05,1.080547963850146,1.0806523275748403,2024-02-21 00:00:00,2024-02-21 00:00:00,-0.00017202380952374696,0.0006580637107658216,1.0806858333333333,-4.4422375554510724e-05,-2.3489979596232417e-05,1.0806236904761903,1.0804622578249878,1.0812380253402207,1.080742096125675,1.0814135211825395,-6.756975577506058e-05,-0.00011783333077041356,1.0808196917797788,1.0797968240866418,62.77056277057296,49.96784710047694,0.0008223359693978417,1.0800530268125157,1.0,1.0805816975969058,bullish,1.080681326115252,1.080743196943277,1.0806275713794287,-6.187082802511235e-05,-6.329911702370856e-05,0.00018152869400912537,2.8156174750826324e-05,1.691434468620301e-05,-3.5156518767287537e-06,1.080809100073438,1.0804460426854194,,True,False,0.0,1.0856999999999999,1.0815,1.0822999999999998,1.0826999999999998,True,2024-02-22 02:35:00,2024-02-22 10:05:32,2024-02-21 06:18:08,0.01,even,True,14.68,5022.849999999998,82,0,8,2
2024-02-21 00:25:00,1.0807,1.08072,1.0807,1.08071,29,28,0,1.0806935721883058,1.0807338041659722,1.1235746713843975e-05,4.200456282989289e-05,4.626663276213078e-05,4.9354219917482976e-05,1.0805308094088732,1.0806738782874927,2024-02-21 00:00:00,2024-02-21 00:00:00,-0.00017202380952374696,0.0006580637107658216,1.0806858333333333,-4.4422375554510724e-05,-2.3489979596232417e-05,1.0806236904761903,1.0804622578249878,1.0812380253402207,1.080742096125675,1.0814135211825395,-6.756975577506058e-05,-0.00011783333077041356,1.0808196917797788,1.0797968240866418,73.80952380953391,62.10647178390317,0.0008223359693978417,1.0800530268125157,1.0,1.0805816975969058,bullish,1.0806857374821361,1.0807407379104417,1.0806566116271075,-5.5000428305529425e-05,-6.163937928007273e-05,0.0001794900185203731,2.904024767880209e-05,2.8156174750826324e-05,1.691434468620301e-05,1.0808361016456278,1.080477121608587,,True,False,0.0,1.08571,1.08151,1.0823099999999999,1.0827099999999998,True,2024-02-22 02:35:00,2024-02-22 10:05:32,2024-02-21 06:17:55,0.01,even,True,14.68,5037.529999999998,83,0,8,2
2024-02-21 00:30:00,1.08072,1.08079,1.0807,1.08077,71,23,0,1.0806800044353664,1.0808066673096968,2.3130995294669155e-05,2.9297947874976616e-05,9.251555840329088e-06,4.034618422712827e-05,1.0805833863695171,1.0807607778799437,2024-02-21 00:00:00,2024-02-21 00:00:00,-0.00017202380952374696,0.0006580637107658216,1.0806858333333333,-4.4422375554510724e-05,-2.3489979596232417e-05,1.0806236904761903,1.0804622578249878,1.0812380253402207,1.080742096125675,1.0814135211825395,-6.756975577506058e-05,-0.00011783333077041356,1.0808196917797788,1.0797968240866418,82.53968253969515,73.03992303993402,0.0008223359693978417,1.0800530268125157,1.0,1.0805816975969058,bullish,1.0806987009464228,1.0807429054726312,1.080686418988647,-4.4204526208346806e-05,-5.815240866572755e-05,0.00016026020533725259,2.9807361539457844e-05,2.904024767880209e-05,2.8156174750826324e-05,1.0808466791939841,1.0805261587833097,,True,False,0.0,1.08577,1.08157,1.0823699999999998,1.0827699999999998,True,2024-02-22 02:40:00,2024-02-22 10:07:05,2024-02-21 06:12:00,0.01,even,True,14.68,5052.209999999998,84,0,8,2
2024-02-21 00:35:00,1.08078,1.0808200000000001,1.08071,1.08079,34,21,0,1.08071,1.0808683328260809,2.8505982492897327e-05,1.542438225532239e-06,1.2090184862004232e-05,1.209014610995391e-05,1.0806718179715888,1.0807710151825745,2024-02-21 00:00:00,2024-02-21 00:00:00,-0.00017202380952374696,0.0006580637107658216,1.0806858333333333,-4.4422375554510724e-05,-2.3489979596232417e-05,1.0806236904761903,1.0804622578249878,1.0812380253402207,1.080742096125675,1.0814135211825395,-6.756975577506058e-05,-0.00011783333077041356,1.0808196917797788,1.0797968240866418,88.20346320345953,81.51755651756288,0.0008223359693978417,1.0800530268125157,1.0,1.0805816975969058,bullish,1.0807127469546653,1.08074639395614,1.0807097626418982,-3.364700147456823e-05,-5.3251327227495686e-05,0.0001552127574693759,2.3343653251295393e-05,2.9807361539457844e-05,2.904024767880209e-05,1.0808649753993675,1.080554549884429,,True,False,0.0,1.0857899999999998,1.0815899999999998,1.0823899999999997,1.0827899999999997,True,2024-02-22 02:40:00,2024-02-22 10:07:16,2024-02-21 06:01:55,0.01,even,True,14.68,5066.8899999999985,85,0,8,2
2024-02-21 00:40:00,1.08081,1.08087,1.08073,1.08083,54,14,0,1.08073,1.0808591929728955,2.800520883227708e-05,9.50064796500948e-06,4.200456282989289e-05,1.1235746713843975e-05,1.080694516008481,1.0807373327500673,2024-02-21 00:00:00,2024-02-21 00:00:00,-0.00017202380952374696,0.0006580637107658216,1.0806858333333333,-4.4422375554510724e-05,-2.3489979596232417e-05,1.0806236904761903,1.0804622578249878,1.0812380253402207,1.080742096125675,1.0814135211825395,-6.756975577506058e-05,-0.00011783333077041356,1.0808196917797788,1.0797968240866418,92.62523191093281,87.7894592180292,0.0008223359693978417,1.0800530268125157,1.0,1.0805816975969058,bullish,1.0807307858847168,1.0807525869964258,1.080733708290333,-2.1801111709018883e-05,-4.6961284123800326e-05,0.00014971862525345165,2.3945648434775535e-05,2.3343653251295393e-05,2.9807361539457844e-05,1.0808834269155865,1.0805839896650795,,True,False,0.0,1.0858299999999999,1.0816299999999999,1.0824299999999998,1.0828299999999997,True,2024-02-22 02:40:00,2024-02-22 10:07:17,2024-02-21 21:05:10,0.01,even,True,14.68,5081.569999999999,86,0,8,2
2024-02-21 00:45:00,1.0808200000000001,1.08085,1.0808,1.08083,22,15,0,1.0808108071762157,1.080848571540807,-1.8754095352389267e-05,1.5860142071979405e-05,2.9297947874976616e-05,2.3130995294669155e-05,1.0806819474514022,1.080809128642104,2024-02-21 00:00:00,2024-02-21 00:00:00,-0.00017202380952374696,0.0006580637107658216,1.0806858333333333,-4.4422375554510724e-05,-2.3489979596232417e-05,1.0806236904761903,1.0804622578249878,1.0812380253402207,1.080742096125675,1.0814135211825395,-6.756975577506058e-05,-0.00011783333077041356,1.0808196917797788,1.0797968240866418,92.28509585650637,91.03793032363292,0.0008223359693978417,1.0800530268125157,1.0,1.0805816975969058,bullish,1.0807460495947603,1.080758321292987,1.080751967664258,-1.2271698226706818e-05,-4.002336694438163e-05,0.00013128467826643915,1.8259373925078037e-05,2.3945648434775535e-05,2.3343653251295393e-05,1.0808832523425245,1.0806206829859917,,True,False,0.0,1.0858299999999999,1.0816299999999999,1.0824299999999998,1.0828299999999997,True,2024-02-22 02:40:00,2024-02-22 10:07:17,2024-02-21 21:05:10,0.01,even,True,14.68,5096.249999999999,87,0,8,2
2024-02-21 00:55:00,1.08083,1.08089,1.08081,1.08085,39,23,0,1.0807833318451199,1.0808791969948728,-2.467338246075063e-05,9.499231831387781e-06,9.50064796500948e-06,2.800520883227708e-05,1.080732353121918,1.0808599913543508,2024-02-21 00:00:00,2024-02-21 00:00:00,-0.00017202380952374696,0.0006580637107658216,1.0806858333333333,-4.4422375554510724e-05,-2.3489979596232417e-05,1.0806236904761903,1.0804622578249878,1.0812380253402207,1.080742096125675,1.0814135211825395,-6.756975577506058e-05,-0.00011783333077041356,1.0808196917797788,1.0797968240866418,91.94344404429205,92.02175819822317,0.0008223359693978417,1.0800530268125157,1.0,1.0805816975969058,bullish,1.0807729704199172,1.0807700285433701,1.0808018610251116,2.9418765470357044e-06,-2.5773105154132352e-05,9.491575254105869e-05,2.588923288593392e-05,2.4004127967547362e-05,1.8259373925078037e-05,1.0808967767776527,1.0807069452725704,,True,False,0.0,1.08585,1.08165,1.08245,1.0828499999999999,True,2024-02-22 02:40:00,2024-02-22 10:08:28,2024-02-21 22:57:51,0.01,even,True,14.68,5110.929999999999,88,0,8,2
2024-02-21 20:10:00,1.08023,1.08074,1.08022,1.08064,399,12,0,1.08022,1.0808099888823137,0.00017608597784641433,9.714506664582688e-05,-5.574935132674825e-05,-3.0609623488434036e-06,1.0799330492667187,1.08090532663628,2024-02-21 20:00:00,2024-02-21 20:00:00,-3.773809523899274e-05,8.832557797022744e-05,1.0811366666666669,-5.128545788358536e-05,-0.00010241993862316932,1.0810686904761904,1.0801472418195301,1.0820321750770148,1.0802548089095845,1.0816530896542467,0.00013315325328193552,-7.121849711054749e-05,1.0810317864488344,1.0806194851815007,28.965517241378432,19.60425489009825,6.52905782989411e-05,1.0792225235200001,1.0,1.0816480425934722,bullish,1.0807152216393892,1.08088945309692,1.0804243206054358,-0.0001742314575308157,-0.00010259708280150194,0.00040805555187881765,-5.005159957827132e-06,-0.00012029583763317753,-0.00011988648090799359,1.0808323761573146,1.080016265053557,,True,False,0.0,1.08564,1.08144,1.0822399999999999,1.0826399999999998,True,2024-02-22 02:35:00,2024-02-22 10:01:40,2024-02-21 21:06:04,0.01,even,True,14.68,5125.61,89,0,8,2
2024-02-21 20:15:00,1.08064,1.08088,1.08059,1.08077,415,12,0,1.0805316790976822,1.0810116669434915,9.098893741879942e-05,7.708542512210009e-06,4.9101806979326633e-05,0.00019515597808340444,1.079825616614903,1.080714121750946,2024-02-21 20:00:00,2024-02-21 20:00:00,-3.773809523899274e-05,8.832557797022744e-05,1.0811366666666669,-5.128545788358536e-05,-0.00010241993862316932,1.0810686904761904,1.0801472418195301,1.0820321750770148,1.0802548089095845,1.0816530896542467,0.00013315325328193552,-7.121849711054749e-05,1.0810317864488344,1.0806194851815007,41.379310344827275,28.357279693485953,6.52905782989411e-05,1.0792225235200001,1.0,1.0816480425934722,bullish,1.0807236490794832,1.0808806047193704,1.080458066735466,-0.00015695563988726846,-0.00011346879421865524,0.0004119061382791923,3.3746130030154475e-05,-5.005159957827132e-06,-0.00012029583763317753,1.0808699728737452,1.0800461605971867,,True,False,0.0,1.08577,1.08157,1.0823699999999998,1.0827699999999998,True,2024-02-22 02:40:00,2024-02-22 10:07:05,2024-02-21 21:05:45,0.01,even,True,14.68,5140.29,90,0,8,2
2024-02-21 20:20:00,1.08076,1.08102,1.08063,1.08094,322,12,0,1.08063,1.08102,9.752255663227908e-05,5.8335738517270636e-05,0.00017579913427136814,0.00018488255698319813,1.0800463385992936,1.0805648084083503,2024-02-21 20:00:00,2024-02-21 20:00:00,-3.773809523899274e-05,8.832557797022744e-05,1.0811366666666669,-5.128545788358536e-05,-0.00010241993862316932,1.0810686904761904,1.0801472418195301,1.0820321750770148,1.0802548089095845,1.0816530896542467,0.00013315325328193552,-7.121849711054749e-05,1.0810317864488344,1.0806194851815007,60.20639315378912,43.51707357999829,6.52905782989411e-05,1.0792225235200001,1.0,1.0816480425934722,bullish,1.0807569338364857,1.0808850043697875,1.0805174269005848,-0.00012807053330177176,-0.00011638914203527856,0.0004124835351283174,5.936016511887132e-05,3.3746130030154475e-05,-5.005159957827132e-06,1.080929910435713,1.0801049433654566,,True,False,0.0,1.08594,1.0825399999999998,1.0833399999999997,1.0839399999999997,True,2024-02-22 09:05:00,2024-02-22 10:12:56,2024-02-22 04:00:17,0.01,even,True,29.36,5169.65,91,0,8,2
2024-02-21 21:10:00,1.08145,1.08194,1.08136,1.0817,639,12,0,1.0813708018588315,1.08194,-9.494830533089033e-06,-3.414185723095924e-05,-2.9193177486752336e-05,0.00033150693499815054,1.0801100057940511,1.0823891164428412,2024-02-21 21:00:00,2024-02-21 21:00:00,6.797619047649306e-05,0.00011149454523406988,1.0812757142857146,-5.129543414856963e-05,9.684834686635487e-05,1.0811366666666669,1.0800918537740944,1.0819382184007513,1.0801472418195301,1.0820321750770148,-0.00010241993862316932,-5.128545788358536e-05,1.0814039288162782,1.0806971263669807,70.84520417854024,74.94792745761751,7.453137168596686e-05,1.0793308225792002,1.0,1.0817469422194694,bullish,1.0812377500583663,1.0811010417837628,1.0814447506019957,0.0001367082746035475,3.2786355095620715e-05,0.0003625042529630433,0.00012811489508113283,9.855865153141075e-05,0.00018013759889745629,1.0818072548549589,1.0810822463490326,,True,False,0.0,1.0867,1.0825,1.0833,1.0836999999999999,True,2024-02-22 07:50:00,2024-02-22 10:15:00,2024-02-22 04:00:27,0.01,even,True,14.68,5184.33,92,0,8,2
2024-02-22 21:05:00,1.08227,1.08244,1.08219,1.08221,150,12,0,1.0821633343219585,1.08244,-6.1609942273018515e-06,-5.2603712489932976e-05,-1.822454871984245e-05,-1.822892750738625e-05,1.082258441350927,1.0824976239403457,2024-02-22 21:00:00,2024-02-22 21:00:00,0.0001842857142846377,-0.0003204917595389656,1.0817488095238097,0.00033637385678220275,0.00020293763460294144,1.0814398809523802,1.0803386998693953,1.0819073401440766,1.0799756456719818,1.082412557219919,2.9833570027865463e-05,0.00033616752648337763,1.0821821170370272,1.0826633215810446,78.1609195402367,83.62068965517967,0.00011564181447041829,,-1.0,1.082774915356843,bearish,1.0822274552089357,1.0820513428013427,1.08235031991744,0.00017611240759296543,0.00016825358988253793,0.00033659471194851263,3.0189198485963686e-05,2.999999999997449e-05,4.9115927072351795e-05,1.0826869146293885,1.0820137252054915,,False,True,1.0,1.07721,1.08061,1.0798100000000002,1.0792100000000002,True,,,2024-02-28 12:03:58,0.01,even,True,29.35,5213.68,93,0,8,2
2024-02-22 21:10:00,1.08222,1.08232,1.08215,1.0822,182,12,0,1.0821300000683483,1.08232,1.8481833821548863e-05,8.987664171556534e-06,-2.309810789890457e-05,-3.850102248205399e-05,1.0822583757638005,1.0824880306143134,2024-02-22 21:00:00,2024-02-22 21:00:00,0.0001842857142846377,-0.0003204917595389656,1.0817488095238097,0.00033637385678220275,0.00020293763460294144,1.0814398809523802,1.0803386998693953,1.0819073401440766,1.0799756456719818,1.082412557219919,2.9833570027865463e-05,0.00033616752648337763,1.0821821170370272,1.0826633215810446,72.12643678161389,77.77777777778418,0.00011564181447041829,,-1.0,1.082774915356843,bearish,1.082223231330638,1.0820623544456878,1.0823702751977986,0.00016087688495014518,0.0001667782488960594,0.0003080595182415813,1.9955280358585625e-05,3.0189198485963686e-05,2.999999999997449e-05,1.0826783347160402,1.082062215679557,,False,True,1.0,1.0772000000000002,1.0806000000000002,1.0798000000000003,1.0792000000000004,True,,,2024-02-28 12:03:58,0.01,even,True,29.35,5243.030000000001,94,0,8,2
2024-02-22 21:35:00,1.08208,1.08208,1.08189,1.08193,158,12,0,1.0817812256407935,1.08208,7.356632619365429e-05,5.2112168995270684e-05,-6.392148141652892e-05,-0.0001478733765912382,1.0821674025193635,1.0824129222878898,2024-02-22 21:00:00,2024-02-22 21:00:00,0.0001842857142846377,-0.0003204917595389656,1.0817488095238097,0.00033637385678220275,0.00020293763460294144,1.0814398809523802,1.0803386998693953,1.0819073401440766,1.0799756456719818,1.082412557219919,2.9833570027865463e-05,0.00033616752648337763,1.0821821170370272,1.0826633215810446,39.51864158012368,57.785596691153266,0.00011564181447041829,,-1.0,1.082774915356843,bearish,1.082162258725671,1.082083973740555,1.082283281733746,7.828498511597282e-05,0.00013083159234098684,0.0002508485601201721,-6.294461644307248e-05,-4.706570347479122e-05,-3.1338149288906436e-06,1.0825341302938662,1.0820324331736257,,False,True,1.0,1.0769300000000002,1.0811300000000001,1.0803300000000002,1.0799300000000003,True,2024-02-28 11:40:00,,2024-02-28 11:00:13,0.01,even,True,14.68,5257.710000000001,95,0,8,2
2024-02-22 22:05:00,1.08211,1.08215,1.08193,1.08207,261,12,0,1.0819407156862997,1.08215,-3.301394493982557e-06,-3.331896472930575e-06,-1.5400918770704877e-05,-2.4395417774632203e-05,1.0820179179684262,1.0822920213832534,2024-02-22 22:00:00,2024-02-22 22:00:00,0.0003089285714295009,-0.00031969882952154194,1.0820498809523802,0.00022676005054163823,9.611676774080627e-05,1.0817488095238097,1.080829340489078,1.0823501270159972,1.0803386998693953,1.0819073401440766,0.00020293763460294144,0.00033637385678220275,1.0821340390123422,1.082619055854561,43.612174229994906,45.24911696043235,2.857368567202625e-05,,-1.0,1.0827354498176118,bearish,1.0821253820754682,1.082089847647378,1.0820266769865847,3.553442809023366e-05,6.695066849191383e-05,0.00024073360127153592,-1.2696938424427984e-05,-1.39112487098636e-05,-1.4127966976085204e-05,1.0822674105878562,1.0817859433853132,,False,True,1.0,1.0770700000000002,1.0804700000000003,1.0796700000000004,1.0790700000000004,True,,,2024-02-28 12:03:39,0.01,even,True,29.35,5287.060000000001,96,0,8,2
2024-02-22 22:10:00,1.08207,1.08208,1.08193,1.082,382,12,0,1.0819033339466329,1.0820883350233212,1.2323524621867304e-05,3.85034873881098e-05,-7.084363958639125e-05,-7.085564233618469e-05,1.0820772899833793,1.0823306309913336,2024-02-22 22:00:00,2024-02-22 22:00:00,0.0003089285714295009,-0.00031969882952154194,1.0820498809523802,0.00022676005054163823,9.611676774080627e-05,1.0817488095238097,1.080829340489078,1.0823501270159972,1.0803386998693953,1.0819073401440766,0.00020293763460294144,0.00033637385678220275,1.0821340390123422,1.082619055854561,35.42008383452433,42.29390681003615,2.857368567202625e-05,,-1.0,1.0827354498176118,bearish,1.0821060925253962,1.0820831922660905,1.0820143790849672,2.2900259305735915e-05,5.8140586654678255e-05,0.00024073360127153592,-1.2297901617497331e-05,-1.2696938424427984e-05,-1.39112487098636e-05,1.0822551126862388,1.0817736454836957,,False,True,1.0,1.0770000000000002,1.0804000000000002,1.0796000000000003,1.0790000000000004,True,,,2024-02-28 12:03:01,0.01,even,True,29.35,5316.410000000002,97,0,8,2
2024-02-22 22:30:00,1.08212,1.08224,1.08182,1.08183,327,12,0,1.0817383363758983,1.08224,3.851469470476215e-05,-7.892447231147173e-05,2.8480033518875553e-05,-4.5967160599288726e-05,1.081976088104678,1.0821499613446208,2024-02-22 22:00:00,2024-02-22 22:00:00,0.0003089285714295009,-0.00031969882952154194,1.0820498809523802,0.00022676005054163823,9.611676774080627e-05,1.0817488095238097,1.080829340489078,1.0823501270159972,1.0803386998693953,1.0819073401440766,0.00020293763460294144,0.00033637385678220275,1.0821340390123422,1.082619055854561,37.218591140170666,43.117766043446444,2.857368567202625e-05,,-1.0,1.0827354498176118,bearish,1.0820659984126721,1.082069844552719,1.0820178706570343,-3.846140046892543e-06,3.057426525088774e-05,0.00017464249229634675,-4.255589955337591e-05,2.206054351572284e-05,1.544547643650418e-05,1.0821925131493306,1.0818432281647379,,False,True,1.0,1.0768300000000002,1.0810300000000002,1.0802300000000002,1.0798300000000003,True,2024-02-29 19:30:00,,2024-02-28 11:00:12,0.01,even,True,14.68,5331.090000000002,98,0,8,2
2024-02-22 22:45:00,1.08196,1.08196,1.08186,1.08192,259,12,0,1.0817900085430596,1.0819899925084873,7.394087487030584e-05,8.779693492595191e-05,-7.892447231147173e-05,3.851469470476215e-05,1.081741616796492,1.082233274662102,2024-02-22 22:00:00,2024-02-22 22:00:00,0.0003089285714295009,-0.00031969882952154194,1.0820498809523802,0.00022676005054163823,9.611676774080627e-05,1.0817488095238097,1.080829340489078,1.0823501270159972,1.0803386998693953,1.0819073401440766,0.00020293763460294144,0.00033637385678220275,1.0821340390123422,1.082619055854561,31.55555555556366,27.419147906085836,2.857368567202625e-05,,-1.0,1.0827354498176118,bearish,1.0820136567534213,1.0820416949213145,1.0819648710010314,-2.8038167893207344e-05,4.780545234370915e-06,0.00016734893719598843,-1.527347781404842e-05,-1.3333333331200237e-05,-2.4392844857556994e-05,1.0821322199382275,1.0817975220638354,,False,True,1.0,1.07692,1.08112,1.0803200000000002,1.0799200000000002,True,2024-02-28 11:40:00,,2024-02-28 11:00:13,0.01,even,True,14.68,5345.770000000002,99,0,8,2
2024-02-22 23:00:00,1.08211,1.08213,1.08203,1.08208,110,11,0,1.0820133350361978,1.08213,-1.5411276505103722e-06,1.822965225274943e-05,8.779693492595191e-05,7.394087487030584e-05,1.0817963184634436,1.0819974862578676,2024-02-22 23:00:00,2024-02-22 23:00:00,0.0003010714285704985,-0.0003190346105088615,1.0822145238095238,0.00020984100707105633,-7.575451159325555e-05,1.0820498809523802,1.0811279212781855,1.0826255323732954,1.080829340489078,1.0823501270159972,9.611676774080627e-05,0.00022676005054163823,1.082178013004114,1.0825855313861963,57.638888888876686,46.75925925925372,-4.0947973564151307e-05,,-1.0,1.0826966782715788,bearish,1.0820326978328645,1.0820452991487852,1.0820109287925685,-1.260131592073499e-05,-6.687432100520139e-06,0.00012348684186089313,1.1778465770939661e-05,3.093567251521989e-05,3.3436532509423245e-06,1.0821344156344295,1.0818874419507076,,False,True,1.0,1.07708,1.08048,1.0796800000000002,1.0790800000000003,True,,,2024-02-28 12:03:39,0.01,even,True,29.35,5375.120000000003,100,0,8,2
2024-02-23 01:45:00,1.08249,1.08249,1.08244,1.08247,44,12,0,1.0824300012009058,1.0824791828008775,4.618660283846957e-06,3.104370848808325e-05,-2.155481173552664e-05,2.534285413574429e-07,1.0824500217389117,1.0825614850496623,2024-02-23 01:00:00,2024-02-23 01:00:00,6.035714285723692e-05,-0.00029281841671613407,1.0823288095238097,-1.886049087838779e-05,2.059816795510778e-05,1.082274880952381,1.0818095918567299,1.0824417668806334,1.0813973125202407,1.0825440664483676,-6.947395368536462e-05,8.571115090726941e-05,1.0823531125560126,1.0825398177652765,92.40506329112763,93.65423051297846,-0.0001328820663561407,,-1.0,1.0826246219138902,bearish,1.0823986458131276,1.082296644994146,1.0825258548331618,0.00010200081898159574,8.011699071659869e-05,0.00017900931107316505,1.9422084623244018e-05,3.4327485380680756e-05,2.746818025367581e-05,1.082704864144235,1.0823468455220886,,False,True,1.0,1.0774700000000001,1.0816700000000001,1.0808700000000002,1.0804700000000003,True,2024-02-28 11:20:00,,2024-02-23 11:56:28,0.01,even,True,14.68,5389.800000000003,101,0,8,2
2024-02-23 02:15:00,1.08268,1.08269,1.08261,1.08263,74,12,0,1.0825933326115793,1.0827266672264635,3.0793501533404247e-06,3.078125355185224e-06,4.772409656960001e-05,6.004294015213283e-05,1.0824301660067952,1.0826307623594758,2024-02-23 02:00:00,2024-02-23 02:00:00,5.392857142871854e-05,-0.0002379184972904902,1.082228571428572,-8.80206893798837e-05,0.00011334820351855852,1.0823288095238097,1.0817832987973979,1.0822588850948132,1.0818095918567299,1.0824417668806334,2.059816795510778e-05,-1.886049087838779e-05,1.0821910375186707,1.0825054323440544,85.58904649329294,90.11655794156309,-0.00015388935254301062,,-1.0,1.082592563339078,bearish,1.0825193498800865,1.0824007991278282,1.08263560371517,0.00011855075225830625,0.00010167754816218833,0.00021276591233897313,8.341933263711354e-06,2.673202614489334e-05,2.2961816304567506e-05,1.082848369627509,1.082422837802831,,False,True,1.0,1.07763,1.08183,1.0810300000000002,1.0806300000000002,True,2024-02-28 11:20:00,,2024-02-23 11:48:34,0.01,even,True,14.68,5404.480000000003,102,0,8,2
2024-02-23 02:20:00,1.08264,1.08273,1.0826,1.08261,76,12,0,1.0826107964842595,1.0828275275670678,-0.00036992762406412474,-4.541739535820127e-05,4.999154538236148e-06,3.720296921995974e-05,1.0824931965738283,1.082714191546312,2024-02-23 02:00:00,2024-02-23 02:00:00,5.392857142871854e-05,-0.0002379184972904902,1.082228571428572,-8.80206893798837e-05,0.00011334820351855852,1.0823288095238097,1.0817832987973979,1.0822588850948132,1.0818095918567299,1.0824417668806334,2.059816795510778e-05,-1.886049087838779e-05,1.0821910375186707,1.0825054323440544,75.00063550167317,84.34278306443203,-0.00015388935254301062,,-1.0,1.082592563339078,bearish,1.0825332960523808,1.0824162954887298,1.082632604059168,0.0001170005636510485,0.00010474215125996036,0.00021101500765115185,-2.9996560020340013e-06,8.341933263711354e-06,2.673202614489334e-05,1.0828436190668191,1.082421589051517,,False,True,1.0,1.0776100000000002,1.0818100000000002,1.0810100000000002,1.0806100000000003,True,2024-02-28 11:20:00,,2024-02-23 11:48:31,0.01,even,True,14.68,5419.1600000000035,103,0,8,2
2024-02-23 02:30:00,1.0827,1.08274,1.08264,1.08268,85,12,0,1.0814249077272917,1.082868848407363,-1.3785358502151235e-05,-0.00018439107591153035,3.078125355185224e-06,3.0793501533404247e-06,1.0825935974376268,1.0827269319797812,2024-02-23 02:00:00,2024-02-23 02:00:00,5.392857142871854e-05,-0.0002379184972904902,1.082228571428572,-8.80206893798837e-05,0.00011334820351855852,1.0823288095238097,1.0817832987973979,1.0822588850948132,1.0818095918567299,1.0824417668806334,2.059816795510778e-05,-1.886049087838779e-05,1.0821910375186707,1.0825054323440544,75.83240637746754,74.6909518880032,-0.00015388935254301062,,-1.0,1.082592563339078,bearish,1.0825762652209354,1.0824546017564556,1.082649418644652,0.00012166346447983756,0.00011070118250914501,0.0002092829029216529,1.289301685636346e-05,3.921568627607286e-06,-2.9996560020340013e-06,1.0828587015475737,1.0824401357417304,,False,True,1.0,1.0776800000000002,1.0818800000000002,1.0810800000000003,1.0806800000000003,True,2024-02-28 11:15:00,,2024-02-23 12:00:43,0.01,even,True,14.68,5433.840000000004,104,0,8,2
2024-02-23 02:35:00,1.08268,1.08268,1.08141,1.08184,409,12,0,1.08141,1.08268,0.00011735615388596332,-0.00018501708969665182,-4.541739535820127e-05,-0.00036992762406412474,1.082579293265208,1.082823658975586,2024-02-23 02:00:00,2024-02-23 02:00:00,5.392857142871854e-05,-0.0002379184972904902,1.082228571428572,-8.80206893798837e-05,0.00011334820351855852,1.0823288095238097,1.0817832987973979,1.0822588850948132,1.0818095918567299,1.0824417668806334,2.059816795510778e-05,-1.886049087838779e-05,1.0821910375186707,1.0825054323440544,66.17924120646104,71.75048712293248,-0.00015388935254301062,,-1.0,1.082592563339078,bearish,1.0824629936484838,1.0824090757004219,1.0825048813209497,5.391794806186567e-05,9.934453561968915e-05,0.00023700773571384734,-0.00014453732370234285,1.289301685636346e-05,3.921568627607286e-06,1.0827418890566636,1.0822678735852358,,False,True,1.0,1.07684,1.08104,1.08024,1.0798400000000001,True,2024-02-29 19:30:00,,2024-02-28 11:00:12,0.01,even,True,14.68,5448.520000000004,105,0,8,2
2024-02-23 02:45:00,1.08224,1.08227,1.08179,1.08184,253,12,0,1.0816362384290132,1.08227,0.0001428891284904537,8.290688426838074e-05,-0.00018439107591153035,-1.3785358502151235e-05,1.0814237350288922,1.0828531417147702,2024-02-23 02:00:00,2024-02-23 02:00:00,5.392857142871854e-05,-0.0002379184972904902,1.082228571428572,-8.80206893798837e-05,0.00011334820351855852,1.0823288095238097,1.0817832987973979,1.0822588850948132,1.0818095918567299,1.0824417668806334,2.059816795510778e-05,-1.886049087838779e-05,1.0821910375186707,1.0825054323440544,42.355889724308305,55.593581655287245,-0.00015388935254301062,,-1.0,1.082592563339078,bearish,1.0823381197128197,1.0823553255319118,1.0823281699346405,-1.720581909214758e-05,6.528099639700387e-05,0.00024392143568823085,-0.00012529755762025196,-5.1413828688895435e-05,-0.00014453732370234285,1.0825720913703287,1.0820842484989524,,False,True,1.0,1.07684,1.08104,1.08024,1.0798400000000001,True,2024-02-29 19:30:00,,2024-02-28 11:00:12,0.01,even,True,14.68,5463.200000000004,106,0,8,2
2024-02-23 03:10:00,1.08262,1.08274,1.08256,1.08259,122,12,0,1.0825312376010032,1.08274,-1.8856833260533076e-05,-3.7197118672113704e-05,0.00012624916899872204,0.00018940635972774416,1.0819113244317657,1.0824241819845755,2024-02-23 03:00:00,2024-02-23 03:00:00,-0.00010023809523773686,-0.00023408846664341176,1.0823392857142862,-0.00014422170985482264,0.00019414256285867673,1.082228571428572,1.081865601948173,1.0823058820904858,1.0817832987973979,1.0822588850948132,0.00011334820351855852,-8.80206893798837e-05,1.0824836791728902,1.08251539775653,87.4686716791943,74.60317460317061,-0.00016992917536309086,,-1.0,1.0825636509740715,bearish,1.0823897026280305,1.082370281323698,1.0823099346405223,1.9421304332523093e-05,1.346155954123464e-05,0.00024010969740780985,3.730306157456731e-05,4.9896800825122156e-05,2.2586859306450435e-05,1.0825500443379301,1.0820698249431144,,False,True,1.0,1.07759,1.08179,1.0809900000000001,1.0805900000000002,True,2024-02-28 11:20:00,,2024-02-23 11:48:31,0.01,even,True,14.68,5477.880000000005,107,0,8,2
2024-02-23 03:15:00,1.08258,1.08263,1.0825,1.08256,157,12,0,1.0825,1.0826191775216176,-8.85817752381114e-06,1.5647633864738334e-05,5.0803193320999354e-05,0.00012651931075849355,1.0821108606600456,1.0826343554560718,2024-02-23 03:00:00,2024-02-23 03:00:00,-0.00010023809523773686,-0.00023408846664341176,1.0823392857142862,-0.00014422170985482264,0.00019414256285867673,1.082228571428572,1.081865601948173,1.0823058820904858,1.0817832987973979,1.0822588850948132,0.00011334820351855852,-8.80206893798837e-05,1.0824836791728902,1.08251539775653,89.22305764410687,84.04344193817505,-0.00016992917536309086,,-1.0,1.0825636509740715,bearish,1.082415902223718,1.0823843345589796,1.082339005847953,3.156766473844108e-05,1.708278058067593e-05,0.0002411790485428322,2.9071207430675372e-05,3.730306157456731e-05,4.9896800825122156e-05,1.0825801848964958,1.0820978267994101,,False,True,1.0,1.07756,1.08176,1.0809600000000001,1.0805600000000002,True,2024-02-28 11:20:00,,2024-02-23 11:48:27,0.01,even,True,14.68,5492.560000000005,108,0,8,2
2024-02-23 03:25:00,1.08261,1.08263,1.08247,1.08257,150,12,0,1.082480822174148,1.08263,1.8222403917403206e-05,0.00010441216094902843,-3.7197118672113704e-05,-1.8856833260533076e-05,1.0825296180699961,1.082736804688262,2024-02-23 03:00:00,2024-02-23 03:00:00,-0.00010023809523773686,-0.00023408846664341176,1.0823392857142862,-0.00014422170985482264,0.00019414256285867673,1.082228571428572,1.081865601948173,1.0823058820904858,1.0817832987973979,1.0822588850948132,0.00011334820351855852,-8.80206893798837e-05,1.0824836791728902,1.08251539775653,87.96992481202966,88.55472013366534,-0.00016992917536309086,,-1.0,1.0825636509740715,bearish,1.0824648767400584,1.0824135652940499,1.0824034227726178,5.1311446008561745e-05,2.8349333172575665e-05,0.0002445587866402938,2.7382180942669976e-05,3.703474372218629e-05,2.9071207430675372e-05,1.082647981559258,1.0821588639859776,,False,True,1.0,1.0775700000000001,1.0817700000000001,1.0809700000000002,1.0805700000000003,True,2024-02-28 11:20:00,,2024-02-23 11:48:31,0.01,even,True,14.68,5507.240000000005,109,0,8,2
2024-02-23 03:30:00,1.08258,1.08267,1.08252,1.08252,177,12,0,1.082390025902882,1.08267,6.927433938445661e-05,0.0001382671229004981,1.5647633864738334e-05,-8.85817752381114e-06,1.0824992396743833,1.0826205207570885,2024-02-23 03:00:00,2024-02-23 03:00:00,-0.00010023809523773686,-0.00023408846664341176,1.0823392857142862,-0.00014422170985482264,0.00019414256285867673,1.082228571428572,1.081865601948173,1.0823058820904858,1.0817832987973979,1.0822588850948132,0.00011334820351855852,-8.80206893798837e-05,1.0824836791728902,1.08251539775653,86.96741854636453,87.80284043441789,-0.00016992917536309086,,-1.0,1.0825636509740715,bearish,1.0824733572415879,1.0824214493463424,1.0824244754041972,5.190789524545103e-05,3.306104558715074e-05,0.00024486390803127783,2.1052631579365766e-05,2.7382180942669976e-05,3.703474372218629e-05,1.0826693393122284,1.082179611496166,,False,True,1.0,1.07752,1.08172,1.08092,1.0805200000000001,True,2024-02-28 11:20:00,,2024-02-23 11:56:42,0.01,even,True,14.68,5521.9200000000055,110,0,8,2
2024-02-23 03:45:00,1.08298,1.08313,1.08294,1.08294,192,12,0,1.0828566646417874,1.08313,-0.00018319013228042464,-0.00012644743043043963,0.0001382671229004981,6.927433938445661e-05,1.0823960004408673,1.082681927910583,2024-02-23 03:00:00,2024-02-23 03:00:00,-0.00010023809523773686,-0.00023408846664341176,1.0823392857142862,-0.00014422170985482264,0.00019414256285867673,1.082228571428572,1.081865601948173,1.0823058820904858,1.0817832987973979,1.0822588850948132,0.00011334820351855852,-8.80206893798837e-05,1.0824836791728902,1.08251539775653,92.59006208609618,90.69233199377943,-0.00016992917536309086,,-1.0,1.0825636509740715,bearish,1.0826281558891915,1.0825113634119088,1.0827039387684891,0.00011679247728269004,6.324087390122796e-05,0.00028291518185527326,0.00010522531819723291,0.00012066391468845694,5.357413140627543e-05,1.0829868539503444,1.0824210235866338,,False,True,1.0,1.0779400000000001,1.08214,1.0813400000000002,1.0809400000000002,True,2024-02-28 10:55:00,,2024-02-23 12:14:04,0.01,even,True,14.68,5536.600000000006,111,0,8,2
2024-02-23 03:50:00,1.08295,1.08295,1.08271,1.08274,217,12,0,1.082444999298647,1.08295,1.385806892974861e-05,-7.413125203804869e-05,0.0001308194088274597,8.350494105312809e-05,1.0824567918913512,1.0828579093081434,2024-02-23 03:00:00,2024-02-23 03:00:00,-0.00010023809523773686,-0.00023408846664341176,1.0823392857142862,-0.00014422170985482264,0.00019414256285867673,1.082228571428572,1.081865601948173,1.0823058820904858,1.0817832987973979,1.0822588850948132,0.00011334820351855852,-8.80206893798837e-05,1.0824836791728902,1.08251539775653,85.46669812062902,89.94146528545178,-0.00016992917536309086,,-1.0,1.0825636509740715,bearish,1.0826453626754697,1.0825282994554712,1.0827651083591325,0.00011706321999849223,7.400534312068081e-05,0.0002868797659726105,6.116959064339511e-05,0.00010522531819723291,0.00012066391468845694,1.083051988125105,1.08247822859316,,False,True,1.0,1.0777400000000001,1.0819400000000001,1.0811400000000002,1.0807400000000003,True,2024-02-28 11:15:00,,2024-02-23 12:04:58,0.01,even,True,14.68,5551.280000000006,112,0,8,2
2024-02-23 03:55:00,1.08274,1.08275,1.08246,1.08263,209,12,0,1.082386677870602,1.08275,8.621512854313367e-05,7.054656476205731e-05,-0.00012157965678614443,-2.1305158420632966e-05,1.082538168900174,1.0832512383312736,2024-02-23 03:00:00,2024-02-23 03:00:00,-0.00010023809523773686,-0.00023408846664341176,1.0823392857142862,-0.00014422170985482264,0.00019414256285867673,1.082228571428572,1.081865601948173,1.0823058820904858,1.0817832987973979,1.0822588850948132,0.00011334820351855852,-8.80206893798837e-05,1.0824836791728902,1.08251539775653,73.33333333333881,83.79669784668802,-0.00016992917536309086,,-1.0,1.0825636509740715,bearish,1.082642999186936,1.0825358328291401,1.0828110010319913,0.00010716635779584038,8.063754605571274e-05,0.0002877336733706081,4.589267285881604e-05,6.116959064339511e-05,0.00010522531819723291,1.083098734705362,1.0825232673586207,,False,True,1.0,1.07763,1.08183,1.0810300000000002,1.0806300000000002,True,2024-02-28 11:20:00,,2024-02-23 11:48:34,0.01,even,True,14.68,5565.960000000006,113,0,8,2
2024-02-23 04:15:00,1.08292,1.08298,1.08281,1.08285,134,12,0,1.08281,1.0830100064158095,-0.00011367321613332334,-6.464181560827245e-05,0.00012005656095132023,9.736401711737476e-05,1.0824883890690655,1.0827403378072629,2024-02-23 04:00:00,2024-02-23 04:00:00,0.00011071428571418629,-0.00016788280430346525,1.0824302380952375,0.00013862071850881326,0.00024875995745992654,1.0823392857142862,1.0811221087926175,1.082343324527833,1.081865601948173,1.0823058820904858,0.00019414256285867673,-0.00014422170985482264,1.08248789305763,1.0825133659360078,62.61964322486843,61.308012452791445,-0.00016951990115116573,,-1.0,1.082538038277949,bearish,1.0827185984768017,1.0826031333654775,1.0828784141726862,0.00011546511132420889,9.676854943407076e-05,0.00030569483714796517,-1.331613347188565e-05,4.691090471231618e-05,-1.9573443411635694e-05,1.0831841090098342,1.0825727193355381,,False,True,1.0,1.0778500000000002,1.0820500000000002,1.0812500000000003,1.0808500000000003,True,2024-02-28 10:55:00,,2024-02-23 12:05:18,0.01,even,True,14.68,5580.640000000007,114,0,8,2
2024-02-23 04:25:00,1.08286,1.08287,1.08261,1.08267,144,12,0,1.0824516403271967,1.08287,-9.996078674377931e-06,-5.87435893601055e-05,-4.578908171345849e-05,-1.8224641279623483e-05,1.082678432727502,1.0830148221143732,2024-02-23 04:00:00,2024-02-23 04:00:00,0.00011071428571418629,-0.00016788280430346525,1.0824302380952375,0.00013862071850881326,0.00024875995745992654,1.0823392857142862,1.0811221087926175,1.082343324527833,1.081865601948173,1.0823058820904858,0.00019414256285867673,-0.00014422170985482264,1.08248789305763,1.0825133659360078,50.24875621891817,58.930733828740706,-0.00016951990115116573,,-1.0,1.082538038277949,bearish,1.0827308308620889,1.0826263900595656,1.0828228689370487,0.0001044408025232535,0.00010185839286266537,0.00031268088118599697,-5.046783625650697e-05,-5.077399380937209e-06,-1.331613347188565e-05,1.0831355498182347,1.0825101880558627,,False,True,1.0,1.0776700000000001,1.08187,1.0810700000000002,1.0806700000000002,True,2024-02-28 11:15:00,,2024-02-23 12:00:43,0.01,even,True,14.68,5595.320000000007,115,0,8,2
2024-02-23 04:30:00,1.08268,1.08269,1.08243,1.08249,178,12,0,1.0823916432392673,1.08269,4.543285823842263e-05,1.514438291186754e-05,-6.464181560827245e-05,-0.00011367321613332334,1.0828002437230193,1.0830044573410582,2024-02-23 04:00:00,2024-02-23 04:00:00,0.00011071428571418629,-0.00016788280430346525,1.0824302380952375,0.00013862071850881326,0.00024875995745992654,1.0823392857142862,1.0811221087926175,1.082343324527833,1.081865601948173,1.0823058820904858,0.00019414256285867673,-0.00014422170985482264,1.08248789305763,1.0825133659360078,33.70291400142495,49.29182408759288,-0.00016951990115116573,,-1.0,1.082538038277949,bearish,1.082693779960229,1.0826162870921903,1.082764819401445,7.74928680387088e-05,9.698528789787406e-05,0.00031180549512855503,-5.8049535603732494e-05,-5.046783625650697e-05,-5.077399380937209e-06,1.0830766248965735,1.0824530139063164,,False,True,1.0,1.07749,1.08169,1.0808900000000001,1.0804900000000002,True,2024-02-28 11:20:00,,2024-02-23 11:56:28,0.01,even,True,14.68,5610.000000000007,116,0,8,2
2024-02-23 04:50:00,1.08274,1.08279,1.08258,1.08259,123,12,0,1.08258,1.0827791916600698,-0.00010753520442376206,-0.00010751591253233957,4.6938480471692946e-05,4.952143629066687e-05,1.0824342537838374,1.0826415698691794,2024-02-23 04:00:00,2024-02-23 04:00:00,0.00011071428571418629,-0.00016788280430346525,1.0824302380952375,0.00013862071850881326,0.00024875995745992654,1.0823392857142862,1.0811221087926175,1.082343324527833,1.081865601948173,1.0823058820904858,0.00019414256285867673,-0.00014422170985482264,1.08248789305763,1.0825133659360078,34.7619047619037,27.619047619044807,-0.00016951990115116573,,-1.0,1.082538038277949,bearish,1.0826644211476386,1.0826200802824526,1.0826768902648771,4.434086518600999e-05,7.000960699884409e-05,0.00021553190048763696,-3.0368077056586174e-05,-4.086687306559256e-06,-9.150326796492081e-06,1.0828924221653649,1.0824613583643894,,False,True,1.0,1.07759,1.08179,1.0809900000000001,1.0805900000000002,True,2024-02-28 11:20:00,,2024-02-23 11:48:31,0.01,even,True,14.68,5624.680000000008,117,0,8,2
2024-02-23 04:55:00,1.08259,1.08259,1.08249,1.08249,179,12,0,1.0824533269418195,1.0826433457281943,-0.00010778852393987181,-9.546141067144894e-05,6.156197973361852e-06,3.3317382222373824e-06,1.0824902858712588,1.082777196699597,2024-02-23 04:00:00,2024-02-23 04:00:00,0.00011071428571418629,-0.00016788280430346525,1.0824302380952375,0.00013862071850881326,0.00024875995745992654,1.0823392857142862,1.0811221087926175,1.082343324527833,1.081865601948173,1.0823058820904858,0.00019414256285867673,-0.00014422170985482264,1.08248789305763,1.0825133659360078,25.952380952379652,30.238095238094107,-0.00016951990115116573,,-1.0,1.082538038277949,bearish,1.082637587124925,1.0826104447059746,1.082624458204334,2.714241895040992e-05,6.143616938915725e-05,0.00018286424872463605,-5.243206054306171e-05,-3.0368077056586174e-05,-4.086687306559256e-06,1.0828073224530588,1.0824415939556093,,False,True,1.0,1.07749,1.08169,1.0808900000000001,1.0804900000000002,True,2024-02-28 11:20:00,,2024-02-23 11:56:28,0.01,even,True,14.68,5639.360000000008,118,0,8,2
2024-02-23 05:00:00,1.0824799999999999,1.08254,1.08236,1.08238,190,12,0,1.0822333298267224,1.08254,-1.231703778405956e-05,-7.107731255805592e-05,-0.00010160184966802351,-7.057610968959726e-05,1.0825939515646932,1.0828913092846257,2024-02-23 05:00:00,2024-02-23 05:00:00,9.095238095135905e-05,-0.00013352128949284392,1.0824769047619043,0.00024674996873553053,2.308504967457881e-05,1.0824302380952375,1.081164335717032,1.0830819743074058,1.0811221087926175,1.082343324527833,0.00024875995745992654,0.00013862071850881326,1.0824759643525435,1.0825098966611273,12.248677248668114,24.320987654317165,-0.0001623201788195014,,-1.0,1.0825157266968122,bearish,1.0825979583364749,1.082593374727754,1.0825481045751633,4.583608720798438e-06,5.006565725548549e-05,0.0001558118527645573,-7.635362917080002e-05,-5.243206054306171e-05,-3.0368077056586174e-05,1.0827039164279277,1.0823922927223988,,False,True,1.0,1.07738,1.08158,1.08078,1.0803800000000001,True,2024-02-28 11:20:00,,2024-02-23 17:50:16,0.01,even,True,14.68,5654.040000000008,119,0,8,2
2024-02-23 05:05:00,1.08239,1.08243,1.08222,1.08222,149,12,0,1.0821666688525866,1.08243,3.0799908255580135e-05,-2.180832950408589e-05,-0.00010751591253233957,-0.00010753520442376206,1.08257080153111,1.0827699931491956,2024-02-23 05:00:00,2024-02-23 05:00:00,9.095238095135905e-05,-0.00013352128949284392,1.0824769047619043,0.00024674996873553053,2.308504967457881e-05,1.0824302380952375,1.081164335717032,1.0830819743074058,1.0811221087926175,1.082343324527833,0.00024875995745992654,0.00013862071850881326,1.0824759643525435,1.0825098966611273,4.62962962962261,14.276895943556802,-0.0001623201788195014,,-1.0,1.0825157266968122,bearish,1.082539810900094,1.082565717340513,1.082454957000344,-2.590644041888801e-05,3.487123772061079e-05,0.0001759668533037547,-9.314757481915237e-05,-7.635362917080002e-05,-5.243206054306171e-05,1.0826309238536478,1.0822789901470404,,False,True,1.0,1.07722,1.0806200000000001,1.0798200000000002,1.0792200000000003,True,,,2024-02-28 12:04:25,0.01,even,True,29.35,5683.3900000000085,120,0,8,2
2024-02-23 05:15:00,1.08229,1.08232,1.08226,1.08228,73,12,0,1.0822533337691758,1.082358333623074,3.0797827485348113e-06,1.0778606021894106e-05,-7.107731255805592e-05,-1.231703778405956e-05,1.082232275832319,1.082533916057951,2024-02-23 05:00:00,2024-02-23 05:00:00,9.095238095135905e-05,-0.00013352128949284392,1.0824769047619043,0.00024674996873553053,2.308504967457881e-05,1.0824302380952375,1.081164335717032,1.0830819743074058,1.0811221087926175,1.082343324527833,0.00024875995745992654,0.00013862071850881326,1.0824759643525435,1.0825098966611273,7.172995780582892,5.552764940943272,-0.0001623201788195014,,-1.0,1.0825157266968122,bearish,1.0824673202302448,1.0825256424387117,1.0823741658066732,-5.832220846690994e-05,3.626689666561343e-06,0.00020251502033404817,-3.7440660475507315e-05,-4.33505331953743e-05,-9.314757481915237e-05,1.0825766808270072,1.0821716507863393,,False,True,1.0,1.07728,1.08068,1.0798800000000002,1.0792800000000002,True,,,2024-02-28 12:04:29,0.01,even,True,29.35,5712.740000000009,121,0,8,2
2024-02-23 05:30:00,1.08233,1.08238,1.0823,1.08231,128,12,0,1.082181670136663,1.082379997026824,3.5418438148362676e-05,4.157469263525463e-05,1.0778606021894106e-05,3.0797827485348113e-06,1.0822535974099783,1.0823592564014446,2024-02-23 05:00:00,2024-02-23 05:00:00,9.095238095135905e-05,-0.00013352128949284392,1.0824769047619043,0.00024674996873553053,2.308504967457881e-05,1.0824302380952375,1.081164335717032,1.0830819743074058,1.0811221087926175,1.082343324527833,0.00024875995745992654,0.00013862071850881326,1.0824759643525435,1.0825098966611273,18.646178250331857,16.259499767243014,-0.0001623201788195014,,-1.0,1.0825157266968122,bearish,1.082413620039352,1.0824857817967215,1.0822676264189892,-7.216175736957098e-05,-3.146717162326507e-05,0.00022399628001393046,-3.5789473684433304e-05,-3.832473340170672e-05,-3.242518059787258e-05,1.0824916226990031,1.0820436301389753,,False,True,1.0,1.0773100000000002,1.0807100000000003,1.0799100000000004,1.0793100000000004,True,,,2024-02-28 12:05:01,0.01,even,True,29.35,5742.090000000009,122,0,8,2
2024-02-23 05:35:00,1.08232,1.08234,1.08222,1.08229,121,12,0,1.08222,1.0824516667987165,4.645046553195857e-05,1.6936595503860052e-05,-1.5403989060497189e-06,-1.5148235905460686e-05,1.08227870352688,1.0823832027502194,2024-02-23 05:00:00,2024-02-23 05:00:00,9.095238095135905e-05,-0.00013352128949284392,1.0824769047619043,0.00024674996873553053,2.308504967457881e-05,1.0824302380952375,1.081164335717032,1.0830819743074058,1.0811221087926175,1.082343324527833,0.00024875995745992654,0.00013862071850881326,1.0824759643525435,1.0825098966611273,17.320667602789594,17.5053049045616,-0.0001623201788195014,,-1.0,1.0825157266968122,bearish,1.0823946015717594,1.0824712794414089,1.0822354970760235,-7.667786964948853e-05,-4.050931122850976e-05,0.0002316189402009738,-3.2129342965703245e-05,-3.5789473684433304e-05,-3.832473340170672e-05,1.0824671160162245,1.0820038781358225,,False,True,1.0,1.07729,1.0806900000000002,1.0798900000000002,1.0792900000000003,True,,,2024-02-28 12:05:01,0.01,even,True,29.35,5771.44000000001,123,0,8,2
2024-02-23 05:45:00,1.08239,1.08243,1.08235,1.08236,89,12,0,1.0823333332416312,1.08243,1.6938468107517595e-05,3.619404826958439e-05,4.157469263525463e-05,3.5418438148362676e-05,1.0821847036598513,1.08238355847517,2024-02-23 05:00:00,2024-02-23 05:00:00,9.095238095135905e-05,-0.00013352128949284392,1.0824769047619043,0.00024674996873553053,2.308504967457881e-05,1.0824302380952375,1.081164335717032,1.0830819743074058,1.0811221087926175,1.082343324527833,0.00024875995745992654,0.00013862071850881326,1.0824759643525435,1.0825098966611273,24.858757062139663,21.157090173465033,-0.0001623201788195014,,-1.0,1.0825157266968122,bearish,1.0823886792318513,1.0824574617981901,1.0822593257653934,-6.878256633879865e-05,-5.110088915842888e-05,0.00022262674320977445,1.0006879944679525e-05,1.382180942521849e-05,-3.2129342965703245e-05,1.0824819525086031,1.0820366990221837,,False,True,1.0,1.07736,1.08156,1.0807600000000002,1.0803600000000002,True,2024-02-28 11:20:00,,2024-02-23 17:50:16,0.01,even,True,14.68,5786.12000000001,124,0,8,2
2024-02-23 17:20:00,1.0819,1.08212,1.08185,1.08203,500,12,0,1.0816716669476831,1.082158360703916,2.6193420900717066e-05,-2.6965682558832517e-05,-0.00012781959585871222,4.6224433460082785e-05,1.0814939488453612,1.082517450741253,2024-02-23 17:00:00,2024-02-23 17:00:00,-7.261904761879379e-05,8.747489177585166e-05,1.0826586904761903,-0.0002474841609765821,-0.00011958257914412767,1.0828389285714288,1.0821596531008755,1.0839985998300101,1.0816642789299584,1.0833250190623342,0.00027145266490652376,0.00016654452860918333,1.0822369651870374,1.0825316827571794,18.75000000000111,17.027417027416828,8.088715602088443e-06,1.081428170210001,1.0,1.0824360934244313,bullish,1.0823942864096885,1.0826555942563472,1.08214661506708,-0.000261307846658676,-0.0001468259948011154,0.0004332147275104535,-0.00011501547987480265,-0.00014793945648583495,-0.00020053663570607227,1.0825798297945903,1.0817134003395696,,True,False,0.0,1.08703,1.08283,1.0836299999999999,1.0840299999999998,True,2024-02-26 12:10:00,,2024-02-26 10:00:53,0.01,even,True,14.68,5800.80000000001,125,0,8,2
2024-02-23 17:50:00,1.08135,1.08197,1.08132,1.08197,307,12,0,1.08132,1.0820783694491254,8.96270449527875e-05,4.6958603641684666e-05,-9.740861670643263e-05,-0.000266610736040576,1.0816639047225374,1.0822671122646326,2024-02-23 17:00:00,2024-02-23 17:00:00,-7.261904761879379e-05,8.747489177585166e-05,1.0826586904761903,-0.0002474841609765821,-0.00011958257914412767,1.0828389285714288,1.0821596531008755,1.0839985998300101,1.0816642789299584,1.0833250190623342,0.00027145266490652376,0.00016654452860918333,1.0822369651870374,1.0825316827571794,22.28392130947879,15.843157297944146,8.088715602088443e-06,1.081428170210001,1.0,1.0824360934244313,bullish,1.081992728058275,1.0823276470467493,1.0815454454764364,-0.00033491898847426427,-0.0002773519550380877,0.0005833058089807591,4.0350877199557544e-06,-0.0001646990024080086,-0.00014089095287195263,1.0821287512854172,1.0809621396674556,,True,False,0.0,1.08697,1.08277,1.08357,1.0839699999999999,True,2024-02-26 12:10:00,,2024-02-26 10:01:37,0.01,even,True,14.68,5815.4800000000105,126,0,8,2
2024-02-23 17:55:00,1.08195,1.08214,1.0818699999999999,1.082,515,12,0,1.0818699999999999,1.0822483631148305,-0.00013227508527020903,-7.316929635961926e-05,-1.2566053886539529e-05,0.00018647738301400305,1.080924301922606,1.0821689282782976,2024-02-23 17:00:00,2024-02-23 17:00:00,-7.261904761879379e-05,8.747489177585166e-05,1.0826586904761903,-0.0002474841609765821,-0.00011958257914412767,1.0828389285714288,1.0821596531008755,1.0839985998300101,1.0816642789299584,1.0833250190623342,0.00027145266490652376,0.00016654452860918333,1.0822369651870374,1.0825316827571794,37.622798933466676,23.92133848261098,8.088715602088443e-06,1.081428170210001,1.0,1.0824360934244313,bullish,1.0819938468185404,1.0823033768951382,1.0815741348469217,-0.0003095300765978415,-0.00028378757935003846,0.0005830400216020283,2.8689370485279753e-05,4.0350877199557544e-06,-0.0001646990024080086,1.0821571748685237,1.0809910948253196,,True,False,0.0,1.087,1.0828,1.0836,1.0839999999999999,True,2024-02-26 12:10:00,,2024-02-26 10:00:53,0.01,even,True,14.68,5830.160000000011,127,0,8,2
2024-02-26 17:20:00,1.08393,1.08454,1.08392,1.08453,362,12,0,1.08392,1.0845775362175558,0.00024003341838912118,0.00014824712495144668,5.507217498863811e-05,8.226213221631075e-05,1.0836597700252308,1.0843548458907373,2024-02-26 17:00:00,2024-02-26 17:00:00,-0.0001133333333320774,0.000756482118607904,1.0852050000000006,-0.00015008475921048415,-3.645018797738997e-05,1.0851741666666674,1.084427554568799,1.0859255102141818,1.0837913773290535,1.085418258644592,0.00023125059140544622,0.00012933834151580687,1.0849687728097719,1.0834578998163371,23.421052631576472,13.420230803831657,0.00048478332893954576,1.08260477241152,1.0,1.0841364034571386,bullish,1.084466082704643,1.0847147266965043,1.08414302373581,-0.0002486439918611971,-0.0001728922353052631,0.0005189518283904985,2.2786377708694516e-05,-0.00012094943240437139,-0.00011149638802843143,1.0846619755642006,1.0836240719074195,,True,False,0.0,1.0895299999999999,1.08533,1.0861299999999998,1.0865299999999998,True,2024-03-04 18:15:00,,2024-02-27 10:01:08,0.01,even,True,14.68,5844.840000000011,128,0,9,2
2024-02-26 17:30:00,1.08452,1.08491,1.08448,1.08481,232,12,0,1.08448,1.0851300070887926,5.250672366394154e-05,-6.451701333835634e-05,0.0001890065587359819,0.00024289711415596772,1.0836781782944191,1.0843517179606728,2024-02-26 17:00:00,2024-02-26 17:00:00,-0.0001133333333320774,0.000756482118607904,1.0852050000000006,-0.00015008475921048415,-3.645018797738997e-05,1.0851741666666674,1.084427554568799,1.0859255102141818,1.0837913773290535,1.085418258644592,0.00023125059140544622,0.00012933834151580687,1.0849687728097719,1.0834578998163371,51.666666666665954,36.14035087719191,0.00048478332893954576,1.08260477241152,1.0,1.0841364034571386,bullish,1.0845247101021407,1.0847077423666873,1.0843195734434115,-0.00018303226454663424,-0.0001835330906089322,0.0005204206633634044,0.00012388028895604641,5.26694186453458e-05,2.2786377708694516e-05,1.0848399941067748,1.0837991527800481,,True,False,0.0,1.08981,1.08561,1.0864099999999999,1.0868099999999998,True,2024-03-05 17:15:00,,2024-02-27 09:37:52,0.01,even,True,14.68,5859.520000000011,129,0,9,2
2024-02-26 19:55:00,1.08441,1.08456,1.08433,1.08446,177,12,0,1.084296669238798,1.084558741510105,-0.00011375913425725067,-4.5718043323704824e-05,-3.047341439435468e-05,-9.375267585710401e-05,1.0844950871098453,1.084656475243991,2024-02-26 19:00:00,2024-02-26 19:00:00,1.749999999933749e-05,0.000752591048731821,1.0849324999999994,-5.809134474227726e-05,-0.00011334837585898796,1.0852225,1.0839108195334872,1.0859122583336824,1.084712112371762,1.0858958711174735,-4.643484516055302e-05,-0.0002914415597282707,1.0847098636455301,1.083675854404548,8.314403867432466,6.763102615890847,0.0005800362793364762,1.0832308656533312,1.0,1.0843232884390395,bullish,1.0847168989770712,1.0848131041423257,1.0846018507051935,-9.620516525443712e-05,-1.7404984227472436e-05,0.0002607725704976022,-9.255589955414756e-05,-0.00012242174062659927,-9.545923632536812e-05,1.084862623275691,1.084341078134696,,True,False,0.0,1.0894599999999999,1.08526,1.0860599999999998,1.0864599999999998,True,2024-03-04 18:10:00,,2024-02-27 10:03:06,0.01,even,True,14.68,5874.200000000012,130,0,9,2
2024-02-27 03:25:00,1.0845,1.08466,1.08449,1.08462,141,12,0,1.0845008276403587,1.084836666182212,4.891979666318173e-05,2.1508829462299543e-05,-3.0986761360188075e-05,-1.0757570269225114e-05,1.0844923851085626,1.0847472696386757,2024-02-27 03:00:00,2024-02-27 03:00:00,2.321428571416817e-05,0.000336411947187365,1.0849329761904767,-8.963228700520172e-06,-2.7257527153626818e-05,1.0849086904761907,1.084518928269985,1.0851258938799555,1.084539220904065,1.0851764789313907,-3.046209238362446e-05,-8.837614277118521e-06,1.0848836869171843,1.0842353390882407,19.068736141893492,16.736852357939558,0.0004540960841359193,1.08451,1.0,1.0848271639646787,bullish,1.0846558561911572,1.0847335235016258,1.08458130374957,-7.766731046854325e-05,-5.705044213658913e-05,0.00015319051380845516,4.4719642211532573e-07,-3.257653938670835e-05,-2.486756105990473e-05,1.0847344942633783,1.0844281132357616,,True,False,0.0,1.0896199999999998,1.0854199999999998,1.0862199999999997,1.0866199999999997,True,2024-03-05 17:15:00,,2024-02-27 10:01:05,0.01,even,True,14.68,5888.880000000012,131,0,9,2
2024-02-27 03:30:00,1.08462,1.08486,1.08457,1.08481,164,12,0,1.08457,1.0848491554702233,4.0211312659903215e-05,1.8694710774503288e-05,9.244753606547561e-05,6.376538027360484e-05,1.0843681745240978,1.084567325891534,2024-02-27 03:00:00,2024-02-27 03:00:00,2.321428571416817e-05,0.000336411947187365,1.0849329761904767,-8.963228700520172e-06,-2.7257527153626818e-05,1.0849086904761907,1.084518928269985,1.0851258938799555,1.084539220904065,1.0851764789313907,-3.046209238362446e-05,-8.837614277118521e-06,1.0848836869171843,1.0842353390882407,40.650406504058424,23.552599162345302,0.0004540960841359193,1.08451,1.0,1.0848271639646787,bullish,1.0846795706232868,1.0847391884274313,1.0846181492948053,-5.961780414454054e-05,-5.7563914538179416e-05,0.00015319051380845516,3.684554523530892e-05,4.4719642211532573e-07,-3.257653938670835e-05,1.0847713398086136,1.084464958780997,,True,False,0.0,1.08981,1.08561,1.0864099999999999,1.0868099999999998,True,2024-03-05 17:15:00,,2024-02-27 09:37:52,0.01,even,True,14.68,5903.560000000012,132,0,9,2
2024-02-27 03:40:00,1.08471,1.08487,1.08466,1.08487,157,12,0,1.0846333392222973,1.084859157952853,2.1509468856443707e-05,4.634443720173211e-05,2.1508829462299543e-05,4.891979666318173e-05,1.0845051494006734,1.0848385669400626,2024-02-27 03:00:00,2024-02-27 03:00:00,2.321428571416817e-05,0.000336411947187365,1.0849329761904767,-8.963228700520172e-06,-2.7257527153626818e-05,1.0849086904761907,1.084518928269985,1.0851258938799555,1.084539220904065,1.0851764789313907,-3.046209238362446e-05,-8.837614277118521e-06,1.0848836869171843,1.0842353390882407,80.48780487804834,60.16260162601009,0.0004540960841359193,1.08451,1.0,1.0848271639646787,bullish,1.0847128286711107,1.0847468762237922,1.0846638286893702,-3.4047552681437665e-05,-5.2094296774703885e-05,0.00014133294091282582,4.048503611930876e-05,5.194358445592684e-06,3.684554523530892e-05,1.084805161630283,1.0845224957484574,,True,False,0.0,1.08987,1.08567,1.0864699999999998,1.0868699999999998,True,2024-03-05 17:15:00,,2024-02-27 09:37:44,0.01,even,True,14.68,5918.2400000000125,133,0,9,2
2024-02-27 12:15:00,1.08434,1.08469,1.08427,1.08463,195,12,0,1.0842466651145168,1.0846791790050123,1.9983469122749228e-05,7.092617597597409e-05,-0.0001661659359569364,-0.0001521695882914611,1.0844165785717204,1.0852053505617887,2024-02-27 12:00:00,2024-02-27 12:00:00,-3.8452380951792264e-05,0.00026725578718211906,1.0853003571428574,-0.0001269712833513918,-2.3022966729150366e-05,1.085380833333333,1.0846394903282923,1.0865679878655605,1.0844898211746288,1.085554786800269,0.00030455255730528946,0.00015080372065734294,1.0851815192646912,1.0847728044504914,14.904319300162735,9.320404224720553,0.00030730252304939895,1.084585216,1.0,1.0849810777215603,bullish,1.084983792419224,1.0852517303831806,1.0846872205022364,-0.0002679379639565216,-0.000138822927604478,0.000533643139380371,-5.7337461299988846e-05,-0.00013610595115243207,-0.00017931200550336257,1.0852208636416167,1.0841535773628561,,True,False,0.0,1.0896299999999999,1.08543,1.0862299999999998,1.0866299999999998,True,2024-03-05 17:15:00,,2024-02-27 15:06:05,0.01,even,True,14.68,5932.920000000013,134,0,9,2
2024-02-27 12:25:00,1.08447,1.08458,1.08429,1.0845,354,12,0,1.08429,1.084809994537274,0.00016928506832199482,9.21828282439202e-05,3.765422261128525e-05,6.174115842057389e-05,1.084105429602904,1.0846416275046156,2024-02-27 12:00:00,2024-02-27 12:00:00,-3.8452380951792264e-05,0.00026725578718211906,1.0853003571428574,-0.0001269712833513918,-2.3022966729150366e-05,1.085380833333333,1.0846394903282923,1.0865679878655605,1.0844898211746288,1.085554786800269,0.00030455255730528946,0.00015080372065734294,1.0851815192646912,1.0847728044504914,25.48504357727666,20.74972368327288,0.00030730252304939895,1.084585216,1.0,1.0849810777215603,bullish,1.0848424785960125,1.0851424300267325,1.084494616443069,-0.0002999514307200357,-0.0001950892793660598,0.0005945777214728164,-8.83109735110299e-05,-0.00010429308565629292,-5.7337461299988846e-05,1.085089194164542,1.0839000387215962,,True,False,0.0,1.0895,1.0853,1.0860999999999998,1.0864999999999998,True,2024-03-04 18:10:00,,2024-02-27 15:11:10,0.01,even,True,14.68,5947.600000000013,135,0,9,2
2024-02-27 12:30:00,1.0845,1.08491,1.0845,1.08485,306,12,0,1.0845,1.084899168296624,0.00010474107864579558,6.477137120576332e-05,7.092617597597409e-05,1.9983469122749228e-05,1.0842484297146804,1.084685444510089,2024-02-27 12:00:00,2024-02-27 12:00:00,-3.8452380951792264e-05,0.00026725578718211906,1.0853003571428574,-0.0001269712833513918,-2.3022966729150366e-05,1.085380833333333,1.0846394903282923,1.0865679878655605,1.0844898211746288,1.085554786800269,0.00030455255730528946,0.00015080372065734294,1.0851815192646912,1.0847728044504914,31.737642202759123,26.360831317471675,0.00030730252304939895,1.084585216,1.0,1.0849810777215603,bullish,1.0848436357350875,1.0851207685432709,1.0844992191262468,-0.00027713280818342234,-0.0002114979851295323,0.000590703535515542,4.6026831777012944e-06,-8.83109735110299e-05,-0.00010429308565629292,1.0850899226617623,1.0839085155907313,,True,False,0.0,1.08985,1.08565,1.08645,1.0868499999999999,True,2024-03-05 17:15:00,,2024-02-27 14:55:10,0.01,even,True,14.68,5962.280000000013,136,0,9,2
2024-02-27 12:40:00,1.08484,1.08504,1.08483,1.08494,170,12,0,1.0847600081657405,1.0850307110264608,6.452079334843237e-05,7.043264549066868e-05,9.21828282439202e-05,0.00016928506832199482,1.0843049642941616,1.0848181471060738,2024-02-27 12:00:00,2024-02-27 12:00:00,-3.8452380951792264e-05,0.00026725578718211906,1.0853003571428574,-0.0001269712833513918,-2.3022966729150366e-05,1.085380833333333,1.0846394903282923,1.0865679878655605,1.0844898211746288,1.085554786800269,0.00030455255730528946,0.00015080372065734294,1.0851815192646912,1.0847728044504914,50.432900432903295,40.91831940669309,0.00030730252304939895,1.084585216,1.0,1.0849810777215603,bullish,1.0848579877156543,1.0850881211790733,1.0845523942208468,-0.0002301334634189356,-0.0002224885203140886,0.0005599336271988069,3.970760234039972e-05,1.3467492259611191e-05,4.6026831777012944e-06,1.0851123278480457,1.083992460593648,,True,False,0.0,1.08994,1.08574,1.0865399999999998,1.0869399999999998,True,2024-03-05 17:20:00,,2024-02-27 14:30:09,0.01,even,True,14.68,5976.960000000014,137,0,9,2
