time,open,high,low,close,tick_volume,spread,real_volume,hourly_time,time2,prev_hour_lsma_slope,prev_hour_macd_line,hour_lsma,fixed_support_gradient,fixed_resistance_gradient,prev_hour_lsma,fixed_support_trendline,fixed_resistance_trendline,prev_fixed_support_trendline,prev_fixed_resistance_trendline,prev_fixed_resistance_gradient,prev_fixed_support_gradient,ema_50,ema_24,stoch_k,stoch_d,prev_hour_macd_signal,ema_short,ema_long,lsma,macd_line,macd_signal,lsma_stddev,lsma_slope,prev_lsma_slope_1,prev_lsma_slope_2,lsma_upper_band,lsma_lower_band,is_buy2,is_sell2,tp,sl,be,be_condition,time_updated,sl_updated,time_to_trail,time_tp_hit,time_sl_hit,lot_size,type,success,profit,account_balance,position_close_time,win_streak,losing_streak,Week,Month
2023-08-03 17:45:00,29261.639,29393.738,29231.41,29353.838,1457,52423,0,2023-08-03 17:00:00,2023-08-03 17:00:00,26.14523809525417,-21.221964681757527,29204.70695238096,0.0009613734780445666,0.001577819720247227,29122.086571428576,29188.99518993936,29546.586870769912,29161.41843632346,29246.072651985625,0.0004144254027887154,0.0009653035059943994,29166.387655952538,29166.572705867366,82.78182263736302,76.6959280314684,-36.78635037774177,29180.43230553546,29141.293982468862,29198.57006123151,39.138323066599696,16.49299219616165,61.94590911756178,42.90040935672732,27.079242518051615,9.673402132793854,29283.697038540216,29114.9430839228,True,False,30353.838,28903.838,29823.838,29853.838,,False,,,2023-08-04 21:46:10,0.02,fail,False,-0.0,700.0,,0,1,31,August
2023-08-04 13:45:00,29146.639,29147.738,29109.037,29126.537,404,52423,0,2023-08-04 13:00:00,2023-08-04 13:00:00,2.4918095238354,-5.757769082156301,29153.21971428574,-1.5450397018464392e-05,9.912232145624769e-05,29168.740226190486,29089.217657733145,29239.03498518994,29169.011043838822,29242.60719764222,0.00012814001507122552,0.0003647408199210936,29172.768856342107,29170.656053183127,16.970814671927183,20.476037697281622,-3.555823953364393,29152.159088993212,29157.603062429367,29149.696739594063,-5.44397343615492,-2.0171419344893806,19.385632691639955,-3.2462139662893605,-1.0070175438850129,-2.34269384244908,29175.867343727776,29122.02613546035,False,True,28126.537,29576.537,28656.537,28626.537,,False,,,2023-08-08 16:02:47,0.02,fail,False,-0.0,700.0,,0,2,31,August
2023-08-04 14:00:00,29130.338,29130.338,29108.947,29117.738,322,52423,0,2023-08-04 14:00:00,2023-08-04 14:00:00,-15.520511904745945,-9.431777428551868,29139.185690476206,2.418286524484472e-05,-7.015799468192924e-05,29153.21971428574,29100.331114370227,29210.866030268877,29089.217657733145,29239.03498518994,9.912232145624769e-05,-1.5450397018464392e-05,29171.108587465947,29167.43812892848,15.646449858470739,17.464798934286048,-4.731014648401889,29146.863536840407,29154.650094842007,29143.401789129664,-7.786558001600497,-3.171025147911604,21.422796382712995,-6.2949504643984255,-3.2462139662893605,-1.0070175438850129,29172.322564246326,29112.981014013003,False,True,28117.738,29567.738,28647.738,28617.738,,False,,,2023-08-08 16:02:44,0.02,fail,False,-163.84,536.16,,0,3,31,August
2023-08-07 18:45:00,28845.139,28847.738,28744.838,28827.34,1561,52423,0,2023-08-07 18:00:00,2023-08-07 18:00:00,-21.72583333334478,-25.655124603028526,28951.89861904759,-0.0011523681819378883,-0.00012675597705449703,29021.002833333343,28636.754641222517,29097.806433618967,28897.60029399863,29124.340527179676,2.214963233677751e-05,-0.0002982451572299482,29099.56540485789,29057.001882219043,16.512226699473384,20.173196232491193,-19.16743262194614,28947.89726190178,28993.08645957374,28912.988697282446,-45.189197671959846,-26.089924018650137,70.18859129891692,-27.835623323004256,-25.55594943235701,-16.737713794329466,29007.743295535984,28816.73409902891,False,True,27827.34,29277.34,28357.34,28327.34,,False,,,2023-08-08 08:47:15,0.02,fail,False,-163.84,372.31999999999994,,0,4,32,August
2023-08-07 19:00:00,28826.963,28857.738,28702.496,28757.438,2184,52423,0,2023-08-07 19:00:00,2023-08-07 19:00:00,-69.10421428575137,-46.03677964326562,28917.173047619035,-0.0017257398295989082,-0.000879472162885886,28951.89861904759,28495.49265322784,28935.295411892384,28636.754641222517,29097.806433618967,-0.00012675597705449703,-0.0011523681819378883,29091.897624275232,29044.76469164152,17.639384039031643,17.822249702247607,-24.541302026210037,28918.595836993816,28975.631018123833,28875.08901754384,-57.03518113001701,-32.27897544092352,86.46184176575233,-37.89967973860621,-27.835623323004256,-25.55594943235701,28991.812503927606,28756.865531160074,False,True,27757.438,29207.438,28287.438,28257.438,,False,,,2023-08-08 00:23:48,0.02,fail,False,-163.84,208.47999999999993,,0,5,32,August
2023-08-08 08:15:00,29214.738,29241.139,29203.838,29235.537,466,52423,0,2023-08-08 08:00:00,2023-08-08 08:00:00,9.129488095240959,32.933311664906796,29178.191916666692,5.306732509732955e-05,0.0004565142978111487,29165.150607142878,29115.942961556677,29338.96404368011,29126.489814658595,29213.08158612589,-8.371894280778317e-05,0.00012981984597553077,29111.423572403568,29112.67517079354,95.23976177695539,88.99455167288016,21.07698055362048,29182.225905100535,29160.07602773273,29197.079411764724,22.14987736780313,17.000918288804606,30.28295292143377,20.22551152395681,10.132831097289454,7.014431028608669,29239.46139820866,29156.197425320788,True,False,30235.537,29705.537,29705.537,29735.537,2023-08-08 20:15:00,True,2023-08-08 20:15:00,,2023-08-08 20:24:39,0.02,even,True,171.09,379.56999999999994,,1,0,32,August
2023-08-08 08:30:00,29232.738,29263.738,29199.537,29246.838,655,52423,0,2023-08-08 08:00:00,2023-08-08 08:00:00,9.129488095240959,32.933311664906796,29178.191916666692,5.306732509732955e-05,0.0004565142978111487,29165.150607142878,29115.942961556677,29338.96404368011,29126.489814658595,29213.08158612589,-8.371894280778317e-05,0.00012981984597553077,29111.423572403568,29112.67517079354,94.83757546019375,94.47742568509018,21.07698055362048,29192.16622739276,29166.502840493267,29211.940515995877,25.66338689949407,18.7334120109425,34.18898064642854,14.86110423115315,20.22551152395681,10.132831097289454,29259.595639868556,29165.785392123198,True,False,30246.838,29716.838,29716.838,29746.838,2023-08-08 20:45:00,True,2023-08-08 20:45:00,,2023-08-08 20:47:29,0.02,even,True,171.09,550.66,,2,0,32,August
2023-08-08 14:45:00,29322.037,29409.139,29303.338,29403.537,955,52423,0,2023-08-08 14:00:00,2023-08-08 14:00:00,27.55235714284572,30.97203776002425,29264.177428571427,0.00012992263967707193,0.0006462586757240755,29194.219511904776,29153.86402110679,29471.424385790386,29150.051657537075,29279.151531954787,-6.547564552955015e-05,0.0001298690146751317,29135.299168928337,29158.427335391512,86.72690093518513,76.27693765130148,26.453481532535026,29258.87240886094,29218.31761852349,29294.376600963184,40.55479033744996,18.2214214374208,65.04339707284683,37.59580529754021,26.217320605432178,25.797448916415306,29383.685187011528,29206.56801491484,True,False,30403.537,29873.537,29873.537,29903.537,2023-08-08 23:30:00,True,2023-08-08 23:30:00,,2023-08-09 00:30:17,0.02,even,True,171.09,721.75,,3,0,32,August
2023-08-08 15:45:00,29487.537,29558.738,29473.838,29534.223,1659,52423,0,2023-08-08 15:00:00,2023-08-08 15:00:00,69.95791666665173,52.08539306809689,29367.85210714284,0.0009924847705947751,0.0012788494244958684,29264.177428571427,29316.668985367447,29683.214068364236,29153.86402110679,29471.424385790386,0.0006462586757240755,0.00012992263967707193,29150.943240735072,29188.490988560196,95.14162207484223,91.69244428412223,31.579863839647402,29362.868916569205,29284.06122448915,29444.90816993461,78.80769208005586,46.084725554316606,119.4436340123522,45.37643446848233,41.221931544594554,36.86833677326649,29607.657075851286,29283.659264017933,True,False,30534.223,30004.223,30004.223,30034.223,2023-08-09 16:00:00,True,2023-08-09 16:00:00,,2023-08-09 16:02:05,0.02,even,True,171.09,892.84,,4,0,32,August
2023-08-08 23:15:00,29863.838,29932.537,29861.885,29930.338,975,72423,0,2023-08-08 23:00:00,2023-08-08 23:00:00,77.40795238093051,168.52549390261993,29883.967559523793,0.0026740893515579773,0.0018726075945760018,29785.462523809496,30055.50395255058,30217.05320528989,29949.659665694944,30160.36030602199,0.0018726177131659397,0.0025582365199507667,29295.1070558539,29436.112994243696,85.75973136553121,82.31642649911532,112.46035050861255,29821.25978605949,29703.620099958793,29910.657192638446,117.63968610069787,117.93555247700512,172.25232731877566,8.89667526660196,5.209024767780647,2.1117079463147093,30144.697834518793,29678.1165507581,True,False,30930.338,29480.338,30400.338,30430.338,,False,,,2023-08-09 19:59:41,0.02,fail,False,-163.84,729.0,,0,1,32,August
2023-08-08 23:30:00,29930.338,29957.738,29887.564,29930.537,1082,72423,0,2023-08-08 23:00:00,2023-08-08 23:00:00,77.40795238093051,168.52549390261993,29883.967559523793,0.0026740893515579773,0.0018726075945760018,29785.462523809496,30055.50395255058,30217.05320528989,29949.659665694944,30160.36030602199,0.0018726177131659397,0.0025582365199507667,29295.1070558539,29436.112994243696,89.31981939369162,84.86463905214968,112.46035050861255,29838.07166512726,29720.428759221104,29919.090958376364,117.64290590615565,117.87702316283523,169.41679348534242,8.433765737918293,8.89667526660196,5.209024767780647,30149.303629581576,29690.378287171152,True,False,30930.537,29480.537,30400.537,30430.537,,False,,,2023-08-09 19:59:41,0.02,fail,False,-163.84,565.16,,0,2,32,August
2023-08-08 23:45:00,29930.537,29951.639,29910.838,29935.639,418,72423,0,2023-08-08 23:00:00,2023-08-08 23:00:00,77.40795238093051,168.52549390261993,29883.967559523793,0.0026740893515579773,0.0018726075945760018,29785.462523809496,30055.50395255058,30217.05320528989,29949.659665694944,30160.36030602199,0.0018726177131659397,0.0025582365199507667,29295.1070558539,29436.112994243696,93.96183886151793,89.68046320691359,112.46035050861255,29853.08202433845,29736.37025853806,29924.264631922935,116.71176580039173,117.64397169034653,166.53447841959235,5.173673546571081,8.433765737918293,8.89667526660196,30150.586177789384,29699.443086056486,True,False,30935.639,29485.639,30405.639,30435.639,,False,,,2023-08-09 19:59:38,0.02,fail,False,-163.84,401.31999999999994,,0,3,32,August
2023-08-09 00:00:00,29955.537,29978.738,29931.938,29976.338,353,68423,0,2023-08-09 00:00:00,2023-08-09 00:00:00,98.50503571429726,183.01692960379296,29886.792119047615,0.0021784305213751977,0.0026553823144284026,29883.967559523793,29985.901081609754,30470.490885596893,30055.50395255058,30217.05320528989,0.0018726075945760018,0.0026740893515579773,29315.37493601649,29466.1789947042,93.93792038338317,92.40652621286422,126.57166632764864,29872.044482132536,29754.145646794503,29940.475220158216,117.89883533803368,117.69494441988397,158.44041813861622,16.21058823528074,5.173673546571081,8.433765737918293,30155.869784645347,29726.580655671085,True,False,30976.338,29526.338,30446.338,30476.338,,False,,,2023-08-09 19:49:47,0.02,fail,False,-163.84,237.47999999999993,,0,4,32,August
2023-08-09 22:45:00,29444.943,29445.037,29389.752,29408.338,478,52423,0,2023-08-09 22:00:00,2023-08-09 22:00:00,-77.31321428568481,-47.15985517300578,29431.794261904775,-0.002710755418220153,-0.0032941732905479196,29507.871761904775,28975.625910068095,29196.52990346279,29164.488539861235,29223.817390251043,-0.0035777957066070436,-0.0019385937901826421,29535.334554583766,29637.15720480006,13.826040964891234,16.735258193714998,15.748328785120497,29493.593877704254,29578.28998999419,29406.281273133805,-84.69611228993745,-80.00987298523356,150.08218411607652,-12.077132782927947,-10.69268145857859,-4.152124183005071,29608.89222169051,29202.170324577102,False,True,28408.338,29858.338,28938.338,28908.338,,False,,,,0.02,running,False,0.0,237.47999999999993,2023-08-10 01:45:00,0,5,32,August
2023-08-09 23:00:00,29321.744,29403.338,29321.744,29390.738,605,72423,0,2023-08-09 23:00:00,2023-08-09 23:00:00,-76.07749999999942,-66.02555953470073,29422.556047619066,-0.002250840888304938,-0.003048978944365903,29431.794261904775,28994.420017649925,29173.893311369586,28975.625910068095,29196.52990346279,-0.0032941732905479196,-0.002710755418220153,29531.96606224715,29622.139668416057,13.398487565039394,14.620054185816755,-0.6064488788437483,29477.769896518985,29564.39724999462,29399.451852769187,-86.62735347563648,-81.33336908331414,147.2261940112957,-6.829420364618272,-12.077132782927947,-10.69268145857859,29598.207214684437,29199.196490853938,False,True,28390.738,29840.738,28920.738,28890.738,,False,,,,0.02,running,False,0.0,237.47999999999993,2023-08-10 02:00:00,0,6,32,August
2023-08-14 17:30:00,29415.738,29559.738,29405.518,29527.576,1187,52423,0,2023-08-14 17:00:00,2023-08-14 17:00:00,-4.547321428563009,3.1186004047558527,29397.606190476195,-0.0003545989386179849,0.000566441628687183,29353.306035714268,29249.188028663593,29614.911216426954,29265.024605009792,29311.98944919086,-0.0006067172000200487,-0.00029834436610161124,29389.582588055444,29369.285290678636,88.20905342536248,72.4587376611738,2.5671369376621205,29384.708954648406,29371.285240324833,29380.139748194004,13.423714323573222,-1.707035755780196,43.98122872231633,33.33993704848399,13.504965944284777,8.107148262821283,29441.01440696913,29320.765089418877,True,False,30527.576,29077.576,29997.576,30027.576,,False,,,2023-08-15 22:09:06,0.02,fail,False,-163.84,73.63999999999993,,0,7,33,August
2023-08-17 19:00:00,27900.537,27943.338,27673.838,27777.746,4031,52423,0,2023-08-17 19:00:00,2023-08-17 19:00:00,-179.4905595238124,-168.88292025279588,28075.158380952365,-0.00408513498975935,-0.0008165768683456359,28220.932809523816,27310.363673107935,28374.609811181963,27522.631293263337,28397.813231554093,-0.0008163764065754922,-0.003474410683982172,28799.077745066323,28549.986818929174,12.411983364754256,26.84039287066658,-124.9016633011343,28197.432004916365,28336.99161212733,28101.621592019284,-139.55960721096562,-80.08094128018041,198.56547568487622,-97.5262734777898,-89.32615307876404,-74.49917991056282,28369.684984193867,27832.0581998447,False,True,26777.746,28227.746,27307.746,27277.746,,False,2023-08-18 00:45:00,2023-08-18 00:42:54,,0.02,success,True,364.02,437.6599999999999,,1,0,33,August
2023-08-17 23:15:00,27828.84,27836.838,27763.838,27771.639,754,72423,0,2023-08-17 23:00:00,2023-08-17 23:00:00,-39.80628571428679,-221.36330001811803,27717.130809523806,-0.0026249579303134676,-0.0043733875266494205,27853.001166666658,27154.120203622166,27467.239776200644,26937.4326223972,27626.719569443274,-0.004169277927457719,-0.004324689619874266,28650.59916085806,28333.934155233175,16.820055620277312,32.633980116665924,-178.5963105143015,27892.369568181926,28010.295761387784,27869.86370691432,-117.926193205858,-125.76494062525894,200.58389846863906,-25.200392156883026,-6.671079807369097,32.235983832106285,28140.651969846982,27597.575443981656,False,True,26771.639,28221.639,27301.639,27271.639,,False,2023-08-18 00:45:00,2023-08-18 00:42:55,,0.02,success,True,364.02,801.6799999999998,,2,0,33,August
2023-08-17 23:30:00,27771.639,27808.738,27668.84,27684.438,1506,72423,0,2023-08-17 23:00:00,2023-08-17 23:00:00,-39.80628571428679,-221.36330001811803,27717.130809523806,-0.0026249579303134676,-0.0043733875266494205,27853.001166666658,27154.120203622166,27467.239776200644,26937.4326223972,27626.719569443274,-0.004169277927457719,-0.004324689619874266,28650.59916085806,28333.934155233175,7.0437044444715164,18.577865016018283,-178.5963105143015,27860.38009615394,27986.158149433133,27819.552932232546,-125.77805327919486,-125.76756315604614,195.36415139015688,-50.31077468177318,-25.200392156883026,-6.671079807369097,28083.294536609257,27554.311327855834,False,True,26684.438,28134.438,27214.438,27184.438,,False,2023-08-18 00:45:00,2023-08-18 00:42:56,,0.02,success,True,364.02,1165.6999999999998,,3,0,33,August
2023-08-17 23:45:00,27685.738,27715.037,27473.838,27514.738,1644,72423,0,2023-08-17 23:00:00,2023-08-17 23:00:00,-39.80628571428679,-221.36330001811803,27717.130809523806,-0.0026249579303134676,-0.0043733875266494205,27853.001166666658,27154.120203622166,27467.239776200644,26937.4326223972,27626.719569443274,-0.004169277927457719,-0.004324689619874266,28650.59916085806,28333.934155233175,5.250208110905288,9.70465605855137,-178.5963105143015,27807.20438905333,27951.238138364013,27746.093711042282,-144.03374931068174,-129.42080038697327,198.90232239065165,-73.45922119026363,-50.31077468177318,-25.200392156883026,28014.61184626966,27476.075575814903,False,True,26514.738,27964.738,27044.738,27014.738,,False,2023-08-18 00:45:00,2023-08-18 00:43:02,,0.02,success,True,364.02,1529.7199999999998,,4,0,33,August
2023-08-18 05:45:00,26478.258,26532.537,26424.838,26444.438,1552,52423,0,2023-08-18 05:00:00,2023-08-18 05:00:00,-93.2165833333238,-501.12182940656203,26430.411047619054,0.011841192372610644,-0.006694604844230595,26499.526047619052,27135.329681477626,26196.378857594336,24599.02202905005,26013.398455630257,-0.008597903429857183,-0.00017192329847915203,28201.617865527794,27631.06088527289,15.712495850188652,29.652139706526714,-389.5908137660272,26580.429942243547,26784.007677944654,26557.034291365675,-203.57773570110658,-241.86679142479386,543.1231386337228,-46.183520811824565,-59.77578087374059,-32.88011523910973,27290.2505285212,25822.31805421015,False,True,25444.438,25974.438,25974.438,25944.438,2023-08-18 20:00:00,True,2023-08-18 20:00:00,2023-08-23 00:26:39,2023-08-18 20:38:18,0.02,even,True,171.09,1700.8099999999997,,5,0,33,August
2023-08-18 06:00:00,26444.438,26479.139,26369.857,26376.438,1479,52423,0,2023-08-18 06:00:00,2023-08-18 06:00:00,-69.11499999999796,-504.34083898034805,26424.1662857143,0.010815476993553572,-0.006694809700571296,26430.411047619054,27200.194178895716,26022.09477845682,27135.329681477626,26196.378857594336,-0.006694604844230595,0.011841192372610644,28129.387282565924,27529.35505445106,7.5825930959926735,18.166276081994784,-412.5408188088914,26549.046566513767,26753.817331430237,26486.506670106653,-204.7707649164695,-234.447586123129,509.97041384837013,-70.52762125902154,-46.183520811824565,-59.77578087374059,27174.966728801952,25796.546611411355,False,True,25376.438,25906.438,25906.438,25876.438,2023-08-18 20:00:00,True,2023-08-18 20:00:00,2023-08-23 00:26:42,2023-08-18 20:03:13,0.02,even,True,171.09,1871.8999999999996,,6,0,33,August
2023-08-18 06:30:00,26410.838,26480.537,26365.037,26370.238,1194,52423,0,2023-08-18 06:00:00,2023-08-18 06:00:00,-69.11499999999796,-504.34083898034805,26424.1662857143,0.010815476993553572,-0.006694809700571296,26430.411047619054,27200.194178895716,26022.09477845682,27135.329681477626,26196.378857594336,-0.006694604844230595,0.011841192372610644,28129.387282565924,27529.35505445106,5.4685105858155,6.601700533471992,-412.5408188088914,26503.337624545362,26701.770348619888,26441.712727898175,-198.43272407452605,-221.85386077028352,405.24169654253836,-20.98152562779069,-23.812416580687568,-70.52762125902154,26988.789018230604,25893.136437565747,False,True,25370.238,25900.238,25900.238,25870.238,2023-08-18 20:00:00,True,2023-08-18 20:00:00,2023-08-23 00:26:45,2023-08-18 20:03:10,0.02,even,True,171.09,2042.9899999999996,,7,0,33,August
2023-08-22 16:15:00,25995.471,26003.139,25968.238,25982.537,767,52423,0,2023-08-22 16:00:00,2023-08-22 16:00:00,-10.319261904758605,-9.271267385422107,25988.81448809526,-0.0003579859962978792,-0.0001560233503597155,26011.08145238096,25894.74466460614,26044.01093771236,26010.794127827514,26047.484966838852,-0.00015998794178206775,0.00020805305366508424,26256.925841470133,26036.240524445322,16.09632872156623,40.894703217169784,-8.277014338638656,26012.597916841332,26017.221600097997,26013.57804334364,-4.623683256664663,-2.1925415013390293,25.1623689264776,-5.142653594764852,-2.062662882708537,0.0911231510253856,26047.547241394386,25978.108845292896,False,True,24982.537,26432.537,25512.537,25482.537,,False,,,2023-08-23 19:51:26,0.02,fail,False,-163.84,1879.1499999999996,,0,1,34,August
2023-08-23 03:00:00,26019.639,26133.438,25990.438,26123.639,1565,52423,0,2023-08-23 03:00:00,2023-08-23 03:00:00,80.70470238096459,-43.8301108512278,25886.578273809526,-0.0010121400702186533,0.0008435754427027035,25806.662142857138,25094.73841071787,26220.434078297876,24774.77469150663,26036.752048245336,5.839518217194342e-05,-0.003691621675731345,26115.702410030073,25930.837899172267,97.45134369612204,93.42718221752189,-49.731912509250286,25885.343747123803,25850.494639717712,25913.155549019608,34.84910740609121,-15.20532664244948,128.46728322085738,68.54824045407076,52.065296869623126,51.80957688338822,26088.086381367764,25739.72471667145,True,False,27123.639,26593.639,26593.639,26623.639,2023-08-23 22:45:00,True,2023-08-23 22:45:00,,2023-08-23 23:05:00,0.02,even,True,171.09,2050.24,,1,0,34,August
2023-08-23 16:00:00,25805.639,25823.338,25773.838,25797.037,802,52423,0,2023-08-23 16:00:00,2023-08-23 16:00:00,-56.54750000000422,-14.515384423240903,25905.577154761915,-0.001173211573171793,-0.0007689774037497226,25893.93536904764,25678.311816347756,25939.929256743846,25739.254632157954,25833.745134134315,-0.001302426297975409,-0.0007964184055718856,26055.758510557298,25951.362318603937,3.940486639797074,8.782950811210997,4.98864354738816,25880.94308385162,25924.458680841697,25833.38011386309,-43.51559699007703,-27.003763105911062,74.6292822514128,-19.861778121758107,-19.91766253871174,-15.6009714482243,25934.1296449025,25731.130582823684,False,True,24797.037,26247.037,25327.037,25297.037,,False,,,2023-08-23 19:18:57,0.02,fail,False,-163.85,1886.3899999999999,,0,1,34,August
2023-08-23 19:30:00,26302.238,26383.738,26288.238,26352.139,1925,52423,0,2023-08-23 19:00:00,2023-08-23 19:00:00,60.1663095238182,17.729275697762205,26123.52432142856,4.603930915526481e-05,0.002300486480192028,25989.51739285715,25781.17150645213,26637.654741125374,25617.978283318826,26204.382582038907,0.0005467086289851169,-0.0011732237007082078,26067.41257347895,25998.40473180507,86.40836377253459,85.8600854287724,5.2454660102845505,26116.48706303826,26036.075491749943,26218.643776057794,80.41157128831765,35.317507912285805,146.17693089526637,64.40701066391557,60.23132782938774,38.278799449624785,26417.482632766405,26021.304919349182,True,False,27352.139,25902.139,26822.139,26852.139,,False,,,2023-08-24 20:38:39,0.02,fail,False,-163.85,1722.54,,0,2,34,August
2023-08-23 19:45:00,26353.139,26443.537,26339.951,26353.037,1881,52423,0,2023-08-23 19:00:00,2023-08-23 19:00:00,60.1663095238182,17.729275697762205,26123.52432142856,4.603930915526481e-05,0.002300486480192028,25989.51739285715,25781.17150645213,26637.654741125374,25617.978283318826,26204.382582038907,0.0005467086289851169,-0.0011732237007082078,26067.41257347895,25998.40473180507,86.10443949522949,85.91867191520394,5.2454660102845505,26152.879361032377,26059.55412199069,26273.558336085323,93.32523904168556,46.91905413816576,164.4261087886451,54.91456002752966,64.40701066391557,60.23132782938774,26497.033582949993,26051.583089220654,True,False,27353.037,25903.037,26823.037,26853.037,,False,,,2023-08-24 20:38:39,0.02,fail,False,-163.85,1558.69,,0,3,34,August
2023-08-23 20:00:00,26353.738,26493.279,26329.438,26463.139,1756,52423,0,2023-08-23 20:00:00,2023-08-23 20:00:00,134.00692857140893,56.430381493286404,26286.173309523794,0.0026897768494160987,0.003039863462003949,26123.52432142856,26276.783668071897,26825.966496587436,25781.17150645213,26637.654741125374,0.002300486480192028,4.603930915526481e-05,26084.40572746017,26038.591393260664,90.54534898608593,87.68605075128333,15.482449106884921,26200.611613181245,26089.44929813953,26337.35182043344,111.16231504171446,59.76770631887551,188.83698987915713,63.79348434811618,54.91456002752966,64.40701066391557,26593.781756770302,26082.421884096577,True,False,27463.139,26013.139,26933.139,26963.139,,False,,,2023-08-24 18:29:30,0.02,fail,False,-163.85,1394.8400000000001,,0,4,34,August
2023-08-23 22:30:00,26487.338,26761.57,26459.439,26656.139,1573,52423,0,2023-08-23 22:00:00,2023-08-23 22:00:00,95.75565476190604,115.80503794947435,26535.569285714293,0.004023398577657591,0.0046955532068595675,26381.9289642857,26745.142101079582,27223.42600176397,26639.085181814276,27021.48537572223,0.004049503235967657,0.004035675667247614,26120.99636740941,26119.175038455833,80.1413088455447,76.05792109707431,48.782507981301535,26439.122635762877,26302.285317078247,26569.562871689035,136.83731868462928,125.64048133689681,235.4497563151813,35.714060887541564,3.744363605062972,4.1735345717243035,26888.92004271453,26251.70570066354,True,False,27656.139,26206.139,27126.139,27156.139,,False,,,2023-08-24 00:54:14,0.02,fail,False,-163.85,1230.9900000000002,,0,5,34,August
2023-08-24 17:30:00,26159.139,26181.238,26029.838,26037.738,3056,52423,0,2023-08-24 17:00:00,2023-08-24 17:00:00,-34.38053571427736,16.55210026498753,26259.80874999999,-0.001972649093471728,-0.0006680229272974828,26368.704047619056,25867.640315727804,26397.334702575885,26213.4392784565,26415.63880065697,-0.0006650205428328651,-0.0004875351130510217,26255.284866724138,26312.77561016128,5.107487258844549,10.726588848936538,44.707958571777795,26275.434209185998,26338.765560318603,26216.410068455458,-63.33135113260505,-29.87218328717437,104.28112414013091,-60.342031647734984,-39.82717887856052,-23.439754042003187,26357.189586044635,26074.13055086628,False,True,25037.738,26487.738,25567.738,25537.738,,False,,,,0.02,running,False,0.0,1230.9900000000002,2023-08-24 20:30:00,0,6,34,August
2023-08-28 15:00:00,25966.539,26073.537,25953.738,26050.037,1046,52423,0,2023-08-28 15:00:00,2023-08-28 15:00:00,19.31692857140297,-16.328107021574397,25987.765107142855,0.00026927202114109526,0.0011991336014043673,25921.937071428558,25869.825438771702,26316.17251348873,25824.044259707636,25952.91564513454,-0.00018702855329561364,-2.3206348980900243e-05,26025.79359550965,25978.44112952477,91.95783410136157,85.10916777542916,-18.303587913005433,25940.133085025955,25932.574671533224,25949.211505331965,7.558413492730324,-8.327897795175698,36.79600291323521,22.462490884085128,9.824360509122926,5.4364465084036055,26000.386109264833,25899.536901399097,True,False,27050.037,25600.037,26520.037,26550.037,,False,2023-08-29 17:30:00,2023-08-29 17:26:30,,0.02,success,True,364.02,1595.0100000000002,,1,0,35,August
2023-08-28 15:15:00,26050.037,26216.338,26031.338,26128.938,1849,52423,0,2023-08-28 15:00:00,2023-08-28 15:00:00,19.31692857140297,-16.328107021574397,25987.765107142855,0.00026927202114109526,0.0011991336014043673,25921.937071428558,25869.825438771702,26316.17251348873,25824.044259707636,25952.91564513454,-0.00018702855329561364,-2.3206348980900243e-05,26025.79359550965,25978.44112952477,88.87299188165353,88.60567834377021,-18.303587913005433,25969.17999502196,25947.120103271507,25986.720810457497,22.05989175045397,-2.2503398860497645,56.639323743937204,37.50930512553168,22.462490884085128,9.824360509122926,26064.68389751181,25910.25772340318,True,False,27128.938,25678.938,26598.938,26628.938,,False,2023-08-29 17:30:00,2023-08-29 17:26:36,,0.02,success,True,364.02,1959.0300000000002,,2,0,35,August
2023-08-29 10:00:00,25970.559,25985.338,25964.338,25969.139,298,52423,0,2023-08-29 10:00:00,2023-08-29 10:00:00,-31.807940476195654,-1.706891464174987,25985.600916666655,-0.0005162322955581993,-0.001041493284987489,26007.586630952363,25907.139160644285,25925.10327911477,25945.193092111687,25931.581529665822,-0.0011384150258124512,-0.00023400024329122522,26029.817466456334,26017.954236355075,14.854848634282192,18.855199310485354,8.272631329430858,26008.637097639355,26024.301731764157,25992.808753009976,-15.664634124801523,-7.867693669260105,32.04265378520953,-8.196751289964595,-8.966395252868097,-5.023417956650519,26036.06633562001,25948.051170399944,False,True,24969.139,26419.139,25499.139,25469.139,,False,,,2023-08-29 17:20:38,0.02,fail,False,-163.85,1795.1800000000003,,0,1,35,August
2023-08-29 11:00:00,25964.275,25967.938,25923.537,25956.889,484,52423,0,2023-08-29 11:00:00,2023-08-29 11:00:00,-21.985714285707218,-7.889015075026691,25956.468773809527,-0.0008190935025276098,-0.0010415278326136009,25985.600916666655,25839.51456366683,25898.16055504802,25907.139160644285,25925.10327911477,-0.001041493284987489,-0.0005162322955581993,26025.304546203144,26009.696937446668,18.119940317121955,19.007875680643497,5.040302048539348,25989.362340273026,26010.007030779285,25968.87801788786,-20.644690506258485,-14.22134617206828,33.32661280217797,-7.501529411769297,-6.936811489493266,-7.820517715856113,26013.868945170798,25922.38709060492,False,True,24956.889,26406.889,25486.889,25456.889,,False,,,2023-08-29 17:20:38,0.02,fail,False,-163.85,1631.3300000000004,,0,2,35,August
2023-08-29 11:45:00,25942.955,25958.438,25906.537,25914.738,522,52423,0,2023-08-29 11:00:00,2023-08-29 11:00:00,-21.985714285707218,-7.889015075026691,25956.468773809527,-0.0008190935025276098,-0.0010415278326136009,25985.600916666655,25839.51456366683,25898.16055504802,25907.139160644285,25925.10327911477,-0.001041493284987489,-0.0005162322955581993,26025.304546203144,26009.696937446668,16.06589002927803,20.246072017980396,5.040302048539348,25968.55210874074,25995.112617991483,25943.362813553475,-26.560509250743053,-19.11693841695109,39.5048760043662,-11.044320605436951,-7.6386102511423815,-6.832273477804847,25996.694396159368,25888.53123094758,False,True,24914.738,26364.738,25444.738,25414.738,,False,,,2023-08-29 17:20:34,0.02,fail,False,-163.85,1467.4800000000005,,0,3,35,August
2023-08-29 17:00:00,26002.039,26200.238,26002.039,26152.838,2304,52423,0,2023-08-29 17:00:00,2023-08-29 17:00:00,21.423357142863097,-11.641431839241704,26474.710440476192,0.001470186683051021,0.008777232704041581,25973.84011904761,26125.44083467912,28451.893135186612,25846.911920818187,26088.027010674836,0.00023726465136657154,-0.0002014499622783139,26071.5307757764,26112.97209494391,80.61654732983003,79.71736260020494,-11.709281928201493,26005.65924487962,25987.39364957349,26025.85837117304,18.2655953061294,-0.5399789754097535,48.358060275436024,34.121646370847884,6.6157106983082485,11.80386136908055,26092.641752544878,25960.5749898012,True,False,27152.838,25702.838,26622.838,26652.838,,False,2023-08-29 17:30:00,2023-08-29 17:26:37,2023-09-01 00:08:44,0.02,success,True,364.02,1831.5000000000005,,1,0,35,August
2023-08-29 17:30:00,26908.338,27613.039,26882.77,27513.139,6771,52423,0,2023-08-29 17:00:00,2023-08-29 17:00:00,21.423357142863097,-11.641431839241704,26474.710440476192,0.001470186683051021,0.008777232704041581,25973.84011904761,26125.44083467912,28451.893135186612,25846.911920818187,26088.027010674836,0.00023726465136657154,-0.0002014499622783139,26071.5307757764,26112.97209494391,85.38794640554913,80.55925424212565,-11.709281928201493,26355.6214120144,26163.857938248875,26469.78883350533,191.7634737655244,52.28682267852355,359.5920589641798,270.0644131406698,173.86604919161982,34.121646370847884,26956.73811310697,25984.339553903686,True,False,28513.139,27063.139,27983.139,28013.139,,False,,,2023-08-30 17:50:29,0.02,fail,False,-163.85,1667.6500000000005,,0,1,35,August
2023-08-31 19:45:00,26451.111,26496.938,26178.838,26198.037,4323,52423,0,2023-08-31 19:00:00,2023-08-31 19:00:00,-90.85480952377839,-48.95953878236833,26753.29726190477,-0.005202907918908709,-0.003741315061853091,27055.82152380955,25750.145036914884,26722.218704673967,26499.643869385607,27248.262101300144,-0.001541095520210519,-0.0025001293766671933,27042.206408872116,27086.477516817795,5.385573381838342,12.639116413521416,-20.521465845089185,26783.477329113935,26958.557396094777,26651.850998968006,-175.08006698084137,-88.59268193091498,269.04330195533197,-139.68093532852072,-99.15591159270116,-62.390735122116894,27015.059456607705,26287.142541328307,False,True,25198.037,25728.037,25728.037,25698.037,2023-09-01 18:00:00,True,2023-09-01 18:00:00,,2023-09-01 18:10:07,0.02,even,True,171.09,1838.7400000000005,,1,0,35,August
2023-09-05 00:00:00,25788.139,25788.139,25714.838,25722.139,349,68423,0,2023-09-05 00:00:00,2023-09-05 00:00:00,-21.15402380953674,-17.982702660967334,25765.029547619033,-0.0006889831230910193,-0.00026290788691329123,25829.74255952379,25520.167238944297,25868.768610290437,25801.446374388925,25874.387182291903,-0.0002695501892452097,0.0005720037035504165,26010.815076835614,25854.0933614566,15.024338876114818,22.080440649235285,-15.159600629073426,25812.049067974276,25828.339834057726,25802.93901891985,-16.290766083449853,-5.408940217909722,43.59053448105758,-25.37516924661395,-16.04809941525673,-13.145233918108715,25861.78624046928,25742.59179737042,False,True,24722.139,26172.139,25252.139,25222.139,,False,,,2023-09-08 00:09:01,0.02,fail,False,-163.85,1674.8900000000006,,0,1,36,September
2023-09-06 05:45:00,25792.037,25822.738,25787.895,25810.537,522,52423,0,2023-09-06 05:00:00,2023-09-06 05:00:00,14.396523809507926,6.615357577429677,25777.33583333334,0.000767379447189869,0.000479586809853449,25744.187178571425,25796.287256595155,25861.62686220662,25800.853974571735,25825.9899137185,0.00037492520697229853,0.0008845826760077276,25807.59894031516,25732.683344412908,80.52504631287235,71.011678554821,-5.269463130600193,25766.372583763736,25746.064292167983,25782.064484004124,20.308291595752962,16.2337605185856,37.12384391598479,7.3760890952871705,4.549620227051491,-1.0063267974110204,25833.681673290703,25731.947294717545,True,False,26810.537,25360.537,26280.537,26310.537,,False,2023-09-08 01:45:00,,2023-09-06 20:05:13,0.02,fail,False,-163.85,1511.0400000000006,,0,2,36,September
2023-09-06 17:30:00,25555.875,25603.238,25536.238,25536.238,1840,52423,0,2023-09-06 17:00:00,2023-09-06 17:00:00,-1.897976190506597,-9.484095039068052,25652.029809523832,-0.001000491314274778,-2.6207432714118485e-05,25687.146547619024,25425.593456741753,25739.73768474932,25624.242724045504,25737.786739655967,-5.851138036040704e-05,-0.0002591077158478198,25763.593006395127,25704.079121948784,10.068765956060822,30.30533398387688,-4.3878895717262765,25643.485761161184,25674.078711962055,25622.721422084636,-30.592950800870312,-15.86974299489594,47.35384632790679,-23.577352941163554,-24.165425868610328,-12.329761265871639,25686.64911462731,25557.29372954196,False,True,24536.238,25986.238,25066.238,25036.238,,False,,,2023-09-06 20:56:04,0.02,fail,False,-163.85,1347.1900000000007,,0,3,36,September
2023-09-07 02:15:00,25729.938,25749.738,25729.338,25742.639,516,52423,0,2023-09-07 02:00:00,2023-09-07 02:00:00,13.492214285717637,-5.971040762509801,25693.770309523807,0.0025624850081485684,-0.0017012707470384228,25683.77914285715,25904.66456324537,25611.64334214581,25870.580475069506,25591.183679330592,-0.0020081065022334284,0.00271556149722122,25732.450159903776,25683.263661720845,89.66478623478822,85.58641299143513,-14.515170485025003,25697.262894760082,25674.730263300386,25719.407103199177,22.53263145969686,15.31238153633904,53.44958960547791,7.236057791538769,13.621400068775984,5.871871689054387,25793.064049166573,25647.25015723178,True,False,26742.639,26212.639,26212.639,26242.639,2023-09-08 01:45:00,True,2023-09-08 01:45:00,,2023-09-08 02:13:21,0.02,even,True,171.09,1518.2800000000007,,1,0,36,September
2023-09-07 14:45:00,25672.037,25675.838,25653.006,25669.238,264,52423,0,2023-09-07 14:00:00,2023-09-07 14:00:00,-10.704023809514183,5.7835192229249515,25690.300000000007,-0.000507431470399001,-0.0005020312964939299,25704.081011904775,25611.99513357647,25680.50648485894,25666.65652229716,25663.957457245164,-0.0006271853167175558,-0.0001584413319913367,25728.88790319792,25706.787047937545,17.920586306457256,29.357729115564453,10.027559639368706,25696.145449165713,25708.74250347458,25687.310059167543,-12.597054308866063,-8.260349201830241,22.397773469536588,-6.675466116241296,-6.1064492604346015,-5.526309253495128,25717.547053351416,25655.57306498367,False,True,24669.238,26119.238,25199.238,25169.238,,False,,,2023-09-08 00:08:59,0.02,fail,False,-163.85,1354.4300000000007,,0,1,36,September
2023-09-08 13:00:00,26006.037,26006.738,25603.838,25697.438,3928,52423,0,2023-09-08 13:00:00,2023-09-08 13:00:00,-69.23584523808313,51.32648072808661,26000.39916666668,-0.0031472386535933406,-0.0015017695792604658,26128.22789285717,25350.632046559986,26029.235054457455,25922.164135176383,26202.909926729862,-0.0007829530938144614,-0.0008902658153581421,25924.484995792114,26023.668918095605,13.963254574338444,15.734564773933096,91.9958694278699,26066.07124617209,26132.53131475101,26021.161466460257,-66.46006857891916,-22.73070583671688,125.6117281872493,-79.63034399724347,-22.773408668759657,-14.369747162003478,26190.737299513043,25850.08563340747,False,True,24697.438,25227.438,25227.438,25197.438,2023-09-11 18:00:00,True,2023-09-11 18:00:00,,2023-09-12 06:03:38,0.02,even,True,171.09,1525.5200000000007,,1,0,36,September
2023-09-08 19:30:00,25793.838,25816.338,25680.838,25719.139,1143,52423,0,2023-09-08 19:00:00,2023-09-08 19:00:00,-0.29234523810009705,-66.87835696096954,25775.47977380952,0.0005020681149600172,-0.00179830421020958,25775.73203571429,25721.81326806981,25685.892947349123,25762.624219745867,25696.330606724096,-0.0020296834236687923,0.000757820615992362,25898.090072631523,25935.436718857916,18.4838284677454,21.77301384558447,-11.792064264840874,25810.205025216605,25858.310336105103,25804.457220846212,-48.105310888498934,-50.60224157567244,34.79982579449789,-23.586251117998472,-8.833608187145728,-4.300400756801537,25851.436985668784,25755.97745602364,False,True,24719.139,25249.139,25249.139,25219.139,2023-09-11 17:45:00,True,2023-09-11 17:45:00,,2023-09-12 06:03:40,0.02,even,True,171.09,1696.6100000000006,,2,0,36,September
2023-09-11 08:45:00,25804.738,25860.414,25793.838,25857.738,545,52423,0,2023-09-11 08:00:00,2023-09-11 08:00:00,7.979821428551077,-55.96892718610616,25747.78332142856,0.00011399703548982366,-0.0007161863111719996,25693.08088095237,25637.289189432227,25801.7026101935,25538.054764803695,25619.71708794475,-0.0015678399261087328,-0.0004119636816709669,25846.573829542875,25824.93012069153,89.12944446591023,87.94132732361709,-57.03738294913127,25752.92605988148,25745.017298552422,25779.81457309942,7.908761329057597,-11.463059997387381,56.15284576720974,26.06131372546588,19.379698658460256,8.911988304051192,25857.120914885152,25704.008231313685,True,False,26857.738,25407.738,26327.738,26357.738,,False,2023-09-14 04:00:00,,2023-09-11 17:05:53,0.02,fail,False,-163.84,1532.7700000000007,,0,1,37,September
2023-09-11 18:00:00,25110.938,25167.438,25006.139,25024.037,3021,52423,0,2023-09-11 18:00:00,2023-09-11 18:00:00,-177.70258333334277,-109.70629211551568,25282.491785714283,-0.005065066091257979,-0.0010510053199785094,25435.884428571415,24425.94710397235,25585.03054252915,24587.295447591998,25664.80500952268,-0.0005514415344546553,-0.004577524119114441,25748.145890810003,25652.48360640102,19.18541064284629,24.87006031958595,-56.39883318976905,25375.88665070681,25511.74578589557,25287.337496732027,-135.8591351887626,-76.3339232212086,190.76697950570178,-88.64123632612609,-82.54807051940588,-64.15454901960766,25544.872919064725,25028.30207439933,False,True,24024.037,25474.037,24554.037,24524.037,,False,,,2023-09-12 06:16:25,0.02,fail,False,-163.84,1368.9300000000007,,0,2,37,September
2023-09-11 22:45:00,24973.238,25040.139,24948.838,24963.639,1236,52423,0,2023-09-11 22:00:00,2023-09-11 22:00:00,-42.48377380950478,-173.18945539895503,25024.65171428572,-0.0019326804409483902,-0.0039017733017419213,25103.009214285717,24553.620149141327,24823.587416711805,24533.802974152448,24860.957511948065,-0.0041935437904551745,-0.002315171067667275,25652.59237147387,25495.370438376627,17.259317951559137,34.191895753362104,-121.27041030360033,25092.884811851978,25193.855869219427,25077.50790746475,-100.97105736744925,-103.6044895831742,125.00441559249403,-31.09817681457207,-36.09690815277281,-7.8413378052537155,25246.26386851462,24907.251946414883,False,True,23963.639,25413.639,24493.639,24463.639,,False,,,2023-09-12 06:16:24,0.02,fail,False,-163.84,1205.0900000000008,,0,3,37,September
2023-09-12 06:15:00,25356.738,25922.738,25349.938,25833.738,4964,52423,0,2023-09-12 06:00:00,2023-09-12 06:00:00,29.862166666636767,-101.86155710176172,25356.867976190482,0.0022577002312637808,0.004672843927446615,25154.89265476189,25332.182018303465,26307.946644843665,25161.055210629547,25347.217138399825,0.0008558590746426435,0.0008349346590325408,25531.86808297374,25364.949616524023,83.69990013694546,76.20499781205088,-133.41368568993565,25269.07918690427,25199.201457940766,25308.876405228744,69.87772896350361,11.812759698048044,149.96962947427832,126.70974544202909,41.03094289646833,8.939596147221891,25512.83540501902,25106.417405438468,True,False,26833.738,26303.738,26303.738,26333.738,2023-09-13 19:30:00,True,2023-09-13 19:30:00,,2023-09-13 19:30:49,0.02,even,True,171.09,1376.1800000000007,,1,0,37,September
2023-09-18 02:30:00,26443.838,26461.738,26429.738,26460.639,153,52423,0,2023-09-18 02:00:00,2023-09-18 02:00:00,42.179761904746556,-18.21348297241275,26445.810047619038,0.001069277063491207,0.0009230101514265242,26414.791333333324,26473.42625519039,26577.49311709496,26445.0858737844,26500.200573977676,0.00045263817602426114,0.0010692505127581345,26362.127241808263,26416.764618414516,81.89683997282062,81.81123154086835,-32.504699233097945,26419.47862846551,26395.581581903032,26454.882103887157,23.897046562477044,16.06279041144675,53.95214670636983,6.86074613000892,3.4986738906081882,3.3963653251230426,26529.217501940755,26382.04670583356,True,False,27460.639,26930.639,26930.639,26960.639,2023-09-18 13:45:00,True,2023-09-18 13:45:00,,2023-09-18 20:25:13,0.02,even,True,171.09,1547.2700000000007,,2,0,38,September
2023-09-18 13:45:00,27044.338,27146.738,27019.139,27090.537,1875,52423,0,2023-09-18 13:00:00,2023-09-18 13:00:00,51.90291666667326,82.04859829521229,26854.419309523815,0.00188165356295323,0.0026372287008276383,26712.38934523809,26897.51831895328,27377.30335455931,26761.407341903905,27003.60817802384,0.001058888230258473,0.0012711219666086846,26471.59577072305,26581.469769020645,88.35065147345301,85.25190678859805,45.662223767723674,26853.279999086444,26743.048601106635,26935.43809494324,110.23139797980912,73.09771801590855,140.73572740945653,59.77686824904231,56.590276229828305,42.123998967999796,27126.931326946007,26745.444862940476,True,False,28090.537,26640.537,27560.537,27590.537,,False,,,2023-09-18 20:34:16,0.02,fail,False,-163.84,1383.4300000000007,,0,1,38,September
2023-09-18 14:00:00,27091.537,27173.738,27091.537,27127.938,1950,52423,0,2023-09-18 14:00:00,2023-09-18 14:00:00,142.02996428572442,121.7062056902505,26990.761285714285,0.0018818391218451739,0.003124373833486596,26854.419309523815,26948.33076282153,27505.877837067015,26897.51831895328,27377.30335455931,0.0026372287008276383,0.00188165356295323,26498.53076010646,26627.627227498997,89.00309564403301,87.60594543085308,60.87102015222904,26895.535076150067,26771.55892695059,26995.3042266942,123.97614919947591,83.27340425262203,160.6973447357861,59.86613175095772,59.77686824904231,56.590276229828305,27213.74564208751,26778.36281130089,True,False,28127.938,26677.938,27597.938,27627.938,,False,,,2023-09-18 20:34:15,0.02,fail,False,-163.84,1219.5900000000008,,0,2,38,September
2023-09-19 18:15:00,27183.037,27336.432,27159.838,27289.338,2204,52423,0,2023-09-19 18:00:00,2023-09-19 18:00:00,-1.5808333333334303,74.37551513262952,27180.27213095237,0.0002090422524899848,4.93172110707778e-05,27112.893345238077,26865.51498317795,27453.616507034796,26874.24119748866,27158.14132337879,-0.001262922104531726,0.00037604386557691077,26814.723840365874,26962.142438432973,81.50692247900398,73.07976305128737,57.325027268185075,27135.948757411144,27090.638258784522,27132.14164809084,45.310498626622575,42.10795736948787,81.01029212547654,34.49212246303068,17.009842105282587,-0.41802407983050216,27243.005542460236,27022.777753721446,True,False,28289.338,26839.338,27759.338,27789.338,,False,,,2023-09-20 22:19:00,0.02,fail,False,-163.84,1055.750000000001,,0,3,38,September
2023-09-19 18:45:00,27266.238,27449.529,27199.838,27387.037,3186,52423,0,2023-09-19 18:00:00,2023-09-19 18:00:00,-1.5808333333334303,74.37551513262952,27180.27213095237,0.0002090422524899848,4.93172110707778e-05,27112.893345238077,26865.51498317795,27453.616507034796,26874.24119748866,27158.14132337879,-0.001262922104531726,0.00037604386557691077,26814.723840365874,26962.142438432973,83.45169737733845,82.1519720450458,57.325027268185075,27191.538447613897,27124.6375990951,27199.93530340558,66.90084851879874,48.70487989995412,91.8620914650923,46.118388716877234,21.675266597860173,34.49212246303068,27325.449126883454,27075.921479927703,True,False,28387.037,26937.037,27857.037,27887.037,,False,,,2023-09-20 00:28:32,0.02,fail,False,-163.84,891.9100000000009,,0,4,38,September
2023-09-19 19:00:00,27387.139,27430.738,27308.961,27425.438,2292,52423,0,2023-09-19 19:00:00,2023-09-19 19:00:00,67.37878571429246,104.51442389193471,27198.017428571417,-0.0009219505805866601,4.9407854869805976e-05,27180.27213095237,26713.148313386533,27454.989022245463,26865.51498317795,27453.616507034796,4.93172110707778e-05,0.0002090422524899848,26831.732238782897,26985.046083358335,85.30416366027093,83.41771910546811,66.76290659293501,27227.522994134837,27146.91911027324,27248.525618163058,80.60388386159684,55.084680692282674,105.72525500090632,48.590314757479064,46.118388716877234,21.675266597860173,27392.75471241428,27105.796523911835,True,False,28425.438,26975.438,27895.438,27925.438,,False,,,2023-09-20 00:27:13,0.02,fail,False,-163.84,728.0700000000008,,0,5,38,September
2023-09-21 04:15:00,26970.238,26993.537,26938.838,26942.238,528,52423,0,2023-09-21 04:00:00,2023-09-21 04:00:00,-8.388154761883925,-13.193976486745669,27022.17485714285,0.0012560521024708995,-0.0008441026462566762,27026.051250000026,27047.701605333532,27033.603917265424,27145.30223955556,27056.413933789932,-0.0008441205465460353,0.0018481203441239903,27007.33844754539,27054.793416378834,5.0473741086562205,18.574397014754656,-8.168482923750307,27029.88848011667,27043.656124961388,27022.410304437555,-13.767644844716415,-3.2768836791599147,77.9641593838834,-25.376924664633407,-26.270491916024184,-20.001107671174395,27127.661919605798,26915.658689269312,False,True,25942.238,27392.238,26472.238,26442.238,,False,2023-09-21 16:45:00,2023-09-21 15:53:29,,0.02,success,True,364.02,1092.0900000000008,,1,0,38,September
2023-09-21 05:30:00,26924.037,26944.139,26893.738,26903.838,558,52423,0,2023-09-21 05:00:00,2023-09-21 05:00:00,-3.876392857175233,-17.999021647494374,27005.271309523832,0.0008371563892615914,-0.0009359619494703553,27022.17485714285,26966.1444529507,26990.763790955727,27047.701605333532,27033.603917265424,-0.0008441026462566762,0.0012560521024708995,27004.33842999459,27044.876983068527,16.742399126257656,22.664779082634368,-10.134590668499122,26985.84026758724,27015.60917688658,26957.953151358804,-29.76890929934234,-16.543482819165828,61.66786148495497,-25.004944960408466,-18.22963295495356,-0.7320213278253505,27041.204764363494,26873.201538354115,False,True,25903.838,27353.838,26433.838,26403.838,,False,2023-09-21 16:45:00,2023-09-21 15:53:29,,0.02,success,True,364.02,1456.1100000000008,,2,0,38,September
2023-09-21 11:45:00,26943.438,26959.738,26866.838,26890.938,799,52423,0,2023-09-21 11:00:00,2023-09-21 11:00:00,-12.002130952387233,-18.00416195350772,26970.49541666666,-0.00016514597759349311,-0.0001788962786662339,27005.881190476175,26852.910232070793,27031.301017769165,26969.914567972268,26992.166858747372,-0.00047302442915303814,0.0003448623333673925,27001.493551254123,27022.378802004405,16.978085525308856,19.61990884905214,-15.583835314934765,26959.428144888647,26980.451616625527,26934.345353629156,-21.02347173688031,-11.734141255070664,40.88285222403393,-20.071056071570638,-11.15680736153081,-14.529891296864662,26989.5372041316,26877.653503126712,False,True,25890.938,27340.938,26420.938,26390.938,,False,2023-09-21 16:45:00,2023-09-21 15:53:29,,0.02,success,True,364.02,1820.1300000000008,,3,0,38,September
2023-09-21 12:30:00,26784.014,26810.537,26673.838,26763.738,2355,52423,0,2023-09-21 12:00:00,2023-09-21 12:00:00,-35.38577380951392,-29.049488101030875,26879.57754761905,-0.0013248620999002526,-0.0004276386658393906,26970.49541666666,26533.26309716426,26973.372923245468,26852.910232070793,27031.301017769165,-0.0001788962786662339,-0.00016514597759349311,26990.097961008865,26997.46097784405,15.090110136368835,15.745694775212982,-18.276965872153987,26899.295498792344,26945.441577187114,26858.369985896134,-46.146078394769575,-24.166215708137265,72.54479530641714,-33.06619883038729,-30.27576195390793,-12.633406948727497,26956.305459559797,26758.93451223247,False,True,25763.738,27213.738,26293.738,26263.738,,False,,2023-09-21 15:53:29,,0.02,success,True,364.02,2184.1500000000005,,4,0,38,September
2023-09-27 12:30:00,26250.037,26320.934,26236.238,26272.838,1035,52423,0,2023-09-27 12:00:00,2023-09-27 12:00:00,2.4236666666438396,8.972568625911663,26264.533845238086,-1.6871813732075762e-06,0.0006520408801357038,26216.856190476174,26182.653370662214,26416.245383506433,26185.06181844154,26241.65363916992,-6.33118113270947e-05,2.3608196931710212e-05,26246.876857278123,26213.9586451587,80.232402167692,77.9787136705224,2.8094684719618828,26226.98130189954,26216.99462947637,26228.719437220505,9.986672423172422,5.680727877091607,17.278890790244954,10.641172686620848,6.508687650501088,2.3602418300542922,26253.545939787335,26205.392934653675,True,False,27272.838,26742.838,26742.838,26772.838,2023-09-28 18:15:00,True,2023-09-28 18:15:00,2023-09-28 19:26:36,2023-09-29 17:09:06,0.02,success,True,364.02,2548.1700000000005,,5,0,39,September
2023-09-27 12:45:00,26272.809,26361.537,26256.639,26357.139,1619,52423,0,2023-09-27 12:00:00,2023-09-27 12:00:00,2.4236666666438396,8.972568625911663,26264.533845238086,-1.6871813732075762e-06,0.0006520408801357038,26216.856190476174,26182.653370662214,26416.245383506433,26185.06181844154,26241.65363916992,-6.33118113270947e-05,2.3608196931710212e-05,26246.876857278123,26213.9586451587,87.57031081618119,83.4279071595527,2.8094684719618828,26247.005563145765,26227.375693959602,26253.713676642572,19.629869186162978,8.470556138905883,32.52615717542637,24.99423942206704,10.641172686620848,6.508687650501088,26299.123988829397,26209.803364455747,True,False,27357.139,26827.139,26827.139,26857.139,2023-09-28 18:45:00,True,2023-09-28 18:45:00,,2023-09-28 18:45:51,0.02,even,True,171.09,2719.2600000000007,,6,0,39,September
2023-09-27 13:00:00,26354.486,26403.738,26321.537,26383.738,1295,52423,0,2023-09-27 13:00:00,2023-09-27 13:00:00,47.67765476191198,24.37080001765571,26313.964535714276,6.261342831870813e-05,0.0010767866758420238,26264.533845238086,26191.33325569918,26544.4077103505,26182.653370662214,26416.245383506433,0.0006520408801357038,-1.6871813732075762e-06,26252.859647188783,26228.796993546006,84.55235397296407,84.11835565227909,7.121734781100649,26268.0413226618,26238.95808699963,26282.22555521155,29.08323566216859,12.593092043558425,45.45424735449016,28.51187856897741,24.99423942206704,10.641172686620848,26345.08878914011,26220.862321282988,True,False,27383.738,26853.738,26853.738,26883.738,2023-09-28 19:00:00,True,2023-09-28 19:00:00,,2023-09-28 21:48:09,0.02,even,True,171.09,2890.350000000001,,7,0,39,September
2023-09-27 14:45:00,26640.238,26810.139,26619.639,26729.639,3047,52423,0,2023-09-27 14:00:00,2023-09-27 14:00:00,49.43069047619065,39.11463159669802,26468.226738095233,0.0013144171423809638,0.002996742311933498,26313.964535714276,26397.122305416484,27067.94856784042,26191.33325569918,26544.4077103505,0.0010767866758420238,6.261342831870813e-05,26271.556876710794,26268.864354062327,91.85556668904205,90.73875200233407,13.520314144220123,26456.458448261474,26355.395725939743,26550.521302717578,101.06272232173069,57.57922615748402,146.44618344465792,66.89717509460024,58.98782593735814,43.62119367046762,26749.723650367865,26352.81895506729,True,False,27729.639,26279.639,27199.639,27229.639,,False,,,2023-09-27 17:25:37,0.02,fail,False,-163.85,2726.500000000001,,0,1,39,September
2023-09-28 10:30:00,26418.596,26458.338,26394.037,26445.938,493,52423,0,2023-09-28 10:00:00,2023-09-28 10:00:00,8.850714285708818,32.82530117252463,26408.806630952367,0.000241987628133347,-0.00027032276749400415,26404.306630952367,26344.782365212868,26447.315475058225,26358.73104570452,26408.25266076326,-0.0004607285438632779,0.0003908451969767688,26310.422621954072,26335.36000573753,86.07852497386068,82.69975751532427,19.655676648332552,26409.598640359418,26385.65613157815,26436.550517715867,23.94250878126695,21.063115518171166,40.957371720664106,5.810201238382433,4.967167182683625,10.219076367386151,26493.342969538764,26381.25806589297,True,False,27445.938,26915.938,26915.938,26945.938,2023-09-28 19:00:00,True,2023-09-28 19:00:00,,2023-09-28 21:46:45,0.02,even,True,171.09,2897.590000000001,,1,0,39,September
2023-10-02 01:00:00,27127.387,27181.76,27101.439,27177.938,718,72423,0,2023-10-02 01:00:00,2023-10-02 01:00:00,99.1404761904887,16.557849758140947,27304.02976190474,0.001764224916181318,0.006197703177643549,26956.756809523817,27003.80193111679,28844.97121907869,26849.403224971804,27178.71919287022,0.00042830622973675045,0.0010103293592012407,26817.737478368123,26981.398889886037,98.23193079755423,97.57594950398213,6.9965743986664695,27005.461063077204,26940.626196690027,27076.580140006885,64.83486638717659,24.28268732489673,122.5324420546882,43.38880495356352,42.888235294132755,42.6416814585391,27243.498936780714,26911.161343233056,True,False,28177.938,26727.938,27647.938,27677.938,,False,2023-10-02 01:30:00,2023-10-02 01:17:57,,0.02,success,True,364.01,3261.6000000000013,,2,0,40,October
2023-10-04 11:15:00,27411.738,27448.438,27394.139,27440.357,522,49424,0,2023-10-04 11:00:00,2023-10-04 11:00:00,26.204880952416715,-9.367073766014073,27426.586464285723,0.0006724062189790297,0.0003613946765940136,27398.79977380956,27405.947042857046,27565.244688468443,27429.1300017765,27378.154751494767,-0.0004231513386745091,0.0010325253615826838,27436.940496724135,27413.006343982994,92.1500433643419,86.09532776981041,-33.520384293978516,27390.67240951502,27374.240685406054,27399.541580667363,16.43172410896659,9.359071270906309,27.103605390352044,14.813295493633632,8.440481596127938,11.261300653623039,27437.63144794434,27362.951713390386,True,False,28440.357,27910.357,27910.357,27940.357,2023-10-05 16:30:00,True,2023-10-05 16:30:00,,2023-10-05 16:39:24,0.02,even,True,171.09,3432.6900000000014,,3,0,40,October
2023-10-04 11:30:00,27440.664,27501.738,27422.037,27493.838,711,48199,0,2023-10-04 11:00:00,2023-10-04 11:00:00,26.204880952416715,-9.367073766014073,27426.586464285723,0.0006724062189790297,0.0003613946765940136,27398.79977380956,27405.947042857046,27565.244688468443,27429.1300017765,27378.154751494767,-0.0004231513386745091,0.0010325253615826838,27436.940496724135,27413.006343982994,90.7792224161153,89.81025172882558,-33.520384293978516,27406.5440388204,27383.099745746345,27422.449611627104,23.444293074055167,12.176115631536081,35.56551775463321,22.908030959741154,14.813295493633632,8.440481596127938,27471.96306059586,27374.43616265835,True,False,28493.838,27963.838,27963.838,27993.838,2023-10-05 17:30:00,True,2023-10-05 17:30:00,,2023-10-05 17:36:05,0.02,even,True,171.09,3603.7800000000016,,4,0,40,October
2023-10-04 22:00:00,27586.416,27803.738,27586.416,27740.639,2671,38496,0,2023-10-04 22:00:00,2023-10-04 22:00:00,50.49902380949061,25.94554190366398,27543.94039285714,0.0011767193226619908,0.0010875787530454275,27480.775428571404,27556.303351465758,27901.472402345018,27357.995257370483,27593.643034506324,1.9800813103093204e-06,0.0003401606492138018,27457.09033332775,27463.297141818846,84.1497165496516,82.89270999249464,11.23577797614036,27536.44051763845,27494.90478838436,27590.38678637771,41.535729254090256,16.35582311663539,92.35657634113942,44.969722394227574,15.595869969038176,9.011816305453976,27716.568164438246,27465.70540831717,True,False,28740.639,27290.639,28210.639,28240.639,,False,,,2023-10-06 15:58:18,0.02,fail,False,-163.85,3439.9300000000017,,0,1,40,October
2023-10-05 02:15:00,27730.639,27795.438,27730.639,27746.938,955,38575,0,2023-10-05 02:00:00,2023-10-05 02:00:00,38.451249999976426,62.723274424279225,27694.89063095237,0.001488288756746677,0.0007767663945479523,27666.100285714278,27779.328420432466,27960.33229712783,27736.597080145166,28154.854067962733,0.002014546453199405,0.0014818612742408777,27488.725031501675,27522.918792646982,83.22192533004534,77.6423872787335,35.22505879059446,27679.796451637183,27626.77454542764,27693.139368765056,53.02190620954207,49.144086028902144,82.89002703795303,9.608419676653284,1.6788782249641372,2.03004987962413,27806.540905266294,27581.237832263818,True,False,28746.938,27296.938,28216.938,28246.938,,False,,,2023-10-06 15:58:18,0.02,fail,False,-163.85,3276.0800000000017,,0,2,40,October
2023-10-06 11:00:00,27599.785,27622.139,27579.838,27599.938,641,48424,0,2023-10-06 11:00:00,2023-10-06 11:00:00,33.37584523806436,-4.546213706580602,27538.052107142845,5.641429171027602e-05,0.0004557359657326027,27519.57452380951,27431.92233775191,27670.251921121853,27471.240251477248,27653.879370956012,0.00043911872492788785,0.00040870605510673753,27523.817368441807,27517.07767067139,90.58550402641372,80.37760994162315,-26.68001032240078,27515.112781287775,27492.186515626425,27518.728728242175,22.926265661350044,8.453119173821225,45.24902435674907,25.6562831097217,25.198645682838105,19.284246646042448,27581.314911123787,27457.642545360563,True,False,28599.938,27149.938,28069.938,28099.938,,False,,,2023-10-06 16:00:31,0.02,fail,False,-163.85,3112.230000000002,,0,3,40,October
2023-10-06 18:15:00,27684.211,27795.139,27589.309,27789.037,1977,44025,0,2023-10-06 18:00:00,2023-10-06 18:00:00,16.27703571427992,5.9040407599604805,27636.746095238104,-0.0010499567166202804,0.0017992551624464084,27518.983880952375,26981.087787704462,28172.914941513398,27009.69199666031,27650.85197929294,-0.0005374906026809037,-0.0010501140876672745,27544.175489782996,27558.871311923667,91.05160485645284,84.10186206179758,1.3289696489668208,27598.7516565135,27573.90502677019,27566.118902304785,24.846629743311496,-1.5593390082469147,134.5099812914056,50.35378259373465,37.26834881319883,27.233987960113154,27749.207377048184,27384.530427561385,True,False,28789.037,27339.037,28259.037,28289.037,,False,,,2023-10-09 16:05:08,0.02,fail,False,-163.85,2948.380000000002,,0,4,40,October
2023-10-06 18:30:00,27787.238,27973.738,27783.037,27916.438,3616,27420,0,2023-10-06 18:00:00,2023-10-06 18:00:00,16.27703571427992,5.9040407599604805,27636.746095238104,-0.0010499567166202804,0.0017992551624464084,27518.983880952375,26981.087787704462,28172.914941513398,27009.69199666031,27650.85197929294,-0.0005374906026809037,-0.0010501140876672745,27544.175489782996,27558.871311923667,94.77309209513608,89.635470098635,1.3289696489668208,27647.626478588347,27599.277839602026,27639.080535947694,48.34863898632102,8.422256590666674,149.50339054018553,72.96163364290987,50.35378259373465,37.26834881319883,27842.410113176946,27437.250958718443,True,False,28916.438,27466.438,28386.438,28416.438,,False,,,2023-10-09 12:50:17,0.02,fail,False,-163.85,2784.530000000002,,0,5,40,October
2023-10-10 05:45:00,27587.537,27661.963,27565.938,27642.037,822,36283,0,2023-10-10 05:00:00,2023-10-10 05:00:00,7.9038333333410264,-18.500064778258093,27575.469773809506,-0.00026730363966623305,0.0002871775813770354,27542.627785714292,27425.53090329684,27687.337185382672,27432.885503776473,27515.83795782987,-0.0006995381216434603,-0.0002673071042557429,27598.074379691792,27577.535259424832,81.06979220186578,73.06778731393949,-36.72316505481212,27561.9309612079,27548.880876099865,27563.390359821133,13.050085108036,5.909132574888107,30.057513818856886,20.60051117993862,8.844289989679964,1.891230134129728,27605.468003476588,27522.812716165678,True,False,28642.037,27192.037,28112.037,28142.037,,False,,,2023-10-11 05:33:38,0.02,fail,False,-163.85,2620.680000000002,,0,6,41,October
2023-10-10 16:00:00,27385.639,27400.037,27352.838,27372.139,1233,47625,0,2023-10-10 16:00:00,2023-10-10 16:00:00,-68.36413095235912,-24.89602886911598,27430.411357142853,-0.001441702346156476,-0.001119079124755294,27495.881357142865,27166.623842191126,27445.730192385072,27282.616423366442,27567.77388664173,-0.0006606220286732762,-0.0009155406076656992,27575.8986812401,27546.459220753008,10.662534113154267,15.82342167117507,-4.4724644890724665,27486.25710901066,27534.126887987208,27432.060126247008,-47.86977897654651,-24.88536059669739,83.40071508582054,-27.567722738196608,-27.612277605818235,-15.32777640175118,27544.651091612865,27317.96916088115,False,True,26372.139,26902.139,26902.139,26872.139,2023-10-11 18:30:00,True,2023-10-11 18:30:00,,2023-10-12 05:54:04,0.02,even,True,171.09,2791.7700000000023,,1,0,41,October
2023-10-16 01:00:00,27128.639,27249.037,27128.639,27212.438,1234,66725,0,2023-10-16 01:00:00,2023-10-16 01:00:00,145.68949999999313,35.4818972578214,26943.495428571423,0.0007607449735094076,0.0022916539048096645,26848.98608333334,26787.703499031788,27449.93768292818,26750.854393024023,27295.73125027843,0.0013044103676986094,0.0006138908791022792,26834.139349915684,26801.509527016373,90.61214829352626,87.66746762512439,7.015836707959251,26956.0563491045,26859.870698288967,27039.303289645675,96.18565081553243,40.33788329367481,169.8804830671869,71.90049535603612,59.90341554865154,61.272746474074665,27270.141941786376,26809.964637504974,True,False,28212.438,27682.438,27682.438,27712.438,2023-10-16 08:30:00,True,2023-10-16 08:30:00,2023-10-16 16:26:24,2023-10-16 12:09:43,0.02,even,True,171.09,2962.8600000000024,,2,0,42,October
2023-10-16 08:15:00,27248.738,27917.064,27241.818,27729.738,3574,0,0,2023-10-16 08:00:00,2023-10-16 08:00:00,-5.82750000003216,113.0156754006457,27427.154642857146,0.0021465422182192777,0.0036068771975172145,27182.28795238093,27398.26832946006,28273.579933139143,27248.75469496788,27242.58237448326,-2.571844172263499e-05,0.0011517195125731478,26941.311875992207,27017.441096257153,82.7070286092146,70.4882628789997,80.40513590552689,27269.874549453736,27178.01499089335,27299.718798073616,91.85955856038709,64.13086496326198,126.97396387391441,96.76663226693927,6.61871345030886,5.210675954604085,27472.6336493034,27128.303946843833,True,False,28729.738,27279.738,28199.738,28229.738,,False,2023-10-16 16:30:00,2023-10-16 16:28:16,,0.02,success,True,364.01,3326.8700000000026,,3,0,42,October
2023-10-16 08:30:00,27730.037,27945.537,27709.139,27819.838,2920,41123,0,2023-10-16 08:00:00,2023-10-16 08:00:00,-5.82750000003216,113.0156754006457,27427.154642857146,0.0021465422182192777,0.0036068771975172145,27182.28795238093,27398.26832946006,28273.579933139143,27248.75469496788,27242.58237448326,-2.571844172263499e-05,0.0011517195125731478,26941.311875992207,27017.441096257153,86.44707410821569,80.68772582251998,80.40513590552689,27354.484311076238,27225.55743601236,27408.711195734457,128.92687506387665,77.09006698338493,176.54149909379083,108.99239766084065,96.76663226693927,6.61871345030886,27648.542219511073,27170.38017195784,True,False,28819.838,27369.838,28289.838,28319.838,,False,2023-10-16 16:30:00,2023-10-16 16:28:18,,0.02,success,True,364.01,3690.880000000003,,4,0,42,October
2023-10-16 09:00:00,27877.238,27940.139,27826.838,27916.139,1671,42424,0,2023-10-16 09:00:00,2023-10-16 09:00:00,244.866690476214,186.29322815681735,27581.68910714284,0.002146788205703704,0.005029020342510398,27427.154642857146,27456.95239168657,28546.64880535379,27398.26832946006,28273.579933139143,0.0036068771975172145,0.0021465422182192777,26973.956037718002,27077.94484855658,91.01634539673957,87.28695714844154,101.582754355785,27508.943500829733,27321.408509612796,27629.636976264195,187.53499121693676,112.61710273583054,255.20463832991072,107.54445958032011,113.3813209494183,108.99239766084065,27975.663238009576,27285.110714518814,True,False,28916.139,27466.139,28386.139,28416.139,,False,2023-10-16 16:30:00,2023-10-16 16:28:22,,0.02,success,True,364.01,4054.890000000003,,5,0,42,October
2023-10-16 16:15:00,27887.902,29452.234,27864.848,29433.139,4089,0,0,2023-10-16 16:00:00,2023-10-16 16:00:00,-21.180035714281985,214.21567639437126,27829.87135714286,-0.0002162263388952821,0.012745732775831787,27756.136380952375,27558.07138246699,31834.806081790477,27880.91119437475,27807.003062817068,-0.000517238664158201,0.0023848530171308017,27174.923344039096,27397.64607060875,93.87496168707634,89.16855057122949,200.52397459638857,28020.5491895605,27831.647510148778,28102.548549363622,188.9016794117233,85.57955199742352,343.0011093555806,322.84771517030094,38.01145958030247,29.593036119706085,28567.100046993655,27639.49705173359,True,False,30433.139,28983.139,29903.139,29933.139,,False,,2023-10-16 16:30:33,2023-10-16 16:35:27,0.02,success,True,364.01,4418.900000000003,,6,0,42,October
2023-10-19 04:00:00,28343.475,28378.037,28341.438,28358.838,721,48824,0,2023-10-19 04:00:00,2023-10-19 04:00:00,32.911964285722206,-16.257852554328565,28264.350499999993,-0.00048588070336355273,0.00026241976714612897,28285.504154761897,28022.706381881075,28402.22734331386,28177.559758777425,28338.994511734683,-0.00019820583720334562,0.00020872707378589598,28222.93162740239,28298.047273637527,83.25355772908668,78.65352059254924,-30.235257907541445,28297.45763812346,28281.279036725922,28328.538463364286,16.178601397536113,4.4608448317749385,44.86868935988007,11.786271069817303,15.49146542829476,4.994045407638623,28390.611194000125,28267.965732728448,True,False,29358.838,28828.838,28828.838,28858.838,2023-10-20 05:45:00,True,2023-10-20 05:45:00,2023-10-20 06:28:33,,0.02,success,True,364.01,4782.9100000000035,,7,0,42,October
2023-10-19 13:00:00,28358.738,28471.938,28350.338,28442.15,1500,31724,0,2023-10-19 13:00:00,2023-10-19 13:00:00,33.08869047618646,4.583828724546038,28356.74201190474,0.0007268034322525316,0.0011417173988370237,28311.99960714287,28328.1397777042,28577.955887773132,28276.41084494454,28433.19806326156,0.0005980409162773882,0.0005194681482080871,28242.27456735512,28296.1868774054,93.10657241168879,86.16411066284802,-14.49255604733284,28324.481318663038,28292.31668419768,28346.611872033023,32.16463446535636,17.857433886991558,52.59061529855526,28.23423219813776,16.245677674596664,16.427744066008017,28419.10920268607,28275.614541379975,True,False,29442.15,28912.15,28912.15,28942.15,2023-10-20 06:15:00,True,2023-10-20 06:15:00,2023-10-20 11:17:27,,0.02,success,True,364.01,5146.920000000004,,8,0,42,October
2023-10-20 11:30:00,29563.111,29813.738,29561.141,29778.438,3623,30623,0,2023-10-20 11:00:00,2023-10-20 11:00:00,37.289285714283324,193.2329692456624,29432.018011904755,0.0034175348300166182,0.0029727974332358835,29274.056869047607,29519.144403979608,30107.30389528794,29569.12703678391,29904.84706556468,0.002461264353427032,0.004042518524850743,28608.996333146395,28848.35314315312,86.36778744654572,74.19277283383589,146.0712834847249,29349.126054611923,29188.74170633884,29399.892834193317,160.38434827308447,129.70096936824507,176.4517938390459,95.33352459577873,64.00355073961327,17.218002063968015,29639.60275587603,29161.682912510605,True,False,30778.438,29328.438,30248.438,30278.438,,False,2023-10-23 04:30:00,2023-10-23 06:49:29,2023-10-20 20:09:25,0.02,fail,False,-163.85,4983.070000000003,,0,1,42,October
2023-10-23 06:45:00,30459.639,30783.838,30451.889,30697.738,3164,2111,0,2023-10-23 06:00:00,2023-10-23 06:00:00,130.72535714289552,254.44002746847764,30448.858273809517,0.004554369295154164,0.0064816800635552,30255.701702380982,30716.66053330537,31687.446308603186,30505.08951349698,31423.413045799793,0.006062741298419303,0.004122966619190695,29249.718252015504,29682.973211311495,80.78274362630233,71.20029378646596,196.26129814328988,30325.2202385054,30127.765027633766,30477.410191606476,197.45521087163434,169.68587279116608,248.29388245337398,77.89761472309692,45.30474337805936,41.20789680083908,30814.10693291853,30142.21345029442,True,False,31697.738,31167.738,31167.738,31197.738,2023-10-23 22:15:00,True,2023-10-23 22:15:00,2023-10-23 23:24:37,2023-10-23 22:15:59,0.02,even,True,171.09,5154.1600000000035,,1,0,43,October
2023-10-27 01:15:00,34142.84,34171.137,34114.648,34169.137,719,67324,0,2023-10-27 01:00:00,2023-10-27 01:00:00,42.28220238094946,-97.74348731493228,34118.04288095236,0.0021378742489988763,-5.6643441229351036e-05,34030.89367857141,34340.393405915886,34215.8971942099,34112.5977978596,34132.194214689094,-0.0004789535770603218,0.0015313340833688054,34027.067399697786,34204.380109862366,81.23855692174783,73.06494576348722,-105.61600202173598,34097.45739824419,34075.921393900324,34150.01867285862,21.53600434386317,0.6607578424810243,118.20204622851843,12.144013759891095,3.7072786378121236,-2.538250774050539,34311.09143526712,33990.44591045012,True,False,35169.137,33719.137,34639.137,34669.137,,False,2023-10-30 01:00:00,,2023-10-27 20:07:16,0.02,fail,False,-163.85,4990.310000000003,,0,1,43,October
2023-10-27 01:30:00,34169.137,34183.34,34142.84,34179.738,646,67121,0,2023-10-27 01:00:00,2023-10-27 01:00:00,42.28220238094946,-97.74348731493228,34118.04288095236,0.0021378742489988763,-5.6643441229351036e-05,34030.89367857141,34340.393405915886,34215.8971942099,34112.5977978596,34132.194214689094,-0.0004789535770603218,0.0015313340833688054,34027.067399697786,34204.380109862366,91.56986020490649,81.35182783726155,-105.61600202173598,34110.115952360466,34083.61151287067,34166.964078775374,26.504439489792276,5.829494171943275,123.06376207893527,16.94540591675468,12.144013759891095,3.7072786378121236,34334.60015758194,34000.82799996881,True,False,35179.738,33729.738,34649.738,34679.738,,False,2023-10-30 14:30:00,,2023-10-27 20:07:16,0.02,fail,False,-163.85,4826.460000000003,,0,2,43,October
2023-10-27 01:45:00,34179.938,34222.895,34133.84,34200.539,592,66325,0,2023-10-27 01:00:00,2023-10-27 01:00:00,42.28220238094946,-97.74348731493228,34118.04288095236,0.0021378742489988763,-5.6643441229351036e-05,34030.89367857141,34340.393405915886,34215.8971942099,34112.5977978596,34132.194214689094,-0.0004789535770603218,0.0015313340833688054,34027.067399697786,34204.380109862366,94.49667589487389,89.1016976738427,-105.61600202173598,34124.02719045886,34092.27280821359,34185.23494392844,31.7543822452717,11.014471786608961,124.32720704833064,18.270865153062914,16.94540591675468,12.144013759891095,34354.576673443684,34017.39321441319,True,False,35200.539,33750.539,34670.539,34700.539,,False,2023-10-30 14:30:00,,2023-10-27 04:54:09,0.02,fail,False,-163.85,4662.610000000002,,0,3,43,October
2023-10-27 02:00:00,34202.238,34232.34,34170.039,34228.238,509,47726,0,2023-10-27 02:00:00,2023-10-27 02:00:00,87.14920238094783,-72.03007255586272,34158.11645238097,0.001890400621227677,0.0008789876057892885,34118.04288095236,34333.44709443222,34376.08684342587,34340.393405915886,34215.8971942099,-5.6643441229351036e-05,0.0021378742489988763,34031.0192663763,34198.25690107338,96.20645999006403,94.09099869661476,-98.89881612856134,34140.05962269596,34102.34430390147,34204.47962745098,37.715318794493214,16.354641188185813,116.49165624490902,19.24468352254189,18.270865153062914,16.94540591675468,34363.2433633816,34047.215891520354,True,False,35228.238,33778.238,34698.238,34728.238,,False,2023-10-30 14:30:00,,2023-10-27 04:52:36,0.02,fail,False,-163.84,4498.770000000002,,0,4,43,October
2023-10-27 09:45:00,34131.34,34227.039,34131.34,34216.137,809,45203,0,2023-10-27 09:00:00,2023-10-27 09:00:00,4.916011904773768,-41.64251805553067,34109.00373809525,0.0009167471526849978,-0.00014402143090269502,34034.70339285715,34011.77642354206,34209.759838364786,33771.93553924265,34090.00887781692,-0.0005309803683190788,8.890361865637991e-05,34036.60692189674,34137.585032341565,81.15471031597151,74.72151626293608,-66.11588296922682,34099.268455670455,34077.6381031877,34107.9306883385,21.63035248275264,5.840508256470057,78.44160416823641,25.129732370129204,3.200908840735792,-12.113876160990912,34215.32685396562,34002.03452271138,True,False,35216.137,33766.137,34686.137,34716.137,,False,2023-10-30 14:30:00,,2023-10-27 20:07:15,0.02,fail,False,-163.84,4334.930000000002,,0,5,43,October
2023-10-30 11:00:00,34358.637,34487.238,34358.637,34435.242,1811,25023,0,2023-10-30 11:00:00,2023-10-30 11:00:00,41.71488095240056,55.72836113766243,34345.9640357143,-0.0005057987317100661,0.0011103103445633253,34254.665059523846,33985.142947474735,34806.27122505221,34000.962782337745,34371.97698394458,-0.0003740901100905438,-0.0005153856653899755,34125.48940267638,34209.03974368287,83.91060910958156,72.26376513848953,54.3451854090504,34290.933038640644,34276.02492263556,34287.119647058826,14.908116005084594,-2.2717339893377546,62.86935791955934,39.622767113869486,23.181613347071107,22.72090540075442,34373.49328025023,34202.24601386742,True,False,35435.242,34905.242,34905.242,34935.242,2023-11-01 23:00:00,True,2023-11-01 23:00:00,2023-11-02 00:00:25,,0.02,success,True,364.01,4698.940000000002,,1,0,44,October
2023-10-30 11:15:00,34435.266,34602.137,34433.977,34564.461,1638,42121,0,2023-10-30 11:00:00,2023-10-30 11:00:00,41.71488095240056,55.72836113766243,34345.9640357143,-0.0005057987317100661,0.0011103103445633253,34254.665059523846,33985.142947474735,34806.27122505221,34000.962782337745,34371.97698394458,-0.0003740901100905438,-0.0005153856653899755,34125.48940267638,34209.03974368287,87.69909244388947,80.94738389748694,54.3451854090504,34333.01426346516,34297.39055799589,34346.417897144805,35.623705469268316,5.3073539023834595,86.48161697803218,59.29825008597982,39.622767113869486,23.181613347071107,34464.66808006515,34229.66771422446,True,False,35564.461,34114.461,35034.461,35064.461,,False,2023-11-01 23:00:00,2023-11-02 02:23:55,2023-10-30 19:12:45,0.02,fail,False,-163.84,4535.100000000002,,0,1,44,October
2023-10-30 11:30:00,34564.496,34673.238,34540.84,34595.824,1635,42320,0,2023-10-30 11:00:00,2023-10-30 11:00:00,41.71488095240056,55.72836113766243,34345.9640357143,-0.0005057987317100661,0.0011103103445633253,34254.665059523846,33985.142947474735,34806.27122505221,34000.962782337745,34371.97698394458,-0.0003740901100905438,-0.0005153856653899755,34125.48940267638,34209.03974368287,89.01269364626391,86.87413173324494,54.3451854090504,34373.446530624366,34319.496738885086,34406.619328517365,53.949791739280045,15.035841469762776,106.64504016626856,60.201431372559455,59.29825008597982,39.622767113869486,34552.090132741825,34262.648524292905,True,False,35595.824,34145.824,35065.824,35095.824,,False,2023-11-02 00:15:00,2023-11-02 02:23:56,2023-10-30 19:12:37,0.02,fail,False,-163.84,4371.260000000002,,0,2,44,October
2023-10-30 19:00:00,34446.84,34450.34,34102.84,34162.332,2059,34188,0,2023-10-30 19:00:00,2023-10-30 19:00:00,-63.923821428543306,95.30006099105958,34471.191702380966,-0.001579792299214978,-0.0004529225423570189,34570.48650000002,33839.29991122233,34722.270328195256,34308.8084396888,34850.01895650431,-2.1645064250295514e-05,-0.00013985003905089973,34236.559040753375,34362.3922889691,13.818019926018948,15.00790299299891,99.07818539517874,34488.727923518425,34521.79892345229,34448.420742690025,-33.070999933865096,21.73023413435236,133.66906934312712,-73.08917371864663,-16.43141004467907,-48.86100206403353,34628.873986303246,34266.4674990768,False,True,33162.332,34612.332,33692.332,33662.332,,False,,,2023-10-31 22:17:01,0.02,fail,False,-163.84,4207.420000000002,,0,3,44,October
2023-10-31 05:45:00,34219.246,34246.137,34182.617,34193.738,999,47223,0,2023-10-31 05:00:00,2023-10-31 05:00:00,-38.934964285719616,8.19485149596585,34341.534833333346,-0.0003222249782284341,0.00029284866108037,34429.79938095237,34145.080776456154,34659.74072942549,34245.34152480649,34806.9291915225,0.001124845445488981,1.4453069804611302e-05,34280.60676161205,34370.92511133136,6.439785507129931,11.490585619733615,32.35864478546214,34325.09744329346,34373.6751751659,34267.80115651871,-48.57773187244311,-21.589974044483114,90.17102795976234,-37.74241658067331,-32.83576780190924,-26.569079807370144,34389.53204426439,34144.57026877303,False,True,33193.738,34643.738,33723.738,33693.738,,False,,,2023-10-31 22:46:29,0.02,fail,False,-163.84,4043.5800000000017,,0,4,44,October
2023-11-01 22:30:00,34776.938,34991.758,34719.238,34934.84,2133,55523,0,2023-11-01 22:00:00,2023-11-01 22:00:00,19.005916666639678,18.493289474026824,34700.987892857156,0.0022024078930787446,-0.00043577584665310354,34454.510345238086,34767.11334863218,35059.38172092303,34621.069837091876,34410.05252188821,-0.0024608913611150517,0.001968925029471349,34427.95341231426,34496.395887783576,88.31877045932735,75.75233201569233,6.366982509930626,34628.236088763,34547.49299636156,34703.60896491227,80.74309240144066,40.578274408048266,176.1575043231579,62.77410663914634,34.77000963186583,6.844771585863782,34942.921595748536,34465.79633407601,True,False,35934.84,35404.84,35404.84,35434.84,2023-11-02 00:15:00,True,2023-11-02 00:15:00,2023-11-02 04:47:56,2023-11-02 00:16:34,0.02,even,True,171.08,4214.660000000002,,1,0,44,November
2023-11-01 22:45:00,34936.84,35112.645,34936.246,35079.137,2168,62766,0,2023-11-01 22:00:00,2023-11-01 22:00:00,19.005916666639678,18.493289474026824,34700.987892857156,0.0022024078930787446,-0.00043577584665310354,34454.510345238086,34767.11334863218,35059.38172092303,34621.069837091876,34410.05252188821,-0.0024608913611150517,0.001968925029471349,34427.95341231426,34496.395887783576,95.57500284264883,86.62388216048244,6.366982509930626,34697.60545972254,34586.87403366811,34791.413831785365,110.7314260544299,54.60890473732459,213.4844328054246,87.80486687309167,62.77410663914634,34.77000963186583,35081.117816072685,34503.209847498045,True,False,36079.137,35549.137,35549.137,35579.137,2023-11-02 03:45:00,True,2023-11-02 03:45:00,,2023-11-02 03:53:12,0.02,even,True,171.08,4385.740000000002,,2,0,44,November
2023-11-02 00:00:00,35330.75,35509.84,35330.75,35462.34,1862,56133,0,2023-11-02 00:00:00,2023-11-02 00:00:00,246.4775476190698,83.68383507702674,34961.905559523824,0.0021991274574197405,0.003560739854016389,34700.987892857156,34843.328784777674,35966.71438336303,34767.11334863218,35059.38172092303,-0.00043577584665310354,0.0022024078930787446,34460.89398438037,34558.119256760896,94.33749713719557,92.74375681305723,21.83035302334985,34815.25692745753,34651.7233645075,34938.72446611628,163.53356295002595,76.39383637986487,277.4920671709336,147.31063433091185,87.80486687309167,62.77410663914634,35314.838756797035,34564.11017543552,True,False,36462.34,35012.34,35932.34,35962.34,,False,,,2023-11-02 15:44:11,0.02,fail,False,-163.84,4221.9000000000015,,0,1,44,November
2023-11-03 16:30:00,34693.238,34763.738,34607.84,34717.637,2723,39343,0,2023-11-03 16:00:00,2023-11-03 16:00:00,81.32859523810475,-102.98697606572387,34483.433178571424,0.0004993167249366013,0.0008367044185095476,34368.07504761903,34224.31633197173,34864.0387855035,33900.02479531732,34539.22953176129,-0.00017157251945888578,-0.0008975234496462403,34664.631658126505,34590.65601308094,88.6110000316615,87.61317746665334,-129.42537582745328,34464.07449416425,34409.365257915015,34546.32495012042,54.70923624923307,-4.672325230370575,147.5449248038895,61.011737186105165,71.85020639836875,37.675242518031155,34747.01059860567,34347.139301635165,True,False,35717.637,35187.637,35187.637,35217.637,2023-11-06 14:00:00,True,2023-11-06 14:00:00,2023-11-07 22:48:49,2023-11-06 14:07:40,0.02,even,True,171.08,4392.980000000001,,1,0,44,November
2023-11-03 17:00:00,34690.039,34750.637,34653.137,34734.539,1641,46829,0,2023-11-03 17:00:00,2023-11-03 17:00:00,115.35813095239428,-60.48211904284108,34600.117404761884,0.0014402426448722491,0.0009634207736368206,34483.433178571424,34450.045862421604,34939.516231131536,34224.31633197173,34864.0387855035,0.0008367044185095476,0.0004993167249366013,34667.20445584703,34601.82257203446,92.08442687747049,91.1075140306245,-115.63672447053085,34534.943833099846,34452.620565427824,34652.4697265222,82.32326767202176,24.44823932173742,181.29713671589514,55.65413450295455,50.49064189882483,61.011737186105165,34898.72086108866,34407.71859195574,True,False,35734.539,34284.539,35204.539,35234.539,,False,2023-11-07 20:15:00,2023-11-07 22:48:49,2023-11-03 19:46:17,0.02,fail,False,-163.84,4229.140000000001,,0,1,44,November
2023-11-06 00:15:00,34643.539,34745.738,34642.078,34736.137,923,63102,0,2023-11-06 00:00:00,2023-11-06 00:00:00,-11.149583333310147,-15.533333709397994,34640.10611904762,0.0002921479033872091,0.000851266922422398,34516.633654761914,34358.67988541841,35105.03219978668,34231.91937734951,34610.13079857034,-0.0007280617825670638,-0.00023650927447677235,34651.79616392741,34602.546353121375,92.23836463124972,89.33050435582986,-46.65230961589863,34572.17514219515,34539.480005207624,34601.466834537285,32.695136987524165,11.802562279642308,125.79976330386641,56.292192982415145,39.20091021670669,29.37818403854908,34772.796514997506,34431.63715407706,True,False,35736.137,35206.137,35206.137,35236.137,2023-11-07 20:15:00,True,2023-11-07 20:15:00,2023-11-07 22:48:49,2023-11-07 20:19:03,0.02,even,True,171.08,4400.220000000001,,1,0,45,November
2023-11-06 00:30:00,34736.137,34769.84,34679.211,34767.039,1264,67778,0,2023-11-06 00:00:00,2023-11-06 00:00:00,-11.149583333310147,-15.533333709397994,34640.10611904762,0.0002921479033872091,0.000851266922422398,34516.633654761914,34358.67988541841,35105.03219978668,34231.91937734951,34610.13079857034,-0.0007280617825670638,-0.00023650927447677235,34651.79616392741,34602.546353121375,95.56426865021159,92.53306733575414,-46.65230961589863,34602.154197242045,34556.3362270441,34655.11874062606,45.817970197946124,18.605643863303072,126.17582597894348,53.6519060887731,56.292192982415145,39.20091021670669,34826.95610569763,34484.781375554485,True,False,35767.039,35237.039,35237.039,35267.039,2023-11-07 20:15:00,True,2023-11-07 20:15:00,2023-11-07 22:49:12,2023-11-07 20:18:52,0.02,even,True,171.08,4571.300000000001,,2,0,45,November
2023-11-06 00:45:00,34767.039,35001.738,34767.039,34948.438,1213,61656,0,2023-11-06 00:00:00,2023-11-06 00:00:00,-11.149583333310147,-15.533333709397994,34640.10611904762,0.0002921479033872091,0.000851266922422398,34516.633654761914,34358.67988541841,35105.03219978668,34231.91937734951,34610.13079857034,-0.0007280617825670638,-0.00023650927447677235,34651.79616392741,34602.546353121375,96.2196765211783,94.6741032675465,-46.65230961589863,34655.42862843558,34585.38080281861,34733.67247093226,70.04782561696629,28.894080214035718,144.00283912640492,78.55373030620103,53.6519060887731,56.292192982415145,34929.5763037529,34539.268638111615,True,False,35948.438,34498.438,35418.438,35448.438,,False,2023-11-07 21:45:00,,2023-11-07 14:12:48,0.02,fail,False,-163.84,4407.460000000001,,0,1,45,November
2023-11-06 10:45:00,34882.406,34952.34,34856.879,34944.938,932,47824,0,2023-11-06 10:00:00,2023-11-06 10:00:00,6.730940476183605,67.45281593121035,34885.88632142856,-0.0003558818162480407,-0.0006509508676494637,34847.294833333326,34636.49432645288,34873.34112392442,34568.07234785442,34815.31753956943,-0.0008958929425687114,-0.0007833167056107116,34735.52306389295,34772.056139684035,84.98205645620901,79.90795707292885,67.30137366759928,34869.28974644137,34855.81071419146,34882.205932920515,13.479032249910233,4.658357791483568,55.19371795127225,24.39647093219537,14.640750602011394,16.54564809081785,34958.217452154735,34807.694413686295,True,False,35944.938,35414.938,35414.938,35444.938,2023-11-07 21:45:00,True,2023-11-07 21:45:00,2023-11-09 01:45:49,2023-11-07 21:53:14,0.02,even,True,171.08,4578.540000000001,,1,0,45,November
2023-11-06 11:00:00,34950.039,35049.738,34925.348,35041.996,1449,45496,0,2023-11-06 11:00:00,2023-11-06 11:00:00,38.59148809523322,70.29519786006131,34960.92095238098,0.00047404395621820575,0.000545630354531749,34885.88632142856,34839.32554589333,35179.876522397615,34636.49432645288,34873.34112392442,-0.0006509508676494637,-0.0003558818162480407,34750.35502217166,34799.39068850931,92.1695553966793,84.44668108611432,67.9001385060917,34895.85993929654,34869.602216843945,34920.061845545235,26.25772245259577,8.978230723706009,66.43073469623752,37.85591262472008,24.39647093219537,14.640750602011394,35011.24333738515,34830.38035370532,True,False,36041.996,34591.996,35511.996,35541.996,,False,2023-11-07 22:45:00,2023-11-09 01:45:50,2023-11-07 12:44:06,0.02,fail,False,-163.84,4414.700000000001,,0,1,45,November
2023-11-06 11:30:00,35038.34,35101.539,35037.641,35091.164,1713,43223,0,2023-11-06 11:00:00,2023-11-06 11:00:00,38.59148809523322,70.29519786006131,34960.92095238098,0.00047404395621820575,0.000545630354531749,34885.88632142856,34839.32554589333,35179.876522397615,34636.49432645288,34873.34112392442,-0.0006509508676494637,-0.0003558818162480407,34750.35502217166,34799.39068850931,96.23305796437829,94.85669268896878,67.9001385060917,34944.32424056143,34897.51884983191,35000.8938844169,46.80539072951797,20.80296415519027,87.28866426028492,44.57858961125021,36.253449260417256,37.85591262472008,35120.233581168286,34883.05418766552,True,False,36091.164,34641.164,35561.164,35591.164,,False,2023-11-07 23:00:00,2023-11-09 01:45:59,2023-11-07 12:06:19,0.02,fail,False,-163.84,4250.860000000001,,0,2,45,November
2023-11-06 11:45:00,35091.285,35113.738,35027.34,35113.738,1573,38223,0,2023-11-06 11:00:00,2023-11-06 11:00:00,38.59148809523322,70.29519786006131,34960.92095238098,0.00047404395621820575,0.000545630354531749,34885.88632142856,34839.32554589333,35179.876522397615,34636.49432645288,34873.34112392442,-0.0006509508676494637,-0.0003558818162480407,34750.35502217166,34799.39068850931,97.02492126721113,96.47514797914606,67.9001385060917,34970.38789585967,34913.535083177696,35035.304658410736,56.852812681972864,28.01293386054679,99.1615818698006,34.41077399383357,44.57858961125021,36.253449260417256,35170.672793934966,34901.436522886506,True,False,36113.738,34663.738,35583.738,35613.738,,False,2023-11-08 21:15:00,2023-11-09 04:23:40,2023-11-07 12:05:51,0.02,fail,False,-163.84,4087.0200000000004,,0,3,45,November
2023-11-06 12:00:00,35113.738,35133.738,35080.941,35127.07,1447,46555,0,2023-11-06 12:00:00,2023-11-06 12:00:00,75.0346309524175,89.28017307358823,35034.83208333334,0.0008980924105973044,0.0011787237281685862,34960.92095238098,34981.5794620553,35418.0922748573,34839.32554589333,35179.876522397615,0.000545630354531749,0.00047404395621820575,34765.828707576686,34827.03415342856,98.34928673474231,97.2024219887772,72.17614541959101,34994.49283495818,34929.35248442379,35064.27676986585,65.14035053439147,35.43841719531573,109.41526434371474,28.972111455113918,34.41077399383357,44.57858961125021,35213.48737672986,34916.56616300184,True,False,36127.07,34677.07,35597.07,35627.07,,False,2023-11-08 21:15:00,2023-11-09 04:23:40,2023-11-07 11:40:33,0.02,fail,False,-163.84,3923.1800000000003,,0,4,45,November
2023-11-07 20:00:00,34829.738,35366.441,34817.84,35271.84,2335,0,0,2023-11-07 20:00:00,2023-11-07 20:00:00,51.36315476191521,-44.65478225499828,34969.41986904759,0.00021965711442811033,0.0033339709444069826,34762.010285714314,34568.07754219539,35941.906811366054,34560.36263734096,34903.27355889407,0.00035745001290412616,0.0002196156434213256,34857.80603538583,34867.0519775662,89.72603455373927,79.38959601568507,-51.50488043971273,34816.68882952779,34772.62907734522,34823.798341589296,44.059752182569355,-0.5612752000941974,125.68765003705788,93.81491675270081,15.143906088749645,11.925852769163612,34994.97666913932,34654.12001403927,True,False,36271.84,35741.84,35741.84,35771.84,2023-11-09 00:15:00,True,2023-11-09 00:15:00,2023-11-09 04:23:41,2023-11-09 00:21:37,0.02,even,True,171.08,4094.26,,1,0,45,November
2023-11-07 21:00:00,35372.539,35579.438,35327.34,35420.176,3176,43433,0,2023-11-07 21:00:00,2023-11-07 21:00:00,207.4095833332758,28.92049287392001,35154.248642857136,0.0004942636417444599,0.0037495504919607715,34969.41986904759,34627.71638304906,36129.319192400835,34568.07754219539,35941.906811366054,0.0033339709444069826,0.00021965711442811033,34880.80336733148,34913.226859360904,81.73248396564166,78.64547444962412,-35.41980577698618,35057.60729047009,34912.490089405925,35175.10331544548,145.1172010641676,66.4920365694393,237.9329660166087,101.11340763674525,99.33997660817113,79.13575163396308,35497.8128195679,34853.893811323054,True,False,36420.176,35890.176,35890.176,35920.176,2023-11-09 03:45:00,True,2023-11-09 03:45:00,2023-11-09 04:23:41,2023-11-09 03:51:26,0.02,even,True,171.08,4265.34,,2,0,45,November
2023-11-08 21:00:00,35579.641,35717.738,35562.781,35689.648,2262,40890,0,2023-11-08 21:00:00,2023-11-08 21:00:00,90.16119047615211,53.45991367322131,35474.30897619048,0.00102682611197931,0.0014102006421194083,35397.70446428569,35317.067623695104,35935.62163534102,34858.81941872685,35719.74759889055,0.0007952867962463692,-0.0008301928260363985,35173.955191146364,35305.33786474137,94.61689763991615,89.43965491599819,44.629523797031794,35423.93597676478,35361.94376302818,35490.0119618163,61.99221373659384,20.803712327797278,121.96521658916797,68.73651565183536,61.329457860403636,40.499170622599195,35656.165004211674,35325.35891942093,True,False,36689.648,35239.648,36159.648,36189.648,,False,2023-11-09 04:30:00,2023-11-09 04:26:23,,0.02,success,True,364.0,4629.34,,3,0,45,November
2023-11-09 11:45:00,36766.676,36839.57,36672.09,36828.438,2116,35449,0,2023-11-09 11:00:00,2023-11-09 11:00:00,14.319976190476154,315.1259485875562,36723.22248809524,0.002918932125500053,-0.00010057992707521822,36692.77761904764,36941.14147984562,36826.18875229479,36940.44455421523,37287.556911097185,0.0015452871131897273,0.0032253521405816218,35649.71189705601,36028.372782247534,83.42779416012658,68.02745110845159,259.6879920621351,36679.738824563894,36560.87960435913,36696.449517715846,118.85922020476573,130.98431024218343,94.72639345225464,23.150470932210737,20.857046783610713,15.92649948401231,36825.83014887639,36568.5688865553,True,False,37828.438,36378.438,37298.438,37328.438,,False,2023-11-09 16:15:00,2023-11-09 16:11:15,2023-11-09 18:12:47,0.02,success,True,364.0,4993.34,,4,0,45,November
2023-11-14 10:15:00,36715.84,36743.738,36663.945,36728.34,1179,41621,0,2023-11-14 10:00:00,2023-11-14 10:00:00,71.38198809523601,-38.83951562951552,36694.61303571427,0.0017910583823342262,0.001481952247946894,36646.43165476192,36873.7307655697,37002.9931447136,36759.4552951378,36884.92185347611,0.0011023828809752464,0.0015898364086088994,36683.700972636056,36663.10343651119,92.08942013841028,90.94430432446775,-87.9243036132674,36651.50273365969,36593.3064874964,36729.675149638824,58.196246163293836,43.00090398880314,110.81806177512594,14.089837633327988,18.280099071191216,11.844652906765987,36880.779533035246,36580.0707662424,True,False,37728.34,36278.34,37198.34,37228.34,,False,2023-11-15 21:00:00,2023-11-15 21:06:06,2023-11-14 13:27:42,0.02,fail,False,-163.84,4829.5,,0,1,46,November
2023-11-15 20:15:00,37064.402,37419.039,36713.938,37139.238,6293,0,0,2023-11-15 20:00:00,2023-11-15 20:00:00,68.49261904759624,169.82552943228075,36715.18328571427,0.0021795596427185296,0.004850459408503486,36371.87385714283,36589.246373035174,38170.29375403303,36417.161164935984,36721.53774043602,0.0010596222413725817,0.001799676869690146,36169.489189812324,36120.48580081264,80.28345634049799,77.113199187176,72.0194095595545,36545.23131977828,36331.553818683016,36701.12329308568,213.67750109526241,142.25151276214876,276.73778669223657,138.27109219125123,134.98621568631643,31.96188716887991,37076.2193051202,36327.52728105116,True,False,38139.238,37609.238,37609.238,37639.238,2023-11-15 23:45:00,True,2023-11-15 23:45:00,,2023-11-15 23:52:52,0.02,even,True,171.08,5000.58,,1,0,46,November
2023-11-15 20:45:00,37202.813,37522.477,37182.82,37385.238,5180,5922,0,2023-11-15 20:00:00,2023-11-15 20:00:00,68.49261904759624,169.82552943228075,36715.18328571427,0.0021795596427185296,0.004850459408503486,36371.87385714283,36589.246373035174,38170.29375403303,36417.161164935984,36721.53774043602,0.0010596222413725817,0.001799676869690146,36169.489189812324,36120.48580081264,84.0952269562434,81.20721697337581,72.0194095595545,36760.537359131195,36469.61027253345,36990.221472652236,290.9270865977451,189.32164470198836,392.1828985212671,153.66597007226665,135.43220949429087,138.27109219125123,37521.16838565595,36460.774559648526,True,False,38385.238,36935.238,37855.238,37885.238,,False,,,2023-11-16 15:16:11,0.02,fail,False,-163.84,4836.74,,0,1,46,November
2023-11-15 21:00:00,37387.637,37810.414,37292.781,37423.84,5299,36125,0,2023-11-15 21:00:00,2023-11-15 21:00:00,343.30942857143964,282.2747440365347,37058.43324999998,0.0054029316546150745,0.005460737000071787,36715.18328571427,37329.437093182605,38546.488595299226,36589.246373035174,38170.29375403303,0.004850459408503486,0.0021795596427185296,36221.64616276086,36230.80629674763,82.95181845957627,82.09667101306857,114.07047645495055,36862.58391926486,36540.29395604949,37122.52351152392,322.28996321536397,215.9153084046635,441.8323394567914,132.30203887168318,153.66597007226665,135.43220949429087,37720.497169790586,36526.04985325725,True,False,38423.84,36973.84,37893.84,37923.84,,False,,,2023-11-16 15:15:28,0.02,fail,False,-163.84,4672.9,,0,2,46,November
2023-11-16 01:45:00,37830.441,37962.938,37767.691,37849.34,4187,62325,0,2023-11-16 01:00:00,2023-11-16 01:00:00,145.60465476191166,473.2059247301804,37809.77321428574,0.006289226148917118,0.004544589015743002,37668.35952380954,38436.759519644555,39128.73037005596,38364.20665271892,39744.2231208726,0.007629912181378847,0.006876256410782881,36435.92253607159,36640.855992996236,81.88287838022325,76.95734379544488,304.10549750260003,37676.41518813267,37403.299044490996,37790.660599931194,273.11614364167326,297.20392434628263,293.40221197066546,30.303769865844515,33.04243102851615,17.92343137255375,38188.253586091596,37394.56761377079,True,False,38849.34,37399.34,38319.34,38349.34,,False,,,2023-11-16 03:59:18,0.02,fail,False,-163.84,4509.0599999999995,,0,3,46,November
2023-11-16 21:15:00,36023.238,36143.039,35653.84,35747.824,5370,38711,0,2023-11-16 21:00:00,2023-11-16 21:00:00,-118.68814285714325,-231.11650184595055,36134.72769047617,-0.005324394706065471,-0.0037933387816317687,36304.01052380953,34809.13257256928,35869.08620516363,35162.97260286482,35944.79291997657,-0.004158335790273521,-0.004578786698941505,36717.71693405977,36789.46960749859,16.444988402178463,18.273415317327615,-70.6780726083368,36253.528819053725,36505.49250558983,36092.21818507052,-251.9636865361026,-210.22786101500233,269.119124926638,-112.16258823528187,-69.46235294116923,-52.36375782597315,36455.52900372148,35727.40736641955,False,True,34747.824,36197.824,35277.824,35247.824,,False,,,2023-11-17 00:20:32,0.02,fail,False,-163.84,4345.219999999999,,0,4,46,November
2023-11-17 15:00:00,36514.637,36606.555,36441.641,36578.84,3464,41024,0,2023-11-17 15:00:00,2023-11-17 15:00:00,70.38619047617976,-25.371722149997368,36389.07122619049,-0.00011490626253748206,0.000656233205531762,36397.62236904762,36078.015373895614,36690.73727630725,36070.606699961,36581.99719391795,0.00041269311418127663,-0.0001729729710921962,36517.74970318455,36441.43369724628,90.64735535987619,80.70411264145291,-73.05508065477991,36399.926395516595,36360.73177662152,36425.08161953907,39.19461889507511,13.422101345805238,98.96143974872696,45.288463708318886,38.508277605767944,-2.382800137551385,36560.179563199854,36291.48367587829,True,False,37578.84,36128.84,37048.84,37078.84,,False,2023-11-20 01:15:00,2023-11-20 18:00:39,2023-11-17 16:45:33,0.02,fail,False,-163.84,4181.379999999999,,0,5,46,November
2023-11-20 00:30:00,36910.238,36958.039,36897.484,36958.039,614,65121,0,2023-11-20 00:00:00,2023-11-20 00:00:00,39.30678571430326,-0.19831575486023212,36622.26414285712,0.0022304624440268243,0.0007177711856211652,36424.47179761906,36631.66884843973,37105.900797065886,36606.27574978075,36856.123915611126,-8.539127028231886e-05,0.002441706600156288,36470.76907061116,36413.88994753524,90.34128341427906,71.71374690767995,-36.150281939733375,36593.603828467414,36469.377126888605,36649.90232989336,124.2267015788093,64.49935975836732,232.2207085996069,97.66260302718729,94.15738562091428,108.07140282072942,36964.90028650283,36336.40437328389,True,False,37958.039,37428.039,37428.039,37458.039,2023-11-20 20:00:00,True,2023-11-20 20:00:00,,2023-11-20 20:09:20,0.02,even,True,171.08,4352.459999999999,,1,0,47,November
2023-11-20 00:45:00,36958.738,36962.637,36909.047,36961.637,534,62945,0,2023-11-20 00:00:00,2023-11-20 00:00:00,39.30678571430326,-0.19831575486023212,36622.26414285712,0.0022304624440268243,0.0007177711856211652,36424.47179761906,36631.66884843973,37105.900797065886,36606.27574978075,36856.123915611126,-8.539127028231886e-05,0.002441706600156288,36470.76907061116,36413.88994753524,91.20610245728606,84.14826798391044,-36.150281939733375,36650.224316395506,36505.84082119315,36732.75782387341,144.38349520235352,80.47618684716457,234.3978655732514,82.85549398005242,97.66260302718729,94.15738562091428,37050.694942397306,36416.32070534952,True,False,37961.637,37431.637,37431.637,37461.637,2023-11-20 20:00:00,True,2023-11-20 20:00:00,,2023-11-20 20:09:20,0.02,even,True,171.08,4523.539999999999,,2,0,47,November
2023-11-20 01:00:00,36961.637,37413.539,36961.637,37361.395,3459,48938,0,2023-11-20 01:00:00,2023-11-20 01:00:00,197.79234523806372,69.34935358960502,36893.03361904762,0.0022306097350022138,0.002714934778756459,36622.26414285712,36714.323293492176,37846.16596198592,36631.66884843973,37105.900797065886,0.0007177711856211652,0.0022304624440268243,36504.84232274406,36487.94971173242,94.07660710994206,91.87466432716904,-15.050354833865697,36759.635190796194,36569.215204808475,36881.36407911935,190.41998598771897,102.46494667527546,272.20747901855214,148.60625524593343,82.85549398005242,97.66260302718729,37250.344175794395,36513.8839824443,True,False,38361.395,36911.395,37831.395,37861.395,,False,,,2023-11-20 16:11:10,0.02,fail,False,-163.84,4359.699999999999,,0,1,47,November
2023-11-20 09:45:00,37178.777,37250.34,37152.742,37234.84,1422,47324,0,2023-11-20 09:00:00,2023-11-20 09:00:00,-42.98227380955359,200.15776044826634,37171.57926190479,-0.00030340777530954275,-0.0004631641601923394,37151.68076190475,36939.40568272017,37189.20535981646,37080.20854054304,37044.98100168449,-0.0011239522057144807,0.0003043564246515448,36697.476868233316,36837.032976961826,84.23668914325656,73.61679277557354,179.7538555298263,37162.713052379346,37131.29429217067,37171.25155108363,31.41876020867494,36.771185822975596,70.16088758442865,26.368364293135528,16.768457860343915,15.76287719290849,37267.46874932261,37076.534352844654,True,False,38234.84,36784.84,37704.84,37734.84,,False,2023-11-22 23:30:00,,2023-11-20 16:11:13,0.02,fail,False,-163.84,4195.859999999999,,0,2,47,November
2023-11-21 16:00:00,36995.84,37008.238,36847.84,36898.738,2695,44625,0,2023-11-21 16:00:00,2023-11-21 16:00:00,-90.4907142857337,-61.64947560172004,36948.02814285715,-0.0031259434073918698,-0.002122481374661005,37142.775047619034,36023.600025730055,36842.40515481081,36858.790765315076,37259.38017277886,-0.000582133828475823,-0.0010421266771467488,37118.646255211366,37220.88257684658,4.460521689844595,8.91385926217238,-3.69574436481067,37117.255974329935,37206.93734967017,37035.59682662539,-89.68137534023117,-61.64227193448885,130.49527360285734,-49.89939766082534,-33.788894048811926,-28.983011695927416,37211.76544598925,36857.92820726153,False,True,35898.738,36428.738,36428.738,36398.738,2023-11-21 17:15:00,True,2023-11-21 17:15:00,2023-11-22 01:46:25,2023-11-21 17:15:27,0.02,even,True,171.08,4366.939999999999,,1,0,47,November
2023-11-22 00:15:00,36764.543,36764.738,36563.84,36563.84,1772,60054,0,2023-11-22 00:00:00,2023-11-22 00:00:00,-50.780416666668316,-118.9380726164527,36668.26885714283,0.00030462887118273667,-0.003024324836203769,36885.82041666665,36302.87308840726,36552.797985001016,36974.5938093713,37154.018061690585,-0.0012508047910559242,0.00226390671443962,37041.56503916984,37025.44246615296,9.525361000392481,18.86234028973804,-93.39786201758977,36831.6524677513,36895.513780829046,36823.68605091162,-63.86131307774485,-33.89433934827034,160.25950686084454,-64.39464809080528,-34.3437230821728,-7.398047471622704,37040.036385173764,36605.83571664948,False,True,35563.84,36093.84,36093.84,36063.84,2023-11-22 01:45:00,True,2023-11-22 01:45:00,,2023-11-22 02:29:52,0.02,even,True,171.08,4538.019999999999,,2,0,47,November
2023-11-22 00:30:00,36563.84,36575.539,36365.754,36415.637,2635,56324,0,2023-11-22 00:00:00,2023-11-22 00:00:00,-50.780416666668316,-118.9380726164527,36668.26885714283,0.00030462887118273667,-0.003024324836203769,36885.82041666665,36302.87308840726,36552.797985001016,36974.5938093713,37154.018061690585,-0.0012508047910559242,0.00226390671443962,37041.56503916984,37025.44246615296,7.969505586210694,11.884157802316574,-93.39786201758977,36767.65008809726,36859.96735261949,36726.03492191263,-92.31726452222938,-45.57892438306215,190.1672273863951,-97.65112899899395,-64.39464809080528,-34.3437230821728,36982.76067888426,36467.809164941,False,True,35415.637,35945.637,35945.637,35915.637,2023-11-22 02:00:00,True,2023-11-22 02:00:00,,2023-11-22 02:12:42,0.02,even,True,171.08,4709.0999999999985,,3,0,47,November
2023-11-22 00:45:00,36415.637,36547.738,36263.84,36348.84,1942,63289,0,2023-11-22 00:00:00,2023-11-22 00:00:00,-50.780416666668316,-118.9380726164527,36668.26885714283,0.00030462887118273667,-0.003024324836203769,36885.82041666665,36302.87308840726,36552.797985001016,36974.5938093713,37154.018061690585,-0.0012508047910559242,0.00226390671443962,37041.56503916984,37025.44246615296,5.291543469968322,7.595470018857138,-93.39786201758977,36703.21776685153,36822.10606724027,36635.90875576196,-118.88830038873857,-60.24079958419743,220.4158443740243,-90.12616615067236,-97.65112899899395,-64.39464809080528,36933.47014566689,36336.84736585702,False,True,35348.84,35878.84,35878.84,35848.84,2023-11-22 02:00:00,True,2023-11-22 02:00:00,,2023-11-22 02:06:08,0.02,even,True,171.08,4880.1799999999985,,4,0,47,November
2023-11-22 01:30:00,36080.664,36167.738,35924.84,36040.738,3999,48187,0,2023-11-22 01:00:00,2023-11-22 01:00:00,-217.55155952381756,-169.2094531499315,36298.0585952381,-0.00424658664189039,-0.003944405310683219,36668.26885714283,35130.60858001797,36215.75830400771,36302.87308840726,36552.797985001016,-0.003024324836203769,0.00030462887118273667,36989.002606261216,36919.50490886073,6.754424184812181,7.166405361110177,-108.56018024405813,36470.412568811735,36677.06884898792,36278.21663811486,-206.65628017618292,-119.62931451859097,293.4416917766225,-124.45637082909525,-127.83586618505797,-105.39988063294004,36674.3629220133,35880.57035421643,False,True,35040.738,36490.738,35570.738,35540.738,,False,,,2023-11-22 08:34:33,0.02,fail,False,-163.84,4716.339999999998,,0,1,47,November
2023-11-22 01:45:00,36040.738,36076.039,35685.879,35701.223,4163,35515,0,2023-11-22 01:00:00,2023-11-22 01:00:00,-217.55155952381756,-169.2094531499315,36298.0585952381,-0.00424658664189039,-0.003944405310683219,36668.26885714283,35130.60858001797,36215.75830400771,36302.87308840726,36552.797985001016,-0.003024324836203769,0.00030462887118273667,36989.002606261216,36919.50490886073,4.443744461265548,5.997462679119766,-108.56018024405813,36352.07571207147,36604.783971285106,36114.68836498108,-252.70825921363576,-146.24510345759995,360.07401255366403,-163.52827313378657,-124.45637082909525,-127.83586618505797,36600.78828192852,35627.08844803363,False,True,34701.223,36151.223,35231.223,35201.223,,False,,,2023-11-22 03:46:32,0.02,fail,False,-163.84,4552.499999999998,,0,2,47,November
2023-11-22 20:15:00,36677.348,37147.34,36676.32,37082.738,4571,14688,0,2023-11-22 20:00:00,2023-11-22 20:00:00,35.56802380951558,-22.160678789790836,36712.665250000005,-0.00019438179182381591,0.002396201390671307,36470.780928571425,36167.95046094994,37579.65871690639,35986.79020860505,36543.78100223593,-0.0005426774785878023,-0.0011421590710436133,36725.257334264,36609.11344416158,91.40475081145878,86.50645082865782,-52.3020512221184,36606.26224114603,36541.64547036332,36639.24122119023,64.61677078271168,13.414956495678382,141.84352303727587,118.91407980736403,38.81369074645045,14.165386308959569,36832.229977290546,36447.75246508991,True,False,38082.738,37552.738,37552.738,37582.738,2023-11-22 23:00:00,True,2023-11-22 23:00:00,2023-11-24 13:34:50,2023-11-22 23:01:09,0.02,even,True,171.08,4723.579999999998,,1,0,47,November
2023-11-22 20:30:00,37083.938,37230.191,37067.734,37129.84,3574,18156,0,2023-11-22 20:00:00,2023-11-22 20:00:00,35.56802380951558,-22.160678789790836,36712.665250000005,-0.00019438179182381591,0.002396201390671307,36470.780928571425,36167.95046094994,37579.65871690639,35986.79020860505,36543.78100223593,-0.0005426774785878023,-0.0011421590710436133,36725.257334264,36609.11344416158,92.76579289630105,90.12672796270954,-52.3020512221184,36686.8126655851,36585.21543552159,36759.561385620924,101.59723006351123,31.051411209244954,187.67120264883516,120.32016443069733,118.91407980736403,38.81369074645045,37014.41750919685,36506.205262045,True,False,38129.84,37599.84,37599.84,37629.84,2023-11-22 23:15:00,True,2023-11-22 23:15:00,2023-11-24 13:34:50,2023-11-22 23:16:14,0.02,even,True,171.08,4894.659999999998,,2,0,47,November
2023-11-28 13:30:00,37151.238,37195.84,37109.938,37153.84,963,44122,0,2023-11-28 13:00:00,2023-11-28 13:00:00,38.968523809518956,-9.016099253414723,37107.68902380953,0.00041722402576181933,0.0004775057517644411,37023.57198809523,36976.03907663765,37295.70134311654,36952.80084836579,37066.87979874874,-0.0002475379606389265,0.00039375703985912577,37145.33922637351,37075.468581155765,88.99619069481163,85.44143717532836,-22.374102717922664,37061.775644333575,37037.1957499226,37087.77946508431,24.57989441097743,4.805536508661516,74.80938272075812,24.740026831837895,29.500199174399313,15.173570003440545,37190.27213175734,36986.78679841129,True,False,38153.84,37623.84,37623.84,37653.84,2023-11-28 18:45:00,True,2023-11-28 18:45:00,2023-11-28 19:22:32,2023-11-29 17:09:29,0.02,success,True,364.0,5258.659999999998,,3,0,48,November
2023-11-28 13:45:00,37152.848,37233.34,37133.84,37223.84,832,44824,0,2023-11-28 13:00:00,2023-11-28 13:00:00,38.968523809518956,-9.016099253414723,37107.68902380953,0.00041722402576181933,0.0004775057517644411,37023.57198809523,36976.03907663765,37295.70134311654,36952.80084836579,37066.87979874874,-0.0002475379606389265,0.00039375703985912577,37145.33922637351,37075.468581155765,92.37154111664078,90.16731799355283,-22.374102717922664,37086.70862212841,37051.02124992833,37119.474741314065,35.68737220008188,10.98190364694559,80.94194234237307,31.69527622975147,24.740026831837895,29.500199174399313,37230.24636347627,37010.20311915186,True,False,38223.84,37693.84,37693.84,37723.84,2023-11-28 18:45:00,True,2023-11-28 18:45:00,2023-11-28 21:41:13,2023-11-29 01:37:03,0.02,success,True,364.0,5622.659999999998,,4,0,48,November
2023-11-28 19:00:00,37840.34,37920.637,37739.84,37876.773,2171,42980,0,2023-11-28 19:00:00,2023-11-28 19:00:00,172.6149285713982,144.46899207655952,37805.669380952386,0.0019302691716493543,0.004316862490976904,37558.076726190455,37659.039464621965,38807.0131772163,37585.78582106204,38304.78970223593,0.003010156917109556,0.0019302630680658875,37238.912565434395,37285.147653488166,91.3869529744956,88.74444736110054,53.68266889244255,37573.47745827148,37404.666110446604,37707.87823460613,168.81134782487788,120.83025674614998,218.03783588935434,73.22334778120421,73.99101410389994,60.84810698311776,38003.729313056756,37413.5271561555,True,False,38876.773,38346.773,38346.773,38376.773,2023-12-01 11:15:00,True,2023-12-01 11:15:00,2023-12-01 18:34:32,2023-12-01 14:44:31,0.02,even,True,171.08,5793.739999999998,,5,0,48,November
2023-11-29 17:00:00,37779.543,37853.34,37544.84,37569.051,2889,42922,0,2023-11-29 17:00:00,2023-11-29 17:00:00,-107.78455952382501,51.67392316929909,37881.8314642857,-0.0018110817883532108,-0.001618840675953578,37979.64410714284,37288.02115347222,37876.42928378901,37630.50357884129,37995.15062434593,-0.0014430589053464145,-0.0008373755333757264,37678.634563645115,37879.52379265382,5.541368984479074,18.703689670599026,109.44917138501782,37944.80318608685,38009.2003626155,37927.08819711041,-64.39717652864783,-10.420826034697823,151.49682223737946,-102.0619999999908,-47.3059855521351,-29.912626418998116,38131.608907130874,37721.067487089946,False,True,36569.051,38019.051,37099.051,37069.051,,False,,,2023-11-30 06:07:26,0.02,fail,False,-163.84,5629.899999999998,,0,1,48,November
2023-11-30 06:00:00,38005.023,38102.84,37986.137,38099.438,744,45426,0,2023-11-30 06:00:00,2023-11-30 06:00:00,106.30915476186783,-5.418565928492171,37893.14774999998,0.0006225516178513913,0.001371892527810179,37855.17076190475,37776.98815923279,38291.43277485708,37753.510860580755,38091.16419675934,0.0006137086389933796,0.0006224657988748365,37721.5112757917,37823.05286290678,97.63063163837616,90.26167730931593,-28.13815609855039,37875.750118445125,37819.1461112966,37916.822945648426,56.60400714852585,19.61549057996897,97.94326043498866,61.64946061230876,45.41742311659618,31.912702786416048,38050.546347235664,37784.59954406119,True,False,39099.438,37649.438,38569.438,38599.438,,False,2023-12-01 12:00:00,,2023-11-30 10:23:15,0.02,fail,False,-163.84,5466.059999999998,,0,2,48,November
2023-12-01 03:45:00,37883.738,37917.137,37825.813,37901.137,1160,46023,0,2023-12-01 03:00:00,2023-12-01 03:00:00,-23.842309523803124,-23.661110395863943,37737.217833333314,-0.0006268504637305893,0.0005807816698401615,37663.59088095238,37419.43329445485,38005.96702433776,37517.11401023636,37761.501454422374,-3.461462643109507e-05,-0.0001933981185423868,37714.745351959325,37729.02466197983,93.0298197827287,75.77271030359104,-25.40822732061864,37739.09709009864,37710.07846502545,37739.26980082559,29.018625073193107,1.2964795916106304,79.32998315776194,41.43179497765232,38.15654351567355,35.52394496041234,37847.86527808857,37632.17432356261,True,False,38901.137,38371.137,38371.137,38401.137,2023-12-01 11:30:00,True,2023-12-01 11:30:00,2023-12-01 18:34:33,2023-12-01 14:42:36,0.02,even,True,171.08,5637.139999999998,,1,0,48,December
2023-12-01 09:00:00,38170.691,38294.938,38156.938,38268.34,1631,44078,0,2023-12-01 09:00:00,2023-12-01 09:00:00,63.74878571431327,107.90786182280863,38187.2398690476,0.0023004287212657305,0.002148263497215025,38137.9188571429,38435.183170498145,38751.87107224446,38346.762590569735,38677.52051479197,0.0021896796214107075,0.00230036762129819,37796.785426761686,37877.145954847714,83.81825462922681,69.53155794743014,47.8423860746274,38112.04549915839,38015.52581473091,38174.96810904715,96.5196844274833,93.31093629619895,142.53951028033603,25.77857241142192,5.109230134185054,3.678751977982756,38368.8964479256,37982.539770168696,True,False,39268.34,38738.34,38738.34,38768.34,2023-12-01 23:15:00,True,2023-12-01 23:15:00,2023-12-04 00:05:00,,0.02,success,True,364.0,6001.139999999998,,2,0,48,December
2023-12-01 09:15:00,38268.34,38318.539,38243.645,38303.84,1549,36223,0,2023-12-01 09:00:00,2023-12-01 09:00:00,63.74878571431327,107.90786182280863,38187.2398690476,0.0023004287212657305,0.002148263497215025,38137.9188571429,38435.183170498145,38751.87107224446,38346.762590569735,38677.52051479197,0.0021896796214107075,0.00230036762129819,37796.785426761686,37877.145954847714,91.36428733611898,81.29965198423777,47.8423860746274,38141.55234544171,38036.882421047136,38204.56264361884,104.66992439457681,95.58273391587453,130.56115263354135,29.59453457169002,25.77857241142192,5.109230134185054,38382.32019967412,38028.30508756356,True,False,39303.84,38773.84,38773.84,38803.84,2023-12-01 23:45:00,True,2023-12-01 23:45:00,2023-12-04 00:05:00,,0.02,success,True,364.0,6365.139999999998,,3,0,48,December
2023-12-01 11:00:00,38271.938,38423.637,38271.938,38395.738,1310,40820,0,2023-12-01 11:00:00,2023-12-01 11:00:00,33.0932023809728,132.83154233148525,38389.17120238096,0.0018910865689708122,0.0025038618991095694,38220.33307142857,38509.91806236721,39063.030975617316,38476.90237344219,38571.59721798733,0.0012459526321323413,0.0021848745352344816,37849.32157233942,37970.42601298311,81.67714346208129,74.37495796394842,76.42393770626799,38236.93134473957,38134.61158103046,38297.24580460955,102.31976370910706,98.2416420849706,116.7653495006886,40.91930753354245,18.51781733741518,10.817603715237055,38456.379026435476,38139.61258278362,True,False,39395.738,37945.738,38865.738,38895.738,,False,2023-12-04 00:15:00,2023-12-04 00:05:00,,0.02,success,True,364.0,6729.139999999998,,4,0,48,December
2023-12-01 11:15:00,38397.738,38716.082,38397.738,38559.738,3551,27226,0,2023-12-01 11:00:00,2023-12-01 11:00:00,33.0932023809728,132.83154233148525,38389.17120238096,0.0018910865689708122,0.0025038618991095694,38220.33307142857,38509.91806236721,39063.030975617316,38476.90237344219,38571.59721798733,0.0012459526321323413,0.0021848745352344816,37849.32157233942,37970.42601298311,82.82451831432171,77.89947083322603,76.42393770626799,38286.59390708733,38166.10242688006,38362.71153732368,120.49148020726716,102.69160970942991,134.58261102450086,65.46573271413217,40.91930753354245,18.51781733741518,38545.898062206754,38181.02501244061,True,False,39559.738,38109.738,39029.738,39059.738,,False,2023-12-04 00:15:00,2023-12-04 00:05:00,,0.02,success,True,364.0,7093.139999999998,,5,0,48,December
2023-12-04 00:15:00,39767.637,39994.121,39691.84,39864.938,2087,52808,0,2023-12-04 00:00:00,2023-12-04 00:00:00,36.148785714300175,170.91185732399754,39200.76316666668,0.0019246222834315855,0.005817243178796055,38779.689630952416,39042.59633778621,41199.740378078,38940.069057060224,38929.09711975098,-0.0001008410828266853,0.0018571155714705175,38203.8738568752,38503.720656554666,87.17635840921791,78.37360667669897,163.1143103137409,39046.18271665967,38834.527027173615,39145.97749810802,211.65568948605505,111.3191618444479,303.8222654526756,199.62615067080333,191.5915717234093,12.066772273828974,39557.63755646913,38735.817439746905,True,False,40864.938,40334.938,40334.938,40364.938,2023-12-04 03:30:00,True,2023-12-04 03:30:00,2023-12-04 03:47:17,,0.02,success,True,364.0,7457.139999999998,,6,0,49,December
2023-12-04 00:30:00,39864.641,40346.438,39863.941,39908.238,3086,5000,0,2023-12-04 00:00:00,2023-12-04 00:00:00,36.148785714300175,170.91185732399754,39200.76316666668,0.0019246222834315855,0.005817243178796055,38779.689630952416,39042.59633778621,41199.740378078,38940.069057060224,38929.09711975098,-0.0001008410828266853,0.0018571155714705175,38203.8738568752,38503.720656554666,87.19242812111766,85.03265922949798,163.1143103137409,39178.80660640434,38914.0611733089,39335.564501892004,264.74543309543515,142.00441609464536,373.8148808565359,189.58700378398498,199.62615067080333,191.5915717234093,39841.71459104833,38830.91441273568,True,False,40908.238,40378.238,40378.238,40408.238,2023-12-04 03:30:00,True,2023-12-04 03:30:00,2023-12-04 06:57:06,,0.02,success,True,364.01,7821.149999999998,,7,0,49,December
2023-12-04 05:00:00,40673.637,40808.738,40658.938,40755.539,951,45621,0,2023-12-04 05:00:00,2023-12-04 05:00:00,291.2874642857423,586.5567230433662,40703.58486904764,0.008236639652854583,0.004347358430527079,40514.80160714286,41887.613837365316,41885.95602466244,41785.53821194658,42481.87618075124,0.006774272857528124,0.00891018676814664,38608.060002599326,39167.261973879715,82.9213985683706,79.18002238473657,378.5039397021631,40460.8048582429,40044.4377077257,40722.01085104918,416.3671505171951,412.6829063326929,629.3555695249881,59.5250254557468,52.289399036853865,50.265327141358284,41573.14086990791,39872.38083219044,True,False,41755.539,41225.539,41225.539,41255.539,2023-12-04 07:30:00,True,2023-12-04 07:30:00,2023-12-04 08:29:07,2023-12-04 17:34:05,0.02,success,True,364.01,8185.159999999998,,8,0,49,December
2023-12-04 05:15:00,40758.738,40873.738,40701.039,40864.238,1335,40922,0,2023-12-04 05:00:00,2023-12-04 05:00:00,291.2874642857423,586.5567230433662,40703.58486904764,0.008236639652854583,0.004347358430527079,40514.80160714286,41887.613837365316,41885.95602466244,41785.53821194658,42481.87618075124,0.006774272857528124,0.00891018676814664,38608.060002599326,39167.261973879715,89.49032013675598,83.66267256259833,378.5039397021631,40522.871495436295,40105.16365530157,40801.15054626763,417.7078401347244,413.6878930930992,597.6057085303853,79.13969521845138,59.5250254557468,52.289399036853865,41609.418252783646,39994.38283975161,True,False,41864.238,41334.238,41334.238,41364.238,2023-12-04 07:45:00,True,2023-12-04 07:45:00,2023-12-04 12:36:46,2023-12-04 08:09:57,0.02,even,True,171.08,8356.239999999998,,9,0,49,December
2023-12-04 06:45:00,40840.539,40923.738,40805.109,40888.84,1750,35121,0,2023-12-04 06:00:00,2023-12-04 06:00:00,188.783261904784,610.8695535211009,40837.58558333334,0.007089895942672804,0.004347153982119207,40703.58486904764,41724.5313271558,42069.23454477288,41887.613837365316,41885.95602466244,0.004347358430527079,0.008236639652854583,38697.50235543857,39304.98821596934,87.30919591718465,84.18619622767675,424.97706246595067,40690.15646884403,40354.05142735834,40883.689416580666,336.10504148568725,371.5629825504669,350.06540237283986,11.27126212589792,18.34788957684941,-11.373400068783667,41357.777709784,40411.10112337733,True,False,41888.84,41358.84,41358.84,41388.84,2023-12-04 07:45:00,True,2023-12-04 07:45:00,2023-12-04 12:36:55,2023-12-04 07:46:36,0.02,even,True,171.08,8527.319999999998,,10,0,49,December
2023-12-04 07:00:00,40886.246,41377.594,40840.938,41185.938,2933,0,0,2023-12-04 07:00:00,2023-12-04 07:00:00,134.00071428569936,634.1954473446822,41055.96229761905,0.004553479644953064,0.004347188324669103,40837.58558333334,41522.25694074926,42255.24661134624,41724.5313271558,42069.23454477288,0.004347153982119207,0.007089895942672804,38807.33269444098,39480.44323869179,88.62483077451596,87.08638201879096,466.820739441697,40766.430550560326,40415.672654961425,40939.829363605095,350.7578955989011,367.40196516015374,369.7248826911822,56.13994702442869,11.27126212589792,18.34788957684941,41440.45795523819,40440.700771972,True,False,42185.938,41655.938,41655.938,41685.938,2023-12-04 12:30:00,True,2023-12-04 12:30:00,2023-12-05 00:12:51,2023-12-04 13:12:41,0.02,even,True,171.08,8698.399999999998,,11,0,49,December
2023-12-04 07:45:00,41402.438,41512.0,41337.84,41498.176,2084,42739,0,2023-12-04 07:00:00,2023-12-04 07:00:00,134.00071428569936,634.1954473446822,41055.96229761905,0.004553479644953064,0.004347188324669103,40837.58558333334,41522.25694074926,42255.24661134624,41724.5313271558,42069.23454477288,0.004347153982119207,0.007089895942672804,38807.33269444098,39480.44323869179,83.26683857351003,81.04351059453433,466.820739441697,41016.292659442784,40617.230015331625,41193.192567251484,399.0626441111599,375.6527099188565,410.7123601884233,113.90678431375272,75.44772961816489,64.00868971447198,41749.154253505854,40638.730880997115,True,False,42498.176,41968.176,41968.176,41998.176,2023-12-05 00:15:00,True,2023-12-05 00:15:00,2023-12-05 18:40:43,2023-12-05 00:46:16,0.02,even,True,171.08,8869.479999999998,,12,0,49,December
2023-12-04 12:45:00,41855.949,42106.762,41820.363,41965.039,3411,37825,0,2023-12-04 12:00:00,2023-12-04 12:00:00,68.27417857143882,701.0554916023102,41764.75970238096,0.0034731513368129355,0.003162037022555922,41596.90354761905,42053.00021519899,42787.51709908991,42139.459380920125,43083.6045241854,0.004683060020354609,0.004118395764859183,39315.71867241839,40210.732681608315,86.88489704777298,77.61175929142789,633.2777580233501,41675.59394187746,41418.04733478312,41786.70725593396,257.54660709433665,269.5995171846249,223.07931711758698,84.62042414862663,45.60157069143315,45.09470141038764,42089.3643340427,41485.550177825215,True,False,42965.039,41515.039,42435.039,42465.039,,False,2023-12-05 18:45:00,2023-12-05 19:05:10,2023-12-04 13:14:36,0.02,fail,False,-163.85,8705.629999999997,,0,1,49,December
2023-12-06 00:15:00,44151.938,44491.137,44093.738,44392.238,3277,46386,0,2023-12-06 00:00:00,2023-12-06 00:00:00,209.56657142854965,590.0779148942966,44151.315428571404,0.006471759611680453,0.0020997675188051622,43956.70298809521,44826.6001884621,44955.332339014974,44841.348586280204,45875.89509864686,0.005008807935031592,0.007257528469853895,41667.26008801146,42582.95774476293,85.51644309684484,77.17518607111394,375.28723691626675,43893.88140922092,43513.691890505,44001.248173374624,380.18951871592435,379.46098632045005,463.2070489902734,82.02451014794497,42.93300240790268,70.8790399036734,44628.07768951149,43375.91865723776,True,False,45392.238,43942.238,44862.238,44892.238,,False,,,2023-12-06 01:14:28,0.02,fail,False,-163.85,8541.779999999997,,0,2,49,December
2023-12-07 21:00:00,43301.238,43331.34,43182.059,43232.039,1367,35121,0,2023-12-07 21:00:00,2023-12-07 21:00:00,-74.62263095234084,-80.55992888956098,43388.369119047595,0.0004214706311622717,-0.0008569867680630095,43494.92763095239,43134.46964047737,43644.07110509345,43426.61105924335,44391.213584491445,0.0015574872446674653,0.001162544575032894,43326.39862068827,43541.282167684236,9.315581004934442,16.588938195397976,-79.46760958393969,43413.03769357399,43451.50156274273,43345.72127313382,-38.46386916873598,1.4185512383665237,182.3650741683819,-73.74942758854013,-61.07958410734864,-69.43233058135229,43591.91412326114,43098.02842300651,False,True,42232.039,43682.039,42762.039,42732.039,,False,,,2023-12-08 13:43:54,0.02,fail,False,-163.85,8377.929999999997,,0,3,49,December
2023-12-07 21:15:00,43233.84,43272.039,43129.066,43134.438,1206,42325,0,2023-12-07 21:00:00,2023-12-07 21:00:00,-74.62263095234084,-80.55992888956098,43388.369119047595,0.0004214706311622717,-0.0008569867680630095,43494.92763095239,43134.46964047737,43644.07110509345,43426.61105924335,44391.213584491445,0.0015574872446674653,0.001162544575032894,43326.39862068827,43541.282167684236,6.428770216285649,11.02821065755335,-79.46760958393969,43370.176202254916,43428.01537290993,43265.67790368074,-57.83917065501737,-10.432993140310256,191.81768956445586,-80.04336945308023,-73.74942758854013,-61.07958410734864,43524.631784592755,43005.22402276873,False,True,42134.438,43584.438,42664.438,42634.438,,False,,,2023-12-08 13:37:49,0.02,fail,False,-163.85,8214.079999999996,,0,4,49,December
2023-12-07 21:30:00,43134.438,43237.637,43070.965,43073.238,1300,42825,0,2023-12-07 21:00:00,2023-12-07 21:00:00,-74.62263095234084,-80.55992888956098,43388.369119047595,0.0004214706311622717,-0.0008569867680630095,43494.92763095239,43134.46964047737,43644.07110509345,43426.61105924335,44391.213584491445,0.0015574872446674653,0.001162544575032894,43326.39862068827,43541.282167684236,2.9207711157031873,6.221707445641041,-79.46760958393969,43324.49340190801,43401.7355675092,43186.65401616788,-77.24216560118657,-23.79482763248552,203.96272246380218,-79.02388751286344,-80.04336945308023,-73.74942758854013,43462.003691494014,42909.80434084174,False,True,42073.238,43523.238,42603.238,42573.238,,False,,,2023-12-08 04:54:17,0.02,fail,False,-163.85,8050.229999999996,,0,5,49,December
2023-12-08 03:15:00,43317.445,43417.738,43313.305,43386.34,640,48281,0,2023-12-08 03:00:00,2023-12-08 03:00:00,75.01589285720547,-83.1973111419502,43332.32444047619,0.0003039255585525057,-0.00011510531687546516,43276.153642857185,43194.617152355146,43405.55416473071,43182.9192490773,43259.84923025239,-0.0009371742400965352,0.00030888427077232095,43321.457077534156,43449.14078167988,81.81864635641497,77.12135622132534,-93.61698711668996,43325.01489790337,43323.48914325412,43325.404067079464,1.5257546492503025,-17.27780977302893,91.41844603984771,10.62978912969993,-7.098457860323833,17.67399621599907,43450.31896923326,43201.98916492567,True,False,44386.34,43856.34,43856.34,43886.34,2023-12-08 16:45:00,True,2023-12-08 16:45:00,2023-12-08 22:57:19,2023-12-08 16:53:25,0.02,even,True,171.08,8221.309999999996,,1,0,49,December
2023-12-08 03:30:00,43386.238,43418.738,43362.891,43410.84,633,43422,0,2023-12-08 03:00:00,2023-12-08 03:00:00,75.01589285720547,-83.1973111419502,43332.32444047619,0.0003039255585525057,-0.00011510531687546516,43276.153642857185,43194.617152355146,43405.55416473071,43182.9192490773,43259.84923025239,-0.0009371742400965352,0.00030888427077232095,43321.457077534156,43449.14078167988,85.5473726574508,80.21002298463087,-93.61698711668996,43338.218759764386,43329.959577087146,43343.771121775055,8.25918267724046,-12.170411282975053,90.18918355501783,18.367054695590923,10.62978912969993,-7.098457860323833,43467.02651957433,43222.01572397578,True,False,44410.84,43880.84,43880.84,43910.84,2023-12-08 16:45:00,True,2023-12-08 16:45:00,2023-12-08 22:58:00,2023-12-08 16:46:15,0.02,even,True,171.08,8392.389999999996,,2,0,49,December
2023-12-08 04:00:00,43403.738,43500.738,43394.039,43471.387,662,45922,0,2023-12-08 04:00:00,2023-12-08 04:00:00,56.170797619008226,-65.14438404289831,43403.66596428568,0.0007569925152585749,0.00040448992374656444,43332.32444047619,43338.75059216396,43597.171290279206,43194.617152355146,43405.55416473071,-0.00011510531687546516,0.0003039255585525057,43328.37558429752,43453.039839145495,94.95311306249305,91.51120294097989,-87.92246650193164,43367.23531320409,43345.4959309732,43391.36461678705,21.739382230887713,-1.3813471866869351,85.82410452561851,28.779889920879214,18.81360509111255,18.367054695590923,43508.72715789663,43275.50207567746,True,False,44471.387,43941.387,43941.387,43971.387,2023-12-08 22:30:00,True,2023-12-08 22:30:00,2023-12-08 23:22:33,2023-12-11 00:00:06,0.02,success,True,364.01,8756.399999999996,,3,0,49,December
2023-12-08 04:30:00,43473.027,43508.039,43442.645,43508.039,760,44426,0,2023-12-08 04:00:00,2023-12-08 04:00:00,56.170797619008226,-65.14438404289831,43403.66596428568,0.0007569925152585749,0.00040448992374656444,43332.32444047619,43338.75059216396,43597.171290279206,43194.617152355146,43405.55416473071,-0.00011510531687546516,0.0003039255585525057,43328.37558429752,43453.039839145495,95.30154363788044,94.6369704861441,-87.92246650193164,43403.061212412395,43366.48972957236,43462.71719057444,36.57148284003779,11.039603009131417,97.77293953971913,39.201532163715456,32.151041623677884,28.779889920879214,43596.21065895306,43330.72372219582,True,False,44508.039,43978.039,43978.039,44008.039,2023-12-08 22:30:00,True,2023-12-08 22:30:00,2023-12-08 23:22:36,2023-12-11 00:00:06,0.02,success,True,364.01,9120.409999999996,,4,0,49,December
2023-12-08 13:00:00,43372.34,43473.637,43369.637,43450.738,1134,44723,0,2023-12-08 13:00:00,2023-12-08 13:00:00,36.51151190474775,-48.19891345833457,43363.776773809484,-0.0002438182120082447,0.0006375886092661159,43239.47891666662,43024.67361897651,43856.63683030247,42696.67165451117,43236.78788347494,-0.0008259701157450193,-0.0014251462490326495,43336.188239477895,43402.125825308205,85.44080134107536,67.21290304922002,-49.638925808827345,43287.49979962807,43301.66186405778,43272.81818954247,-14.162064429707243,-38.47189881029655,114.2224596835477,49.502275885795825,40.523470588239434,23.091707946296083,43428.51851011526,43118.61786896968,True,False,44450.738,43920.738,43920.738,43950.738,2023-12-08 17:00:00,True,2023-12-08 17:00:00,2023-12-08 23:20:15,2023-12-08 17:02:29,0.02,even,True,171.08,9291.489999999996,,5,0,49,December
2023-12-08 13:15:00,43450.84,43522.039,43420.668,43503.738,1137,39426,0,2023-12-08 13:00:00,2023-12-08 13:00:00,36.51151190474775,-48.19891345833457,43363.776773809484,-0.0002438182120082447,0.0006375886092661159,43239.47891666662,43024.67361897651,43856.63683030247,42696.67165451117,43236.78788347494,-0.0008259701157450193,-0.0014251462490326495,43336.188239477895,43402.125825308205,96.7297041092999,83.68679180365724,-49.638925808827345,43320.76721506991,43316.63046672016,43330.86692053665,4.136748349745176,-29.950169378288205,116.80045541360839,58.048730994181824,49.502275885795825,40.523470588239434,43490.047535345024,43173.18630572828,True,False,44503.738,43973.738,43973.738,44003.738,2023-12-08 22:30:00,True,2023-12-08 22:30:00,2023-12-08 23:22:35,2023-12-11 00:00:06,0.02,success,True,364.01,9655.499999999996,,6,0,49,December
2023-12-08 13:30:00,43503.738,43692.238,43466.039,43669.938,1590,42723,0,2023-12-08 13:00:00,2023-12-08 13:00:00,36.51151190474775,-48.19891345833457,43363.776773809484,-0.0002438182120082447,0.0006375886092661159,43239.47891666662,43024.67361897651,43856.63683030247,42696.67165451117,43236.78788347494,-0.0008259701157450193,-0.0014251462490326495,43336.188239477895,43402.125825308205,95.52767348608768,92.5660596454876,-49.638925808827345,43374.48579736684,43342.80139511126,43416.3365249398,31.684402255581517,-17.62325505151426,135.15920558669455,85.46960440314433,58.048730994181824,49.502275885795825,43600.301452481835,43233.87159739776,True,False,44669.938,44139.938,44139.938,44169.938,2023-12-08 22:45:00,True,2023-12-08 22:45:00,2023-12-08 23:24:15,2023-12-11 00:00:06,0.02,success,True,364.01,10019.509999999997,,7,0,49,December
2023-12-08 22:15:00,43948.602,44040.438,43946.859,44031.539,799,40765,0,2023-12-08 22:00:00,2023-12-08 22:00:00,48.99567857140937,121.68907180202223,44031.811571428596,0.0009361959962818012,0.001374956382514204,43845.801833333324,43898.34135308229,44641.080928600255,43849.20596174188,43918.28231182748,-0.0003436379835481914,0.0009037882316312678,43497.13968677219,43657.22970694151,91.66351214464184,86.38165040528463,78.6085202635585,43882.75184986435,43808.91805437543,43902.07568524251,73.83379548892117,63.669134158052046,101.22623680526146,32.92769556240091,36.06566047472734,34.49651702785195,44040.23110492961,43765.42026555541,True,False,45031.539,44501.539,44501.539,44531.539,2023-12-08 23:30:00,True,2023-12-08 23:30:00,,2023-12-08 23:40:56,0.02,even,True,171.08,10190.589999999997,,8,0,49,December
2023-12-08 22:30:00,44028.066,44270.109,44024.336,44222.637,1634,42824,0,2023-12-08 22:00:00,2023-12-08 22:00:00,48.99567857140937,121.68907180202223,44031.811571428596,0.0009361959962818012,0.001374956382514204,43845.801833333324,43898.34135308229,44641.080928600255,43849.20596174188,43918.28231182748,-0.0003436379835481914,0.0009037882316312678,43497.13968677219,43657.22970694151,92.28510373219922,90.54297781911085,78.6085202635585,43935.04187296214,43839.56390219947,43979.41643515651,95.47797076266579,70.0309014789748,119.56932352214746,77.34074991400121,32.92769556240091,36.06566047472734,44142.335021911415,43817.99784840161,True,False,45222.637,43772.637,44692.637,44722.637,,False,,,2023-12-11 00:01:48,0.02,fail,False,-163.84,10026.749999999996,,0,1,49,December
2023-12-08 22:45:00,44221.84,44414.938,44152.957,44366.938,2044,33715,0,2023-12-08 22:00:00,2023-12-08 22:00:00,48.99567857140937,121.68907180202223,44031.811571428596,0.0009361959962818012,0.001374956382514204,43845.801833333324,43898.34135308229,44641.080928600255,43849.20596174188,43918.28231182748,-0.0003436379835481914,0.0009037882316312678,43497.13968677219,43657.22970694151,94.64724186553694,92.86528591412595,78.6085202635585,44001.487430967965,43878.62865018469,44078.09180564158,122.85878078327369,80.59647733983458,155.48141519661812,98.67537048507074,77.34074991400121,32.92769556240091,44289.49171615702,43868.19189512615,True,False,45366.938,43916.938,44836.938,44866.938,,False,,,2023-12-11 00:00:06,0.02,fail,False,-163.84,9862.909999999996,,0,2,49,December
2023-12-11 03:15:00,43382.637,43398.738,43234.285,43311.84,1484,33722,0,2023-12-11 03:00:00,2023-12-11 03:00:00,-126.89825000003475,75.76851824521145,43613.2038809524,-0.0017741556002894082,-0.002911376248565195,43874.011833333316,42907.15173547733,43754.48439637466,43446.45373778794,45115.107892106986,0.0012391248355251622,-0.0003813993275830559,43538.35792585061,43673.10074007358,11.257111774613847,11.43094686583783,116.0731287736651,43654.43747917303,43773.68250648341,43414.2857416581,-119.24502731038228,-50.67682084003087,324.1793735675439,-70.11711283113982,-83.07566047464934,-63.29621706227044,43851.92789597429,42975.14358734192,False,True,42311.84,43761.84,42841.84,42811.84,,False,2023-12-11 04:15:00,2023-12-11 04:11:54,,0.02,success,True,364.01,10226.919999999996,,1,0,50,December
2023-12-11 03:45:00,43257.824,43367.438,43212.66,43215.539,951,38726,0,2023-12-11 03:00:00,2023-12-11 03:00:00,-126.89825000003475,75.76851824521145,43613.2038809524,-0.0017741556002894082,-0.002911376248565195,43874.011833333316,42907.15173547733,43754.48439637466,43446.45373778794,45115.107892106986,0.0012391248355251622,-0.0003813993275830559,43538.35792585061,43673.10074007358,9.230560199775198,10.83686257945657,116.0731287736651,43535.66381644932,43697.15716399469,43309.547746474,-161.49334754537267,-87.42276102001433,372.9731907133029,-37.035348813231394,-67.70264637086802,-70.11711283113982,43813.06155393696,42804.533939011046,False,True,42215.539,43665.539,42745.539,42715.539,,False,2023-12-11 04:15:00,2023-12-11 04:12:00,,0.02,success,True,364.01,10590.929999999997,,2,0,50,December
2023-12-13 17:30:00,41746.738,41943.039,41725.84,41895.938,2308,42223,0,2023-12-13 17:00:00,2023-12-13 17:00:00,46.62583333337534,31.452252240880625,41540.06252380952,0.0006867764460518223,0.0022806587928470017,41322.92464285715,41171.784201100905,42299.80841087625,41215.248700090255,41680.80237712266,0.0009810061023610233,0.0009958041282262242,41545.33879281197,41310.00044990356,89.07564152936818,87.56955697183405,-41.318750624547825,41526.37630584519,41371.710374304086,41678.07017371858,154.6659315411016,97.59936393646566,225.24760241586307,92.37475954591355,71.72488820087892,92.11598796006729,41983.654436979996,41373.985910457166,True,False,42895.938,42365.938,42365.938,42395.938,2023-12-13 21:45:00,True,2023-12-13 21:45:00,2023-12-13 23:53:36,2023-12-14 15:29:31,0.02,success,True,364.01,10954.939999999997,,3,0,50,December
2023-12-13 17:45:00,41895.938,41949.738,41844.25,41933.738,1407,43325,0,2023-12-13 17:00:00,2023-12-13 17:00:00,46.62583333337534,31.452252240880625,41540.06252380952,0.0006867764460518223,0.0022806587928470017,41322.92464285715,41171.784201100905,42299.80841087625,41215.248700090255,41680.80237712266,0.0009810061023610233,0.0009958041282262242,41545.33879281197,41310.00044990356,91.3930359578573,89.2596010034233,-41.318750624547825,41589.04733571516,41413.342050281564,41764.54376814583,175.7052854335925,113.22054823589104,255.11408835736924,86.47359442724701,92.37475954591355,71.72488820087892,42110.447787428275,41420.13974886338,True,False,42933.738,42403.738,42403.738,42433.738,2023-12-13 21:45:00,True,2023-12-13 21:45:00,2023-12-13 23:53:42,2023-12-14 15:29:31,0.02,success,True,364.01,11318.949999999997,,4,0,50,December
2023-12-13 18:00:00,41934.039,42221.938,41885.57,42154.34,2716,31321,0,2023-12-13 18:00:00,2023-12-13 18:00:00,217.13788095237396,103.87099094702717,41706.05032142857,0.002563578288293394,0.0032782120609394037,41540.06252380952,41795.20496113988,42729.0803587062,41171.784201100905,42299.80841087625,0.0022806587928470017,0.0006867764460518223,41557.80527152523,41354.25913391128,95.3940663459568,91.95424794439406,-12.280802310232826,41676.01543791283,41468.23078729775,41874.69415755075,207.78465061508177,132.1333687117292,300.7308881042218,110.15038940492377,86.47359442724701,92.37475954591355,42282.18085649145,41468.70745861005,True,False,43154.34,42624.34,42624.34,42654.34,2023-12-13 21:45:00,True,2023-12-13 21:45:00,2023-12-13 23:54:59,2023-12-13 22:13:50,0.02,even,True,171.08,11490.029999999997,,5,0,50,December
2023-12-13 21:00:00,42115.137,42459.738,42115.137,42363.84,3976,39723,0,2023-12-13 21:00:00,2023-12-13 21:00:00,144.35654761902697,226.20196169626433,42326.57813095237,0.004121837186771289,0.005155119330496646,42057.64324999999,42755.72847882574,43696.895628147024,42421.02918712839,43375.99486066819,0.004774336870181498,0.0035700360761137767,41644.457913424485,41570.859449747106,80.02267645089798,78.74643093503845,88.53272081459158,42050.587477991154,41834.1638838617,42198.15259786721,216.4235941294537,204.6582550951018,321.2523072849295,34.10815204679966,-2.089968008323922,4.606748194062675,42633.34321270186,41764.461983032554,True,False,43363.84,42833.84,42833.84,42863.84,2023-12-14 00:00:00,True,2023-12-14 00:00:00,2023-12-14 00:13:43,2023-12-14 01:21:48,0.02,success,True,364.01,11854.039999999997,,6,0,50,December
2023-12-13 21:15:00,42363.84,42428.938,42238.438,42371.539,2418,41824,0,2023-12-13 21:00:00,2023-12-13 21:00:00,144.35654761902697,226.20196169626433,42326.57813095237,0.004121837186771289,0.005155119330496646,42057.64324999999,42755.72847882574,43696.895628147024,42421.02918712839,43375.99486066819,0.004774336870181498,0.0035700360761137767,41644.457913424485,41570.859449747106,84.89023955458096,80.19799071162429,88.53272081459158,42099.96463522328,41873.96944802009,42223.45747024427,225.99518720318883,208.92564151671922,323.83382546756985,25.304872377062566,34.10815204679966,-2.089968008323922,42662.13313462549,41786.28180586305,True,False,43371.539,42841.539,42841.539,42871.539,2023-12-14 00:00:00,True,2023-12-14 00:00:00,2023-12-14 00:13:44,2023-12-14 01:21:46,0.02,success,True,364.01,12218.049999999997,,7,0,50,December
2023-12-13 21:30:00,42375.137,42879.625,42301.746,42721.34,3920,35610,0,2023-12-13 21:00:00,2023-12-13 21:00:00,144.35654761902697,226.20196169626433,42326.57813095237,0.004121837186771289,0.005155119330496646,42057.64324999999,42755.72847882574,43696.895628147024,42421.02918712839,43375.99486066819,0.004774336870181498,0.0035700360761137767,41644.457913424485,41570.859449747106,87.32169114549777,84.07820238365885,88.53272081459158,42195.56084518893,41936.737637055645,42333.593485036145,258.8232081332826,218.9051548400319,351.2781015994432,110.13601479187491,25.304872377062566,34.10815204679966,42809.318922195394,41859.368047876895,True,False,43721.34,43191.34,43191.34,43221.34,2023-12-14 00:15:00,True,2023-12-14 00:15:00,,2023-12-14 00:25:56,0.02,even,True,171.08,12389.129999999997,,8,0,50,December
2023-12-15 15:15:00,42578.137,42608.738,42424.738,42437.137,1546,44023,0,2023-12-15 15:00:00,2023-12-15 15:00:00,-36.19405952379748,-25.863372911408078,42605.111083333315,-0.0010862301526083132,-0.00045423576437377737,42769.255309523825,42018.47647388285,42878.43751764026,42654.634067358544,43251.46906251378,0.0007787282092657623,0.0003576360882696593,42577.4121925509,42720.14810662568,11.433625890989275,18.383912288660927,-5.561982719594129,42671.713488429785,42723.38829937017,42597.42648847609,-51.674810940385214,-16.552693429251395,122.72963630697073,-60.52501375992142,-46.25004231162893,-46.38934158927441,42763.1114974905,42430.241479461685,False,True,41437.137,41967.137,41967.137,41937.137,2023-12-15 17:45:00,True,2023-12-15 17:45:00,2023-12-18 01:32:57,2023-12-15 18:03:50,0.02,even,True,171.08,12560.209999999997,,9,0,50,December
2023-12-15 15:30:00,42435.941,42513.438,42251.738,42290.938,2600,42023,0,2023-12-15 15:00:00,2023-12-15 15:00:00,-36.19405952379748,-25.863372911408078,42605.111083333315,-0.0010862301526083132,-0.00045423576437377737,42769.255309523825,42018.47647388285,42878.43751764026,42654.634067358544,43251.46906251378,0.0007787282092657623,0.0003576360882696593,42577.4121925509,42720.14810662568,12.277214751946445,15.179630058142125,-5.561982719594129,42613.13264405597,42691.35494386127,42529.29577812175,-78.22229980529664,-28.886614704460445,152.9035670511585,-68.13071035434405,-60.52501375992142,-46.25004231162893,42735.71559364081,42321.37596260269,False,True,41290.938,41820.938,41820.938,41790.938,2023-12-15 17:45:00,True,2023-12-15 17:45:00,2023-12-18 01:34:44,2023-12-15 17:48:43,0.02,even,True,171.08,12731.289999999997,,10,0,50,December
2023-12-15 15:45:00,42295.438,42351.238,42185.5,42285.238,2041,40707,0,2023-12-15 15:00:00,2023-12-15 15:00:00,-36.19405952379748,-25.863372911408078,42605.111083333315,-0.0010862301526083132,-0.00045423576437377737,42769.255309523825,42018.47647388285,42878.43751764026,42654.634067358544,43251.46906251378,0.0007787282092657623,0.0003576360882696593,42577.4121925509,42720.14810662568,7.610727731360697,10.440522791432102,-5.561982719594129,42562.687314201205,42661.272207278955,42460.99596869623,-98.58489307775017,-42.82627037911839,177.15249236053228,-68.29980942551629,-68.13071035434405,-60.52501375992142,42700.15183338295,42220.34010400951,False,True,41285.238,41815.238,41815.238,41785.238,2023-12-15 17:45:00,True,2023-12-15 17:45:00,2023-12-18 01:34:44,2023-12-15 17:48:43,0.02,even,True,171.08,12902.369999999997,,11,0,50,December
2023-12-18 22:45:00,41886.84,42044.574,41884.137,41968.238,1880,38824,0,2023-12-18 22:00:00,2023-12-18 22:00:00,81.30932142855454,39.739122405553644,41716.75698809524,0.0019345555378573903,0.0011577963086393695,41603.66948809522,41757.23805435916,42221.98882918557,41675.99861571761,41759.83322208448,1.8565066693570598e-05,0.0019345752006189342,41760.59607250041,41519.3705311778,84.52699520074262,79.8495567052258,-77.89580357179824,41695.61542106553,41555.400222047516,41796.54382937737,140.21519901801366,111.84024116869395,175.32651946278952,59.322696594448644,45.308253525945474,14.214866185066057,42034.734630652136,41559.8530281026,True,False,42968.238,42438.238,42438.238,42468.238,2023-12-18 23:45:00,True,2023-12-18 23:45:00,2023-12-19 03:46:42,2023-12-19 00:09:35,0.02,even,True,171.08,13073.449999999997,,12,0,51,December
2023-12-18 23:00:00,41968.238,42579.039,41955.813,42426.738,2973,32766,0,2023-12-18 23:00:00,2023-12-18 23:00:00,113.08750000002328,92.81709192958078,42019.33329761905,0.002882256450561045,0.003375004511490979,41716.75698809524,42125.431678419816,43281.99826677024,41757.23805435916,42221.98882918557,0.0011577963086393695,0.0019345555378573903,41791.009442206276,41600.711848683575,88.87834085309608,83.53901887179124,-43.75322447152244,41808.09581782468,41619.94376115511,41929.5322005504,188.152056669569,127.10260426886896,249.29168859246553,132.988371173029,59.322696594448644,45.308253525945474,42267.57598015023,41592.98842095057,True,False,43426.738,42896.738,42896.738,42926.738,2023-12-19 04:00:00,True,2023-12-19 04:00:00,2023-12-19 04:00:24,2023-12-19 06:37:32,0.02,success,True,364.01,13437.459999999997,,13,0,51,December
2023-12-18 23:30:00,42422.637,42497.738,42324.004,42489.238,1861,61422,0,2023-12-18 23:00:00,2023-12-18 23:00:00,113.08750000002328,92.81709192958078,42019.33329761905,0.002882256450561045,0.003375004511490979,41716.75698809524,42125.431678419816,43281.99826677024,41757.23805435916,42221.98882918557,0.0011577963086393695,0.0019345555378573903,41791.009442206276,41600.711848683575,89.30926813566138,88.83995008199406,-43.75322447152244,41993.21181039518,41739.56180071597,42179.911014791905,253.65000967920787,167.8256727789234,341.6879073311222,122.02918128653982,128.3496329549671,132.988371173029,42642.68968968892,41718.63233989489,True,False,43489.238,42959.238,42959.238,42989.238,2023-12-19 04:00:00,True,2023-12-19 04:00:00,2023-12-19 04:00:24,2023-12-19 06:33:33,0.02,success,True,364.01,13801.469999999998,,14,0,51,December
2023-12-19 00:00:00,42606.84,42713.738,42427.039,42661.637,2288,57922,0,2023-12-19 00:00:00,2023-12-19 00:00:00,302.57630952380714,190.3210809355951,42272.634130952385,0.0028823918549245827,0.004282447723225916,42019.33329761905,42246.93404679596,43611.67586415086,42125.431678419816,43281.99826677024,0.003375004511490979,0.002882256450561045,41818.56742486486,41672.15394078889,89.44075079180601,88.83327724004981,3.061636609901072,42166.72310685099,41862.49845466047,42439.793209150324,304.2246521905181,212.76078367401755,414.1472483490907,132.4480636395092,127.43413071890973,122.02918128653982,43000.391994421596,41880.69442387905,True,False,43661.637,43131.637,43131.637,43161.637,2023-12-19 04:00:00,True,2023-12-19 04:00:00,2023-12-20 15:46:57,2023-12-19 04:12:15,0.02,even,True,171.08,13972.549999999997,,15,0,51,December
2023-12-19 03:45:00,42843.539,43411.238,42841.84,43319.938,3321,3188,0,2023-12-19 03:00:00,2023-12-19 03:00:00,173.47260714288132,333.2684122315186,42934.75983333334,0.004926186513407288,0.0048569555018093125,42645.783821428595,43378.98081203441,44374.92013142941,43316.47449247507,44447.463623701005,0.005841550864007921,0.00539108718879487,41940.608426954386,41945.59200010103,87.07815172853832,77.43263197409026,147.7324449745155,42760.2263425689,42468.60937803167,42879.604944960454,291.61696453722834,274.34761965994767,399.8152563280153,112.94391434471618,29.925533195731987,-3.094070863473462,43420.85554100327,42339.85434891764,True,False,44319.938,42869.938,43789.938,43819.938,,False,2023-12-20 16:30:00,2023-12-20 17:14:36,2023-12-19 06:41:21,0.02,fail,False,-163.85,13808.699999999997,,0,1,51,December
2023-12-19 10:15:00,43140.238,43172.438,43067.164,43166.137,1552,42086,0,2023-12-19 10:00:00,2023-12-19 10:00:00,-15.705880952395091,343.09003221139574,42978.824583333306,0.0010307894578476227,-0.0012311610527370616,42991.26610714285,43071.60901125743,42993.60616572593,42910.79641816366,42833.45159885622,-0.0018037987194030767,0.0007496518436954203,42201.15493964435,42415.18773654115,87.36918798700601,74.64634274899974,336.3377206467684,43021.042535774635,42933.45218119841,43028.28548985208,87.59035457622667,88.38936007235876,88.39469593582113,45.573072239429166,36.72004299963737,18.295122807016014,43149.11832936544,42908.952650338724,True,False,44166.137,42716.137,43636.137,43666.137,,False,2023-12-20 16:00:00,2023-12-20 16:30:31,2023-12-19 16:07:30,0.02,fail,False,-163.85,13644.849999999997,,0,2,51,December
2023-12-20 06:45:00,42616.465,42871.625,42585.754,42815.238,2088,42422,0,2023-12-20 06:00:00,2023-12-20 06:00:00,27.905178571447323,-40.48491903614922,42530.2357380952,9.684611413039458e-05,0.0013808166344038014,42394.353511904745,42222.01961700686,43089.11417933685,42254.818828157106,42453.77272903841,-0.00016253312942846558,0.0002846360655710072,42353.67051899675,42449.21948882479,83.08178095896955,79.34640663009894,-49.15799305918234,42513.44934728625,42438.18258385918,42558.92949088408,75.26676342706924,34.992845377762336,131.23003780209706,67.56605503956962,35.68704747161246,31.72859993120801,42737.59004191691,42381.76893985125,True,False,43815.238,43285.238,43285.238,43315.238,2023-12-20 15:30:00,True,2023-12-20 15:30:00,2023-12-20 16:00:15,2023-12-20 15:33:03,0.02,even,True,171.08,13815.929999999997,,1,0,51,December
2023-12-20 15:15:00,43126.039,43411.539,43121.918,43403.84,2682,25609,0,2023-12-20 15:00:00,2023-12-20 15:00:00,48.74584523809608,115.82070305573143,43194.08500000002,0.0009549417135361462,0.002558171483184257,42898.36670238095,42945.63608559607,44222.91138905724,42770.08503069458,42996.27715648101,-8.262077364646855e-05,0.0004056992226538633,42541.29129263117,42739.273206601814,93.4086014526125,87.13623242279728,77.05092196442564,42995.13162547719,42886.55758374727,43036.583686274505,108.57404172991664,67.85020162790849,139.00047756972063,92.13189817681268,61.738438252512424,27.191441348477383,43225.734330993626,42848.933041555385,True,False,44403.84,43873.84,43873.84,43903.84,2023-12-20 16:30:00,True,2023-12-20 16:30:00,2023-12-22 08:34:58,2023-12-20 16:59:31,0.02,even,True,171.08,13987.009999999997,,2,0,51,December
2023-12-20 15:30:00,43396.508,43448.738,43259.215,43448.738,2619,30922,0,2023-12-20 15:00:00,2023-12-20 15:00:00,48.74584523809608,115.82070305573143,43194.08500000002,0.0009549417135361462,0.002558171483184257,42898.36670238095,42945.63608559607,44222.91138905724,42770.08503069458,42996.27715648101,-8.262077364646855e-05,0.0004056992226538633,42541.29129263117,42739.273206601814,96.44285044688438,91.90170159248703,77.05092196442564,43064.91722155762,42928.20057754377,43134.550851737185,136.71664401384623,81.62349010509604,177.55220719069314,97.96716546267999,92.13189817681268,61.738438252512424,43375.74633144462,42894.85537202975,True,False,44448.738,43918.738,43918.738,43948.738,2023-12-20 16:30:00,True,2023-12-20 16:30:00,,2023-12-20 16:52:25,0.02,even,True,171.08,14158.089999999997,,3,0,51,December
2023-12-20 15:45:00,43448.738,43807.738,43433.84,43792.637,3416,18324,0,2023-12-20 15:00:00,2023-12-20 15:00:00,48.74584523809608,115.82070305573143,43194.08500000002,0.0009549417135361462,0.002558171483184257,42898.36670238095,42945.63608559607,44222.91138905724,42770.08503069458,42996.27715648101,-8.262077364646855e-05,0.0004056992226538633,42541.29129263117,42739.273206601814,99.18045713872345,96.34396967940675,77.05092196442564,43176.87411054876,42992.232905133125,43296.01315170279,184.6412054156317,102.22703316720319,249.8307125039582,161.46229996560578,97.96716546267999,92.13189817681268,43634.784613583135,42958.74168982245,True,False,44792.637,44262.637,44262.637,44292.637,2023-12-20 17:15:00,True,2023-12-20 17:15:00,,2023-12-20 17:15:11,0.02,even,True,171.08,14329.169999999996,,4,0,51,December
2023-12-26 07:15:00,43241.84,43264.238,43030.723,43089.738,1690,36226,0,2023-12-26 07:00:00,2023-12-26 07:00:00,-86.07285714284808,-48.74105944658368,43332.29990476187,-0.0028331014905405845,-0.0015291468076048256,43630.54504761903,42183.72526417208,43449.964531944475,43305.14297874245,43722.81585934154,-0.0008721676665469325,-0.00041072212639463497,43588.85628418163,43634.92862999533,15.800935470299867,17.333569989671215,-32.538256732899,43459.237106167566,43568.79601481877,43362.71551737184,-109.55890865120455,-49.972572310773074,200.0726728947974,-72.27575335404254,-56.92133298931731,-28.76691296867648,43632.81362577982,43091.117408963866,False,True,42089.738,42619.738,42619.738,42589.738,2023-12-26 11:45:00,True,2023-12-26 11:45:00,2023-12-26 11:45:25,2023-12-26 12:34:57,0.02,success,True,364.01,14693.179999999997,,5,0,52,December
2023-12-26 07:30:00,43092.637,43132.84,42623.84,42757.238,3780,33922,0,2023-12-26 07:00:00,2023-12-26 07:00:00,-86.07285714284808,-48.74105944658368,43332.29990476187,-0.0028331014905405845,-0.0015291468076048256,43630.54504761903,42183.72526417208,43449.964531944475,43305.14297874245,43722.81585934154,-0.0008721676665469325,-0.00041072212639463497,43588.85628418163,43634.92862999533,12.585071325959667,15.842851070740496,-32.538256732899,43351.237243680254,43508.680606313676,43226.713907120735,-157.4433626334212,-71.4667303753027,267.2843108056469,-136.0016102511072,-72.27575335404254,-56.92133298931731,43587.547726708355,42864.380087533114,False,True,41757.238,43207.238,42287.238,42257.238,,False,2023-12-26 19:45:00,2023-12-26 19:39:31,2023-12-27 12:44:30,0.02,success,True,364.01,15057.189999999997,,6,0,52,December
2023-12-27 12:30:00,43073.938,43225.34,43018.0,43212.938,2274,39125,0,2023-12-27 12:00:00,2023-12-27 12:00:00,117.0691666666753,25.002673986273294,42867.87234523809,0.0013976443751044924,0.002961967322544488,42644.294749999994,42754.31489768395,43708.60690815591,42693.919486211016,42985.89237325495,0.0010880802416492936,0.0013974823810126093,42837.99848747766,42619.788371390045,93.06172770458568,91.39493721322297,-68.33472597913448,42786.43389529494,42633.098711563885,42911.09867320263,153.3351837310547,97.90638006938347,223.1672423800125,101.83413691092574,83.38097385613946,13.018722050233919,43213.87445041564,42609.822895989615,True,False,44212.938,42762.938,43682.938,43712.938,,False,,,2023-12-27 15:02:49,0.02,fail,False,-163.85,14893.339999999997,,0,1,52,December
2023-12-27 12:45:00,43208.801,43235.539,43109.84,43216.738,1675,38723,0,2023-12-27 12:00:00,2023-12-27 12:00:00,117.0691666666753,25.002673986273294,42867.87234523809,0.0013976443751044924,0.002961967322544488,42644.294749999994,42754.31489768395,43708.60690815591,42693.919486211016,42985.89237325495,0.0010880802416492936,0.0013974823810126093,42837.99848747766,42619.788371390045,96.79014197483328,93.86754580060203,-68.33472597913448,42852.634526788024,42676.33125144804,43003.070085999316,176.30327533998206,113.58575912350321,250.77162466224829,91.97141279668722,101.83413691092574,83.38097385613946,43343.11177929335,42664.52839270528,True,False,44216.738,42766.738,43686.738,43716.738,,False,,,2023-12-27 15:02:49,0.02,fail,False,-163.85,14729.489999999996,,0,2,52,December
2023-12-27 22:30:00,43325.539,43491.34,43265.691,43460.566,1859,36625,0,2023-12-27 22:00:00,2023-12-27 22:00:00,51.49683333330904,146.88039297915384,43255.252047619055,0.0010446800263706631,0.0015403586433213427,43128.89066666665,43164.27996730601,43812.10412395041,43085.40292818392,43318.672173480765,0.00041207660900318386,0.0009076505162634394,42918.7852349634,42891.39235641342,92.97474103750262,85.07330173455368,113.95736497424684,43175.3832572898,43078.863779975785,43218.61985620915,96.51947731401742,63.89357964471816,137.79100039964865,62.24715479873703,44.68548469214875,28.666770553849346,43406.137706748676,43032.60200566963,True,False,44460.566,43010.566,43930.566,43960.566,,False,,,2023-12-28 08:31:15,0.02,fail,False,-163.85,14565.639999999996,,0,3,52,December
2023-12-28 09:00:00,43045.039,43075.438,42966.324,43002.438,1574,45726,0,2023-12-28 09:00:00,2023-12-28 09:00:00,-123.1081190476034,62.14028388920269,43127.45132142858,-0.001898168015853494,-0.0016900293678650585,43214.82007142857,42513.71136882819,43151.13946144326,42821.51943795186,43385.07933609882,-0.0010346316952126841,-0.0010771099491726102,43056.69661169878,43131.06748389179,10.043346531650684,10.658565201861604,130.40787442722913,43180.433548909416,43269.24122761821,43086.36500068803,-88.80767870879208,-47.895439084823906,180.3217714852591,-46.87539146885683,-43.44492088062543,-39.86505916749593,43329.79939219313,42841.43060918293,False,True,42002.438,42532.438,42532.438,42502.438,2023-12-28 17:30:00,True,2023-12-28 17:30:00,2023-12-29 18:22:36,2023-12-28 17:37:05,0.02,even,True,171.08,14736.719999999996,,1,0,52,December
2023-12-28 14:45:00,42920.539,42977.84,42751.34,42799.84,1886,29024,0,2023-12-28 14:00:00,2023-12-28 14:00:00,17.055166666643345,-17.405553283206245,42966.93834523812,-0.0002766856203815526,-0.0007442284190794141,43038.97859523806,42708.43092649906,43036.81009910238,42709.23465057075,42911.0670951124,-0.0015792582236698945,-0.00031006143543146545,43046.126303418736,43084.91232728296,19.01827715433258,39.69561133786947,37.8275009798084,43015.60490915532,43071.33099390937,43030.65755280356,-55.72608475404559,-40.54325870112431,95.52935971874896,-52.17759614723036,-25.378013071909663,-18.262060199514963,43159.62218842387,42900.19291718325,False,True,41799.84,42329.84,42329.84,42299.84,2023-12-29 03:45:00,True,2023-12-29 03:45:00,2023-12-29 19:08:43,2023-12-29 03:53:25,0.02,even,True,171.08,14907.799999999996,,2,0,52,December
2023-12-29 12:30:00,42747.738,42828.738,42741.137,42796.738,1009,44223,0,2023-12-29 12:00:00,2023-12-29 12:00:00,15.450380952381238,-43.15112696681172,42569.10345238094,-0.0006998253625221306,5.6587470393255305e-05,42529.47909523811,42030.62609562976,42837.613923951634,42174.99737460511,42650.80356125682,-0.0003899257512780998,-0.0002195673558373381,42764.33320094061,42649.73885842182,89.37323991741538,88.82015523921295,-69.83856611894845,42632.920055449475,42591.299410769585,42646.276774681784,41.620644679889665,5.71496250485173,134.34375104240806,55.95880701753049,50.99384932923567,41.49799174401414,42829.14083858903,42464.91271077454,True,False,43796.738,42346.738,43266.738,43296.738,,False,2024-01-02 00:15:00,2024-01-02 01:21:04,2023-12-29 17:48:23,0.02,fail,False,-163.84,14743.959999999995,,0,1,52,December
2023-12-29 13:45:00,42852.34,42923.738,42818.84,42882.637,873,33988,0,2023-12-29 13:00:00,2023-12-29 13:00:00,39.624357142834924,-22.297537260237732,42680.077166666684,0.0008187439106667963,0.0005874084836165096,42569.10345238094,42492.91785229117,43055.16153716938,42030.62609562976,42837.613923951634,5.6587470393255305e-05,-0.0006998253625221306,42768.972565609605,42668.37070974807,85.57945206452109,85.16096408291114,-60.33036034720631,42743.149425613185,42664.299352844835,42879.42043962849,78.85007276834949,45.72640183680433,166.4740507024298,43.492028207816475,45.88688304090465,56.379756105969136,43105.66040807677,42654.68047118021,True,False,43882.637,42432.637,43352.637,43382.637,,False,2024-01-02 00:15:00,2024-01-02 01:25:36,2023-12-29 17:47:26,0.02,fail,False,-163.84,14580.119999999995,,0,2,52,December
2023-12-29 19:00:00,41970.84,42060.637,41723.938,41889.34,4205,34125,0,2023-12-29 19:00:00,2023-12-29 19:00:00,-281.0821904762779,-71.53627171810513,42182.096642857185,-0.003321195988758767,-0.0020379217632058573,42456.26695238091,41158.328924665526,42563.79335131879,41507.91661355467,43422.50081105119,0.0011391231602412245,-0.0020803571987045044,42697.714846482624,42564.27394410689,18.731587814663268,21.952967770586667,-11.289815481589706,42352.66644966636,42526.59683627389,42174.22853525971,-173.93038660753518,-69.89604251061151,325.78702306109267,-127.19001685587136,-120.80542414860975,-75.49781871344749,42614.041016392184,41732.916054127236,False,True,40889.34,42339.34,41419.34,41389.34,,False,,2024-01-03 14:09:34,2024-01-02 00:00:00,0.02,fail,False,-163.84,14416.279999999995,,0,3,52,December
2024-01-02 01:00:00,43547.84,43723.738,43547.84,43697.539,1714,63485,0,2024-01-02 01:00:00,2024-01-02 01:00:00,589.4606428571133,-5.608957644319162,43165.27394047617,0.002303910597104543,0.006159810152533622,42499.78427380951,42412.51883139144,45247.91586346551,42095.357691687255,44022.89969290517,0.0020792545110519707,0.0011999628966507057,42698.04446710208,42639.4239229081,92.99248234782242,90.85218047626181,-93.26651210199599,42898.90762281253,42588.15452341493,43200.47395837633,310.7530993975961,103.71470918786896,644.3256920257238,220.75326109388698,198.89283178536425,210.37668730651785,44071.81364261106,42330.6342741416,True,False,44697.539,43247.539,44167.539,44197.539,,False,2024-01-02 02:15:00,2024-01-02 02:14:11,2024-01-03 14:01:17,0.02,success,True,364.01,14780.289999999995,,1,0,1,January
2024-01-02 01:30:00,44022.938,44138.832,43953.34,44103.738,2398,57726,0,2024-01-02 01:00:00,2024-01-02 01:00:00,589.4606428571133,-5.608957644319162,43165.27394047617,0.002303910597104543,0.006159810152533622,42499.78427380951,42412.51883139144,45247.91586346551,42095.357691687255,44022.89969290517,0.0020792545110519707,0.0011999628966507057,42698.04446710208,42639.4239229081,98.44868019852085,95.95127323196004,-93.26651210199599,43230.58962343382,42798.82761198125,43689.54253801171,431.76201145257073,213.11391092424037,790.9549102558116,235.16236910904263,253.9062105263365,220.75326109388698,44758.831666857055,42621.75340916636,True,False,45103.738,44573.738,44573.738,44603.738,2024-01-02 02:15:00,True,2024-01-02 02:15:00,2024-01-02 02:57:23,2024-01-02 02:16:10,0.02,even,True,171.08,14951.369999999995,,2,0,1,January
2024-01-02 01:45:00,44103.738,44229.738,44054.496,44194.039,1824,57125,0,2024-01-02 01:00:00,2024-01-02 01:00:00,589.4606428571133,-5.608957644319162,43165.27394047617,0.002303910597104543,0.006159810152533622,42499.78427380951,42412.51883139144,45247.91586346551,42095.357691687255,44022.89969290517,0.0020792545110519707,0.0011999628966507057,42698.04446710208,42639.4239229081,98.41508528533761,97.75880754446511,-93.26651210199599,43378.812604444,42902.17660368635,43916.73942242862,476.63600075765135,265.8183288909226,845.6729572393543,227.1968844169096,235.16236910904263,253.9062105263365,45059.897914701745,42775.08093015549,True,False,45194.039,44664.039,44664.039,44694.039,2024-01-02 02:15:00,True,2024-01-02 02:15:00,2024-01-02 02:58:01,2024-01-02 02:15:53,0.02,even,True,171.08,15122.449999999995,,3,0,1,January
2024-01-02 02:00:00,44195.238,44747.336,44174.516,44716.289,3012,31406,0,2024-01-02 02:00:00,2024-01-02 02:00:00,665.4896666666536,187.8711904942611,43991.94866666669,0.006714964951629153,0.010753041309176604,43165.27394047617,43791.04029452814,47198.076041009015,42412.51883139144,45247.91586346551,0.006159810152533622,0.002303910597104543,42794.22778211768,42840.327529075454,98.62634712856753,98.49670420414198,-37.038971582744566,43584.578203760306,43036.55529970958,44211.306416924665,548.0229040507256,322.25924392288323,931.47798680694,294.5669944960464,227.1968844169096,235.16236910904263,45470.30169911403,42953.8111347353,True,False,45716.289,45186.289,45186.289,45216.289,2024-01-02 04:45:00,True,2024-01-02 04:45:00,2024-01-02 09:25:23,2024-01-02 04:49:32,0.02,even,True,171.08,15293.529999999995,,4,0,1,January
2024-01-02 04:30:00,45141.137,45334.039,45094.438,45305.637,1840,42925,0,2024-01-02 04:00:00,2024-01-02 04:00:00,532.325880952354,547.7616778641968,45072.052833333335,0.014026689021242501,0.014530782957887109,44524.27454761905,47307.82396649429,49280.90982449817,46022.961824242055,48055.29074189853,0.012303467385718957,0.012294907500281746,42975.43487076685,43196.038023809466,84.45966992311193,78.649949063395,153.57446999653973,44758.27129005298,44088.37176366347,45320.72595768836,669.8995263895122,636.5213920079177,1198.9749099853418,91.32610663916421,-37.75321568625077,-9.92458857929887,46940.84208616857,43702.109829208144,True,False,46305.637,45775.637,45775.637,45805.637,2024-01-02 11:30:00,True,2024-01-02 11:30:00,,2024-01-02 11:33:43,0.02,even,True,171.08,15464.609999999995,,5,0,1,January
2024-01-02 04:45:00,45304.129,45399.938,45176.539,45391.684,1733,34422,0,2024-01-02 04:00:00,2024-01-02 04:00:00,532.325880952354,547.7616778641968,45072.052833333335,0.014026689021242501,0.014530782957887109,44524.27454761905,47307.82396649429,49280.90982449817,46022.961824242055,48055.29074189853,0.012303467385718957,0.012294907500281746,42975.43487076685,43196.038023809466,90.58023724517541,84.31289901594658,153.57446999653973,44855.7193992756,44184.913410799505,45396.82011592708,670.8059884760951,643.3783113015531,1168.4320350112225,76.09415823872405,91.32610663916421,-37.75321568625077,46975.70336319223,43819.436868661935,True,False,46391.684,44941.684,45861.684,45891.684,,False,,,2024-01-02 17:18:03,0.02,fail,False,-163.84,15300.769999999995,,0,1,1,January
2024-01-03 13:15:00,44730.727,44871.34,44323.84,44357.094,4547,9778,0,2024-01-03 13:00:00,2024-01-03 13:00:00,-17.22898809522303,43.42418496731989,44703.24361904759,-0.005303876639260398,0.0009634789327106425,45200.2852738095,42632.42141477039,45804.03654420166,44750.45126098252,45738.47288311781,0.0008573774572825448,-0.0006087852745549428,44564.54062393751,44956.193518406944,13.244153917133083,23.70278399382738,66.46944182476007,45034.48778879757,45129.769549070435,44998.07490884066,-95.28176027286827,-12.64395955202249,229.39329689350814,-147.4033247334737,-92.64020639831142,-13.634777777799172,45307.755859646895,44686.89395803442,False,True,43357.094,43887.094,43887.094,43857.094,2024-01-03 14:00:00,True,2024-01-03 14:00:00,2024-01-03 14:01:13,2024-01-04 17:15:40,0.02,success,True,364.02,15664.789999999995,,1,0,1,January
2024-01-03 13:45:00,44498.938,44518.34,43473.84,43691.879,5332,14226,0,2024-01-03 13:00:00,2024-01-03 13:00:00,-17.22898809522303,43.42418496731989,44703.24361904759,-0.005303876639260398,0.0009634789327106425,45200.2852738095,42632.42141477039,45804.03654420166,44750.45126098252,45738.47288311781,0.0008573774572825448,-0.0006087852745549428,44564.54062393751,44956.193518406944,9.38946610077068,9.76018085257087,66.46944182476007,44758.216049967494,44979.992227941046,44652.90146405231,-221.77617797355197,-73.39869332054668,393.4819804697473,-241.00372686618357,-104.16971792216646,-147.4033247334737,45184.10213768647,44120.20079041815,False,True,42691.879,44141.879,43221.879,43191.879,,False,2024-01-03 14:15:00,2024-01-03 14:01:31,2024-01-04 17:29:07,0.02,success,True,364.02,16028.809999999996,,2,0,1,January
2024-01-04 17:00:00,43644.203,43804.637,43583.34,43796.738,2637,24922,0,2024-01-04 17:00:00,2024-01-04 17:00:00,199.26128571430309,69.04134855506709,43671.518190476185,0.0035290521337495435,0.0044687674455261735,43435.97972619049,43949.34935445785,45053.83012840055,43400.963724392124,44001.969860401725,0.0016312583830261664,0.002358099696967507,43538.38995237808,43316.9203284558,93.1473104416179,84.6710647175113,-60.50749635315571,43394.642796793356,43245.373425311125,43512.53961575505,149.26937148223078,98.57725908232999,234.6205645460791,83.90916718263179,48.54193051254697,30.69457378739753,43830.77737789226,43195.80185361784,True,False,44796.738,44266.738,44266.738,44296.738,2024-01-04 21:30:00,True,2024-01-04 21:30:00,,2024-01-04 21:32:33,0.02,even,True,171.09,16199.899999999996,,3,0,1,January
2024-01-08 19:30:00,45262.438,45422.238,45187.438,45362.438,2836,33750,0,2024-01-08 19:00:00,2024-01-08 19:00:00,50.36223809519288,329.07342600024276,45218.45577380951,0.003913309725843063,0.002147147987534415,45012.56940476189,45525.59801904546,46007.95015036954,45456.1547567253,46378.832636666724,0.0034710084073271722,0.004165461799911616,44015.25361776237,44290.59051617735,80.45419578239098,62.78786798285054,222.63489201195432,45034.8921343455,44821.962517640146,45073.7145249398,212.92961670535442,208.67719567489198,235.1953267464082,83.55063123498257,70.74309769520914,24.502004815956752,45392.72821604745,44756.200833832154,True,False,46362.438,45832.438,45832.438,45862.438,2024-01-08 20:15:00,True,2024-01-08 20:15:00,2024-01-08 20:36:16,2024-01-08 20:15:16,0.02,even,True,171.09,16370.989999999996,,4,0,2,January
2024-01-08 19:45:00,45362.438,45641.473,45286.082,45633.137,3219,30023,0,2024-01-08 19:00:00,2024-01-08 19:00:00,50.36223809519288,329.07342600024276,45218.45577380951,0.003913309725843063,0.002147147987534415,45012.56940476189,45525.59801904546,46007.95015036954,45456.1547567253,46378.832636666724,0.0034710084073271722,0.004165461799911616,44015.25361776237,44290.59051617735,92.2333476113397,78.33287194292032,222.63489201195432,45126.929805984655,44882.04951633347,45205.42169418649,244.88028965118428,215.91781447015046,229.59395848325778,131.70716924668523,83.55063123498257,70.74309769520914,45516.87353813888,44895.46985023409,True,False,46633.137,45183.137,46103.137,46133.137,,False,2024-01-08 20:45:00,2024-01-08 20:38:32,2024-01-09 23:25:17,0.02,success,True,364.02,16735.009999999995,,5,0,2,January
2024-01-08 20:45:00,46929.84,46993.34,46599.949,46949.664,4560,25922,0,2024-01-08 20:00:00,2024-01-08 20:00:00,205.88636904762097,402.42754087917274,45799.715571428555,0.0035790517155441987,0.006982352586147201,45218.45577380951,45636.21768428728,48336.73034076339,45525.59801904546,46007.95015036954,0.002147147987534415,0.003913309725843063,44130.32853471287,44503.316394883164,92.13022538132503,90.37301723241988,258.59342178539805,45803.834602199546,45302.66990115885,46140.87407361545,501.16470104069595,327.24290128560256,598.1230923069518,298.2379287926087,323.2726955624894,156.02264189883135,46949.84024822983,45333.40789900107,True,False,47949.664,46499.664,47419.664,47449.664,,False,2024-01-09 23:15:00,2024-01-09 23:14:57,2024-01-09 02:37:33,0.02,fail,False,-163.85,16571.159999999996,,0,1,2,January
2024-01-08 21:00:00,46949.637,47258.305,46750.547,47105.164,4248,0,0,2024-01-08 21:00:00,2024-01-08 21:00:00,581.2597976190445,589.4857921317816,46298.329583333325,0.0030689797638466555,0.006982444100129884,45799.715571428555,45665.647218050224,48675.65936129992,45636.21768428728,48336.73034076339,0.006982352586147201,0.0035790517155441987,44242.09753335158,44701.48612329252,93.95142336870119,91.5436625081144,324.77189585467477,46004.03912493808,45436.1879825545,46442.99773684208,567.8511423835807,375.36454950519817,703.1932603546517,302.12366322663,298.2379287926087,323.2726955624894,47393.80863832086,45493.6868353633,True,False,48105.164,46655.164,47575.164,47605.164,,False,2024-01-09 23:15:00,2024-01-11 16:37:11,2024-01-08 21:28:27,0.02,fail,False,-163.85,16407.309999999998,,0,2,2,January
2024-01-10 09:30:00,45875.137,45901.637,45709.238,45814.238,1203,24523,0,2024-01-10 09:00:00,2024-01-10 09:00:00,25.147726190436515,-127.87488227949507,45917.66733333336,0.00036698727185893623,-0.00015240410387412962,45981.42910714285,45772.30087831732,46147.284638577185,46043.60038355855,46224.47493830134,4.7111212045993045e-06,0.0010852302640158543,45844.75298514977,46138.06894692534,15.479564654930428,23.041696867775112,-98.37940128496238,45933.015990098975,45988.636156296525,45873.92233505332,-55.620166197550134,-48.532086877889576,106.57536914489455,-23.737876161052554,-30.677718954226293,-38.486477812126395,46017.79908339893,45728.54558670771,False,True,44814.238,45344.238,45344.238,45314.238,2024-01-10 11:00:00,True,2024-01-10 11:00:00,2024-01-10 14:48:47,2024-01-10 11:00:13,0.02,even,True,171.08,16578.39,,1,0,2,January
2024-01-10 09:45:00,45817.738,45845.738,45728.867,45740.137,1419,42762,0,2024-01-10 09:00:00,2024-01-10 09:00:00,25.147726190436515,-127.87488227949507,45917.66733333336,0.00036698727185893623,-0.00015240410387412962,45981.42910714285,45772.30087831732,46147.284638577185,46043.60038355855,46224.47493830134,4.7111212045993045e-06,0.0010852302640158543,45844.75298514977,46138.06894692534,14.568643766706906,17.131189229340603,-98.37940128496238,45903.342299314514,45970.22881138567,45842.57513347094,-66.88651207115618,-52.2029719165429,107.51861250603963,-31.347201582379057,-23.737876161052554,-30.677718954226293,45987.7252603541,45695.925006587786,False,True,44740.137,45270.137,45270.137,45240.137,2024-01-10 14:30:00,True,2024-01-10 14:30:00,2024-01-10 14:54:45,2024-01-10 14:30:13,0.02,even,True,171.09,16749.48,,2,0,2,January
2024-01-10 10:15:00,45759.746,45807.438,45690.039,45717.586,1317,44023,0,2024-01-10 10:00:00,2024-01-10 10:00:00,-63.7617738094923,-146.4255458714979,45691.82988095236,-0.0010182931738219644,-0.0012117019820287922,45917.66733333336,45113.92594903883,45743.31764086292,45772.30087831732,46147.284638577185,-0.00015240410387412962,0.00036698727185893623,45823.22698573213,46070.69063117131,9.304799325950107,12.72226933591238,-107.98863020226949,45856.994877024,45937.564679171526,45785.606355005184,-80.56980214752548,-61.175226925121336,126.05824645863619,-29.19539938080561,-27.773379084952467,-31.347201582379057,45955.78498772434,45613.927722286026,False,True,44717.586,45247.586,45247.586,45217.586,2024-01-10 14:45:00,True,2024-01-10 14:45:00,2024-01-10 14:54:45,2024-01-10 15:28:43,0.02,success,True,364.02,17113.5,,3,0,2,January
2024-01-10 10:30:00,45717.586,45746.039,45606.84,45625.367,1579,27515,0,2024-01-10 10:00:00,2024-01-10 10:00:00,-63.7617738094923,-146.4255458714979,45691.82988095236,-0.0010182931738219644,-0.0012117019820287922,45917.66733333336,45113.92594903883,45743.31764086292,45772.30087831732,46147.284638577185,-0.00015240410387412962,0.00036698727185893623,45823.22698573213,46070.69063117131,8.336748567664081,10.644970936231438,-107.98863020226949,45821.359819020305,45914.43892515882,45751.26257653937,-93.07910613851709,-67.55600276780049,141.35095705623033,-34.343778465816285,-29.19539938080561,-27.773379084952467,45942.08636856528,45558.938784513455,False,True,44625.367,45155.367,45155.367,45125.367,2024-01-10 14:45:00,True,2024-01-10 14:45:00,2024-01-10 14:54:45,2024-01-10 15:28:07,0.02,success,True,364.01,17477.51,,4,0,2,January
2024-01-10 10:45:00,45628.637,45719.438,45284.801,45295.84,2804,0,0,2024-01-10 10:00:00,2024-01-10 10:00:00,-63.7617738094923,-146.4255458714979,45691.82988095236,-0.0010182931738219644,-0.0012117019820287922,45917.66733333336,45113.92594903883,45743.31764086292,45772.30087831732,46147.284638577185,-0.00015240410387412962,0.00036698727185893623,45823.22698573213,46070.69063117131,4.418447516301882,7.3533318033053545,-107.98863020226949,45740.5106160941,45868.61678255446,45655.99140660483,-128.10616646036215,-79.66603550631282,192.22212799445367,-95.2711699345382,-34.343778465816285,-29.19539938080561,45915.49127939734,45394.99153381232,False,True,44295.84,44825.84,44825.84,44795.84,2024-01-10 15:00:00,True,2024-01-10 15:00:00,2024-01-10 15:01:34,2024-01-10 15:05:18,0.02,success,True,364.02,17841.53,,5,0,2,January
2024-01-10 19:45:00,46266.539,46413.801,45981.84,46378.949,4222,31101,0,2024-01-10 19:00:00,2024-01-10 19:00:00,14.018464285742084,-233.21793599932425,45578.046083333305,0.0015289633761676024,0.0021721096418540553,45152.90482142859,44799.694223447,46792.8556481794,44036.51603261367,45703.65857443925,-2.1923576427013245e-05,-0.000796143721615185,45695.35807854194,45726.52936711353,94.73235704144388,83.93688984743764,-240.59565836225408,45629.41923987824,45488.896732889894,45815.46440591676,140.5225069883454,1.063686993325149,381.2681154159946,197.08041726862575,175.4760729274276,29.096334709363873,46331.67636172836,45300.75245010517,True,False,47378.949,45928.949,46848.949,46878.949,,False,2024-01-11 01:15:00,2024-01-11 01:10:28,2024-01-10 20:09:36,0.02,fail,False,-163.85,17677.68,,0,1,2,January
2024-01-11 08:00:00,46046.309,46072.137,45594.617,45688.34,2887,19223,0,2024-01-11 08:00:00,2024-01-11 08:00:00,-247.7467142857422,116.10590264006896,46126.136964285666,-0.002322871624438623,-0.004472051212921852,46287.537511904746,45192.210423580495,45429.20601447615,45950.11015175243,45632.11421216774,-0.0044718666615283795,0.00046992412425483833,45961.660907447884,46129.90860162846,16.057106118593246,20.681479948240277,144.48789003991925,46202.13302889894,46294.51167560413,46092.869836257305,-92.37864670519048,-2.5314339168620066,222.7733960886713,-118.39548641210422,-47.891377708976506,-74.2346869624962,46393.61392097701,45790.6257515376,False,True,44688.34,46138.34,45218.34,45188.34,,False,2024-01-12 17:15:00,2024-01-12 17:26:22,2024-01-11 09:28:56,0.02,fail,False,-163.85,17513.83,,0,2,2,January
2024-01-11 13:00:00,46841.609,46966.438,46678.246,46961.539,3021,15922,0,2024-01-11 13:00:00,2024-01-11 13:00:00,249.79616666673246,94.7736856588017,46624.93410714286,0.003225569582685754,0.0020055742250400387,46334.985000000044,46892.11075221624,47498.35926034922,45918.5926246939,46997.3026763659,0.000843283878183076,0.0009378751359630715,46058.71344381749,46262.6943098105,98.64613895370881,96.29334046921964,81.76200456952782,46480.08403940784,46346.78564563491,46638.18043962848,133.29839377292956,38.300739228262344,303.37964233419876,106.5029253526227,87.71774234602344,71.84207086339302,47049.24295677965,46228.61792247731,True,False,47961.539,47431.539,47431.539,47461.539,2024-01-11 16:15:00,True,2024-01-11 16:15:00,2024-01-11 16:35:14,2024-01-11 17:38:45,0.02,success,True,364.02,17877.850000000002,,1,0,2,January
2024-01-12 17:30:00,44932.34,44943.438,44482.965,44534.582,5141,34922,0,2024-01-12 17:00:00,2024-01-12 17:00:00,-140.7018333333399,-175.34995545545826,45272.459702380955,-0.004035732193741608,-0.0025454182307309047,45711.9683095238,43676.30747557187,45355.28268779248,45044.13940865532,46258.25923492694,1.4536388651607341e-05,-0.0011597467862418422,46067.640286825466,45943.517223150266,8.126374245799795,9.566048732367081,-136.2253554329875,45367.65199928643,45621.17345721454,45136.06191847269,-253.52145792811643,-132.05666922710097,386.12625841298734,-202.9350395596921,-141.00013347090135,-119.14650945991889,45657.33236733022,44613.29146961516,False,True,43534.582,44984.582,44064.582,44034.582,,False,2024-01-12 18:45:00,2024-01-12 18:37:38,,0.02,success,True,364.02,18241.870000000003,,2,0,2,January
2024-01-12 17:45:00,44537.938,44663.738,44333.84,44468.84,4802,36074,0,2024-01-12 17:00:00,2024-01-12 17:00:00,-140.7018333333399,-175.34995545545826,45272.459702380955,-0.004035732193741608,-0.0025454182307309047,45711.9683095238,43676.30747557187,45355.28268779248,45044.13940865532,46258.25923492694,1.4536388651607341e-05,-0.0011597467862418422,46067.640286825466,45943.517223150266,10.450774744832232,10.70826705427212,-136.2253554329875,45229.37323016544,45535.8154233468,44962.378108703146,-306.4421931813631,-166.9337740179534,458.91459338172854,-173.6838097695436,-202.9350395596921,-141.00013347090135,45581.91280976848,44341.34340763781,False,True,43468.84,44918.84,43998.84,43968.84,,False,2024-01-12 18:45:00,2024-01-12 18:38:59,,0.02,success,True,364.02,18605.890000000003,,3,0,2,January
2024-01-12 18:00:00,44465.605,44684.113,44300.359,44363.84,4424,37800,0,2024-01-12 18:00:00,2024-01-12 18:00:00,-439.508607142845,-305.3991523512959,44624.876488095266,-0.007428816126341657,-0.002545624089944216,45272.459702380955,42030.436604432776,45242.108125660205,43676.30747557187,45355.28268779248,-0.0025454182307309047,-0.004035732193741608,45972.24415793035,45758.838965298244,5.059837284512123,7.87899542504805,-170.0601148166492,45096.21427167845,45449.00242902481,44781.55601272787,-352.7881573463601,-204.10465068363476,525.9747992620388,-180.82209597527253,-173.6838097695436,-202.9350395596921,45491.62199173163,44069.99003372412,False,True,43363.84,43893.84,43893.84,43863.84,2024-01-12 18:45:00,True,2024-01-12 18:45:00,2024-01-12 18:53:44,2024-01-12 18:49:47,0.02,even,True,171.09,18776.980000000003,,4,0,2,January
2024-01-15 00:15:00,42518.059,42533.738,42288.938,42295.238,1675,64324,0,2024-01-15 00:00:00,2024-01-15 00:00:00,-35.46648809522594,-690.5739900479821,43022.09020238095,-0.0045292108885736084,-0.006006138311663385,43367.19564285717,41348.93102238701,42639.81373588151,42658.11435240548,42805.455083940346,-0.0065389231558599745,-0.0014449836958881858,45407.553640052,44789.615011699345,13.0655173667714,19.512930347685316,-527.5667843237245,43264.69440858737,43696.56656114042,43170.064272789816,-431.8721525530491,-376.1350233327285,383.433388593504,-207.59455899553723,-202.50598383210308,-40.0362242862393,43687.69934739105,42650.92919818858,False,True,41295.238,41825.238,41825.238,41795.238,2024-01-15 02:00:00,True,2024-01-15 02:00:00,,2024-01-15 02:04:37,0.02,even,True,171.09,18948.070000000003,,5,0,3,January
2024-01-15 00:30:00,42295.238,42336.34,42038.137,42270.371,2029,44922,0,2024-01-15 00:00:00,2024-01-15 00:00:00,-35.46648809522594,-690.5739900479821,43022.09020238095,-0.0045292108885736084,-0.006006138311663385,43367.19564285717,41348.93102238701,42639.81373588151,42658.11435240548,42805.455083940346,-0.0065389231558599745,-0.0014449836958881858,45407.553640052,44789.615011699345,5.647525128888255,11.424450986173555,-527.5667843237245,43111.721576497,43590.922445500386,42970.91194220845,-479.20086900338356,-396.74819246685956,436.6355484460082,-199.152330581368,-207.59455899553723,-202.50598383210308,43560.369932610556,42379.95395180634,False,True,41270.371,41800.371,41800.371,41770.371,2024-01-15 02:00:00,True,2024-01-15 02:00:00,,2024-01-15 02:04:30,0.02,even,True,171.09,19119.160000000003,,6,0,3,January
2024-01-15 00:45:00,42270.402,42398.738,42148.039,42243.738,2123,65410,0,2024-01-15 00:00:00,2024-01-15 00:00:00,-35.46648809522594,-690.5739900479821,43022.09020238095,-0.0045292108885736084,-0.006006138311663385,43367.19564285717,41348.93102238701,42639.81373588151,42658.11435240548,42805.455083940346,-0.0065389231558599745,-0.0014449836958881858,45407.553640052,44789.615011699345,7.664679243503239,8.7925739130543,-527.5667843237245,42978.185641651304,43491.13100509295,42775.96183900925,-512.9453634416495,-419.98762666181756,496.8353372591514,-194.95010319919675,-199.152330581368,-207.59455899553723,43446.689544309105,42103.7341337094,False,True,41243.738,41773.738,41773.738,41743.738,2024-01-15 02:00:00,True,2024-01-15 02:00:00,,2024-01-15 02:01:20,0.02,even,True,171.09,19290.250000000004,,7,0,3,January
2024-01-16 23:15:00,43285.238,43453.84,43254.68,43431.34,2426,50769,0,2024-01-16 23:00:00,2024-01-16 23:00:00,65.79530952386267,87.82018538018019,43251.59048809523,0.0037873568561426663,0.0006002854037588361,43149.86847619051,43758.52854509368,43639.713199688595,43666.2016652398,43429.08724227478,4.845122479393252e-05,0.003962962563341771,43239.56574957785,42990.50461894447,84.23163803782334,74.27772878077253,64.76093983414391,43181.60946565902,43093.52302284205,43228.779630202946,88.08644281697343,62.69521735859545,121.89147506165149,74.05473993806663,47.50228861368669,14.45036738905037,43394.833121536176,43064.226138869715,True,False,44431.34,42981.34,43901.34,43931.34,,False,,,2024-01-17 03:50:58,0.02,fail,False,-163.85,19126.400000000005,,0,1,3,January
2024-01-17 03:45:00,43077.738,43088.34,42924.988,42931.137,1253,39484,0,2024-01-17 03:00:00,2024-01-17 03:00:00,-21.78107142855879,74.01014744244458,43086.91622619048,0.0004201351834740466,-0.0006010660339038051,43170.450452380945,42991.600634921306,43343.626206977635,43152.90426820151,43792.21826198267,0.0008527109186817029,0.0008507116958532556,43213.16470495352,43009.33744346634,16.66556870086461,17.55324859588278,82.64353372484395,43086.186694358315,43111.40391994759,42990.784704506375,-25.217225589272857,1.5518128331906516,129.9900724720117,-25.762236670096172,-15.057925696586608,-11.320887512913032,43166.27130234359,42813.79810666916,False,True,41931.137,42461.137,42461.137,42431.137,2024-01-17 18:30:00,True,2024-01-17 18:30:00,2024-01-18 18:40:49,2024-01-17 20:41:44,0.02,even,True,171.09,19297.490000000005,,1,0,3,January
2024-01-17 05:30:00,42947.688,42951.438,42874.953,42888.438,1319,44813,0,2024-01-17 05:00:00,2024-01-17 05:00:00,-71.88722619049076,27.87463319226663,42915.48857142858,-0.0007391013996496912,-0.0019271803595552683,43015.02899999999,42696.96124756956,42740.318298405546,42868.89323921593,42835.910833901355,-0.0018909803375803834,-9.792892605303493e-05,43188.38141506859,42990.884248949915,18.262231386531752,25.31975689244555,65.65162323906577,42994.087476796136,43047.53684133697,42941.377256621985,-53.44936454083654,-34.90939436696024,147.64297293765316,-17.566811145494285,-10.497082215333648,-5.869535259727854,43140.69527008782,42740.55924315615,False,True,41888.438,42418.438,42418.438,42388.438,2024-01-17 18:30:00,True,2024-01-17 18:30:00,2024-01-18 18:48:23,2024-01-17 19:30:49,0.02,even,True,171.09,19468.580000000005,,2,0,3,January
2024-01-17 05:45:00,42888.438,42927.438,42812.34,42815.84,1069,36523,0,2024-01-17 05:00:00,2024-01-17 05:00:00,-71.88722619049076,27.87463319226663,42915.48857142858,-0.0007391013996496912,-0.0019271803595552683,43015.02899999999,42696.96124756956,42740.318298405546,42868.89323921593,42835.910833901355,-0.0018909803375803834,-9.792892605303493e-05,43188.38141506859,42990.884248949915,9.200424151686471,17.888588856046734,65.65162323906577,42966.66478805827,43030.37411234905,42913.173255245965,-63.70932429077948,-40.66938035172409,147.73208714724427,-28.204001376019733,-17.566811145494285,-10.497082215333648,43112.61157289475,42712.23493759718,False,True,41815.84,42345.84,42345.84,42315.84,2024-01-17 18:45:00,True,2024-01-17 18:45:00,2024-01-18 18:48:51,2024-01-17 18:55:04,0.02,even,True,171.09,19639.670000000006,,3,0,3,January
2024-01-17 09:45:00,42723.898,42727.637,42589.145,42627.84,2034,38524,0,2024-01-17 09:00:00,2024-01-17 09:00:00,-30.29682142859383,-53.841077041572134,42709.20905952381,-0.001318648529426685,-0.0013539737264307177,42772.55620238096,42370.974082651024,42610.73965674568,42405.7299068188,42613.412046449506,-0.0015025085261344776,-0.0014059442891111826,43121.925362643735,42918.56744072292,19.515882458814307,27.119386474949447,6.448454508726963,42767.17089282131,42846.09726760479,42730.175732714146,-78.92637478347751,-73.301049411404,95.6089196012053,-21.56137289302569,-5.72832714136166,-5.185564155457541,42859.247774175776,42599.603691252516,False,True,41627.84,42157.84,42157.84,42127.84,2024-01-18 18:45:00,True,2024-01-18 18:45:00,2024-01-18 19:13:42,2024-01-19 22:14:42,0.02,success,True,364.02,20003.690000000006,,4,0,3,January
2024-01-18 08:00:00,42750.84,42848.637,42750.84,42832.539,1102,44523,0,2024-01-18 08:00:00,2024-01-18 08:00:00,39.049642857164145,-1.1721845370557276,42695.86171428569,0.000445338023397501,0.0003314237748645827,42648.3475,42653.093896928134,42909.010800079355,42661.70189047352,42766.028126156205,-1.1565537806773821e-05,0.0005597181904838018,42827.91870149108,42682.68713874732,91.26657602878079,88.56385864215775,-26.309582624410673,42691.97892437386,42656.97784722226,42715.66706914345,35.00107715160266,13.235547847047329,70.43247893444124,25.552712762306328,25.19304196765006,19.513157894725737,42812.25091570494,42620.583222581954,True,False,43832.539,42382.539,43302.539,43332.539,,False,,,2024-01-18 12:55:55,0.02,fail,False,-163.85,19839.840000000007,,0,1,3,January
2024-01-18 09:00:00,42782.738,42900.848,42776.676,42886.223,1370,42824,0,2024-01-18 09:00:00,2024-01-18 09:00:00,47.51421428568574,13.562332716435776,42782.38190476187,0.0008729900898441643,0.00043847426036556836,42695.86171428569,42812.27257560743,42971.24354586413,42653.093896928134,42909.010800079355,0.0003314237748645827,0.000445338023397501,42830.43322300124,42699.43528764754,82.46344952285615,80.28305812682193,-18.335199556241385,42750.74567486285,42697.16433252083,42811.0194258686,53.581342342018615,32.60169507182572,95.9245007954331,39.496753009989334,21.456537667676457,16.355973168218043,42942.017501942435,42681.52134979477,True,False,43886.223,42436.223,43356.223,43386.223,,False,,,2024-01-18 12:53:03,0.02,fail,False,-163.85,19675.99000000001,,0,2,3,January
2024-01-18 19:00:00,41927.637,41929.039,41613.84,41674.84,3354,8121,0,2024-01-18 19:00:00,2024-01-18 19:00:00,-193.5015952381509,-96.33438823714823,42158.10277380953,-0.003224620322108581,0.0001510310195148005,42352.225904761886,40948.14732998762,42831.60796305101,41286.03958363753,42752.48388320569,-0.00021473788301107694,-0.0027055962183117656,42689.76946189307,42515.89258820409,16.72208654681731,20.455154300672792,-36.700510744040436,42282.759314892144,42423.861964898264,42250.24525662196,-141.1026500061198,-58.321077995919424,231.04643601008272,-153.14990436875087,-112.71639834880625,-85.52038149294094,42562.15794523557,41936.83256800834,False,True,40674.84,42124.84,41204.84,41174.84,,False,2024-01-18 22:00:00,2024-01-18 22:35:44,2024-01-18 19:27:02,0.02,fail,False,-163.85,19512.14000000001,,0,3,3,January
2024-01-19 05:00:00,41085.438,41117.238,40977.238,41039.137,1481,41941,0,2024-01-19 05:00:00,2024-01-19 05:00:00,3.078654761920916,-323.80245928707154,41171.835666666666,0.00022258406440278606,0.00017163333256568292,41236.1299047619,40745.880329617794,41391.34286257931,41298.93498774698,41126.32630832811,-0.0010235045337319267,0.0016466315028420596,42188.37301373984,41752.24770114882,10.668814210794821,20.991312217372364,-310.5932753895694,41152.432048540606,41237.371898870544,41121.925401444794,-84.93985032993805,-91.90754138634686,104.40497633836985,-28.128476436184428,-29.779276229783136,-30.35105366355856,41262.8721195016,40979.47868338799,False,True,40039.137,41489.137,40569.137,40539.137,,False,2024-01-19 18:45:00,2024-01-22 20:49:22,2024-01-19 09:01:35,0.02,fail,False,-163.85,19348.29000000001,,0,4,3,January
2024-01-19 05:15:00,41041.238,41074.238,40868.496,40915.84,1857,35007,0,2024-01-19 05:00:00,2024-01-19 05:00:00,3.078654761920916,-323.80245928707154,41171.835666666666,0.00022258406440278606,0.00017163333256568292,41236.1299047619,40745.880329617794,41391.34286257931,41298.93498774698,41126.32630832811,-0.0010235045337319267,0.0016466315028420596,42188.37301373984,41752.24770114882,12.738897209023278,13.759381282649898,-310.5932753895694,41116.033271842054,41213.55472117643,41079.11503577573,-97.52144933437376,-93.03032297595225,103.26936679497676,-42.810365669065504,-28.128476436184428,-29.779276229783136,41218.52868094895,40938.20139060251,False,True,39915.84,41365.84,40445.84,40415.84,,False,2024-01-19 18:45:00,2024-01-22 21:17:17,2024-01-19 08:46:24,0.02,fail,False,-163.85,19184.440000000013,,0,5,3,January
2024-01-24 09:15:00,39896.563,40161.34,39893.563,40075.34,2674,36422,0,2024-01-24 09:00:00,2024-01-24 09:00:00,-2.4113333333662013,99.87386932035588,39788.3854404762,-0.0003588582276030179,-0.0002303027497709649,39724.59883333332,39438.38426649468,40127.69961140007,39644.54958244607,39657.93277990155,-0.0014818776458304208,0.0005072681803175072,39937.604805098184,39643.46575397469,92.00877098403107,89.81027781520318,37.962711379590615,39818.77751290826,39742.74395746001,39873.851287925674,76.03355544825172,51.01076184754301,116.67936953343954,70.8329865840642,45.10507327145024,38.376579635369126,40032.86843679582,39716.33413905553,True,False,41075.34,39625.34,40545.34,40575.34,,False,2024-01-26 12:45:00,2024-01-26 13:30:39,2024-01-24 20:23:19,0.02,fail,False,-163.85,19020.590000000015,,0,6,4,January
2024-01-25 07:00:00,39930.137,39941.438,39798.238,39810.34,1353,36422,0,2024-01-25 07:00:00,2024-01-25 07:00:00,-40.49497619047179,26.60334185072861,39925.79271428573,0.0001533941233565039,-0.00038277148001042134,39988.63748809526,39782.42895236621,40035.214030675874,40099.3250516904,40145.77004120169,-2.1064525564978473e-05,0.0015084997461010641,39941.91774952498,39888.50038950301,18.814889965161985,23.30882741339113,31.756684960894052,39945.40485175287,39954.11991664383,39909.426959752294,-8.715064890959184,12.468569537664752,76.71042052248316,-24.83501238394092,-15.013933264526713,-8.873642930870119,40012.98602745765,39804.36789204694,False,True,38810.34,40260.34,39340.34,39310.34,,False,,,2024-01-25 13:28:15,0.02,fail,False,-163.85,18856.740000000016,,0,7,4,January
2024-01-25 07:15:00,39810.34,39829.938,39765.738,39793.539,1215,36422,0,2024-01-25 07:00:00,2024-01-25 07:00:00,-40.49497619047179,26.60334185072861,39925.79271428573,0.0001533941233565039,-0.00038277148001042134,39988.63748809526,39782.42895236621,40035.214030675874,40099.3250516904,40145.77004120169,-2.1064525564978473e-05,0.0015084997461010641,39941.91774952498,39888.50038950301,12.65059476633767,19.223015608661417,31.756684960894052,39922.04087456012,39942.22503392948,39887.931178534556,-20.184159369353438,5.9380237562611144,87.40508251528253,-21.495781217738113,-24.83501238394092,-15.013933264526713,40005.928039930186,39768.43431713893,False,True,38793.539,40243.539,39323.539,39293.539,,False,,,2024-01-25 13:13:17,0.02,fail,False,-163.85,18692.890000000018,,0,8,4,January
2024-01-25 15:30:00,39812.738,39936.637,39763.852,39805.34,2076,36422,0,2024-01-25 15:00:00,2024-01-25 15:00:00,-74.73034523811657,24.226374536636285,39958.20660714288,-0.0005478202934538958,-0.0005040815693908639,40025.399785714275,39617.249547600375,40167.92071189394,39820.04787350147,40474.287914265515,0.0010383560017374683,0.00014126724309430368,39960.3058938564,39944.44013940603,10.78283768546615,11.565949668257659,35.55306878089166,39943.381577689666,39985.92663684735,39915.070724114186,-42.54505915768095,-3.0650373410893774,118.96072446260739,-37.7778682490607,-41.91651737186476,-40.982613347085135,40075.66770213871,39752.973746089665,False,True,38805.34,40255.34,39335.34,39305.34,,False,,,2024-01-26 11:42:35,0.02,fail,False,-163.85,18529.04000000002,,0,9,4,January
2024-01-26 04:15:00,40035.637,40162.637,40021.84,40145.84,1865,36422,0,2024-01-26 04:00:00,2024-01-26 04:00:00,-0.036428571424039546,-4.241536092114984,39972.8504047619,0.0009552619421524578,0.0009630128923023048,39908.23064285713,39968.67897710961,40369.835387761545,39930.321649323254,39891.80455419777,-0.00029679927375471935,0.0009552623618682734,39930.28855421318,39913.16545247492,84.13427197101625,67.31653475999434,-13.32418395982735,39941.81052939201,39905.98097281722,39949.6741513588,35.82955657479033,15.562507337508976,79.35527009991593,45.08658754731732,19.043935328510997,1.894755417961278,40058.30376599368,39842.544536723915,True,False,41145.84,40615.84,40615.84,40645.84,2024-01-26 13:00:00,True,2024-01-26 13:00:00,2024-01-26 13:30:44,,0.02,success,True,364.02,18893.06000000002,,1,0,4,January
2024-01-26 11:00:00,40098.152,40171.84,40079.762,40159.137,857,36422,0,2024-01-26 11:00:00,2024-01-26 11:00:00,12.870678571467579,35.61811049622338,40025.47219047621,-0.0002041989406570427,0.0005609882356586481,40039.38845238096,39817.890924984305,40469.63600957222,39917.43123028034,40101.131063235465,-0.00033460835921841187,0.0002944108937791167,39957.037107764474,39968.83690414416,89.76026391655834,87.66741556084257,24.89148538674374,40068.052793862764,40043.4990827106,40049.08979738561,24.553711152162577,15.476905028421736,71.67950416648787,28.356212934268115,14.882746818031592,16.697797385641024,40147.35712801037,39952.32246676085,True,False,41159.137,40629.137,40629.137,40659.137,2024-01-26 13:15:00,True,2024-01-26 13:15:00,2024-01-26 13:30:45,,0.02,success,True,364.02,19257.08000000002,,2,0,4,January
2024-01-26 11:30:00,40145.84,40281.039,40139.77,40277.137,979,36422,0,2024-01-26 11:00:00,2024-01-26 11:00:00,12.870678571467579,35.61811049622338,40025.47219047621,-0.0002041989406570427,0.0005609882356586481,40039.38845238096,39817.890924984305,40469.63600957222,39917.43123028034,40101.131063235465,-0.00033460835921841187,0.0002944108937791167,39957.037107764474,39968.83690414416,95.47282319529354,91.74678765691529,24.89148538674374,40111.47815418577,40068.421501638026,40119.00657275542,43.05665254774067,23.258006090722652,83.83719668122023,45.61979910561058,24.29697626419511,28.356212934268115,40233.68678827507,40005.82635723577,True,False,41277.137,40747.137,40747.137,40777.137,2024-01-26 13:30:00,True,2024-01-26 13:30:00,2024-01-26 13:30:51,,0.02,success,True,364.02,19621.10000000002,,3,0,4,January
2024-01-26 12:45:00,40608.996,40724.453,40491.848,40654.238,2864,36422,0,2024-01-26 12:00:00,2024-01-26 12:00:00,-13.916261904749263,34.97927583540877,40236.20259523811,-0.0004680602752597528,0.0019890668744216877,40025.47219047621,39739.84502600253,41018.161815911895,39817.890924984305,40469.63600957222,0.0005609882356586481,-0.0002041989406570427,39984.37831922469,40023.66899181263,86.13615196519699,68.99562401383253,26.909043476476747,40268.68483424619,40160.93072694316,40363.79826487789,107.75410730302974,52.80287681551796,177.7791753004128,101.4619109047344,102.5862855177038,36.572490884078434,40605.30015153345,40123.79637822234,True,False,41654.238,41124.238,41124.238,41154.238,2024-01-26 13:45:00,True,2024-01-26 13:45:00,2024-01-26 18:19:18,2024-01-26 13:47:35,0.02,even,True,171.09,19792.19000000002,,4,0,4,January
2024-01-26 13:00:00,40646.652,40866.238,40645.086,40776.547,2893,36422,0,2024-01-26 13:00:00,2024-01-26 13:00:00,210.73040476189635,101.46648209866544,40603.802166666675,0.0014328590996252777,0.003963361604515081,40236.20259523811,40301.474030292484,41925.29106389345,39739.84502600253,41018.161815911895,0.0019890668744216877,-0.0004680602752597528,40034.15713023549,40122.07451246762,91.41769238778346,82.50812465102992,41.82053120091449,40346.81747513139,40206.531932354774,40476.57231750945,140.28554277661897,70.29941000773817,220.64504522096442,112.77405263156106,101.4619109047344,102.5862855177038,40775.94312855775,40178.701506461155,True,False,41776.547,41246.547,41246.547,41276.547,2024-01-26 14:15:00,True,2024-01-26 14:15:00,2024-01-26 18:29:39,2024-01-26 14:42:54,0.02,even,True,171.09,19963.28000000002,,5,0,4,January
2024-01-26 13:45:00,41216.738,41301.367,41120.688,41253.738,2426,36422,0,2024-01-26 13:00:00,2024-01-26 13:00:00,210.73040476189635,101.46648209866544,40603.802166666675,0.0014328590996252777,0.003963361604515081,40236.20259523811,40301.474030292484,41925.29106389345,39739.84502600253,41018.161815911895,0.0019890668744216877,-0.0004680602752597528,40034.15713023549,40122.07451246762,94.29697882487166,93.49700938697147,41.82053120091449,40665.08283086021,40400.09209709107,40904.900693498465,264.9907337691402,147.9502180900982,395.235873647781,142.93394530443766,159.14655108360603,126.24787960096728,41439.96912292297,40371.33226407396,True,False,42253.738,41723.738,41723.738,41753.738,2024-01-26 18:30:00,True,2024-01-26 18:30:00,2024-01-29 03:36:45,2024-01-26 18:30:19,0.02,even,True,171.09,20134.37000000002,,6,0,4,January
2024-01-26 18:15:00,41601.637,41781.738,41545.23,41780.137,2694,36422,0,2024-01-26 18:00:00,2024-01-26 18:00:00,115.72771428572742,371.9654808276464,41638.016547619045,0.005444099710771894,0.003441853158684393,41403.496845238085,42193.178698557786,42574.79419058735,42035.68276731745,42673.29981304465,0.004201674983975908,0.005649828453771617,40283.30829525419,40566.71519421025,89.43806148387989,76.45389044472621,225.46637007715356,41381.64531415944,41114.14248417862,41471.232297213624,267.5028299808182,256.57346840003635,332.83792438881324,94.05224492600246,63.1862394221389,4.20646886825125,41922.06349513852,41021.90109928873,True,False,42780.137,42250.137,42250.137,42280.137,2024-01-29 05:15:00,True,2024-01-29 05:15:00,2024-01-29 18:19:47,2024-01-29 06:17:06,0.02,even,True,171.09,20305.46000000002,,7,0,4,January
2024-01-26 18:30:00,41777.848,41864.738,41689.852,41781.84,2652,36422,0,2024-01-26 18:00:00,2024-01-26 18:00:00,115.72771428572742,371.9654808276464,41638.016547619045,0.005444099710771894,0.003441853158684393,41403.496845238085,42193.178698557786,42574.79419058735,42035.68276731745,42673.29981304465,0.004201674983975908,0.005649828453771617,40283.30829525419,40566.71519421025,95.6731740865685,87.22111558652294,225.46637007715356,41443.21372736568,41163.60155942465,41561.160523219805,279.612167941028,261.1812083082347,297.4426638243367,89.92822600618092,94.05224492600246,63.1862394221389,41964.20811938266,41159.61292705695,True,False,42781.84,42251.84,42251.84,42281.84,2024-01-29 05:15:00,True,2024-01-29 05:15:00,2024-01-29 18:20:01,2024-01-29 06:17:06,0.02,even,True,171.09,20476.55000000002,,8,0,4,January
2024-01-26 18:45:00,41778.023,41963.34,41756.539,41926.137,2580,36422,0,2024-01-26 18:00:00,2024-01-26 18:00:00,115.72771428572742,371.9654808276464,41638.016547619045,0.005444099710771894,0.003441853158684393,41403.496845238085,42193.178698557786,42574.79419058735,42035.68276731745,42673.29981304465,0.004201674983975908,0.005649828453771617,40283.30829525419,40566.71519421025,96.00136328230224,93.70419961758353,225.46637007715356,41517.50961546326,41220.085666133935,41683.45497213626,297.423949329328,268.42975651245337,300.68726482305937,122.29444891645107,89.92822600618092,94.05224492600246,42090.882779647385,41277.52716462513,True,False,42926.137,42396.137,42396.137,42426.137,2024-01-29 05:30:00,True,2024-01-29 05:30:00,2024-01-29 18:20:50,2024-01-29 05:32:47,0.02,even,True,171.09,20647.64000000002,,9,0,4,January
2024-01-26 20:30:00,41997.438,42125.938,41960.199,42122.34,2140,36422,0,2024-01-26 20:00:00,2024-01-26 20:00:00,102.21132142856368,465.2345769327876,41881.15242857144,0.004107162381058911,0.003441814345266383,41740.22786904761,42294.7605684748,42869.336071785176,42423.02979246013,42721.397158890984,0.0034418013977847313,0.005443610199725503,40413.18110376983,40782.91711957956,87.0254731625107,85.29293644843783,307.195025015674,41812.47098611024,41514.64247370633,42030.27687891296,297.8285124039103,288.4023298090751,350.5799775110996,53.493600963178324,31.122707258349692,36.68565875473723,42505.05984855295,41556.99390927298,True,False,43122.34,41672.34,42592.34,42622.34,,False,2024-01-29 18:30:00,2024-01-29 18:40:31,2024-01-29 00:39:32,0.02,fail,False,-163.85,20483.790000000023,,0,1,4,January
2024-01-30 04:00:00,43407.039,43549.066,43407.039,43541.039,1834,36422,0,2024-01-30 04:00:00,2024-01-30 04:00:00,91.0103333333318,294.0347780320444,43384.10825000001,0.0009877717197868748,0.0021204903247486464,43256.17583333335,43313.90747727099,44111.23376854106,43270.979232171885,43782.71717549171,0.0014929771898040754,0.00098782226463628,42022.89155839212,42682.26246487686,80.72057457080992,79.74313841033666,278.3374171193511,43307.19073636636,43171.22793121022,43384.482513931885,135.9628051561449,118.39600124040027,139.79851773831942,61.77482662534749,34.74203921571461,39.112016167870024,43574.71051287861,43195.75451498516,True,False,44541.039,43091.039,44011.039,44041.039,,False,,,2024-01-30 16:10:49,0.02,fail,False,-163.85,20319.940000000024,,0,2,5,January
2024-01-31 01:30:00,42855.926,42967.738,42661.938,42747.098,2544,36422,0,2024-01-31 01:00:00,2024-01-31 01:00:00,-52.541190476185875,53.25084765440988,43246.69688095242,-0.0017744127848043226,0.00024100669904629675,43429.903642857134,42370.60125482352,43802.058372317806,43337.95059199498,43887.55003203799,0.0006266651665433463,0.0003779574094879129,42784.25589651701,43236.378521622755,3.1983124248350343,3.744444723989354,88.7857846928334,43229.67493205169,43328.523763657315,43164.996165806675,-98.84883160562458,-14.329863001958483,209.85128644774483,-133.58983625728433,-121.62710010322917,-64.29427966977528,43448.29540251113,42880.19692910222,False,True,41747.098,43197.098,42277.098,42247.098,,False,2024-02-01 03:15:00,,2024-01-31 17:33:44,0.02,fail,False,-163.85,20156.090000000026,,0,3,5,January
2024-01-31 11:15:00,42805.738,42861.738,42745.738,42748.637,1438,36422,0,2024-01-31 11:00:00,2024-01-31 11:00:00,13.161726190468471,-80.3434233294538,42859.93801190477,-0.00013811266116474174,0.0001278239154059313,42979.096142857175,42561.13144960449,43082.678389031455,43075.11452242779,43115.81757298857,0.0003196651906336146,0.0010893713300733929,42815.31738864299,43032.9931481105,16.605257695764777,27.015699170961444,-73.69013941561967,42899.69994139045,42931.0051975733,42893.23688476094,-31.305256182851736,-18.129546831045786,56.35848067515287,-37.400371173003805,-30.586733746167738,-3.642722050230077,42969.3208336724,42815.65293584948,False,True,41748.637,43198.637,42278.637,42248.637,,False,2024-02-01 03:15:00,,2024-01-31 17:33:44,0.02,fail,False,-163.85,19992.240000000027,,0,4,5,January
2024-01-31 11:45:00,42819.137,42869.738,42582.246,42619.938,1480,36422,0,2024-01-31 11:00:00,2024-01-31 11:00:00,13.161726190468471,-80.3434233294538,42859.93801190477,-0.00013811266116474174,0.0001278239154059313,42979.096142857175,42561.13144960449,43082.678389031455,43075.11452242779,43115.81757298857,0.0003196651906336146,0.0010893713300733929,42815.31738864299,43032.9931481105,12.993325950838695,14.238453732811541,-73.69013941561967,42846.172159220376,42900.2904670553,42812.93066563466,-54.11830783492769,-28.092655011612443,85.90622611828441,-59.98126762988977,-20.324951496389986,-37.400371173003805,42928.90407089434,42695.45726037498,False,True,41619.938,43069.938,42149.938,42119.938,,False,2024-02-01 03:30:00,,2024-01-31 17:31:45,0.02,fail,False,-163.85,19828.39000000003,,0,5,5,January
2024-01-31 17:30:00,42982.34,43441.738,42976.426,43349.637,3700,36422,0,2024-01-31 17:00:00,2024-01-31 17:00:00,67.64813095240243,-104.54584107402479,42907.620952380945,0.00010113387849840292,0.0012695716667471832,42664.65083333335,42355.529928252305,43644.613584899365,42125.884685678306,42908.90345201071,-0.0003555712616343641,-0.0006991741544851326,42805.68009496914,42937.765130848726,89.51965968760909,83.68111750819982,-118.2202654107487,42848.69296115446,42778.60568514096,42942.58041142068,70.08727601350256,-8.064643627849579,198.9753744081537,112.70107774333883,42.372106983166304,49.02750257997104,43212.69716687169,42673.96365596967,True,False,44349.637,42899.637,43819.637,43849.637,,False,,,2024-01-31 22:05:31,0.02,fail,False,-163.85,19664.54000000003,,0,6,5,January
2024-02-01 16:45:00,42499.457,42618.438,42437.867,42609.137,2339,36422,0,2024-02-01 16:00:00,2024-02-01 16:00:00,11.567250000000058,-122.23155927841435,42290.36472619049,-0.0008485010410053178,0.0011611187224801983,42135.88705952384,41707.5632774051,42799.92998395751,41765.048814271635,42360.14533397334,0.0001946858305800355,-0.0007365855270934857,42543.768734188845,42399.57600064836,94.34709727914175,88.96312348870372,-159.36545156291362,42292.077294940595,42230.38808365967,42317.01884038529,61.68921128092188,12.639752960606598,126.2994464362749,82.21755693153682,62.9857113863618,32.84334124523593,42489.02309307426,42146.514587696314,True,False,43609.137,43079.137,43079.137,43109.137,2024-02-01 22:00:00,True,2024-02-01 22:00:00,,2024-02-01 22:02:14,0.02,even,True,171.09,19835.63000000003,,1,0,5,February
2024-02-01 17:00:00,42593.891,42774.938,42530.637,42748.438,2947,36422,0,2024-02-01 17:00:00,2024-02-01 17:00:00,154.4776666666512,-58.65809554016596,42375.6244642857,0.0008845020344383455,0.0023054773447731903,42290.36472619049,42156.24107552298,43276.75956155944,41707.5632774051,42799.92998395751,0.0011611187224801983,-0.0008485010410053178,42541.34015637752,42406.157120596494,97.02847746528937,93.63264381790317,-139.2239803583641,42362.286634180506,42268.76215153673,42413.45688132094,93.52448264377745,28.81669889724077,166.91388707036904,96.43804093565268,82.21755693153682,62.9857113863618,42640.290628865936,42188.123133775945,True,False,43748.438,43218.438,43218.438,43248.438,2024-02-02 02:30:00,True,2024-02-02 02:30:00,,2024-02-02 02:32:41,0.02,even,True,171.09,20006.72000000003,,2,0,5,February
2024-02-05 09:30:00,42882.738,43068.738,42880.191,43038.137,2113,36422,0,2024-02-05 09:00:00,2024-02-05 09:00:00,72.74004761900142,-47.66264581098949,42875.61222619046,0.002110617528000651,0.00184273913083088,42731.167964285705,43087.319974620514,43442.55645470083,42938.28043514176,43007.22715146317,0.000862575708818789,0.0019557267828701676,42787.24726281515,42787.05375363393,86.93774448629313,83.48818937923949,-71.77558951493732,42776.00429661675,42704.255180096516,42840.88317096664,71.7491165202373,33.694203063829555,159.4289638805512,49.2022707258584,18.99257894729817,4.003355693152116,43057.612272205384,42625.6540697279,True,False,44038.137,42588.137,43508.137,43538.137,,False,2024-02-07 20:30:00,2024-02-07 22:17:10,2024-02-05 17:56:59,0.02,fail,False,-163.85,19842.87000000003,,0,1,6,February
2024-02-05 09:45:00,43038.137,43150.137,43005.539,43040.738,2050,36422,0,2024-02-05 09:00:00,2024-02-05 09:00:00,72.74004761900142,-47.66264581098949,42875.61222619046,0.002110617528000651,0.00184273913083088,42731.167964285705,43087.319974620514,43442.55645470083,42938.28043514176,43007.22715146317,0.000862575708818789,0.0019557267828701676,42787.24726281515,42787.05375363393,86.9850136862007,86.5603560605747,-71.77558951493732,42816.732558675714,42729.1798334227,42885.69310904714,87.55272525301552,44.46590750166675,173.31827620221637,44.809938080499705,49.2022707258584,18.99257894729817,43121.17278192013,42651.71343617415,True,False,44040.738,42590.738,43510.738,43540.738,,False,2024-02-07 20:30:00,2024-02-07 22:17:10,2024-02-05 17:56:59,0.02,fail,False,-163.85,19679.020000000033,,0,2,6,February
2024-02-05 12:30:00,43142.938,43187.539,43127.891,43151.82,970,36422,0,2024-02-05 12:00:00,2024-02-05 12:00:00,56.43983333330834,41.55804291907407,43051.199797619076,0.0019813304654321693,0.0021450102320150935,43002.89522619048,43317.31979978185,43772.078492103356,43231.36671803959,43795.94383075443,0.0026204115726326275,0.0019813064889453716,42816.26170855056,42844.22111196571,82.07700960034772,76.41058253405784,-25.183237316027977,43019.839091234215,42908.033887664875,43119.35669005847,111.80520356933994,97.75693392419232,172.62478416945234,21.43829136561544,27.90654489166627,28.832321637462883,43353.90014868723,42886.31323142971,True,False,44151.82,42701.82,43621.82,43651.82,,False,2024-02-07 22:15:00,2024-02-07 22:17:20,2024-02-05 17:43:52,0.02,fail,False,-163.85,19515.170000000035,,0,3,6,February
2024-02-05 15:00:00,43222.039,43295.738,43182.738,43231.738,1632,36422,0,2024-02-05 15:00:00,2024-02-05 15:00:00,57.957119047641754,102.7940943491194,43269.1838571429,0.0016401336205887629,0.001551500005113798,43171.86189285717,43418.13284608698,43802.98184061661,43346.67862079714,43425.77383228286,0.0007340861758677317,0.0016401729228591318,42867.57819978188,42939.27044680236,81.98771679336988,74.61117913449455,29.445696199240352,43139.206265674526,43041.59850813303,43204.49150085999,97.60775754149654,98.5364934164054,110.73093726196609,16.281222910220094,21.939213622288662,18.973823185406218,43355.47826616365,43055.00473555634,True,False,44231.738,42781.738,43701.738,43731.738,,False,2024-02-07 22:15:00,2024-02-07 23:26:24,2024-02-05 17:20:08,0.02,fail,False,-163.85,19351.320000000036,,0,4,6,February
2024-02-05 15:15:00,43231.738,43423.438,43231.738,43356.738,1868,36422,0,2024-02-05 15:00:00,2024-02-05 15:00:00,57.957119047641754,102.7940943491194,43269.1838571429,0.0016401336205887629,0.001551500005113798,43171.86189285717,43418.13284608698,43802.98184061661,43346.67862079714,43425.77383228286,0.0007340861758677317,0.0016401729228591318,42867.57819978188,42939.27044680236,84.27598845792967,79.68350950338841,29.445696199240352,43172.67268633998,43064.94217419725,43244.10220433434,107.73051214273437,100.3752971616712,108.44249832009156,39.61070347434725,16.281222910220094,21.939213622288662,43391.99957706646,43097.70483160222,True,False,44356.738,42906.738,43826.738,43856.738,,False,2024-02-07 22:30:00,2024-02-07 23:32:00,2024-02-05 17:16:57,0.02,fail,False,-163.85,19187.470000000038,,0,5,6,February
2024-02-05 23:15:00,42376.039,42410.438,42332.723,42366.738,1083,56422,0,2024-02-05 23:00:00,2024-02-05 23:00:00,-124.5014166667097,-84.2706136331617,42479.32038095241,-0.001010205356582871,-0.002695322014952503,42538.45253571426,42097.16484807679,42237.26113377934,41727.399978777954,42351.2410956986,-0.0026951406588509746,-0.002295878738334573,42809.976513023954,42793.51101152565,15.495759138631373,18.316842939130492,-7.496209785524611,42528.396460604956,42659.78723519335,42458.34138390089,-131.39077458839165,-107.84888073449268,142.50997006676016,-42.4400890953184,-57.93461885108263,-57.246376332950604,42650.72984349102,42264.45292431077,False,True,41366.738,42816.738,41896.738,41866.738,,False,,,2024-02-06 04:36:50,0.02,fail,False,-163.85,19023.62000000004,,0,6,6,February
2024-02-06 05:00:00,42809.691,42922.84,42801.84,42904.84,911,36422,0,2024-02-06 05:00:00,2024-02-06 05:00:00,100.88801190476806,-52.37636154502252,42755.1764047619,0.001928317749352228,0.0005367896243089421,42655.61292857147,42995.440333386854,43016.389315496235,42548.13921539262,42941.02301749918,0.00020478658697460145,0.000815453605866316,42779.375009428346,42746.75191412391,88.28855970218733,86.47127865015948,-66.46132470856885,42726.17090435939,42666.720706139626,42801.358506019926,59.45019821976166,19.510716195515077,158.60598500576333,30.837296525627607,18.799056071511586,42.44643722053297,43016.97658577771,42587.24042626214,True,False,43904.84,43374.84,43374.84,43404.84,2024-02-07 19:30:00,True,2024-02-07 19:30:00,2024-02-07 22:16:40,2024-02-07 19:47:43,0.02,even,True,171.09,19194.71000000004,,1,0,6,February
2024-02-06 17:45:00,43156.137,43229.738,43107.355,43213.84,1878,36422,0,2024-02-06 17:00:00,2024-02-06 17:00:00,5.904000000031374,27.135545069504587,42944.1648214286,-0.0002281872799403319,0.00059842843897201,42829.94160714289,42547.967218918326,43339.22290135231,42560.57860192866,43037.90120090137,-0.000137078701652891,-0.00021820838568030929,42816.77837820967,42836.074605929876,91.00864541480428,83.04613263717108,16.386661199125392,42996.060936893846,42919.37861647356,43070.46340350874,76.6823204202883,37.37256351793459,131.35352061494706,54.13150739586854,45.67447609223018,56.64301995182905,43249.29065633891,42893.13615067856,True,False,44213.84,42763.84,43683.84,43713.84,,False,2024-02-07 22:15:00,2024-02-07 22:49:53,2024-02-07 05:52:28,0.02,fail,False,-163.85,19030.86000000004,,0,1,6,February
2024-02-07 05:45:00,42827.891,42842.938,42745.238,42764.84,1157,36422,0,2024-02-07 05:00:00,2024-02-07 05:00:00,-26.56094047620718,34.17225811367098,42939.50265476191,-0.000967687421152756,-0.0006215890985594821,43027.66032142857,42593.9703437125,43002.586973538586,42846.41016862063,43027.97614913047,-0.0006254762666807548,-0.00045504831171572463,42911.93813014548,42972.81084940439,4.6223715628210185,7.988504953974968,62.52883011635667,42954.912357943984,43017.01850848314,42908.65892844858,-62.10615053915535,-31.371668274891462,98.87540856802156,-47.58936635704595,-35.84878947369725,-21.23277089784824,43042.14073001541,42773.677126881754,False,True,41764.84,43214.84,42294.84,42264.84,,False,,,2024-02-07 16:46:27,0.02,fail,False,-163.85,18867.010000000042,,0,2,6,February
2024-02-09 05:00:00,46252.738,46329.238,46071.961,46264.738,2888,36422,0,2024-02-09 05:00:00,2024-02-09 05:00:00,313.1271071428346,286.52212946468353,45810.38167857144,0.0007464405879067861,0.0028499556170342904,45635.53155952381,45427.25589820176,46996.64178711585,45393.49615485332,46863.53041206945,0.002849822391615899,0.0007462965670302416,44492.5938514344,45084.63984614144,92.85630428575428,91.40360002230629,240.2513584469774,45703.388149808015,45496.11056300414,45853.400584795316,207.27758680387342,104.88989597474443,301.1004450869873,142.43046405229688,162.53827210178133,109.78303336776298,46261.38618566275,45446.91498392788,True,False,47264.738,45814.738,46734.738,46764.738,,False,2024-02-09 13:45:00,2024-02-09 13:55:01,2024-02-09 06:19:31,0.02,fail,False,-163.85,18703.160000000044,,0,3,6,February
2024-02-09 09:15:00,46208.324,46283.539,46149.633,46283.539,1187,36422,0,2024-02-09 09:00:00,2024-02-09 09:00:00,85.59071428575407,343.47195675005787,46224.35382142859,0.0033448236209598645,0.0006052667829016319,46189.46363095239,46731.03835960609,46612.36832244241,46691.585147619495,47173.11628035337,0.0022284857932910714,0.0036309318930738,44733.71059156216,45380.1284226357,86.56162319790518,80.04903274058707,294.2529502501413,46122.52776513771,45945.93583842372,46174.13697213626,176.5919267139907,180.67718515945498,289.21427080037,51.89381940148451,12.305480908114987,-5.774204678287788,46566.076237716756,45783.69770655576,True,False,47283.539,46753.539,46753.539,46783.539,2024-02-09 13:45:00,True,2024-02-09 13:45:00,2024-02-09 14:08:06,2024-02-09 16:20:55,0.02,success,True,364.02,19067.180000000044,,1,0,6,February
2024-02-14 08:00:00,49532.84,49643.637,49498.039,49616.738,890,36422,0,2024-02-14 08:00:00,2024-02-14 08:00:00,20.653154761916085,19.732205832464388,49503.96505952383,-0.0004747659213546056,-0.00033111057838195026,49463.184000000016,49062.19797738325,49580.52395996941,49123.16767629547,49548.272898637064,-0.00043124511916813155,-0.00031545161887542835,49022.87091118022,49423.168930718704,83.1450563696623,75.98930693714675,-11.996319716918425,49495.5602297746,49465.425420287575,49501.56354833165,30.13480948702636,22.81348582772622,71.02598436447033,17.670005159925495,8.591318197453802,7.887009631966066,49598.94862722368,49405.67846943962,True,False,50616.738,49166.738,50086.738,50116.738,,False,2024-02-14 11:00:00,2024-02-14 10:58:00,,0.02,success,True,364.02,19431.200000000044,,2,0,7,February
2024-02-14 08:45:00,49559.738,49628.039,49531.84,49616.438,1362,36422,0,2024-02-14 08:00:00,2024-02-14 08:00:00,20.653154761916085,19.732205832464388,49503.96505952383,-0.0004747659213546056,-0.00033111057838195026,49463.184000000016,49062.19797738325,49580.52395996941,49123.16767629547,49548.272898637064,-0.00043124511916813155,-0.00031545161887542835,49022.87091118022,49423.168930718704,86.96222300470977,86.60296066749726,-11.996319716918425,49531.81978053254,49490.37037524734,49543.26450773996,41.449405285202374,30.206856028861992,78.81826517714575,19.253641210838396,8.86739903686248,13.579919160605641,49651.1691657291,49436.859849750814,True,False,50616.438,49166.438,50086.438,50116.438,,False,2024-02-14 11:00:00,2024-02-14 10:58:00,,0.02,success,True,364.02,19795.220000000045,,3,0,7,February
2024-02-14 09:00:00,49616.438,49717.238,49616.438,49649.637,1330,36422,0,2024-02-14 09:00:00,2024-02-14 09:00:00,40.781059523811564,36.00726031549857,49633.41614285712,0.00021947226969683194,0.0005170760349810612,49503.96505952383,49271.420463809736,49977.777171096546,49062.19797738325,49580.52395996941,-0.00033111057838195026,-0.0004747659213546056,49054.39511074178,49455.45445626121,87.24436715934071,87.06374706014985,-2.395603710435025,49549.945506604454,49502.1679030068,49570.12463536292,47.77760359765671,33.72100554262094,85.79884702532628,26.860127622960135,19.253641210838396,8.86739903686248,49687.45307884711,49454.296191878726,True,False,50649.637,49199.637,50119.637,50149.637,,False,2024-02-14 11:00:00,2024-02-14 10:58:01,,0.02,success,True,364.02,20159.240000000045,,4,0,7,February
2024-02-14 09:15:00,49649.637,49848.383,49611.34,49833.328,1033,36422,0,2024-02-14 09:00:00,2024-02-14 09:00:00,40.781059523811564,36.00726031549857,49633.41614285712,0.00021947226969683194,0.0005170760349810612,49503.96505952383,49271.420463809736,49977.777171096546,49062.19797738325,49580.52395996941,-0.00033111057838195026,-0.0004747659213546056,49054.39511074178,49455.45445626121,92.85748060469973,89.02135692291677,-2.395603710435025,49593.54281328069,49526.69828056185,49627.065802201556,66.84453271883831,40.345710977864414,108.02282177712128,56.94116683863831,26.860127622960135,19.253641210838396,49774.39661160067,49481.23499280244,True,False,50833.328,49383.328,50303.328,50333.328,,False,2024-02-14 11:00:00,2024-02-14 10:58:33,,0.02,success,True,364.01,20523.250000000044,,5,0,7,February
2024-02-14 09:45:00,49791.184,49869.738,49758.008,49826.738,1552,36422,0,2024-02-14 09:00:00,2024-02-14 09:00:00,40.781059523811564,36.00726031549857,49633.41614285712,0.00021947226969683194,0.0005170760349810612,49503.96505952383,49271.420463809736,49977.777171096546,49062.19797738325,49580.52395996941,-0.00033111057838195026,-0.0004747659213546056,49054.39511074178,49455.45445626121,91.84812370926734,91.60215091274644,-2.395603710435025,49653.917777556,49566.41588114013,49726.12789370481,87.50189641587349,55.626563476764275,128.0455562596028,50.37734709318465,48.68474441007129,56.94116683863831,49900.48939465528,49553.26639275435,True,False,50826.738,49376.738,50296.738,50326.738,,False,2024-02-14 11:00:00,2024-02-14 10:58:33,,0.02,success,True,364.01,20887.260000000042,,6,0,7,February
2024-02-14 11:00:00,50767.168,51667.438,50631.773,50988.438,4749,36422,0,2024-02-14 11:00:00,2024-02-14 11:00:00,409.9161904761859,197.63400554266263,50623.321761904794,0.002658616284818251,0.006089949143877309,50043.3323333333,50369.51853086082,52934.944998945626,50233.716936723446,51611.17720134076,0.00383486700153517,0.0026582778023509657,49217.410058781636,49720.76080857949,83.13925049942584,81.3534904288007,49.15149446911113,50042.773265262666,49793.043654929614,50236.509775369756,249.72961033305182,124.28106002618054,387.4042056268655,213.84403130369174,199.79709838324197,43.343899552797666,50761.00545296603,49713.514097773485,True,False,51988.438,51458.438,51458.438,51488.438,2024-02-14 12:00:00,True,2024-02-14 12:00:00,2024-02-14 16:32:38,2024-02-14 12:02:27,0.02,even,True,171.08,21058.340000000044,,7,0,7,February
2024-02-14 15:45:00,51794.938,51824.637,51668.027,51801.84,2301,36422,0,2024-02-14 15:00:00,2024-02-14 15:00:00,229.02904761902755,562.6262114389247,51790.12388095241,0.007108214432965931,0.005266525997264436,51601.17221428572,52954.63573998204,53892.161468498045,52668.081411496496,54909.49348458508,0.00876799297093931,0.007326136966806657,49566.652756778756,50250.07646091186,88.25177211927583,78.69224730547836,311.03761345790133,51556.04468224819,51151.529090163865,51687.72237942891,404.51559208432445,429.8248426339854,661.0620386179626,38.62635534913716,23.89229274156969,3.4250718954281183,52581.656131563155,50795.28862729466,True,False,52801.84,51351.84,52271.84,52301.84,,False,2024-02-15 02:45:00,2024-02-15 16:34:31,2024-02-14 17:16:30,0.02,fail,False,-163.85,20894.490000000045,,0,1,7,February
2024-02-19 08:15:00,52372.738,52481.738,52332.805,52437.637,1883,36422,0,2024-02-19 08:00:00,2024-02-19 08:00:00,-18.595119047589833,28.60094514445518,52219.21784523808,0.0004364547863728899,0.00010193046883795001,52120.571440476226,52116.23693393057,52524.23677213035,52104.59570466141,51962.75349771242,-0.0010992910596371794,0.000492246483370829,51879.84320129512,52094.83782158405,83.75819149447332,61.70732636387396,21.03495113810689,52191.307894832215,52147.69630046695,52191.95722566222,43.611594365262135,16.12873176833577,102.05813166043633,55.384112831139646,39.2641114551152,3.3233298933701008,52331.23570340381,52054.17874792063,True,False,53437.637,51987.637,52907.637,52937.637,,False,,,2024-02-19 18:51:58,0.02,fail,False,-163.85,20730.640000000047,,0,2,8,February
2024-02-20 08:00:00,51923.039,52044.238,51912.941,52032.781,681,36422,0,2024-02-20 08:00:00,2024-02-20 08:00:00,71.34885714288976,-74.8488831321738,51846.961547619045,0.0013219323783333545,9.336802245603858e-05,51752.06152380954,51916.745911613725,52076.308338788425,51412.88024933859,51937.857230386944,-0.000318616099440736,0.00024912164701927663,51913.782761038485,51918.189359933196,91.35686811005401,89.54082538225481,-89.65165785746669,51847.45993231624,51805.397487165006,51917.99853835576,42.06244515123399,-3.895106382828569,138.10330148201712,41.85855624359829,16.696830409382528,52.224327485397225,52105.93799535648,51731.55908135504,True,False,53032.781,51582.781,52502.781,52532.781,,False,2024-02-20 15:45:00,2024-02-20 15:40:24,2024-02-20 11:20:21,0.02,fail,False,-163.85,20566.790000000048,,0,3,8,February
2024-02-21 00:00:00,52023.84,52163.039,51999.84,52153.695,968,56422,0,2024-02-21 00:00:00,2024-02-21 00:00:00,209.11091666668653,-3.8432499268310494,52062.32708333331,0.004623658095052738,0.0005841608154370217,51890.895202380954,52893.59116893044,52431.47870294268,51683.34605685313,51772.20700896868,-0.001975099843330434,0.0022682273125457135,51931.542920691885,51940.2758094464,87.45754279529093,86.98603865314386,-23.29866946771846,51993.00931409962,51893.42117825221,52236.730629859005,99.5881358474071,46.071449188689954,361.70144709056746,15.35964705888182,-1.2497856897753081,45.75409838324413,52726.52758343127,51748.43367628674,True,False,53153.695,51703.695,52623.695,52653.695,,False,,,2024-02-21 08:50:19,0.02,fail,False,-163.85,20402.94000000005,,0,4,8,February
2024-02-21 00:15:00,52155.738,52200.738,52098.988,52157.637,862,56422,0,2024-02-21 00:00:00,2024-02-21 00:00:00,209.11091666668653,-3.8432499268310494,52062.32708333331,0.004623658095052738,0.0005841608154370217,51890.895202380954,52893.59116893044,52431.47870294268,51683.34605685313,51772.20700896868,-0.001975099843330434,0.0022682273125457135,51931.542920691885,51940.2758094464,88.54806360324613,87.78396471757844,-23.29866946771846,52018.33665039199,51912.9927206039,52252.0007901617,105.34392978809046,57.925945308570064,372.3625550554327,15.270160302694421,15.35964705888182,-1.2497856897753081,52756.19023948653,51749.311340836866,True,False,53157.637,51707.637,52627.637,52657.637,,False,,,2024-02-21 08:49:12,0.02,fail,False,-163.85,20239.09000000005,,0,5,8,February
2024-02-21 00:30:00,52158.039,52260.738,52116.125,52260.738,500,56422,0,2024-02-21 00:00:00,2024-02-21 00:00:00,209.11091666668653,-3.8432499268310494,52062.32708333331,0.004623658095052738,0.0005841608154370217,51890.895202380954,52893.59116893044,52431.47870294268,51683.34605685313,51772.20700896868,-0.001975099843330434,0.0022682273125457135,51931.542920691885,51940.2758094464,94.0844971733959,90.03003452397769,-23.29866946771846,52055.6291657163,51938.751630188795,52270.587148950806,116.87753552750655,69.71626335235737,387.08785676643186,18.58635878910718,15.270160302694421,15.35964705888182,52794.65575558549,51748.018542316124,True,False,53260.738,51810.738,52730.738,52760.738,,False,,,2024-02-21 08:06:11,0.02,fail,False,-163.85,20075.240000000053,,0,6,8,February
2024-02-21 07:45:00,51870.137,51891.738,51832.738,51848.039,1334,36422,0,2024-02-21 07:00:00,2024-02-21 07:00:00,-66.7120595238448,30.708552729200164,51956.44751190474,-0.0005663274252758678,-0.0012967072527935314,52050.43279761902,51681.12098509042,51876.282422197044,51786.800097179635,51809.246705328296,-0.0015887221693886109,-0.0001832252782292251,51963.584907104436,51989.427135748134,19.4177501413222,36.098951102566815,34.10062817358075,51975.96793504734,52025.27174544483,51917.5877110423,-49.30381039749045,-23.253069911199283,134.75139317539802,-25.773541795708297,-16.17696594420704,-11.582088063310948,52099.50209182909,51734.173330255515,False,True,50848.039,51378.039,51378.039,51348.039,2024-02-21 11:45:00,True,2024-02-21 11:45:00,2024-02-21 13:56:57,2024-02-21 12:50:20,0.02,even,True,171.09,20246.330000000053,,1,0,8,February
2024-02-21 20:45:00,50944.531,50986.238,50831.84,50850.105,972,36422,0,2024-02-21 20:00:00,2024-02-21 20:00:00,-85.86780952385016,-201.25780617461714,51031.71423809521,0.0008074152289305609,-6.556551128396228e-05,51111.71279761901,50970.75819616512,51419.42945920721,51138.32284678164,51422.800143635104,-6.553978433839833e-05,0.0012699540559290654,51658.47026291101,51453.84755445001,10.527544537279132,18.385041743907582,-178.6950085309435,51030.09581824077,51122.14793388745,51013.85276608192,-92.05211564667843,-70.42833545192411,156.90064956427278,-62.07724148604757,-28.926820433378452,-48.33857103547052,51225.66864299369,50800.53688917016,False,True,49850.105,51300.105,50380.105,50350.105,,False,,,2024-02-21 23:29:59,0.02,fail,False,-163.85,20082.480000000054,,0,1,8,February
2024-02-22 01:00:00,51496.984,51674.438,51484.063,51621.84,1620,56422,0,2024-02-22 01:00:00,2024-02-22 01:00:00,125.27803571425466,-87.09486994606414,51461.238166666684,0.0018054505426060316,0.0014595365633574852,51220.08546428572,51368.31300568245,52260.99584828244,50619.80438670812,51573.80661583697,0.0002648645224806554,-7.218978986132913e-05,51604.33139534214,51428.22682167476,94.54497786931448,92.22087401388457,-162.31861471189714,51319.668259899976,51223.566183306044,51459.99470966629,96.102076593932,34.63592519570238,213.4093964797292,74.8876859304437,52.79440522880759,59.64741417262849,51749.59739491392,51171.89202441865,True,False,52621.84,51171.84,52091.84,52121.84,,False,,,2024-02-22 03:53:21,0.02,fail,False,-163.85,19918.630000000056,,0,2,8,February
2024-02-22 08:30:00,51634.738,51769.738,51634.738,51754.418,1117,36422,0,2024-02-22 08:00:00,2024-02-22 08:00:00,-9.258690476141055,36.428838160732994,51562.11302380952,0.0010232846348521068,-0.0003905534888178929,51478.67557142859,51623.595323568756,51748.29114983675,51349.15911155983,51530.70062374189,-0.0008581640344016272,0.0004752376711658515,51584.14852116126,51473.32402597491,82.76165035408805,72.58549103151812,-17.546522910123027,51594.871722571625,51536.67864452667,51634.93444341245,58.193078044954746,48.87029303574489,104.88232481910234,25.806185758490756,-1.678853801175137,9.40014757480094,51778.02558191824,51493.34330490666,True,False,52754.418,51304.418,52224.418,52254.418,,False,,,2024-02-22 15:15:48,0.02,fail,False,-163.85,19754.780000000057,,0,3,8,February
2024-02-22 08:45:00,51753.215,51826.738,51730.289,51780.84,1569,36422,0,2024-02-22 08:00:00,2024-02-22 08:00:00,-9.258690476141055,36.428838160732994,51562.11302380952,0.0010232846348521068,-0.0003905534888178929,51478.67557142859,51623.595323568756,51748.29114983675,51349.15911155983,51530.70062374189,-0.0008581640344016272,0.0004752376711658515,51584.14852116126,51473.32402597491,88.69162787764263,80.03632282975934,-17.546522910123027,51623.48222679138,51554.76467085803,51667.79052872377,68.7175559333482,52.83974561526556,116.13371380184783,32.85608531132311,25.806185758490756,-1.678853801175137,51826.07104235627,51511.01001509128,True,False,52780.84,51330.84,52250.84,52280.84,,False,,,2024-02-22 15:15:47,0.02,fail,False,-163.85,19590.93000000006,,0,4,8,February
2024-02-22 09:30:00,51859.84,51930.84,51793.484,51891.637,1527,36422,0,2024-02-22 09:00:00,2024-02-22 09:00:00,83.43745238093106,68.32314788499934,51700.29902380952,0.0013076771219178336,0.00010186388254256463,51562.11302380952,51821.56123026298,51950.756978254314,51623.595323568756,51748.29114983675,-0.0003905534888178929,0.0010232846348521068,51594.27367719415,51502.84530389692,89.8004744581584,89.43015542911753,-0.3725887510985526,51708.89477827006,51612.72608231249,51767.93322703826,96.16869595757453,69.3141006981418,153.08198287560103,40.35878431382298,36.57430615755584,23.209607843105914,51976.09390392032,51561.272550156194,True,False,52891.637,51441.637,52361.637,52391.637,,False,,,2024-02-22 14:40:39,0.02,fail,False,-163.85,19427.08000000006,,0,5,8,February
2024-02-22 15:00:00,51539.75,51566.637,51371.34,51423.238,1149,36422,0,2024-02-22 15:00:00,2024-02-22 15:00:00,-101.65861904763733,67.71501591356355,51490.94915476192,-0.0016494142579333553,-0.0011566481949658112,51707.007940476164,50627.408752248804,51589.60886449028,51433.955021910944,52179.651592903625,0.0003358677569828036,-3.418855204780785e-06,51603.226259620606,51548.21099689675,12.327706415494616,17.805216895364804,74.2439992764838,51624.29039948645,51669.21368651586,51534.644221190254,-44.923287029414496,-0.7477771629666048,140.11285133825342,-52.86798245616228,-39.779406948699034,-47.24710629515175,51723.796570496896,51343.99187188361,False,True,50423.238,51873.238,50953.238,50923.238,,False,2024-02-23 17:30:00,,2024-02-22 22:28:38,0.02,fail,False,-163.85,19263.23000000006,,0,6,8,February
2024-02-22 15:15:00,51422.09,51422.09,51114.023,51268.539,2399,36422,0,2024-02-22 15:00:00,2024-02-22 15:00:00,-101.65861904763733,67.71501591356355,51490.94915476192,-0.0016494142579333553,-0.0011566481949658112,51707.007940476164,50627.408752248804,51589.60886449028,51433.955021910944,52179.651592903625,0.0003358677569828036,-3.418855204780785e-06,51603.226259620606,51548.21099689675,14.265265796933411,14.884043581753117,74.2439992764838,51569.55941495007,51639.53408010728,51465.35015548674,-69.97466515721317,-14.593154761815919,169.99436571095117,-69.2940657035142,-52.86798245616228,-39.779406948699034,51694.842549196524,51234.357761776955,False,True,50268.539,51718.539,50798.539,50768.539,,False,2024-02-23 18:15:00,,2024-02-22 18:07:01,0.02,fail,False,-163.85,19099.380000000063,,0,7,8,February
2024-02-22 15:30:00,51268.539,51368.738,51078.445,51078.938,1534,36422,0,2024-02-22 15:00:00,2024-02-22 15:00:00,-101.65861904763733,67.71501591356355,51490.94915476192,-0.0016494142579333553,-0.0011566481949658112,51707.007940476164,50627.408752248804,51589.60886449028,51433.955021910944,52179.651592903625,0.0003358677569828036,-3.418855204780785e-06,51603.226259620606,51548.21099689675,8.61510177447369,11.7360246623006,74.2439992764838,51494.07919726544,51598.00844454378,51361.61236876504,-103.92924727834179,-32.46037326512109,211.8526550798177,-103.7377867217001,-69.2940657035142,-52.86798245616228,51647.613453122794,51074.111284407285,False,True,50078.938,51528.938,50608.938,50578.938,,False,,,2024-02-22 17:32:30,0.02,fail,False,-163.85,18935.530000000064,,0,8,8,February
2024-02-26 00:30:00,51832.238,51876.84,51832.238,51874.137,639,56422,0,2024-02-26 00:00:00,2024-02-26 00:00:00,-24.103833333356306,-49.22722743124905,51301.212988095234,0.0013837608995454884,0.0020509373990880483,51076.619119047595,51329.87330876155,52289.58095876598,51257.9759334608,51035.638313964286,-0.0005737537550927179,0.0013838874515319907,51328.644616358135,51217.350633714974,96.44736561340767,72.84317928755883,-64.98001121539767,51356.75856389693,51217.13019254947,51415.25726762985,139.62837134746223,50.942916117365286,252.4251220644022,121.00476367389638,134.88482318542083,129.15346233228047,51757.531182416795,51074.48335284291,True,False,52874.137,51424.137,52344.137,52374.137,,False,2024-02-26 17:30:00,2024-02-26 18:01:07,2024-02-26 05:06:24,0.02,fail,False,-163.85,18771.680000000066,,0,9,9,February
2024-02-26 11:30:00,51064.004,51102.438,50956.844,50969.074,2410,36422,0,2024-02-26 11:00:00,2024-02-26 11:00:00,-60.224654761907004,31.047381030286488,51237.893095238076,-0.0014488332845856563,-0.00044066968755299103,51403.671821428565,50637.11320161437,51471.38454202582,51152.06327897127,51521.96616171375,-0.00034756702722392614,-0.0005673827774139359,51371.662837243864,51341.92687611563,9.918910930959228,10.437975060663744,63.990676025484866,51276.35979789421,51374.48024140605,51176.176671138615,-98.12044351183431,-50.6812172789093,160.53767342137758,-73.40372893023596,-61.922221878150594,-18.673592707280477,51392.902530257474,50957.95081201976,False,True,49969.074,51419.074,50499.074,50469.074,,False,,,2024-02-26 15:26:11,0.02,fail,False,-163.85,18607.830000000067,,0,10,9,February
2024-02-26 11:45:00,50968.398,51051.039,50919.539,50966.137,1534,36422,0,2024-02-26 11:00:00,2024-02-26 11:00:00,-60.224654761907004,31.047381030286488,51237.893095238076,-0.0014488332845856563,-0.00044066968755299103,51403.671821428565,50637.11320161437,51471.38454202582,51152.06327897127,51521.96616171375,-0.00034756702722392614,-0.0005673827774139359,51371.662837243864,51341.92687611563,3.3477495906316292,7.654782209254525,63.990676025484866,51228.63321360279,51344.23259389449,51104.38163742693,-115.59938029170007,-63.66484988146746,184.2710834602821,-71.79503371168539,-73.40372893023596,-61.922221878150594,51353.14760009831,50854.11567475555,False,True,49966.137,51416.137,50496.137,50466.137,,False,,,2024-02-26 15:26:11,0.02,fail,False,-163.85,18443.98000000007,,0,11,9,February
2024-02-26 17:00:00,51703.039,52044.637,51649.859,51960.738,2092,36422,0,2024-02-26 17:00:00,2024-02-26 17:00:00,199.4844285713989,12.583797389663232,51897.48338095232,0.002436441518523757,0.003990220215178786,51356.9534642857,51831.42808223312,53689.56768405606,51067.384381542266,51835.565749989175,0.0005117917242412243,0.0003263708288861497,51418.943918731355,51455.97319249864,94.06795410184696,89.36281509283133,-3.1801954066297498,51469.62003298997,51374.08680164903,51575.42399931199,95.53323134094535,17.000731977283614,221.90976868692024,121.39721362231649,82.10533195731114,51.855483316147,51876.50218703933,51275.84581158465,True,False,52960.738,52430.738,52430.738,52460.738,2024-02-26 17:45:00,True,2024-02-26 17:45:00,2024-02-26 18:06:50,,0.02,success,True,364.01,18807.990000000067,,1,0,9,February
2024-02-26 17:15:00,51960.738,52466.539,51960.738,52389.738,3284,36422,0,2024-02-26 17:00:00,2024-02-26 17:00:00,199.4844285713989,12.583797389663232,51897.48338095232,0.002436441518523757,0.003990220215178786,51356.9534642857,51831.42808223312,53689.56768405606,51067.384381542266,51835.565749989175,0.0005117917242412243,0.0003263708288861497,51418.943918731355,51455.97319249864,94.28238684927932,93.20381195483431,-3.1801954066297498,51611.17664329921,51449.3202237491,51764.03591262471,161.85641955010942,45.97186949184878,315.9725324908613,188.6119133127213,121.39721362231649,82.10533195731114,52192.098831487376,51337.47299376205,True,False,53389.738,51939.738,52859.738,52889.738,,False,2024-02-26 18:15:00,2024-02-26 18:08:43,,0.02,success,True,364.01,19172.000000000065,,2,0,9,February
2024-02-26 17:45:00,52564.84,52865.738,52532.039,52854.039,2829,36422,0,2024-02-26 17:00:00,2024-02-26 17:00:00,199.4844285713989,12.583797389663232,51897.48338095232,0.002436441518523757,0.003990220215178786,51356.9534642857,51831.42808223312,53689.56768405606,51067.384381542266,51835.565749989175,0.0005117917242412243,0.0003263708288861497,51418.943918731355,51455.97319249864,94.1939469044399,93.4306156805189,-3.1801954066297498,51926.53176236216,51629.88373915389,52202.04377502585,296.64802320826857,124.90244343730708,488.6879425764668,236.53872652221617,201.4691358789205,188.6119133127213,52863.27249750408,51542.31505254762,True,False,53854.039,53324.039,53324.039,53354.039,2024-02-26 18:15:00,True,2024-02-26 18:15:00,2024-02-26 21:14:46,2024-02-26 18:19:58,0.02,even,True,171.09,19343.090000000066,,3,0,9,February
2024-02-26 18:00:00,52854.039,53667.238,52761.117,53543.738,4749,36422,0,2024-02-26 18:00:00,2024-02-26 18:00:00,540.5299166666155,178.15117648074374,52529.174809523814,0.0024367661876067534,0.006369522650238567,51897.48338095232,51959.31569663187,55012.16794704634,51831.42808223312,53689.56768405606,0.003990220215178786,0.002436441518523757,51497.44564740855,51613.15437709875,94.24752527599496,93.41899515609077,33.086078970844945,52175.332721998755,51771.65072143879,52534.98623942203,403.6820005599657,180.6583548618388,634.0143119442346,332.9424643961829,236.53872652221617,201.4691358789205,53392.40556054675,51679.066918297314,True,False,54543.738,54013.738,54013.738,54043.738,2024-02-26 21:30:00,True,2024-02-26 21:30:00,2024-02-26 21:38:03,,0.02,success,True,364.01,19707.100000000064,,4,0,9,February
2024-02-26 21:30:00,54274.738,54571.039,54231.84,54547.84,3394,36422,0,2024-02-26 21:00:00,2024-02-26 21:00:00,401.38596428565506,556.2663718515541,53976.17142857141,0.008532643733220267,0.010118812486188747,53427.96224999997,55254.94046268004,57551.78875510184,54657.98228646798,56675.86423665092,0.009261649419348358,0.008235961131807868,51768.798617168126,52121.742660874275,94.6492094338793,94.1633420936102,249.06301555546494,53667.28074740688,53048.63423747969,54063.016998968014,618.6465099271954,553.9187433126812,998.155229101778,112.45821396628162,77.84669040247536,16.912017543872935,55412.02655825541,52715.507439680616,True,False,55547.84,55017.84,55017.84,55047.84,2024-02-27 03:45:00,True,2024-02-27 03:45:00,2024-02-27 03:48:30,,0.02,success,True,364.01,20071.110000000062,,5,0,9,February
2024-02-27 03:45:00,55186.539,55870.238,55091.438,55838.91,4015,36422,0,2024-02-27 03:00:00,2024-02-27 03:00:00,34.102630952394975,791.8201517593843,55074.61725,0.0033514443620601786,0.0032738586717296052,54674.33992857143,55252.70076334867,56593.36562678003,55299.0097608324,55840.321901730524,0.002003273128566052,0.0038313392064526506,52414.71773814445,53184.40863383217,86.37218951828591,74.63690692232132,656.9473757582457,54862.770406569834,54501.28727954694,54945.186298933564,361.48312702289695,327.76405443628613,289.6347914050824,222.9881348468989,103.48329170966463,24.786361541060614,55337.693267330425,54554.1793305367,True,False,56838.91,55388.91,56308.91,56338.91,,False,2024-02-27 04:15:00,2024-02-27 04:07:50,,0.02,success,True,364.01,20435.12000000006,,6,0,9,February
2024-02-27 10:30:00,56384.039,56470.539,56280.836,56431.84,1308,36422,0,2024-02-27 10:00:00,2024-02-27 10:00:00,-31.910107142932247,878.1481405651211,56189.355988095274,0.00393587401470984,-0.0031960377708580854,56238.59483333326,56928.493041693815,55792.59256338054,56704.13762435558,56022.292916697916,-0.003095137229838947,0.003935943402540925,53320.33265873658,54486.09870987051,87.80408807391613,72.84968492220096,873.5469719138039,56226.33395140146,55998.49596286219,56329.0471998624,227.83798853927146,264.75405085130745,250.1077522590079,38.48441898862802,25.483373925017077,86.31731647748529,56668.19266541206,55991.401734312734,True,False,57431.84,56901.84,56901.84,56931.84,2024-02-27 14:30:00,True,2024-02-27 14:30:00,2024-02-27 14:44:47,2024-02-27 14:30:25,0.02,even,True,171.09,20606.21000000006,,7,0,9,February
2024-02-28 18:15:00,61080.137,61626.637,61001.949,61460.137,3232,36422,0,2024-02-28 18:00:00,2024-02-28 18:00:00,299.30880952378357,992.0031903043928,61383.70667857141,0.0070701287988871354,0.007317398330606253,60562.64825,62371.03556241159,64515.139399314554,61101.60630185692,63009.608572225115,0.005135798055100076,0.005347970099343579,56989.755139026696,58659.07642415863,85.6312913552584,83.00941548801559,725.0233710013117,60783.581738160574,60139.96804552777,61354.59416546268,643.6136926328036,610.4013367101526,813.1743578882251,105.55625937391596,81.9640670794397,109.27206639149517,62453.87954861178,60256.80878231358,True,False,62460.137,61010.137,61930.137,61960.137,,False,2024-02-28 19:00:00,2024-02-28 18:57:36,2024-02-28 19:31:07,0.02,success,True,364.01,20970.22000000006,,8,0,9,February
2024-03-01 22:30:00,62533.348,62662.34,62446.57,62616.938,1485,36422,0,2024-03-01 22:00:00,2024-03-01 22:00:00,83.33190476191521,108.02453203953337,62335.487130952424,0.0018395980611055317,0.0010054698248002406,61998.855226190484,62208.89530004296,63432.57467709728,61444.340560323304,62342.30147560851,-0.0006203154846102369,0.0005325720586794292,61303.93454103835,61926.7902611886,92.33246379874754,86.60396947938922,62.81839005503459,62289.23285877913,62148.32020289737,62541.4849501204,140.91265588175884,80.6860460077084,364.9689849166309,61.31831682151096,49.0359838321383,53.36823426208866,63035.69307975785,62048.77682048295,True,False,63616.938,63086.938,63086.938,63116.938,2024-03-04 00:30:00,True,2024-03-04 00:30:00,2024-03-04 02:27:54,2024-03-04 00:42:43,0.02,even,True,171.08,21141.30000000006,,9,0,9,March
2024-03-01 22:45:00,62618.238,63175.34,62453.84,62917.438,2796,36422,0,2024-03-01 22:00:00,2024-03-01 22:00:00,83.33190476191521,108.02453203953337,62335.487130952424,0.0018395980611055317,0.0010054698248002406,61998.855226190484,62208.89530004296,63432.57467709728,61444.340560323304,62342.30147560851,-0.0006203154846102369,0.0005325720586794292,61303.93454103835,61926.7902611886,92.22259537412639,90.21430198756786,62.81839005503459,62385.87980358234,62205.291891571644,62648.85730546953,180.58791201069835,100.6664192083064,408.4211836673613,107.37235534912907,61.31831682151096,49.0359838321383,63201.72590342047,62097.48870751859,True,False,63917.438,62467.438,63387.438,63417.438,,False,2024-03-04 02:30:00,2024-03-04 02:30:22,2024-03-01 23:03:13,0.02,fail,False,-163.85,20977.450000000063,,0,1,9,March
2024-03-04 02:00:00,63160.34,63346.34,63069.738,63346.34,1830,36422,0,2024-03-04 02:00:00,2024-03-04 02:00:00,184.30951190483756,308.96271195200825,63193.273952380936,0.0019201693083200871,0.004840603788809956,62976.00414285714,62789.356085544096,65687.98406842345,63604.74666378546,65012.22737573767,0.004063458915500229,0.0033965629302570586,61562.304577233466,62250.39860260168,83.459159805421,73.91832760818492,176.31216588555606,62963.987593194586,62703.13567922393,63180.80792982454,260.851913970655,237.03385865406295,372.4934278997458,67.72134296521108,24.85998211218248,7.048925696624792,63685.1740574892,62677.94180215988,True,False,64346.34,62896.34,63816.34,63846.34,,False,2024-03-04 02:45:00,2024-03-04 02:43:46,2024-03-04 02:49:32,0.02,success,True,364.0,21341.450000000063,,1,0,10,March
2024-03-04 02:15:00,63342.637,63884.738,63315.449,63842.84,2678,36422,0,2024-03-04 02:00:00,2024-03-04 02:00:00,184.30951190483756,308.96271195200825,63193.273952380936,0.0019201693083200871,0.004840603788809956,62976.00414285714,62789.356085544096,65687.98406842345,63604.74666378546,65012.22737573767,0.004063458915500229,0.0033965629302570586,61562.304577233466,62250.39860260168,94.24790078618007,83.45995825463939,176.31216588555606,63099.19565578003,62787.55822150364,63316.271580667264,311.6374342763884,251.95457377852804,416.9946672742691,135.4636508427211,67.72134296521108,24.85998211218248,63880.71438148753,62753.328779847,True,False,64842.84,63392.84,64312.84,64342.84,,False,2024-03-04 10:15:00,2024-03-04 10:08:26,2024-03-04 02:47:51,0.02,fail,False,-163.85,21177.600000000064,,0,1,10,March
2024-03-04 09:15:00,63629.637,63807.039,63629.637,63793.738,901,36422,0,2024-03-04 09:00:00,2024-03-04 09:00:00,20.93572619050974,405.54669018196,63769.23471428575,0.0027806649604427535,-0.00010996000030985437,63632.42590476194,64249.14301946547,64331.554764200184,64082.67919132101,63283.970458707096,-0.0017525943702254413,0.002800809937797738,62078.889248738735,62885.885560361254,82.47852249052123,73.93734549857147,371.8237755826087,63613.48480719521,63517.66959269604,63593.17848400418,95.81521449916909,106.79761709318447,148.81281849356526,50.79901754394086,31.229656002717093,24.112269349840062,63795.57578897049,63392.28117903787,True,False,64793.738,63343.738,64263.738,64293.738,,False,2024-03-04 10:15:00,2024-03-04 10:08:14,2024-03-05 21:11:10,0.02,success,True,364.0,21541.600000000064,,1,0,10,March
2024-03-04 09:30:00,63793.738,64181.738,63731.84,64177.539,1927,36422,0,2024-03-04 09:00:00,2024-03-04 09:00:00,20.93572619050974,405.54669018196,63769.23471428575,0.0027806649604427535,-0.00010996000030985437,63632.42590476194,64249.14301946547,64331.554764200184,64082.67919132101,63283.970458707096,-0.0017525943702254413,0.002800809937797738,62078.889248738735,62885.885560361254,87.46154174105327,80.03369458876436,371.8237755826087,63700.26237531902,63566.548808051884,63705.52860749908,133.71356726713566,112.18080712797472,178.87977606011373,112.35012349489989,50.79901754394086,31.229656002717093,63948.51630518023,63464.04090981793,True,False,65177.539,64647.539,64647.539,64677.539,2024-03-04 10:15:00,True,2024-03-04 10:15:00,2024-03-04 10:35:24,2024-03-04 10:20:36,0.02,even,True,171.08,21712.680000000066,,2,0,10,March
2024-03-04 10:00:00,64102.34,64969.738,64061.84,64855.84,4232,36422,0,2024-03-04 10:00:00,2024-03-04 10:00:00,136.8088095238054,436.26373221577524,64305.24580952386,0.002650234563552934,0.0038644788465125547,63769.23471428575,64388.06944794676,66710.27845173689,64249.14301946547,64331.554764200184,-0.00010996000030985437,0.0027806649604427535,62205.722493886235,63080.06567553236,90.04107118805615,89.45644036060759,384.711766909242,63930.38501428167,63698.80022638193,64033.616446508466,231.58478789973742,143.0540224508595,313.9500553337829,224.02225937399635,104.06557963538944,112.35012349489989,64458.949021209075,63609.78387180786,True,False,65855.84,65325.84,65325.84,65355.84,2024-03-04 10:45:00,True,2024-03-04 10:45:00,2024-03-04 16:35:48,2024-03-04 10:45:20,0.02,even,True,171.08,21883.760000000068,,3,0,10,March
2024-03-04 10:30:00,64947.309,65664.938,64827.461,65586.734,5222,36421,0,2024-03-04 10:00:00,2024-03-04 10:00:00,136.8088095238054,436.26373221577524,64305.24580952386,0.002650234563552934,0.0038644788465125547,63769.23471428575,64388.06944794676,66710.27845173689,64249.14301946547,64331.554764200184,-0.00010996000030985437,0.0027806649604427535,62205.722493886235,63080.06567553236,93.7927947151973,90.35646509319376,384.711766909242,64318.17840667504,63924.589543880254,64563.31904643963,393.5888627947861,217.6185785708262,534.525571161201,316.27039559684636,213.43220433431998,224.02225937399635,65286.42856750725,63841.70952537201,True,False,66586.734,65136.734,66056.734,66086.734,,False,2024-03-04 16:45:00,2024-03-04 17:53:14,2024-03-04 11:04:30,0.02,fail,False,-163.85,21719.91000000007,,0,1,10,March
2024-03-04 16:45:00,66177.336,66461.734,65831.836,66205.133,5355,36421,0,2024-03-04 16:00:00,2024-03-04 16:00:00,-30.37133333318343,656.4376429026088,65622.20673809528,0.002279085417837151,0.0020085438391783065,65359.245321428636,65154.09908637732,67010.70874034837,66165.10518440815,66038.66015174288,0.000624712421185909,0.004036527253335819,62888.25237688204,64001.44152438365,82.48763895460718,71.2669079423202,597.6726613990331,65514.201030502125,65175.5933065633,65677.02444960442,338.6077239388251,290.77736642646613,314.3682483165365,173.16729790160025,179.4683883729158,54.1448661850809,66102.92158483174,65252.627314377096,True,False,67205.133,66675.133,66675.133,66705.133,2024-03-04 18:15:00,True,2024-03-04 18:15:00,2024-03-04 19:25:55,2024-03-04 18:15:49,0.02,even,True,171.08,21890.99000000007,,1,0,10,March
2024-03-04 17:00:00,66205.133,66391.438,65866.234,66351.734,4437,36421,0,2024-03-04 17:00:00,2024-03-04 17:00:00,262.96141666664334,733.7153617681251,65885.55390476191,0.0012586713152963848,0.0021210665749903518,65622.20673809528,64964.114710516835,67229.96708556003,65154.09908637732,67010.70874034837,0.0020085438391783065,0.002279085417837151,63029.42047974941,64200.36932243296,90.34130182400946,82.27580477424976,624.8812014728516,65643.05225657873,65262.71483941046,65849.55108737528,380.33741716826626,308.68937657482616,380.36975682417244,172.52663777086127,173.16729790160025,179.4683883729158,66364.55025908792,65336.05191566265,True,False,67351.734,65901.734,66821.734,66851.734,,False,2024-03-04 19:30:00,2024-03-04 19:27:06,2024-03-05 07:03:35,0.02,success,True,364.0,22254.99000000007,,2,0,10,March
2024-03-05 00:45:00,67818.164,67971.734,67721.984,67967.117,2988,56421,0,2024-03-05 00:00:00,2024-03-05 00:00:00,13.021726190447225,894.0400374463206,67590.79509523815,0.002988604680408185,0.0011642232348004068,67328.16846428569,67777.84811609528,68338.56766033359,68141.2105042793,68815.49059019028,0.002165920740244434,0.004873049549188786,64054.902175207026,65554.47058398892,87.97586947529783,81.37730876199423,832.1055115218105,67428.5450771009,67062.1345560618,67681.04242862055,366.41052103909897,352.26039954981684,444.85787494705664,67.10258651529148,105.35946267627878,49.050485380212194,68283.10055979907,67080.48429744203,True,False,68967.117,67517.117,68437.117,68467.117,,False,2024-03-05 03:30:00,2024-03-05 17:02:41,2024-03-05 01:31:12,0.02,fail,False,-163.85,22091.140000000072,,0,1,10,March
2024-03-05 01:00:00,67966.563,68571.734,67875.273,68412.141,5216,56421,0,2024-03-05 01:00:00,2024-03-05 01:00:00,262.62663095246535,924.695649692163,67892.6625357143,0.003289194314401032,0.0023370807247481895,67590.79509523815,68147.97846441666,69236.38042170306,67777.84811609528,68338.56766033359,0.0011642232348004068,0.002988604680408185,64220.52303108126,65772.37165726982,95.04054861664281,88.58888537567928,850.6235391558811,67579.86752677769,67162.13503339056,67830.5462566219,417.73249338712776,365.35481831727907,499.3293748630754,149.50382800135412,67.10258651529148,105.35946267627878,68506.14091268706,67156.45160055676,True,False,69412.141,67962.141,68882.141,68912.141,,False,,,2024-03-05 01:27:19,0.02,fail,False,-163.85,21927.290000000074,,0,2,10,March
2024-03-05 18:00:00,66826.336,67066.898,64581.84,65444.941,7833,36421,0,2024-03-05 18:00:00,2024-03-05 18:00:00,-246.51736904760764,183.45794187903812,67066.12035714286,-0.0033884491287756954,0.005784764548929182,67650.9545238095,63692.689850395174,71395.75888319526,66996.15630932209,70743.89871451296,0.00493461586020879,0.001919068907130727,65717.92262159412,66844.47900889932,15.379182206574894,22.32056966960738,228.35305201999154,67204.76471637476,67274.36435232034,67378.59077949775,-69.59963594557485,137.40572297262094,702.6828572211022,-470.55961197119905,-183.81908943918825,-176.41303130380402,68327.21263674625,66428.46892224926,False,True,64444.941,65894.94099999999,64974.941,64944.941,,False,2024-03-05 19:15:00,2024-03-05 19:07:49,2024-03-05 18:25:11,0.02,fail,False,-163.85,21763.440000000075,,0,3,10,March
2024-03-05 19:00:00,65603.734,65606.734,63481.938,64278.738,6904,36421,0,2024-03-05 19:00:00,2024-03-05 19:00:00,-584.8341666666383,-36.42815067891206,66509.30538095241,-0.006625367431692782,0.00456172980732426,67066.12035714286,61784.03646629715,71277.13811826793,63692.689850395174,71395.75888319526,0.005784764548929182,-0.0033884491287756954,65714.78655800219,66747.95692818737,16.00776391310457,18.790473933445515,175.39681148021083,66202.85669109775,66724.82243707792,65688.60992466466,-521.9657459801674,-162.68331095182998,1073.0007807292445,-552.7748052975076,-343.39990264875814,-439.75122325416305,67137.16097864915,64238.55887068018,False,True,63278.738,64728.738,63808.738,63778.738,,False,2024-03-05 21:15:00,2024-03-05 21:17:25,2024-03-05 19:21:33,0.02,fail,False,-163.85,21599.590000000077,,0,4,10,March
2024-03-06 04:45:00,63444.938,63475.238,62810.84,62833.238,3241,36422,0,2024-03-06 04:00:00,2024-03-06 04:00:00,244.19124999994528,-923.4003942057607,63396.909749999984,0.008712420922476566,0.00026577795016823123,63332.72703571425,65066.05783369881,64495.74714202833,65983.49762092301,62950.64628218855,-0.003788189669146693,0.010967577200735898,64910.71882439901,64807.20808156149,15.269783817432996,24.22710627152207,-802.1108631519977,63333.85018621745,63564.880919888106,63276.953177846626,-231.03073367065372,-239.3829250109663,455.7126013933378,-156.53250257992477,-36.45517199860478,-76.23686446512875,63892.16518972763,62660.24116596562,False,True,61833.238,63283.238,62363.238,62333.238,,False,,,2024-03-06 05:26:12,0.02,fail,False,-163.85,21435.740000000078,,0,5,10,March
2024-03-06 05:00:00,62834.84,63099.738,62814.938,62830.34,2047,36422,0,2024-03-06 05:00:00,2024-03-06 05:00:00,64.18271428573644,-913.8530978518975,63322.75507142854,0.003658198051346681,-0.0009485475896242416,63396.909749999984,63754.44273644774,63885.60193183433,65066.05783369881,64495.74714202833,0.00026577795016823123,0.008712420922476566,64847.7666352069,64687.06647503657,11.479472607295447,18.911368444289323,-824.4593100919777,63256.38708064554,63510.47048137787,63107.01505228754,-254.08340073233558,-242.32302015524016,359.43277822801684,-169.93812555908517,-156.53250257992477,-36.45517199860478,63592.24930289536,62620.28080167972,False,True,61830.34,63280.34,62360.34,62330.34,,False,,,2024-03-06 05:26:10,0.02,fail,False,-163.85,21271.89000000008,,0,6,10,March
2024-03-06 07:00:00,64633.84,65466.938,64275.621,65396.039,4845,36422,0,2024-03-06 07:00:00,2024-03-06 07:00:00,323.5893095238789,-607.9654783263395,64614.37407142862,0.0010783144052586217,0.005343059059237385,63646.34438095242,63229.76477319507,67946.0004197477,63590.44960370044,64857.326743527046,0.0008213158441435551,0.002415201978295262,64902.398803203294,64823.90730447096,96.4295764825042,85.45780303904856,-782.4025032786691,63846.77271322111,63696.35681149181,63941.05126866184,150.41590172929864,-86.52667856675042,544.6035061709027,406.65694152047945,298.9383137255063,86.64789645677229,64677.76600199256,63205.83653533112,True,False,66396.03899999999,65866.03899999999,65866.03899999999,65896.03899999999,2024-03-06 07:45:00,True,2024-03-06 07:45:00,2024-03-06 07:59:15,2024-03-06 07:46:44,0.02,even,True,171.08,21442.97000000008,,1,0,10,March
2024-03-06 07:15:00,65390.785,65911.336,65151.309,65796.609,4895,36421,0,2024-03-06 07:00:00,2024-03-06 07:00:00,323.5893095238789,-607.9654783263395,64614.37407142862,0.0010783144052586217,0.005343059059237385,63646.34438095242,63229.76477319507,67946.0004197477,63590.44960370044,64857.326743527046,0.0008213158441435551,0.002415201978295262,64902.398803203294,64823.90730447096,97.6899184914624,93.02696012846444,-782.4025032786691,64146.74752657171,63851.9310476776,64369.364442380494,294.8164788941067,-10.258047074579004,701.7088899501529,428.3131737186559,406.65694152047945,298.9383137255063,65318.171443813204,63422.057440947785,True,False,66796.609,66266.609,66266.609,66296.609,2024-03-06 08:00:00,True,2024-03-06 08:00:00,2024-03-06 09:59:34,2024-03-06 08:05:18,0.02,even,True,171.08,21614.050000000083,,2,0,10,March
2024-03-08 16:45:00,68399.234,68713.734,68301.438,68487.734,4247,36421,0,2024-03-08 16:00:00,2024-03-08 16:00:00,87.95326190479682,156.4356059989077,67963.2696428571,0.0009173150928001668,0.0021243109061690837,67609.03769047624,67651.7729939677,69319.30517922294,67610.20764882193,68090.93554949114,0.0005698601038344945,0.0009905649386624247,66915.58172318303,67338.11807513915,86.48513746816639,80.58588919625828,110.45695883364084,67884.94174876911,67652.65950717016,68037.24883866525,232.28224159895035,145.4419769057339,331.97552449181757,130.16168455446314,126.69476848990598,52.03862951499468,68486.91579672921,67589.0818806013,True,False,69487.734,68037.734,68957.734,68987.734,,False,2024-03-08 17:30:00,2024-03-08 17:28:05,2024-03-08 17:32:37,0.02,success,True,364.0,21978.050000000083,,3,0,10,March
2024-03-08 17:00:00,68478.531,68901.641,68394.5,68856.438,4019,36421,0,2024-03-08 17:00:00,2024-03-08 17:00:00,354.2319523808692,249.01986667860183,67944.84183333332,0.000293193906677985,0.00590082736714174,67963.2696428571,67286.65883885762,72021.42634466589,67651.7729939677,69319.30517922294,0.0021243109061690837,0.0009173150928001668,66944.91585168566,67364.15678912803,91.42446783787254,85.75773828785532,138.16954040263306,68034.40271049694,67741.82828441681,68229.19970794632,292.57442608012934,174.868466740613,412.8157426900544,191.9508692810632,130.16168455446314,126.69476848990598,68788.00096057789,67671.89845531475,True,False,69856.438,68406.438,69326.438,69356.438,,False,2024-03-08 17:30:00,2024-03-08 17:29:00,2024-03-08 17:32:05,0.02,success,True,364.0,22342.050000000083,,4,0,10,March
2024-03-11 09:00:00,69375.039,70817.547,69329.258,70759.813,6056,36421,0,2024-03-11 09:00:00,2024-03-11 09:00:00,278.3088571428525,260.31937757150445,69712.24565476194,0.0036926715956888106,0.005121773977966322,68803.81589285712,69803.89804284302,73058.48882311316,69541.34365197194,69586.95121634992,0.0007139498874940439,0.0036955796630181743,67822.28096166349,68489.18594748742,91.07498895800167,78.62213049875307,236.11450206998725,69056.72290141773,68798.09144051865,69210.48978500172,258.6314608990797,93.26569650472003,521.7640221167511,372.682804609547,136.12675885800854,30.472158582677366,69916.37121485933,68506.1083551441,True,False,71759.813,70309.813,71229.813,71259.813,,False,2024-03-11 10:15:00,2024-03-11 10:23:17,2024-03-11 09:16:15,0.02,fail,False,-163.85,22178.200000000084,,0,1,11,March
2024-03-13 03:30:00,71851.336,72177.836,71816.984,71903.133,3628,36421,0,2024-03-13 03:00:00,2024-03-13 03:00:00,19.951357142839697,-133.58630184925278,71555.67996428566,0.0012669052328312057,0.001084119857918885,71304.70169047623,71336.56468241668,72506.07214296731,73087.06471072254,71845.55390188126,0.00020496038631335372,0.00569001713847545,71017.78455264571,71534.70542631365,82.11084424794704,78.82958071738025,-138.39403537859408,71518.67410952979,71382.77186610372,71719.91039181284,135.90224342606962,66.09230439094935,287.56471717748974,80.07717234260053,99.00486412110331,29.77684382525331,72109.62276000244,71331.69802362323,True,False,72903.133,72373.133,72373.133,72403.133,2024-03-13 08:30:00,True,2024-03-13 08:30:00,2024-03-13 09:08:49,2024-03-13 15:38:22,0.02,success,True,364.0,22542.200000000084,,1,0,11,March
2024-03-13 03:45:00,71903.32,72102.938,71881.867,72058.438,2326,36421,0,2024-03-13 03:00:00,2024-03-13 03:00:00,19.951357142839697,-133.58630184925278,71555.67996428566,0.0012669052328312057,0.001084119857918885,71304.70169047623,71336.56468241668,72506.07214296731,73087.06471072254,71845.55390188126,0.00020496038631335372,0.00569001713847545,71017.78455264571,71534.70542631365,88.8955729114283,83.66394235252558,-138.39403537859408,71601.71470806366,71432.8212093553,71809.44263157896,168.89349870836304,86.65254325443209,323.432903284476,89.53223976612207,80.07717234260053,99.00486412110331,72247.57705101301,71372.80821214491,True,False,73058.438,72528.438,72528.438,72558.438,2024-03-13 08:45:00,True,2024-03-13 08:45:00,2024-03-13 09:10:58,2024-03-13 08:53:39,0.02,even,True,171.08,22713.280000000086,,2,0,11,March
2024-03-13 06:45:00,72247.141,72276.438,72185.086,72274.539,2063,36421,0,2024-03-13 06:00:00,2024-03-13 06:00:00,216.65576190467982,75.85459799815726,72181.46692857142,0.002997960748359706,0.0027502839765103267,72001.66253571429,72881.88194629039,73618.96610757757,72954.49836850543,73163.26377048461,0.0021936181281381564,0.0034334407147332806,71144.95384668201,71669.96318079733,92.28395964256465,87.41977259175717,-57.04740233071805,72069.31315128737,71843.98767670445,72267.52800894392,225.3254745829181,210.72495073107513,341.73992944094357,22.796131750932545,33.91497282424825,20.66800378395419,72730.3769136892,71806.17910419864,True,False,73274.539,72744.539,72744.539,72774.539,2024-03-13 09:15:00,True,2024-03-13 09:15:00,2024-03-13 09:16:42,2024-03-13 14:35:15,0.02,success,True,364.0,23077.280000000086,,3,0,11,March
2024-03-13 08:00:00,72209.234,72360.641,72161.836,72360.641,1638,36421,0,2024-03-13 08:00:00,2024-03-13 08:00:00,57.64630952384323,153.59230518643744,72451.29569047618,0.002181215965817557,0.001773667657216873,72239.11323809526,72825.17044354127,73364.6339079336,72849.39092414756,73121.3320646518,0.0015862481543450582,0.0026903667130160087,71248.77384001673,71797.64205862687,86.7320347548385,77.69333281009166,14.684069273625393,72161.38949965118,71964.94289905,72256.51724871,196.44660060117894,202.9472392155339,281.39744643098305,31.393303061529878,3.8604513244354166,-22.78443515651452,72637.90380139183,71876.63069602818,True,False,73360.641,72830.641,72830.641,72860.641,2024-03-13 09:15:00,True,2024-03-13 09:15:00,2024-03-13 10:10:14,2024-03-13 09:55:25,0.02,even,True,171.08,23248.360000000088,,4,0,11,March
2024-03-13 08:15:00,72357.141,72574.234,72309.461,72465.234,2606,36421,0,2024-03-13 08:00:00,2024-03-13 08:00:00,57.64630952384323,153.59230518643744,72451.29569047618,0.002181215965817557,0.001773667657216873,72239.11323809526,72825.17044354127,73364.6339079336,72849.39092414756,73121.3320646518,0.0015862481543450582,0.0026903667130160087,71248.77384001673,71797.64205862687,87.81312707825263,83.51286361886037,14.684069273625393,72208.13480739715,72002.00149912038,72314.61225868594,206.1333082767669,203.5844530277805,278.5832701837503,58.09500997593568,31.393303061529878,3.8604513244354166,72692.199673434,71938.52484393788,True,False,73465.234,72935.234,72935.234,72965.234,2024-03-13 09:15:00,True,2024-03-13 09:15:00,2024-03-13 10:24:13,2024-03-13 09:23:01,0.02,even,True,171.08,23419.44000000009,,5,0,11,March
2024-03-13 09:00:00,72770.445,73176.039,72683.195,73115.836,3092,36421,0,2024-03-13 09:00:00,2024-03-13 09:00:00,212.18245238091913,229.7981999428448,72665.67442857145,0.002063007654328502,0.002526092093883993,72451.29569047618,72939.72709483936,74060.54843266825,72825.17044354127,73364.6339079336,0.001773667657216873,0.002181215965817557,71314.9086306043,71888.64757393672,88.35744958505926,86.36257175684655,57.70689540746928,72465.69814685735,72176.08922988143,72619.81417956656,289.6089169759216,230.1934770484296,322.9524272443041,140.59592707258707,87.61262263500248,76.99337117302639,73057.29995634637,72183.82840278675,True,False,74115.836,73585.836,73585.836,73615.836,2024-03-13 10:45:00,True,2024-03-13 10:45:00,,2024-03-13 10:47:02,0.02,even,True,171.08,23590.52000000009,,6,0,11,March
2024-03-13 22:00:00,73376.836,73443.336,73073.25,73435.734,2285,36421,0,2024-03-13 22:00:00,2024-03-13 22:00:00,242.98505952383857,238.31008901864698,73231.47734523809,0.0025604447888102635,0.0006902955697446798,73128.59741666669,73737.59373281231,73665.26229815758,73639.09524885144,73487.64238199234,0.00027956273301639635,0.002679493493725769,71996.5248972141,72621.42169758416,82.1196636084149,69.16944372962662,228.27348579625624,73077.15847419783,72973.81054338244,73216.57525730995,103.34793081539101,52.59090768815669,259.0156224240987,82.41745476442156,75.74355865150574,-14.770839353339397,73567.74634758248,72866.90416703741,True,False,74435.734,72985.734,73905.734,73935.734,,False,,,2024-03-13 22:33:41,0.02,fail,False,-163.85,23426.670000000093,,0,1,11,March
2024-03-15 11:00:00,67099.234,67381.836,65561.836,66163.695,7432,36421,0,2024-03-15 11:00:00,2024-03-15 11:00:00,-274.961119047628,-1063.321141521199,67741.79524999995,-0.0027241033733321567,-0.007488228740335514,67515.47304761906,64829.26378684934,66076.40430722083,66759.43542315268,66552.22643972134,-0.007527416740552565,0.0001937503022439893,70899.61811236705,69952.35632344031,14.980033278366884,26.19860708541455,-831.656259598472,67727.09447961787,68342.37786724893,67748.55881561746,-615.2833876310615,-542.2560013913758,671.9799545845239,-423.81814379086427,-158.94531131751137,-55.888862401014194,68655.73175430657,66839.88587692835,False,True,65163.69500000001,66613.695,65693.695,65663.695,,False,2024-03-19 05:30:00,2024-03-19 05:35:08,2024-03-15 11:17:31,0.02,fail,False,-163.85,23262.820000000094,,0,2,11,March
2024-03-15 20:45:00,69276.758,70506.641,69212.109,70253.102,6345,36421,0,2024-03-15 20:00:00,2024-03-15 20:00:00,53.40101190477435,-433.1276084830606,68926.07551190478,0.0021287670602816748,0.005246251017460574,68305.47821428571,68388.0109614705,72062.26755141537,68239.82870813076,69027.8645178459,0.0006182596282677192,0.002131832523026572,70132.48324605414,69146.6853651299,85.70413130224881,76.50302413286583,-646.3953566471271,68670.04395424003,68375.61739540487,68746.21644478843,294.42655883515545,121.60689520048189,519.0804553343462,347.92686068105104,178.08919263852295,53.31284932914423,69448.47505948979,68045.45783008706,True,False,71253.102,69803.102,70723.102,70753.102,,False,,,2024-03-15 21:23:11,0.02,fail,False,-163.85,23098.970000000096,,0,3,11,March
2024-03-15 21:00:00,70257.734,70684.219,70104.836,70301.336,5445,36421,0,2024-03-15 21:00:00,2024-03-15 21:00:00,620.5972976190678,-154.71186896332074,69022.76651190475,0.0013613240574981283,0.005246620122339192,68926.07551190478,68208.84937250226,72434.57554413215,68388.0109614705,72062.26755141537,0.005246251017460574,0.0021287670602816748,70087.78782464025,69134.37053591952,91.88918483706948,85.33010801598368,-548.0586591103659,68921.01196128002,68518.26321796747,69072.75672136218,402.7487433125498,177.83526482289545,647.845646376077,326.54027657375264,347.92686068105104,178.08919263852295,69948.84834396989,68198.16509875447,True,False,71301.336,69851.336,70771.336,70801.336,,False,,,2024-03-15 21:22:29,0.02,fail,False,-163.85,22935.120000000097,,0,4,11,March
2024-03-18 17:00:00,67024.68,67171.336,66699.836,66775.336,4762,36421,0,2024-03-18 17:00:00,2024-03-18 17:00:00,-332.0967500000261,-210.02573470685456,67595.66663095242,-0.0016133305889068292,0.0003202882128452989,67721.99554761905,66135.38624245366,68801.7634597148,66241.50469863007,68779.58044971485,0.00032029529160150613,-0.0016163287005434204,68974.32828898031,68202.15649234368,8.981628993648108,13.58710394755635,-128.0108829385719,67529.48268148716,67817.661247671,67261.7995847953,-288.17856618383667,-134.37048616070192,481.9355079255682,-222.18414619885152,-205.26446026835765,-238.8767963535647,67912.41252049482,66609.68664909578,False,True,65775.336,67225.336,66305.336,66275.336,,False,2024-03-19 03:45:00,2024-03-19 04:04:29,2024-03-18 17:34:42,0.02,fail,False,-163.85,22771.2700000001,,0,5,12,March
2024-03-19 07:15:00,65110.938,65266.938,64773.84,64794.938,3869,36422,0,2024-03-19 07:00:00,2024-03-19 07:00:00,-436.4800714285666,-555.0687491968711,65392.48178571432,-0.0073298759744135425,-0.007489558931186704,65719.11679761903,62044.00176539361,63675.50271418232,62839.82801441913,64938.72827183926,-0.005984828189222515,-0.00626254216647812,67970.60877291216,67035.63842198499,15.777631782453511,23.124409060433347,-353.33848787978354,65549.7959114873,66095.16810405812,65152.499667010605,-545.3721925708232,-477.73688725207546,978.671086747183,-96.92303543172602,-43.898806673591025,6.214160646733944,66473.70563411931,63829.79369990191,False,True,63794.938,65244.938,64324.938,64294.938,,False,2024-03-19 09:15:00,2024-03-19 09:16:58,2024-03-19 07:59:39,0.02,fail,False,-163.85,22607.4200000001,,0,6,12,March
2024-03-19 10:30:00,63750.438,64197.844,63507.449,63677.637,5087,36422,0,2024-03-19 10:00:00,2024-03-19 10:00:00,-194.02226190477086,-724.6461260922806,64430.44036904764,-0.005404259222663951,-0.005237343653660533,64929.49936904762,61775.39460625292,63429.4601832064,62339.39165784984,63284.890082605045,-0.006698312651779676,-0.004935543116262269,67564.18150215485,66442.53421659466,18.465796467811078,30.376356390443433,-512.5605339837746,64460.51133275871,65060.360760609336,64071.28607774342,-599.849427850626,-547.7782084605699,676.523088715297,-160.76171001028706,-150.50722359822976,-97.66005056760332,64984.59224750907,63156.479907977766,False,True,62677.637,64127.637,63207.637,63177.637,,False,2024-03-19 12:30:00,2024-03-19 13:13:47,2024-03-19 11:54:02,0.02,fail,False,-163.85,22443.5700000001,,0,7,12,March
2024-03-19 10:45:00,63679.738,63791.84,63145.441,63508.602,6214,36422,0,2024-03-19 10:00:00,2024-03-19 10:00:00,-194.02226190477086,-724.6461260922806,64430.44036904764,-0.005404259222663951,-0.005237343653660533,64929.49936904762,61775.39460625292,63429.4601832064,62339.39165784984,63284.890082605045,-0.006698312651779676,-0.004935543116262269,67564.18150215485,66442.53421659466,10.417686675138887,20.591657705279662,-512.5605339837746,64314.06374310352,64945.41566723087,63912.418215342266,-631.3519241273461,-564.4929515939251,696.8935793096838,-158.8678624011518,-160.76171001028706,-150.50722359822976,64853.22454741034,62970.11188327419,False,True,62508.602,63958.602,63038.602,63008.602,,False,2024-03-19 13:15:00,2024-03-19 16:32:49,2024-03-19 11:17:15,0.02,fail,False,-163.85,22279.720000000103,,0,8,12,March
2024-03-20 21:00:00,65437.238,65769.359,65111.859,65605.578,5541,36421,0,2024-03-20 21:00:00,2024-03-20 21:00:00,505.60042857150984,357.4057488181934,64859.428857142884,0.0005811553396457695,0.0036739537944614703,64322.33177380954,62295.95223753265,67039.34860578556,60891.43110805141,66298.69144705386,0.002939784844421412,-0.0030680969376604503,64521.486068934304,63831.300961576504,93.35193879246039,91.08157995474652,62.295472302143864,64481.7459991268,64057.40842139331,64697.43365187473,424.3375777334877,250.94872896677674,663.6713781024123,313.92026487786643,311.6115438596389,111.40149294800358,65594.89001231299,63801.47729143647,True,False,66605.578,66075.578,66075.578,66105.578,2024-03-20 22:15:00,True,2024-03-20 22:15:00,2024-03-20 22:24:41,2024-03-21 19:41:59,0.02,success,True,364.0,22643.720000000103,,1,0,12,March
2024-03-21 01:15:00,67829.656,67990.539,67657.273,67852.227,4085,36421,0,2024-03-21 01:00:00,2024-03-21 01:00:00,724.3755000000965,1100.0586062652146,67851.30754761907,0.011918513679691963,0.011258084519025723,67369.88040476196,70835.96146589227,73477.98404594015,70821.45737542158,72233.16210012614,0.010311133652972449,0.013078289486364018,64974.49839891151,64899.385728974165,87.42653022870412,85.5405132849475,551.5769884131333,67405.93583801345,66495.51815510102,68186.52851427588,910.4176829124335,928.9793572768776,1417.1601277429081,32.610268317876034,-7.762586859375006,13.535780873862677,70101.1946867288,66273.36234182295,True,False,68852.227,67402.227,68322.227,68352.227,,False,,,2024-03-21 05:15:03,0.02,fail,False,-163.85,22479.870000000104,,0,1,12,March
2024-03-22 16:45:00,62946.34,63117.84,62597.055,62771.738,5366,36422,0,2024-03-22 16:00:00,2024-03-22 16:00:00,-656.4993214286078,-583.8789571935558,63324.09314285714,-0.008552606298348336,-0.006217603023021857,63878.12938095234,60177.27476697288,62474.601287009675,60898.20718110496,62862.36652148821,-0.006217695592094446,-0.007714230760733301,65506.82218729106,65220.07817066928,11.69630653203599,12.518699778111705,-266.446322203981,63608.626077756555,64307.4661998976,63082.53829755759,-698.8401221410459,-568.2352867482873,953.9777371829623,-200.36777468182845,-173.27457069142838,-151.26267045069108,64370.408242754595,61793.16835236059,False,True,61771.738,63221.738,62301.738,62271.738,,False,,,2024-03-22 17:09:07,0.02,fail,False,-163.85,22316.020000000106,,0,2,12,March
2024-03-25 01:00:00,66972.742,67643.734,66951.336,67588.336,4284,36421,0,2024-03-25 01:00:00,2024-03-25 01:00:00,1108.8604642857608,-104.38508504796482,65761.11897619045,0.004147431693765689,0.007133390869017695,64837.8689761905,64979.39264787234,69698.13053990509,64098.784552903046,68960.6592553376,0.0067903981822222395,0.002292851121731161,65266.33986770958,64991.138018216865,98.11516981676876,97.62871044982556,-446.0221206415376,65606.80975685337,64807.22528800803,66334.93375060198,799.5844688453435,336.50975630083036,1440.4108584171786,537.8122229102592,452.4284888200127,509.1158875129622,68280.98840946516,64390.37909173879,True,False,68588.336,67138.336,68058.336,68088.336,,False,2024-03-25 16:15:00,2024-03-25 16:11:17,2024-03-25 02:02:20,0.02,fail,False,-163.85,22152.170000000107,,0,3,13,March
2024-03-25 06:45:00,67328.336,67566.734,67312.016,67520.734,3186,36421,0,2024-03-25 06:00:00,2024-03-25 06:00:00,303.05054761904466,615.6052086658165,67421.0843928572,0.008118013202359546,0.0005695027187954268,67271.91953571427,69336.95583854488,68034.18561879998,68919.8265650746,70272.16290001487,0.004626557097722592,0.008325545981192981,65578.65772872981,65680.09437637101,86.13823562421733,84.08985491666014,169.42657826820113,67092.89072965216,66642.3864614396,67267.7409889921,450.50426821256406,473.44059250549026,322.2181995046946,127.83669384250243,96.78884072926303,108.85715927068668,67704.23555832343,66832.74641966076,True,False,68520.734,67070.734,67990.734,68020.734,,False,2024-03-25 16:00:00,2024-03-25 16:09:14,2024-03-25 08:36:14,0.02,fail,False,-163.85,21988.32000000011,,0,4,13,March
2024-03-25 16:00:00,68028.336,68839.836,67711.75,68616.242,6416,36421,0,2024-03-25 16:00:00,2024-03-25 16:00:00,369.8497500000085,461.96095256783883,68104.33670238098,0.0009108516150192624,0.004616784676365669,67338.23538095239,67179.05111633672,70855.70158678817,67116.60138720088,68457.63062709168,0.0013575536831515358,0.0009106716941859768,66192.31464882629,66711.70458059583,86.62974125668235,66.32397592657831,454.2856967441254,67411.35312544805,67203.34441357196,67488.78552872376,208.00871187608573,70.68230829019039,390.49198691054283,275.2617313381779,176.11364017885353,22.77724355008104,68017.44971105299,66961.62134639453,True,False,69616.242,69086.242,69086.242,69116.242,2024-03-25 16:30:00,True,2024-03-25 16:30:00,2024-03-25 17:00:11,2024-03-25 16:30:08,0.02,even,True,171.08,22159.40000000011,,1,0,13,March
2024-03-25 16:15:00,68610.352,69511.734,68610.281,69217.273,6499,36421,0,2024-03-25 16:00:00,2024-03-25 16:00:00,369.8497500000085,461.96095256783883,68104.33670238098,0.0009108516150192624,0.004616784676365669,67338.23538095239,67179.05111633672,70855.70158678817,67116.60138720088,68457.63062709168,0.0013575536831515358,0.0009106716941859768,66192.31464882629,66711.70458059583,91.48743954671778,81.5987066171282,454.2856967441254,67689.18695230219,67352.52430886292,67862.31006707944,336.6626434392674,123.8783753200058,572.3426357593852,373.52453835567576,275.2617313381779,176.11364017885353,68636.47262535461,67089.64750880426,True,False,70217.273,69687.273,69687.273,69717.273,2024-03-25 18:00:00,True,2024-03-25 18:00:00,2024-03-25 18:37:35,2024-03-25 18:07:56,0.02,even,True,171.08,22330.480000000112,,2,0,13,March
2024-03-25 16:45:00,69140.352,69480.641,69001.836,69416.438,4738,36421,0,2024-03-25 16:00:00,2024-03-25 16:00:00,369.8497500000085,461.96095256783883,68104.33670238098,0.0009108516150192624,0.004616784676365669,67338.23538095239,67179.05111633672,70855.70158678817,67116.60138720088,68457.63062709168,0.0013575536831515358,0.0009106716941859768,66192.31464882629,66711.70458059583,90.72299229923006,90.15720688492821,454.2856967441254,68144.11164040571,67628.17873119249,68563.53791537667,515.9329092132248,250.894595701376,808.5846803508418,352.36520123844093,348.8626470587915,373.52453835567576,69656.6272338503,67471.94859690304,True,False,70416.438,69886.438,69886.438,69916.438,2024-03-25 18:45:00,True,2024-03-25 18:45:00,2024-03-25 19:05:48,2024-03-25 23:18:44,0.02,success,True,364.0,22694.480000000112,,3,0,13,March
2024-03-25 20:30:00,70673.305,70713.734,70394.727,70693.938,2997,36421,0,2024-03-25 20:00:00,2024-03-25 20:00:00,640.4768452381104,1069.4679401302128,70676.44911904761,0.010291092823328673,0.008307327654227885,70152.78513095237,73481.16749090652,74392.57999127352,71904.02629492455,73586.83759008613,0.007905853944415427,0.008899353779529025,66813.16726457357,67760.56705168006,87.60180440584445,86.01524159191204,725.5730603331584,70240.98298234682,69453.1425426359,70765.42716443067,787.8404397109116,776.6268217387787,1314.2969429095099,34.58676608178939,17.567076711449772,-23.626622291034437,72541.22803735851,68991.12629150283,True,False,71693.938,70243.938,71163.938,71193.938,,False,2024-03-26 09:30:00,2024-03-27 15:29:35,2024-03-25 23:15:47,0.02,fail,False,-163.85,22530.630000000114,,0,1,13,March
2024-03-25 20:45:00,70693.938,70953.734,70661.836,70881.734,2979,36421,0,2024-03-25 20:00:00,2024-03-25 20:00:00,640.4768452381104,1069.4679401302128,70676.44911904761,0.010291092823328673,0.008307327654227885,70152.78513095237,73481.16749090652,74392.57999127352,71904.02629492455,73586.83759008613,0.007905853944415427,0.008899353779529025,66813.16726457357,67760.56705168006,91.31832238277808,88.40187683808124,725.5730603331584,70339.56006198577,69558.96413207028,70857.99086549702,780.5959299154929,777.4206433741217,1268.2108945195298,92.56370106634859,34.58676608178939,17.567076711449772,72571.57557309838,69145.90615789566,True,False,71881.734,70431.734,71351.734,71381.734,,False,2024-03-26 09:30:00,,2024-03-25 23:14:37,0.02,fail,False,-163.85,22366.780000000115,,0,2,13,March
2024-03-25 21:45:00,70776.336,71045.336,70750.039,70995.734,3075,36421,0,2024-03-25 21:00:00,2024-03-25 21:00:00,523.6639880952425,1153.7737770251551,70980.40263095242,0.008904403268879658,0.006937337955890119,70676.44911904761,73202.7967148323,74174.48375828288,73481.16749090652,74392.57999127352,0.008307327654227885,0.010291092823328673,66977.18948949226,68019.38040754566,86.96794629489405,83.67645725154806,811.2132036715577,70559.49006748831,69881.68499360033,70953.59828345374,677.8050738879829,731.64897264126,777.1850839126577,50.387440660444554,12.187011351968977,18.845109735091683,72004.29814673583,69904.39842017165,True,False,71995.734,70545.734,71465.734,71495.734,,False,2024-03-26 09:30:00,,2024-03-25 23:11:41,0.02,fail,False,-163.85,22202.930000000117,,0,3,13,March
2024-03-27 03:00:00,70646.734,70777.539,70443.367,70708.297,3259,36421,0,2024-03-27 03:00:00,2024-03-27 03:00:00,211.26634523819666,10.77330699772574,70360.41196428573,0.0016979841316313777,0.0006549135729113656,70248.43171428579,70485.55707104331,70976.87136734923,69946.39560651245,70930.58618265922,0.000654909354838909,0.0009647137503256955,69315.50546635102,70097.45837349653,94.47100765697739,83.44277173927753,10.752137594152089,70286.42300504733,70174.33685646209,70400.29401375988,112.08614858523651,31.970572790494572,286.39250759857475,86.88244994834531,84.73062091505562,65.7826590987097,70788.42389901796,70013.6641285018,True,False,71708.297,70258.297,71178.297,71208.297,,False,2024-03-27 15:15:00,2024-03-27 15:29:35,2024-03-27 03:57:00,0.02,fail,False,-163.85,22039.080000000118,,0,4,13,March
2024-03-27 15:15:00,71286.141,71760.539,71181.836,71703.938,4601,36421,0,2024-03-27 15:00:00,2024-03-27 15:00:00,54.40958333337039,-18.109667111668386,70102.33708333338,0.0004807292428592067,0.002426275751668765,70105.69327380955,69723.56428593914,72568.87515142372,69089.07984207575,70258.46419940185,-0.0005215489636106808,-0.000729236997761876,69640.24867800644,70130.78279345584,88.85792245118444,78.35977283695523,-19.288092043571936,70547.02881943573,70337.02047287514,70745.47852975571,210.00834656058578,57.44050439395413,457.3121501174578,237.85673065004812,194.81531406953582,19.403499140084023,71364.34993241428,70128.10712709714,True,False,72703.938,71253.938,72173.938,72203.938,,False,,,2024-03-27 15:35:10,0.02,fail,False,-163.85,21875.23000000012,,0,5,13,March
2024-03-28 08:15:00,70022.086,70161.438,69916.336,70106.836,2821,36421,0,2024-03-28 08:00:00,2024-03-28 08:00:00,36.25367857146193,3.4542793903383426,69858.91369047621,0.001353632139106333,0.000950190626564127,69575.5482142857,69689.4469887465,70729.60318354958,69103.48271030394,69901.9701321129,-0.0002310350129914824,0.00036414292667125625,69516.82240440877,69618.46366043566,90.52943105852029,86.6610394452684,-110.76677267549047,69758.88464317277,69601.42650080626,69916.81066563471,157.45814236650767,103.33726424031845,266.4728664622263,101.45294461651065,95.31182146536594,43.13055108363915,70278.04903535871,69557.07229591071,True,False,71106.836,70576.836,70576.836,70606.836,2024-03-28 10:45:00,True,2024-03-28 10:45:00,2024-03-28 15:28:25,2024-03-28 10:59:42,0.02,even,True,171.08,22046.31000000012,,1,0,13,March
2024-03-28 08:30:00,70113.836,70431.336,70046.0,70406.734,3158,36421,0,2024-03-28 08:00:00,2024-03-28 08:00:00,36.25367857146193,3.4542793903383426,69858.91369047621,0.001353632139106333,0.000950190626564127,69575.5482142857,69689.4469887465,70729.60318354958,69103.48271030394,69901.9701321129,-0.0002310350129914824,0.00036414292667125625,69516.82240440877,69618.46366043566,97.24433450641281,91.45056798585934,-110.76677267549047,69858.55377499234,69661.07890815396,70075.6823856209,197.4748668383836,122.16478475993148,309.1915389343521,158.87171998618578,101.45294461651065,95.31182146536594,70494.59096318227,69658.27380805952,True,False,71406.734,70876.734,70876.734,70906.734,2024-03-28 15:30:00,True,2024-03-28 15:30:00,2024-03-28 15:35:43,2024-03-28 15:31:37,0.02,even,True,171.08,22217.390000000123,,2,0,13,March
2024-03-28 10:30:00,70531.234,70764.938,70515.555,70675.836,3081,36421,0,2024-03-28 10:00:00,2024-03-28 10:00:00,245.26158333331114,173.81087181561452,70382.30941666667,0.002733153513071743,0.002251230319970361,70104.17527380952,70850.39920898133,71560.98286791678,70534.39337056805,70796.93229929126,0.0009502663055182083,0.0025211484574356163,69594.1227539352,69757.55163259275,84.5678229724028,84.25857340304435,-19.55695331905835,70308.55984721013,70023.88976254834,70575.04625111804,284.6700846617896,241.31347106423135,494.51713672583384,69.24624630206381,37.02962125906197,8.591421396631631,71244.14438569792,69907.44811653816,True,False,71675.836,71145.836,71145.836,71175.836,2024-03-28 16:45:00,True,2024-03-28 16:45:00,,2024-03-28 17:27:49,0.02,even,True,171.08,22388.470000000125,,3,0,13,March
2024-04-01 01:00:00,70901.734,71078.438,70881.68,71002.141,1736,56421,0,2024-04-01 01:00:00,2024-04-01 01:00:00,526.4584523809026,-51.73582520158379,70485.92577380955,0.0024068032988184005,0.002028019546049458,69997.5893571428,70579.72714616627,71773.14659188979,70187.64485208015,71312.01954065745,0.0009689322341115308,0.0018584552120855244,70125.09779132955,70145.5770912984,93.17960383630675,92.579647054951,-168.99846143177226,70355.05292673846,70065.90775486267,70681.73571964225,289.14517187578895,107.44635294542903,594.3322850588319,173.68719470244832,174.2579814241617,192.61188716893957,71485.58430447167,69879.38713481283,True,False,72002.141,70552.141,71472.141,71502.141,,False,,,2024-04-01 07:37:19,0.02,fail,False,-163.85,22224.620000000126,,0,1,14,April
2024-04-01 17:30:00,69426.141,69486.836,69036.852,69066.141,3899,36421,0,2024-04-01 17:00:00,2024-04-01 17:00:00,77.51122619042872,-145.33049239318643,69502.12460714283,-0.0013751814619657014,0.0007399656016352277,69731.39346428568,68246.1111674084,70394.00901306067,69932.72233632993,70342.67238816948,0.0007399580432684806,0.0013632599873264679,70032.8813362229,69911.79877917083,14.93102470643516,39.69791931716214,-137.17561093895347,69634.02836317591,69699.81924073439,69717.36548503608,-65.79087755848013,-36.33492240127946,222.77601677086074,-131.8692019264272,-72.95053560375527,-11.819185414453386,70018.11310767673,69415.11786239542,False,True,68066.141,68596.141,68596.141,68566.141,2024-04-01 18:15:00,True,2024-04-01 18:15:00,2024-04-02 05:36:01,2024-04-01 18:15:08,0.02,even,True,171.08,22395.700000000128,,1,0,14,April
2024-04-01 17:45:00,69046.328,69246.141,68635.844,68931.836,4376,36421,0,2024-04-01 17:00:00,2024-04-01 17:00:00,77.51122619042872,-145.33049239318643,69502.12460714283,-0.0013751814619657014,0.0007399656016352277,69731.39346428568,68246.1111674084,70394.00901306067,69932.72233632993,70342.67238816948,0.0007399580432684806,0.0013632599873264679,70032.8813362229,69911.79877917083,8.320549001203181,20.554413711400027,-137.17561093895347,69525.99876884115,69642.93159327257,69552.96952872376,-116.9328244314238,-52.45450280730833,261.768640770886,-164.39595631232078,-131.8692019264272,-72.95053560375527,69906.35719376444,69198.08186368307,False,True,67931.836,68461.836,68461.836,68431.836,2024-04-01 19:00:00,True,2024-04-01 19:00:00,2024-04-02 05:36:10,2024-04-01 19:01:46,0.02,even,True,171.08,22566.78000000013,,2,0,14,April
2024-04-02 01:30:00,69766.734,69869.438,69683.258,69843.641,1261,36421,0,2024-04-02 01:00:00,2024-04-02 01:00:00,282.18757142845425,-103.50955161973252,69727.33352380947,0.0039839054006285055,0.0028593885461890927,69521.974547619,70742.27091240088,71288.22627428372,69935.55577013452,69890.75202507434,-0.000101290196777811,0.0030664781964928603,69807.53494555014,69594.19318657742,86.37888347105898,82.65561783776708,-220.16323931275383,69611.75830915329,69420.34803172479,69897.08447506024,191.41027742849838,139.3930588187107,498.3309836967859,7.570158926740987,28.93831613349903,15.03034640524129,70571.3313030509,69224.33764706958,True,False,70843.641,69393.641,70313.641,70343.641,,False,,,2024-04-02 03:20:05,0.02,fail,False,-163.85,22402.93000000013,,0,1,14,April
2024-04-02 16:15:00,65366.539,65483.742,64781.84,64889.762,5351,36422,0,2024-04-02 16:00:00,2024-04-02 16:00:00,-284.73908333333384,-873.6742762387876,65440.11782142854,-0.0035402348635756786,-0.003466853448155431,65676.63094047624,63703.6897079436,64717.877350932526,64219.05719938402,65208.885428828304,-0.0028885458158535407,-0.0026504805925903468,68404.94642028924,67379.03115324157,18.571201958927784,27.575309156896964,-738.7740148764094,65567.09974992863,65986.79496906498,65291.19890608869,-419.69521913635253,-398.01284607271276,483.4538190683044,-142.11153697974805,-51.22351599587273,-56.84888751299877,65943.8615618309,64637.03625034648,False,True,63889.762,65339.762,64419.762,64389.762,,False,,,2024-04-02 16:54:35,0.02,fail,False,-163.85,22239.080000000133,,0,2,14,April
2024-04-03 21:15:00,65767.344,65852.641,65581.836,65641.836,2397,36421,0,2024-04-03 21:00:00,2024-04-03 21:00:00,-16.31285714288242,-14.569014385953778,66062.18864285715,-0.00014229365588566453,-0.0004517466551826942,66070.64472619048,65434.07532846412,66665.85145281853,65999.81728142382,67449.40581598005,0.0011310562336794409,0.0006972111336689144,66759.35956511297,66173.49915126115,12.667639639417615,19.16868261874835,-5.022208270018538,66015.09030140619,66093.40127573577,65853.50374785002,-78.31097432957904,-16.33425407213812,321.732185915054,-144.4377358101192,-129.8112229102262,-89.0140846232971,66287.84219883534,65417.665296864696,False,True,64641.835999999996,66091.836,65171.835999999996,65141.835999999996,,False,,,2024-04-03 21:50:37,0.02,fail,False,-163.85,22075.230000000134,,0,3,14,April
2024-04-04 19:15:00,67677.516,68153.734,67650.039,67899.227,2982,36421,0,2024-04-04 19:00:00,2024-04-04 19:00:00,265.86886904761195,397.0174458300171,67627.86188095238,0.0036748349707984317,0.004431260171501367,67379.31148809525,68323.55111630863,69765.50221635422,67794.82220992226,69176.06844640015,0.00364191708756789,0.003101231418244897,66563.41662938941,66521.1355256169,82.20031530648082,81.54324407174458,176.21381895596784,67522.96200141053,67138.26078138385,67892.86101582393,384.7012200266763,368.02291354370965,602.458493144417,41.279650498807314,26.44027175786323,18.598574819392525,68707.6799815689,67079.54205007896,True,False,68899.227,68369.227,68369.227,68399.227,2024-04-04 21:00:00,True,2024-04-04 21:00:00,2024-04-04 21:00:11,2024-04-04 22:01:37,0.02,success,True,363.99,22439.220000000136,,1,0,14,April
2024-04-04 20:45:00,68035.641,68890.438,68015.688,68824.641,3882,36421,0,2024-04-04 20:00:00,2024-04-04 20:00:00,248.550392857127,447.3618876109831,68140.45217857145,0.004140780960181365,0.005270882284679032,67627.86188095238,68872.30356908658,70501.44185839387,68323.55111630863,69765.50221635422,0.004431260171501367,0.0036748349707984317,66652.09209490355,66705.41596356756,81.69944866601901,74.24187084155106,230.44343268697088,67889.65419448807,67476.89284047575,68096.88716099071,412.7613540123275,371.20180321843617,562.8327909476334,185.0354767802346,28.572408324675052,-17.61145579633012,68858.21142877001,67337.0628932114,True,False,69824.641,68374.641,69294.641,69324.641,,False,,,2024-04-04 22:01:36,0.02,fail,False,-163.85,22275.370000000137,,0,1,14,April
2024-04-08 04:15:00,69538.141,69843.938,69533.555,69721.836,2795,36421,0,2024-04-08 04:00:00,2024-04-08 04:00:00,342.98547619041346,482.0495955750521,69450.56329761907,0.0057573343991403165,0.0037508030237934707,69226.18483333329,70944.76863350195,71569.4786090551,70539.75933828471,71990.34360272506,0.005096862156078659,0.00576237035018796,67621.6700046159,68070.76966726633,86.55899239539833,77.55337374858033,246.64444738346145,69310.68314374727,68909.41620416021,69445.11886205715,401.26693958706164,408.9235388578129,810.1613020000898,-47.70189198483422,-51.71841623664659,-64.86741933260055,70538.83661975728,68349.90110435702,True,False,70721.836,69271.836,70191.836,70221.836,,False,2024-04-08 10:45:00,2024-04-08 10:37:25,2024-04-08 05:08:49,0.02,fail,False,-163.85,22111.52000000014,,0,2,15,April
2024-04-08 10:15:00,69911.734,70157.234,69856.445,70092.039,2577,36421,0,2024-04-08 10:00:00,2024-04-08 10:00:00,104.70779761907761,510.6262292200263,70013.9359404762,0.0018259249386725475,0.0024314824916457796,69611.31723809529,70172.11259273815,71591.3461745385,69459.65249312832,69816.67326196528,-4.2656761122998035e-05,0.0006593243318909158,68074.97961334753,68742.9632626789,92.3696382465625,88.51470579259205,439.41750588367074,69733.39546676776,69520.74409045292,69888.01099277605,212.65137631483958,191.16025612981986,231.30746793865902,76.27826281389571,58.827920536641614,41.492159270797856,70201.77607449325,69575.74591105885,True,False,71092.039,70562.039,70562.039,70592.039,2024-04-08 10:45:00,True,2024-04-08 10:45:00,2024-04-08 11:12:55,2024-04-09 10:25:22,0.02,success,True,363.99,22475.51000000014,,1,0,15,April
2024-04-08 10:30:00,70092.039,70869.734,70087.398,70675.836,4062,36421,0,2024-04-08 10:00:00,2024-04-08 10:00:00,104.70779761907761,510.6262292200263,70013.9359404762,0.0018259249386725475,0.0024314824916457796,69611.31723809529,70172.11259273815,71591.3461745385,69459.65249312832,69816.67326196528,-4.2656761122998035e-05,0.0006593243318909158,68074.97961334753,68742.9632626789,91.19903369320342,89.97018421768514,439.41750588367074,69878.38631803426,69606.30645412307,70063.72077880974,272.079863911189,207.3441776860937,322.7844739515684,175.7097860336944,76.27826281389571,58.827920536641614,70500.97981864437,69627.96173897512,True,False,71675.836,71145.836,71145.836,71175.836,2024-04-08 11:15:00,True,2024-04-08 11:15:00,2024-04-08 11:53:49,2024-04-08 11:23:01,0.02,even,True,171.08,22646.590000000142,,2,0,15,April
2024-04-08 11:00:00,70720.336,71361.734,70656.25,71357.938,3424,36421,0,2024-04-08 11:00:00,2024-04-08 11:00:00,402.61870238091797,604.7054465979454,70772.61248809518,0.002894968735061354,0.005020461961059564,70013.9359404762,70845.5105774614,73877.69087572454,70172.11259273815,71591.3461745385,0.0024314824916457796,0.0018259249386725475,68230.43292262802,69006.64932166459,92.76459304234966,91.44340702622303,472.4750940265257,70215.61257090027,69812.46500113432,70502.15356965942,403.147569765948,264.3841680101463,523.6125648539747,273.1042665978457,165.32852425183228,175.7097860336944,71210.53053221229,69795.27660710656,True,False,72357.938,71827.938,71827.938,71857.938,2024-04-08 12:00:00,True,2024-04-08 12:00:00,2024-04-08 12:27:29,2024-04-08 12:05:19,0.02,even,True,171.08,22817.670000000144,,3,0,15,April
2024-04-10 16:00:00,67992.938,68000.039,67599.641,67633.977,3863,36421,0,2024-04-10 16:00:00,2024-04-10 16:00:00,-397.8090952381608,-246.12639225984458,68471.86391666664,-0.004184210465972991,-0.0008450829723947346,68687.99535714283,66095.71929800807,68952.17860615409,66599.02204397102,69010.74227977717,-0.0008449949920324193,-0.003364235504007743,69498.75007586315,69216.00571794994,19.698105857531388,35.42191139709097,-198.7990845448125,68575.16554156737,68838.58667091712,68416.68745854832,-263.4211293497501,-122.97506193917255,444.33131900851953,-231.8332088063471,-171.69560440313944,-196.4691506708332,69016.53473920982,67815.34017788681,False,True,66633.977,68083.977,67163.977,67133.977,,False,2024-04-12 21:45:00,2024-04-12 21:33:03,2024-04-10 16:51:52,0.02,fail,False,-163.85,22653.820000000145,,0,1,15,April
2024-04-10 22:45:00,69761.734,70103.539,69714.719,70097.938,3097,36421,0,2024-04-10 22:00:00,2024-04-10 22:00:00,190.3932857142645,-12.39672527773655,69677.74786904757,0.004154116304470678,0.0020259574958166413,69239.64022619047,70440.66902861919,70835.09565942749,70099.01506024675,70641.61655119254,0.0018920958915106037,0.0040816718725572645,69459.53421035525,69267.40661407213,84.59316114964727,72.98044591203349,-142.8264708256808,69475.81266529392,69216.1620572436,69749.52356415548,259.65060805033136,186.6714077300344,491.6386987816275,114.17621259031876,47.352840729246964,47.658427244532504,70414.73580751067,69085.81132080028,True,False,71097.938,69647.938,70567.938,70597.938,,False,2024-04-11 01:30:00,2024-04-11 01:25:11,2024-04-11 00:29:15,0.02,fail,False,-163.85,22489.970000000147,,0,2,15,April
2024-04-11 01:15:00,70501.234,71258.336,70438.578,70955.734,3453,36421,0,2024-04-11 01:00:00,2024-04-11 01:00:00,129.38869047618937,198.94173700430838,70209.6051904762,0.0031476767505849777,0.0036864860595127295,69940.19721428568,70724.03073503707,72360.70936670067,70521.80147872843,71139.67875113167,0.00205428219493199,0.0032219723347909255,69537.4456340328,69464.7716551306,88.58385273164366,76.15930298014113,3.5466927883090023,70020.46925482793,69673.60139508336,70261.60315376674,346.8678597445687,268.7458349250707,439.52705351772306,203.2077258341742,131.72082628133649,75.70276126592944,70856.46467601568,69668.24163151781,True,False,71955.734,70505.734,71425.734,71455.734,,False,,,2024-04-11 03:02:49,0.02,fail,False,-163.85,22326.120000000148,,0,3,15,April
2024-04-11 05:30:00,70836.922,70961.836,70771.914,70931.734,2343,36421,0,2024-04-11 05:00:00,2024-04-11 05:00:00,81.28009523812216,391.77890917244076,70772.88442857141,0.002520632749643855,0.0010958466851407628,70627.09077380956,71210.97049932541,71899.23481352763,71030.7450032367,73140.14885430133,0.0036380781613434645,0.002520800200487366,69711.11666343041,69820.25497131367,82.83743141314409,63.12029305109687,215.65359422850133,70650.85296099036,70387.89918121339,70659.14751496387,262.95377977697353,275.0006917493455,391.84661700556217,46.27562641892291,-1.7273856209212681,-31.40582456131233,71189.64044792138,70130.15458200636,True,False,71931.734,70481.734,71401.734,71431.734,,False,,,2024-04-11 07:17:49,0.02,fail,False,-163.85,22162.27000000015,,0,4,15,April
2024-04-11 05:45:00,70927.641,71110.438,70792.133,71017.445,2295,36421,0,2024-04-11 05:00:00,2024-04-11 05:00:00,81.28009523812216,391.77890917244076,70772.88442857141,0.002520632749643855,0.0010958466851407628,70627.09077380956,71210.97049932541,71899.23481352763,71030.7450032367,73140.14885430133,0.0036380781613434645,0.002520800200487366,69711.11666343041,69820.25497131367,87.94124566953552,77.62141617462242,215.65359422850133,70707.25173622262,70434.5322048272,70756.40456484348,272.7195313954144,274.5444596785593,391.49347112060394,97.25704987961217,46.27562641892291,-1.7273856209212681,71286.4207508563,70227.88837883067,True,False,72017.445,70567.445,71487.445,71517.445,,False,,,2024-04-11 07:06:56,0.02,fail,False,-163.85,21998.42000000015,,0,5,15,April
2024-04-12 02:15:00,70074.492,70105.039,69781.844,69999.039,1430,36421,0,2024-04-12 02:00:00,2024-04-12 02:00:00,-63.9089999999851,-15.454327447310789,70216.02610714285,0.0003890094808094109,0.0004279499857540025,70303.22179761909,69895.4455502866,70978.89376590593,70358.37219414554,71369.2263800873,0.0013877485377268577,0.001077028555094844,70075.5073723333,70220.22355314945,15.396796748685178,18.52996200163948,15.42528398771654,70204.9126192354,70246.74066922514,70141.21768868247,-41.82804998973734,-0.6464655089865516,175.69365444890582,-79.34463020296243,-56.36351152390125,-45.817475748219294,70378.4041221885,69902.53125517645,False,True,68999.039,70449.039,69529.039,69499.039,,False,2024-04-12 18:00:00,2024-04-12 19:19:10,2024-04-12 05:06:09,0.02,fail,False,-163.85,21834.570000000153,,0,6,15,April
2024-04-12 17:00:00,69908.141,70118.938,69640.141,69793.641,3627,36421,0,2024-04-12 17:00:00,2024-04-12 17:00:00,-278.826869047567,-17.32454239219078,70013.01730952383,-0.002792724574697229,-0.00035896746797427974,70449.7302619048,68451.693517593,70852.85228561226,69009.79106412058,70969.39261000733,-0.00010915172993142396,-0.002220210429649587,70299.81079163612,70435.63856557905,10.882285966887652,13.024482488176089,91.01933397345844,70306.44518230302,70522.75930554175,70134.27183694532,-216.31412323872792,-100.88407412867011,349.48405286273373,-150.76655280351406,-135.8772851738031,-158.6099570002698,70606.07530831001,69660.96836558063,False,True,68793.641,69323.641,69323.641,69293.641,2024-04-12 18:00:00,True,2024-04-12 18:00:00,2024-04-12 19:20:49,2024-04-12 18:00:21,0.02,even,True,171.08,22005.650000000154,,1,0,15,April
2024-04-15 07:30:00,64897.844,64939.438,64731.867,64853.836,2621,36422,0,2024-04-15 07:00:00,2024-04-15 07:00:00,42.217392857135565,-1176.1330971093994,65202.2004880953,0.003037771522013199,0.0006116479705377237,65093.34097619043,65437.70691208761,66148.18618135953,66172.90221038222,64040.87946534994,-0.004694764335138491,0.0044459348349398615,68463.6302881549,67257.85717813502,18.212177695562477,21.189030023380614,-1107.69620552305,65066.1780170447,65368.64095424992,64912.819563123485,-302.462937205215,-338.1256128437062,253.2558872749682,-32.65671310629841,-41.70734502923733,-76.59980116964289,65254.71501094469,64569.42411530228,False,True,63853.836,65303.836,64383.836,64353.836,,False,2024-04-15 18:00:00,2024-04-15 18:01:44,2024-04-15 08:42:47,0.02,fail,False,-163.85,21841.800000000156,,0,1,16,April
2024-04-17 15:30:00,62378.047,62458.738,62006.637,62217.852,3921,36422,0,2024-04-17 15:00:00,2024-04-17 15:00:00,-283.862964285654,-126.21044966683985,62591.978761904815,-0.003706467911639316,-0.0034775529358657357,62863.20517857146,61085.238270728696,62024.73031400062,61824.09763050011,62238.359999710236,-0.0034808014605905505,-0.0025854691901027165,63906.271660208055,63276.50085250381,11.743554560040073,12.97535386204631,43.825592628142665,62760.8319741511,63068.527181027945,62499.44140488471,-307.69520687684417,-235.62797811956355,430.1185396724116,-123.84001479198923,-124.43801616781275,-67.02222428620735,63080.10143344247,61917.28137632695,False,True,61217.852,62667.852,61747.852,61717.852,,False,2024-04-17 17:30:00,2024-04-17 17:19:14,2024-04-17 16:37:31,0.02,fail,False,-163.85,21677.950000000157,,0,2,16,April
2024-04-18 14:15:00,62344.176,62981.738,62344.176,62876.438,4739,36422,0,2024-04-18 14:00:00,2024-04-18 14:00:00,148.7533452380885,-68.02154627266282,61864.46640476193,0.0005713476361940837,0.002287948640315011,61422.717999999986,61049.80493978671,63617.02470857534,60812.1141433749,61718.511145943616,-0.0006690982114286569,0.00013153733892289687,62412.04935738212,61748.057625585665,93.44594468092072,90.28669043188732,-179.6116441054086,61805.707309512814,61588.099324965835,62035.79730994147,217.60798454697942,61.47942079629904,444.34551197893023,254.2612404540123,157.751493636104,81.2066738905778,62637.163751113025,61435.93086876991,True,False,63876.438,62426.438,63346.438,63376.438,,False,2024-04-18 17:15:00,2024-04-18 17:37:21,2024-04-18 15:06:27,0.02,fail,False,-163.85,21514.10000000016,,0,3,16,April
2024-04-19 04:00:00,62676.039,62741.738,62071.137,62083.34,3828,36422,0,2024-04-19 04:00:00,2024-04-19 04:00:00,-183.61498809524346,270.6647636292473,62438.25847619046,-0.003930516710234889,-0.002995148776346777,63244.384964285746,59612.85815427919,62485.05708439024,62830.22635221072,64068.63176648727,0.0006449932778116033,0.0009224781841595597,62657.80586173342,62569.07753556826,7.1072574684895935,7.867187159662394,344.00273588612816,62980.967991708625,63117.434153288676,62840.21514585483,-136.46616158005054,6.469536690618025,336.57894568034595,-218.60700722389447,-122.18152253187145,-72.9493464051775,63294.596722523296,62384.33356918637,False,True,61083.34,62533.34,61613.34,61583.34,,False,2024-04-19 04:45:00,2024-04-19 04:39:20,2024-04-19 07:36:31,0.02,success,True,363.99,21878.09000000016,,1,0,16,April
2024-04-19 04:15:00,62087.137,62250.938,61819.816,62040.84,5040,36422,0,2024-04-19 04:00:00,2024-04-19 04:00:00,-183.61498809524346,270.6647636292473,62438.25847619046,-0.003930516710234889,-0.002995148776346777,63244.384964285746,59612.85815427919,62485.05708439024,62830.22635221072,64068.63176648727,0.0006449932778116033,0.0009224781841595597,62657.80586173342,62569.07753556826,6.8387901305568315,7.769680535408511,344.00273588612816,62836.33291606115,63037.68643823025,62633.909285517664,-201.35352216910542,-35.09507508132667,414.8037262116204,-206.30586033716827,-218.60700722389447,-122.18152253187145,63193.89431590335,62072.42425513198,False,True,61040.84,62490.84,61570.84,61540.84,,False,2024-04-19 04:45:00,2024-04-19 04:39:28,2024-04-19 07:35:28,0.02,success,True,363.99,22242.08000000016,,2,0,16,April
2024-04-19 04:30:00,62038.48,62139.738,60862.105,60977.938,6372,36422,0,2024-04-19 04:00:00,2024-04-19 04:00:00,-183.61498809524346,270.6647636292473,62438.25847619046,-0.003930516710234889,-0.002995148776346777,63244.384964285746,59612.85815427919,62485.05708439024,62830.22635221072,64068.63176648727,0.0006449932778116033,0.0009224781841595597,62657.80586173342,62569.07753556826,5.7452747865238,6.563774128523437,344.00273588612816,62550.42600589789,62885.11247984283,62261.88957344328,-334.68647394493746,-95.01335485404884,610.6045120924906,-372.0197120743833,-206.30586033716827,-218.60700722389447,63086.205664768146,61436.073482118416,False,True,59977.938,61427.938,60507.938,60477.938,,False,2024-04-19 05:30:00,2024-04-19 05:21:34,2024-04-19 06:00:36,0.02,success,True,363.99,22606.070000000163,,3,0,16,April
2024-04-19 05:00:00,60981.637,61140.039,60577.172,60661.34,5619,36422,0,2024-04-19 05:00:00,2024-04-19 05:00:00,-806.1264880952876,1.2034809372198652,61893.46236904765,-0.008135503448783216,-0.00299527124370446,62438.25847619046,57629.80170781953,62297.1204976508,59612.85815427919,62485.05708439024,-0.002995148776346777,-0.003930516710234889,62605.14833774388,62468.7544527228,7.0501718762311,7.616553632698161,275.4428848963465,62055.524394755295,62589.807352402975,61552.925291021675,-534.2829576476797,-237.27670248672308,878.8119450842979,-355.4865916753042,-353.47769074630196,-372.0197120743833,62739.321416885476,60365.029165157874,False,True,59661.34,61111.34,60191.34,60161.34,,False,2024-04-19 05:30:00,2024-04-19 05:29:37,2024-04-19 05:55:33,0.02,success,True,363.99,22970.060000000165,,4,0,16,April
2024-04-19 12:00:00,64574.891,64720.938,64431.84,64622.438,3117,36422,0,2024-04-19 12:00:00,2024-04-19 12:00:00,706.2196071429426,425.73348466228344,64627.58714285714,0.00919938404555752,0.010751168501222786,64226.56586904767,65936.05568851827,70075.14216495234,65328.62381283429,67714.89340076449,0.00688713487155299,0.009195260491835548,62846.23817432063,63007.49523081214,81.93117522624853,81.86497297837137,153.6277737559466,64084.89982309588,63428.44583768296,64963.92812521504,656.4539854129252,520.365027673055,1226.7804628544047,146.53228586180194,148.5419645682632,158.5582163742365,66621.58175006848,63307.77450036159,True,False,65622.438,65092.438,65092.438,65122.438,2024-04-19 14:45:00,True,2024-04-19 14:45:00,2024-04-22 04:23:03,2024-04-19 14:48:20,0.02,even,True,171.08,23141.140000000167,,5,0,16,April
2024-04-19 12:45:00,64598.34,64898.625,64598.34,64726.637,3236,36422,0,2024-04-19 12:00:00,2024-04-19 12:00:00,706.2196071429426,425.73348466228344,64627.58714285714,0.00919938404555752,0.010751168501222786,64226.56586904767,65936.05568851827,70075.14216495234,65328.62381283429,67714.89340076449,0.00688713487155299,0.009195260491835548,62846.23817432063,63007.49523081214,84.27059785790762,83.70908968942946,153.6277737559466,64302.594157733554,63676.590621846066,65126.043332301306,626.0035358874884,575.5270653500336,1228.6687533138293,19.396794289612444,44.22854110771732,98.48987168893655,66786.24614927497,63467.34051532764,True,False,65726.637,65196.637,65196.637,65226.637,2024-04-19 14:45:00,True,2024-04-19 14:45:00,2024-04-22 06:45:05,2024-04-19 14:46:32,0.02,even,True,171.08,23312.22000000017,,6,0,16,April
2024-04-24 23:15:00,63881.77,63968.637,63549.586,63863.938,3961,56422,0,2024-04-24 23:00:00,2024-04-24 23:00:00,-268.18101190475136,-612.112684043168,64042.937738095236,-0.0033291366356082413,-0.004896068512821747,64154.570416666706,62555.05831844015,62979.63367934228,62763.712929663845,63291.39978497624,-0.0048913702721845986,-0.0033296580958592547,65750.64882683496,65544.16414529439,16.664188413538497,25.27980156854244,-351.1628921779746,64280.67409840295,64702.236181075925,64081.64197695217,-421.5620826729719,-397.4911306426111,396.11021578624326,-117.35739422086772,-126.91882834531134,-107.07721018236043,64616.3907682636,63545.393185640736,False,True,62863.938,64313.938,63393.938,63363.938,,False,2024-04-25 16:15:00,2024-04-25 16:10:57,2024-04-25 00:20:35,0.02,fail,False,-163.85,23148.37000000017,,0,1,17,April
2024-04-29 00:30:00,63612.406,63637.738,63538.613,63604.039,957,56422,0,2024-04-29 00:00:00,2024-04-29 00:00:00,40.49149999998917,-117.64044354184443,63800.37174999993,0.0008386391673418348,-0.0018083937973500837,63803.72994047621,63755.95670082703,63481.40793333574,63717.159002993234,63595.834013855754,-0.001808270860873378,0.0008666434875813473,64329.1765946681,64052.671676324186,10.912730367321691,24.756828394518504,-104.16303998804871,63766.57484355883,63828.982290467684,63732.86606879942,-62.40744690885185,-44.71156729278509,179.65721364158625,-62.74271276232321,-64.67527003774012,-66.47678740978881,63975.40330721556,63488.82883038328,False,True,62604.039,63134.039,63134.039,63104.039,2024-04-29 02:15:00,True,2024-04-29 02:15:00,2024-04-29 05:40:12,2024-04-29 03:05:18,0.02,even,True,171.08,23319.45000000017,,1,0,18,April
2024-04-30 01:15:00,63117.84,63463.738,63117.398,63463.738,2833,36422,0,2024-04-30 01:00:00,2024-04-30 01:00:00,-25.396904761924816,41.00661362289975,63250.87239285719,0.0001238169702337737,0.0018937283257652391,62955.28125000002,62547.62170051037,64401.48879501295,63304.632442175585,63148.22044320199,-0.00010547608467734572,0.0021391030767434287,63331.4918250564,62966.13386511983,93.54522856995591,84.77653283842825,-74.40837377539113,63019.26527740795,62902.89563470043,63091.75120708637,116.36964270751923,80.29435603821639,178.80457568140187,118.22296250428917,55.598775369813666,53.5409060887323,63334.63738425626,62850.36502991647,True,False,64463.738,63933.738,63933.738,63963.738,2024-04-30 03:45:00,True,2024-04-30 03:45:00,2024-04-30 03:48:04,2024-04-30 04:54:50,0.02,success,True,363.99,23683.440000000173,,2,0,18,April
2024-04-30 01:30:00,63463.738,63857.738,63455.84,63702.383,3076,36422,0,2024-04-30 01:00:00,2024-04-30 01:00:00,-25.396904761924816,41.00661362289975,63250.87239285719,0.0001238169702337737,0.0018937283257652391,62955.28125000002,62547.62170051037,64401.48879501295,63304.632442175585,63148.22044320199,-0.00010547608467734572,0.0021391030767434287,63331.4918250564,62966.13386511983,94.58681204570912,91.12504428940836,-74.40837377539113,63124.36031165288,62962.11692101892,63235.131148606764,162.24339063396474,96.68416295736606,238.8440708800554,143.37994152039755,118.22296250428917,55.598775369813666,63559.070644294836,62912.69165291869,True,False,64702.383,64172.383,64172.383,64202.383,2024-04-30 04:00:00,True,2024-04-30 04:00:00,,2024-04-30 04:27:15,0.02,even,True,171.08,23854.520000000175,,3,0,18,April
2024-04-30 01:45:00,63701.371,63907.738,63696.422,63837.75,2509,36422,0,2024-04-30 01:00:00,2024-04-30 01:00:00,-25.396904761924816,41.00661362289975,63250.87239285719,0.0001238169702337737,0.0018937283257652391,62955.28125000002,62547.62170051037,64401.48879501295,63304.632442175585,63148.22044320199,-0.00010547608467734572,0.0021391030767434287,63331.4918250564,62966.13386511983,94.40314544059622,94.1783953520871,-74.40837377539113,63234.1125713986,63026.97863057307,63394.9250299278,207.13394082552986,118.77411853099882,296.5778985712537,159.79388132103486,143.37994152039755,118.22296250428917,63796.80519299899,62994.54486685661,True,False,64837.75,64307.75,64307.75,64337.75,2024-04-30 04:00:00,True,2024-04-30 04:00:00,,2024-04-30 04:10:44,0.02,even,True,171.08,24025.600000000177,,4,0,18,April
2024-04-30 11:00:00,63104.07,63202.137,62806.84,62806.84,2733,36422,0,2024-04-30 11:00:00,2024-04-30 11:00:00,-161.00157142851094,71.92300423669076,62769.97248809523,-0.003405986187520441,-0.0030322143872077555,63191.11864285715,60939.75904629134,62452.66865927816,62981.55696784978,62638.49879606672,-0.0030324094401722574,-0.0001335030158659058,63342.69219345173,63153.765882055675,16.350882208029173,30.29700382829498,148.51791216766,63235.52544663663,63357.687451345264,63123.52101823187,-122.1620047086326,-74.90073811368603,216.77508820350764,-84.87685483309178,-27.31188338494394,-20.64212074304669,63416.1673873066,62829.37464915714,False,True,61806.84,62336.84,62336.84,62306.84,2024-04-30 11:45:00,True,2024-04-30 11:45:00,2024-04-30 11:57:13,,0.02,success,True,364.0,24389.600000000177,,5,0,18,April
2024-04-30 11:15:00,62806.086,62930.539,62686.676,62713.238,3607,36422,0,2024-04-30 11:00:00,2024-04-30 11:00:00,-161.00157142851094,71.92300423669076,62769.97248809523,-0.003405986187520441,-0.0030322143872077555,63191.11864285715,60939.75904629134,62452.66865927816,62981.55696784978,62638.49879606672,-0.0030324094401722574,-0.0001335030158659058,63342.69219345173,63153.765882055675,5.4712720380407065,17.617920732876254,148.51791216766,63155.173531769455,63309.950454949314,63035.49247678023,-154.7769231798593,-90.87597512692068,256.8358206710917,-88.0285414516402,-84.87685483309178,-27.31188338494394,63382.2208346862,62687.26411887426,False,True,61713.238,62243.238,62243.238,62213.238,2024-04-30 11:45:00,True,2024-04-30 11:45:00,2024-04-30 12:34:42,,0.02,success,True,364.0,24753.600000000177,,6,0,18,April
2024-04-30 11:30:00,62713.238,62720.637,62115.137,62166.539,4934,36422,0,2024-04-30 11:00:00,2024-04-30 11:00:00,-161.00157142851094,71.92300423669076,62769.97248809523,-0.003405986187520441,-0.0030322143872077555,63191.11864285715,60939.75904629134,62452.66865927816,62981.55696784978,62638.49879606672,-0.0030324094401722574,-0.0001335030158659058,63342.69219345173,63153.765882055675,2.472730408905413,8.098294884991768,148.51791216766,63003.07591149723,63225.25331013825,62859.33247884413,-222.17739864101895,-117.13625982974034,349.61311582568777,-176.15999793609808,-88.0285414516402,-84.87685483309178,63331.31018520881,62385.854772479455,False,True,61166.539,61696.539,61696.539,61666.539,2024-04-30 13:00:00,True,2024-04-30 13:00:00,2024-04-30 14:29:45,2024-04-30 13:04:26,0.02,even,True,171.08,24924.68000000018,,7,0,18,April
2024-05-01 11:00:00,57459.238,57552.34,56903.887,57315.539,6246,36422,0,2024-05-01 11:00:00,2024-05-01 11:00:00,-801.8433809524722,-615.2814923076439,58265.97010714291,-0.008098775745035609,-0.0036274695627853994,59048.00489285712,54737.72590233071,58792.11886533325,55377.58244652353,59004.63853485037,-0.0036272145379369933,-0.007379892669455596,61255.40335442572,60177.47658271106,15.198839587879213,19.452738113906317,-465.9477805894979,58639.71824050239,59284.60504071143,58060.33945958035,-644.8868002090385,-358.14589174097046,932.7668190790365,-362.8553914688455,-390.41926659786986,-381.4430309597301,59319.574665337044,56799.60425382365,False,True,56315.539,57765.539,56845.539,56815.539,,False,2024-05-01 20:15:00,,2024-05-01 14:02:08,0.02,fail,False,-163.85,24760.83000000018,,0,1,18,May
2024-05-01 18:30:00,57052.707,57115.738,56896.238,56938.938,3462,36422,0,2024-05-01 18:00:00,2024-05-01 18:00:00,150.75486904761783,-780.5742668881285,57360.78172619045,0.0002919691809226436,0.000811343269287278,57576.56323809523,56699.505791914286,58568.677234322146,57375.98160564076,56730.55707067608,-0.004403921646663986,0.001511951018549492,60321.77394387574,58957.74720600932,16.62653778584132,20.58716892030715,-751.7284658357264,57314.170939330834,57596.13066436086,57134.317023047835,-281.9597250300285,-260.72578841897996,353.25030961692784,-119.88510767114349,-94.88738183687383,-138.0070024079978,57611.204941030686,56655.929105064984,False,True,55938.938,57388.938,56468.938,56438.938,,False,,,2024-05-01 19:30:18,0.02,fail,False,-163.85,24596.98000000018,,0,2,18,May
2024-05-03 16:00:00,60583.898,61219.852,60464.137,61105.871,5076,36422,0,2024-05-03 16:00:00,2024-05-03 16:00:00,475.787892857159,228.8093257573346,60391.74866666672,0.002388923268023507,0.005401199068170541,59638.58669047622,59664.858550864425,63172.22256322664,58865.44847067108,61374.04142369961,0.0027040618107998433,0.00018429573438204743,59220.73119994085,59365.16370485992,95.43791444677929,77.65819182582477,180.13416082286648,59777.709087521325,59527.89111073823,59897.49890780871,249.81797678309522,45.27208448447662,521.5703327839229,328.8955569314785,249.67877158589545,225.10080632951576,60603.118857067006,59193.37895855041,True,False,62105.871,61575.871,61575.871,61605.871,2024-05-03 17:00:00,True,2024-05-03 17:00:00,2024-05-03 17:02:23,2024-05-03 17:07:38,0.02,success,True,364.0,24960.98000000018,,1,0,18,May
2024-05-03 23:15:00,62112.039,62827.84,62112.039,62702.184,4358,56422,0,2024-05-03 23:00:00,2024-05-03 23:00:00,-22.19461904761556,717.0418738593507,62193.302869047664,0.002935177627830158,0.002605052605717039,61909.61219047619,62457.09380298788,63822.210028705544,63080.13608881098,62247.71258499813,0.00013148220458512736,0.0061328474965028365,59879.76806866837,60507.978588150145,89.51178003388095,72.98646781325304,567.1705636396556,61942.85649638109,61592.06134242274,62013.21429102166,350.7951539583519,349.5500169431893,256.80960332740165,158.99438562097203,43.502102511127305,22.71206467148295,62361.40725551365,61666.52132652966,True,False,63702.184,63172.184,63172.184,63202.184,2024-05-06 00:15:00,True,2024-05-06 00:15:00,2024-05-06 00:23:38,2024-05-06 17:59:07,0.02,success,True,363.99,25324.970000000183,,2,0,18,May
2024-05-03 23:30:00,62707.039,62923.207,62640.309,62877.738,3227,56422,0,2024-05-03 23:00:00,2024-05-03 23:00:00,-22.19461904761556,717.0418738593507,62193.302869047664,0.002935177627830158,0.002605052605717039,61909.61219047619,62457.09380298788,63822.210028705544,63080.13608881098,62247.71258499813,0.00013148220458512736,0.0061328474965028365,59879.76806866837,60507.978588150145,93.84973950314459,85.96169527574266,567.1705636396556,62086.684420014775,61687.29665039142,62196.34734399722,399.38776962335396,359.51756747922224,338.7226915907815,183.13305297556508,158.99438562097203,43.502102511127305,62655.12297764478,61739.071710349664,True,False,63877.738,63347.738,63347.738,63377.738,2024-05-06 00:15:00,True,2024-05-06 00:15:00,2024-05-06 02:01:12,2024-05-06 15:54:48,0.02,success,True,363.99,25688.960000000185,,3,0,18,May
2024-05-07 11:15:00,63783.938,64298.34,63766.637,64208.438,3182,36422,0,2024-05-07 11:00:00,2024-05-07 11:00:00,1.2905714285152499,23.363211270545435,63728.5445357143,0.0019163828519729881,0.000994685767721241,63517.326761904726,63890.294941479915,64634.17729711169,63371.718966675726,63726.09786443177,-0.0003129215992594705,0.0011451734818263186,62777.6552033767,63466.43106564496,86.21776032101252,85.14144886002481,11.166569343765083,63698.30249894449,63576.03751711788,63838.678716890274,122.26498182660725,61.68228448011346,262.50518692213984,106.9759982800606,37.24188888885692,-6.071916064705874,64194.56071923516,63484.29671454539,True,False,65208.438,63758.438,64678.438,64708.438,,False,,,2024-05-07 13:19:12,0.02,fail,False,-163.85,25525.110000000186,,0,1,19,May
2024-05-08 02:15:00,62379.938,62403.34,62205.719,62291.039,3047,36422,0,2024-05-08 02:00:00,2024-05-08 02:00:00,-84.79584523811354,-189.07619596484437,62645.20172619047,-0.0017445342312655018,-0.0020640907177720273,62877.598642857134,61758.29881777494,62417.60078640029,62015.80641303746,62372.06082478731,-0.0027479643221551527,-0.0014424596436051506,62999.688280192546,63268.82028065411,18.032017021798566,31.834297544711507,-86.45193275181776,62783.506300565365,62994.28925608631,62674.3674678362,-210.78295552094642,-162.4826263499664,253.13634883018213,-109.79750498800422,-119.5232972136364,-30.94503061580326,63016.10153875695,62331.13339691545,False,True,61291.039,62741.039,61821.039,61791.039,,False,2024-05-08 23:30:00,2024-05-09 01:11:36,2024-05-08 05:23:34,0.02,fail,False,-163.85,25361.260000000188,,0,2,19,May
2024-05-09 00:00:00,61512.121,61602.039,61412.414,61453.738,1748,56422,0,2024-05-09 00:00:00,2024-05-09 00:00:00,-306.3799880952647,-178.95816972754983,61799.38317857142,-0.0014734456638933256,-0.0012332839052212367,62062.336047619036,60919.62921494991,62182.996297360194,61166.358936640776,62638.371439846705,-0.00022702334860935712,-0.0008350436309050932,62577.279534802765,62385.092552096634,8.987097893892502,11.60676662909337,-141.93401632966808,61917.314149654405,62106.92904845672,61710.683372548985,-189.61489880231238,-81.26277286352197,336.3970989340149,-149.74157000340347,-146.52563880293746,-141.2778716890607,62164.81945610991,61255.04728898806,False,True,60453.738,60983.738,60983.738,60953.738,2024-05-09 02:30:00,True,2024-05-09 02:30:00,2024-05-10 19:05:45,2024-05-09 02:30:19,0.02,even,True,171.07,25532.330000000187,,1,0,19,May
2024-05-09 18:15:00,61820.34,62235.637,61618.941,62147.688,3031,36422,0,2024-05-09 18:00:00,2024-05-09 18:00:00,139.84609523806284,-135.19429823690007,61566.59748809526,0.0013716918117616642,0.0019146559282478225,61264.52819047617,61194.020874507645,62718.497663499584,60193.26689908277,61568.27135730342,-4.7369570635831244e-05,-0.0007778157542107302,61961.22940297426,61609.233651809045,89.27126787142076,80.9581184192741,-198.2452394304672,61475.03896431118,61356.30444888124,61615.48049466801,118.73451542994007,19.839534147250543,298.2521921472941,131.6376900584437,107.11636773305509,46.7759356724855,62019.62095406686,61212.84003526916,True,False,63147.688,61697.688,62617.688,62647.688,,False,2024-05-10 01:30:00,2024-05-10 01:47:46,2024-05-09 20:01:14,0.02,fail,False,-163.84,25368.490000000187,,0,1,19,May
2024-05-09 18:45:00,62055.82,62149.438,61883.938,62104.34,3041,36422,0,2024-05-09 18:00:00,2024-05-09 18:00:00,139.84609523806284,-135.19429823690007,61566.59748809526,0.0013716918117616642,0.0019146559282478225,61264.52819047617,61194.020874507645,62718.497663499584,60193.26689908277,61568.27135730342,-4.7369570635831244e-05,-0.0007778157542107302,61961.22940297426,61609.233651809045,90.65821996762111,89.92252473714821,-198.2452394304672,61648.073447820425,61460.0158992466,61822.4901895425,188.05754857382271,75.37215903978154,374.28896321935645,98.60069625044707,108.4089986240433,131.6376900584437,62329.28028988863,61317.20008919637,True,False,63104.34,62574.34,62574.34,62604.34,2024-05-10 00:15:00,True,2024-05-10 00:15:00,2024-05-10 01:47:43,2024-05-10 00:15:08,0.02,even,True,171.07,25539.560000000187,,1,0,19,May
2024-05-09 19:00:00,62104.34,62457.738,62042.738,62395.707,3409,36422,0,2024-05-09 19:00:00,2024-05-09 19:00:00,302.06929761909123,-29.535653866150824,61725.56057142862,0.0025215065012655262,0.0029894409774148195,61566.59748809526,61917.28764517806,63378.334229946064,61194.020874507645,62718.497663499584,0.0019146559282478225,0.0013716918117616642,61955.147347955666,61624.98591966433,91.47252934926148,90.65627856309511,-164.50332231760393,61763.09399430959,61529.32635115426,61974.49103611969,233.76764315532637,107.05125586289051,432.57943200515024,152.0008465771898,98.60069625044707,108.4089986240433,62559.97326932664,61390.50880291274,True,False,63395.707,61945.707,62865.707,62895.707,,False,2024-05-10 01:45:00,2024-05-10 01:52:28,2024-05-09 19:55:03,0.02,fail,False,-163.84,25375.720000000187,,0,1,19,May
2024-05-09 23:00:00,62400.047,62561.738,62328.406,62477.324,2354,36422,0,2024-05-09 23:00:00,2024-05-09 23:00:00,164.67623809519137,168.91944236867857,62392.1773452381,0.0032843526666467933,0.0015919477914537697,62196.324559523804,63075.387823237106,63426.04622249797,62868.001402823895,64019.295586008244,0.003140751699352112,0.0032842407276124546,62002.65205160116,61813.001145228256,80.66540580863419,70.75626768023598,-8.741995990644924,62205.10368181156,61993.94965006094,62240.059966288325,211.15403175062238,195.2537358815726,357.5372765271596,57.26945132443507,55.17361369111313,15.643685930466745,62724.235289599994,61757.384642976656,True,False,63477.324,62947.324,62947.324,62977.324,2024-05-10 02:00:00,True,2024-05-10 02:00:00,,2024-05-10 02:17:27,0.02,even,True,171.07,25546.790000000186,,1,0,19,May
2024-05-09 23:45:00,62450.34,62593.34,62381.961,62551.84,1514,56422,0,2024-05-09 23:00:00,2024-05-09 23:00:00,164.67623809519137,168.91944236867857,62392.1773452381,0.0032843526666467933,0.0015919477914537697,62196.324559523804,63075.387823237106,63426.04622249797,62868.001402823895,64019.295586008244,0.003140751699352112,0.0032842407276124546,62002.65205160116,61813.001145228256,85.7262632385049,84.60657488923766,-8.741995990644924,62306.56388005971,62089.32238491095,62440.82785036114,217.241495148759,203.48840849330693,255.61217532132665,96.77395906431775,72.6016759545164,31.39224905397714,62787.40428704493,62095.751413677346,True,False,63551.84,63021.84,63021.84,63051.84,2024-05-10 02:00:00,True,2024-05-10 02:00:00,,2024-05-10 02:11:41,0.02,even,True,171.07,25717.860000000186,,2,0,19,May
2024-05-10 00:00:00,62550.633,62761.738,62542.324,62607.738,1955,56422,0,2024-05-10 00:00:00,2024-05-10 00:00:00,195.85278571429808,222.81955484128412,62451.591190476174,0.002961303248400761,0.0004533583053326556,62392.1773452381,63112.240025201165,62876.271541638715,63075.387823237106,63426.04622249797,0.0015919477914537697,0.0032843526666467933,62021.067186832486,61865.74009361,88.14612071638841,86.07265379554462,37.57031417574089,62352.898360050516,62127.723541584215,62529.11398727215,225.17481846630108,207.82569048790577,230.96309255123614,88.28613691101054,96.77395906431775,72.6016759545164,62842.414162216315,62217.31381232798,True,False,63607.738,63077.738,63077.738,63107.738,2024-05-10 02:00:00,True,2024-05-10 02:00:00,,2024-05-10 02:08:38,0.02,even,True,171.07,25888.930000000186,,3,0,19,May
2024-05-10 01:30:00,62703.926,62975.039,62611.953,62931.867,2213,36422,0,2024-05-10 01:00:00,2024-05-10 01:00:00,59.4138452380721,245.73744606083346,62733.67330952378,0.002386822261312114,0.0020727250886434768,62451.591190476174,63032.02706157103,63937.740374114124,63112.240025201165,62876.271541638715,0.0004533583053326556,0.002961303248400761,62068.65431676062,61975.24400612121,87.01889407783085,76.5051977032358,79.20374055275941,62538.03213164089,62309.8734450879,62701.93794289646,228.15868655298982,210.23699093743357,281.60869280560263,79.9498145854086,33.47793429654848,27.400298589636805,63083.609678184024,62321.7662076089,True,False,63931.867,62481.867,63401.867,63431.867,,False,,,2024-05-10 17:11:25,0.02,fail,False,-163.84,25725.090000000186,,0,1,19,May
2024-05-10 01:45:00,62928.895,63403.242,62881.84,63234.539,2898,36422,0,2024-05-10 01:00:00,2024-05-10 01:00:00,59.4138452380721,245.73744606083346,62733.67330952378,0.002386822261312114,0.0020727250886434768,62451.591190476174,63032.02706157103,63937.740374114124,63112.240025201165,62876.271541638715,0.0004533583053326556,0.002961303248400761,62068.65431676062,61975.24400612121,90.9416463776966,84.93051764092819,79.20374055275941,62645.18703446537,62378.367189896206,62822.26447884423,266.8198445691669,221.55356166378027,338.06410563069835,120.32653594776639,79.9498145854086,33.47793429654848,63280.15102144567,62365.87793624278,True,False,64234.539,62784.539,63704.539,63734.539,,False,,,2024-05-10 03:16:18,0.02,fail,False,-163.84,25561.250000000186,,0,2,19,May
2024-05-10 17:15:00,62515.637,62584.34,62164.039,62171.738,3390,36422,0,2024-05-10 17:00:00,2024-05-10 17:00:00,-68.29349999999249,168.53532825691946,62357.498678571406,-0.005345024571778654,0.00026570264373165916,63027.03661904762,59343.385358288564,63529.25518360007,62796.32876341107,63512.91595342903,0.0002657416030019386,0.0001607785589027404,62418.83457210145,62560.449097369885,13.401723354493392,16.684562828299246,224.68371852466743,62792.271561089685,62883.28771937748,62745.76903061581,-91.01615828779177,-4.115671282435796,223.17117185705524,-141.6823360852286,-81.97803680774814,-24.26128723767033,63047.050112622834,62442.98794860879,False,True,61171.738,62621.738,61701.738,61671.738,,False,2024-05-10 18:00:00,2024-05-10 17:52:18,2024-05-13 11:13:04,0.02,success,True,363.98,25925.230000000185,,1,0,19,May
2024-05-10 17:30:00,62168.238,62274.438,61684.609,61779.34,4290,36422,0,2024-05-10 17:00:00,2024-05-10 17:00:00,-68.29349999999249,168.53532825691946,62357.498678571406,-0.005345024571778654,0.00026570264373165916,63027.03661904762,59343.385358288564,63529.25518360007,62796.32876341107,63512.91595342903,0.0002657416030019386,0.0001607785589027404,62418.83457210145,62560.449097369885,5.147447066670579,12.577805046234493,224.68371852466743,62636.435936306654,62801.5138142384,62527.403540419706,-165.07787793174793,-36.30811261229823,322.53769592364705,-218.36549019610538,-141.6823360852286,-81.97803680774814,62962.82942991663,62090.47765092278,False,True,60779.34,62229.34,61309.34,61279.34,,False,2024-05-10 18:00:00,2024-05-10 17:54:32,2024-05-13 10:54:03,0.02,success,True,363.98,26289.210000000185,,2,0,19,May
2024-05-10 17:45:00,61764.98,61775.238,60631.938,61016.539,5746,36422,0,2024-05-10 17:00:00,2024-05-10 17:00:00,-68.29349999999249,168.53532825691946,62357.498678571406,-0.005345024571778654,0.00026570264373165916,63027.03661904762,59343.385358288564,63529.25518360007,62796.32876341107,63512.91595342903,0.0002657416030019386,0.0001607785589027404,62418.83457210145,62560.449097369885,6.600055102039626,8.383075174401199,224.68371852466743,62387.22102302871,62669.29345762815,62196.0228403853,-282.07243459943857,-85.46097700972629,495.4811376922847,-331.38070003440225,-218.36549019610538,-141.6823360852286,62864.92237626989,61525.62330450072,False,True,60016.539,60546.539,60546.539,60516.539,2024-05-10 20:30:00,True,2024-05-10 20:30:00,,2024-05-10 20:44:31,0.02,even,True,171.07,26460.280000000184,,3,0,19,May
2024-05-13 10:45:00,61692.848,62407.738,61603.969,62278.34,3076,36422,0,2024-05-13 10:00:00,2024-05-13 10:00:00,108.55994047618151,-163.41432596047525,61467.99639285717,8.458062161090317e-05,0.0014702326338287375,61076.181833333336,60773.75025573423,62779.468554861705,59960.58148974866,61359.88736689209,-0.0006623595714845651,-0.0018190226984068731,61786.50708711366,61525.80935636841,93.78490479515533,89.39901531672574,-244.44093618207205,61471.25320847236,61296.2718164436,61635.31021052626,174.9813920287561,48.762306845620664,349.7461008180047,186.18476883383846,94.03476264186611,109.49662469901523,62108.967446630566,61163.15297442195,True,False,63278.34,62748.34,62748.34,62778.34,2024-05-13 11:45:00,True,2024-05-13 11:45:00,2024-05-13 19:25:51,2024-05-13 11:53:51,0.02,even,True,171.07,26631.350000000184,,4,0,20,May
2024-05-13 11:00:00,62278.184,62635.539,62278.184,62621.637,3796,36422,0,2024-05-13 11:00:00,2024-05-13 11:00:00,391.8145595238311,-20.624709505049395,61964.986559523764,0.0002644468828887658,0.0036158683971656154,61467.99639285717,60845.066030385715,64012.755194533194,60773.75025573423,62779.468554861705,0.0014702326338287375,8.458062161090317e-05,61823.555358207246,61622.243647858944,96.28467841770207,92.72844652959151,-199.67769084666753,61648.235330245836,61394.44701522555,61872.5732077743,253.78831502028333,89.7675084805532,454.18666562536254,237.26299724804267,186.18476883383846,94.03476264186611,62487.22520636854,61259.421209180065,True,False,63621.637,63091.637,63091.637,63121.637,2024-05-13 19:30:00,True,2024-05-13 19:30:00,2024-05-15 15:30:23,2024-05-13 19:41:43,0.02,even,True,171.07,26802.420000000184,,5,0,20,May
2024-05-15 20:15:00,64943.84,65011.238,64737.242,65006.637,1838,36422,0,2024-05-15 20:00:00,2024-05-15 20:00:00,282.3506190477274,732.4929734190955,64883.17896428574,0.007420509266287978,0.004621869377736987,64592.44233333337,66701.16079430943,67067.46982348374,66262.32521198316,67617.4894211048,0.006431626140595266,0.0075258485875786775,62534.20566710137,62982.76040814725,83.91501968606529,80.73986835716148,434.9273244441191,64656.09931532305,64103.60267687406,64998.001530099704,552.496638448989,571.5019163784364,899.0738092563262,38.025040591666766,38.03738665286073,-66.32103611968341,66213.25117259574,63784.25188760366,True,False,66006.637,65476.637,65476.637,65506.637,2024-05-15 22:00:00,True,2024-05-15 22:00:00,2024-05-15 22:40:20,2024-05-15 22:03:33,0.02,even,True,171.07,26973.490000000183,,6,0,20,May
2024-05-15 20:30:00,65000.461,65076.039,64902.602,65047.238,1897,36422,0,2024-05-15 20:00:00,2024-05-15 20:00:00,282.3506190477274,732.4929734190955,64883.17896428574,0.007420509266287978,0.004621869377736987,64592.44233333337,66701.16079430943,67067.46982348374,66262.32521198316,67617.4894211048,0.006431626140595266,0.0075258485875786775,62534.20566710137,62982.76040814725,93.12944745943214,85.8719795219345,434.9273244441191,64716.27449758104,64173.50158969821,65021.0321025112,542.7729078828343,565.7561146793159,853.6021216468797,23.030572411495086,38.025040591666766,38.03738665286073,66174.89496673449,63868.66923828791,True,False,66047.238,65517.238,65517.238,65547.238,2024-05-15 22:00:00,True,2024-05-15 22:00:00,2024-05-15 22:40:20,2024-05-15 22:03:04,0.02,even,True,171.07,27144.560000000183,,7,0,20,May
2024-05-15 21:15:00,65151.34,65312.855,65010.039,65273.039,2420,36422,0,2024-05-15 21:00:00,2024-05-15 21:00:00,290.73663095237134,780.558017302792,65262.59751190472,0.006671370679766368,0.0035593240129978745,64883.17896428574,66696.99427163547,66733.58094784577,66701.16079430943,67067.46982348374,0.004621869377736987,0.007420509266287978,62657.053915450335,63197.48645549547,94.93310253733667,94.60696699669226,504.0534630158537,64888.031776185875,64373.47373119111,65185.33822566215,514.5580449947665,542.2823147047819,615.7804392701337,56.38609700718371,66.34229067766864,41.57773546609678,66018.14181867683,64354.03463264747,True,False,66273.03899999999,65743.03899999999,65743.03899999999,65773.03899999999,2024-05-15 22:30:00,True,2024-05-15 22:30:00,2024-05-15 22:41:09,2024-05-15 23:03:47,0.02,success,True,363.98,27508.540000000183,,8,0,20,May
2024-05-15 21:30:00,65281.238,65423.738,65233.453,65366.738,2466,36422,0,2024-05-15 21:00:00,2024-05-15 21:00:00,290.73663095237134,780.558017302792,65262.59751190472,0.006671370679766368,0.0035593240129978745,64883.17896428574,66696.99427163547,66733.58094784577,66701.16079430943,67067.46982348374,0.004621869377736987,0.007420509266287978,62657.053915450335,63197.48645549547,96.0063543452924,95.3985881976252,504.0534630158537,64961.67888754189,64447.04886221399,65229.07148847609,514.6300253279041,536.7518568294064,504.66786539468717,43.73326281394111,56.38609700718371,66.34229067766864,65911.87310675891,64547.76987019326,True,False,66366.738,65836.738,65836.738,65866.738,2024-05-15 22:45:00,True,2024-05-15 22:45:00,2024-05-16 02:43:23,2024-05-15 22:56:14,0.02,even,True,171.07,27679.610000000182,,9,0,20,May
2024-05-15 22:30:00,65824.516,66364.039,65781.836,66342.734,2795,36421,0,2024-05-15 22:00:00,2024-05-15 22:00:00,379.4185476189814,870.4105780791215,65524.521297619074,0.006469269720674961,0.004466636449754457,65262.59751190472,66994.89893497415,67588.85929587377,66696.99427163547,66733.58094784577,0.0035593240129978745,0.006671370679766368,62785.85329131503,63417.002579055836,90.82659308443215,89.57319543535631,577.3248860285073,65417.47279144641,64823.92514925709,65714.23620536638,593.5476421893181,548.5717939997016,566.8044395668304,219.58994633646216,110.9943839009211,61.80369625039748,66480.9221987816,64949.05021195116,True,False,67342.734,65892.734,66812.734,66842.734,,False,2024-05-17 18:15:00,2024-05-17 18:29:58,2024-05-15 22:55:51,0.02,fail,False,-163.84,27515.770000000182,,0,1,20,May
2024-05-17 18:00:00,66758.109,66901.734,66499.633,66844.734,3318,36421,0,2024-05-17 18:00:00,2024-05-17 18:00:00,151.0316428571823,232.9514039085043,66637.82895238097,-0.0007250219219094773,0.00204401554661565,66345.04140476194,65473.92615217739,67951.25050511114,65647.940058655,67023.45011275251,0.0007630611086143777,-0.0003482330001708967,65372.2978204778,65962.61808838196,87.16072895358953,75.65761717827672,168.69125107278327,66354.4246857148,66225.84721453617,66360.14848366014,128.57747117862164,81.94102796286441,205.4540586040808,123.78570863434288,117.24818163053715,18.833136566943722,66639.01146277566,66082.78550454463,True,False,67844.734,66394.734,67314.734,67344.734,,False,2024-05-20 19:00:00,2024-05-20 19:04:13,2024-05-17 21:04:00,0.02,fail,False,-163.84,27351.930000000182,,0,2,20,May
2024-05-20 08:00:00,67075.992,67251.734,67061.836,67088.133,2155,36421,0,2024-05-20 08:00:00,2024-05-20 08:00:00,258.5676666666841,135.46342181027285,66918.42974999997,0.002130692845344302,0.0017979465020223249,66758.45701190479,67143.2323292788,67750.3900797486,66390.79214083099,67593.0007871723,0.0017442681681945416,0.0008460073445653476,65924.72717165622,66451.43871404293,91.87132484650624,90.92785232846184,129.10254132200433,66757.95925939234,66614.83299536898,66907.80179084968,143.12626402336173,76.95752192928532,278.4409807314339,72.97123942209873,71.98643790853384,70.97478328170837,67285.19711483712,66531.90646686224,True,False,68088.133,66638.133,67558.133,67588.133,,False,2024-05-20 19:30:00,2024-05-20 19:39:53,2024-05-20 09:52:50,0.02,fail,False,-163.84,27188.090000000182,,0,3,21,May
2024-05-20 19:30:00,67772.57,68206.102,67605.766,68200.438,2859,36421,0,2024-05-20 19:00:00,2024-05-20 19:00:00,135.00941666669678,161.49683496945363,67476.37504761906,7.511550924073362e-05,0.0022117465356470576,67122.85822619048,66729.255170613,68831.90126558514,66695.24578389151,67580.4518655188,0.0004438009432580979,-9.647747425458464e-06,66326.39615605057,66842.63149374482,83.88077524584673,80.42832409521753,132.16562891435868,67380.76890472458,67163.00484948931,67545.29106295147,217.76405523526773,101.70565407484236,330.02207326045277,213.58189026487526,141.37875404195802,96.83652975573204,67992.32086185308,67099.76126404986,True,False,69200.438,67750.438,68670.438,68700.438,,False,2024-05-20 22:30:00,2024-05-20 22:23:13,2024-05-23 17:08:13,0.02,success,True,363.98,27552.07000000018,,1,0,21,May
2024-05-20 20:00:00,68143.68,68410.961,67985.836,68343.938,2557,36421,0,2024-05-20 20:00:00,2024-05-20 20:00:00,353.51682142858044,270.6774531652336,67804.25804761903,0.0021675744641108056,0.0026759419098574123,67476.37504761906,67738.21837057974,69342.55677952725,66729.255170613,68831.90126558514,0.0022117465356470576,7.511550924073362e-05,66402.66403228388,66956.91913424522,97.29736088534838,92.02052051590253,159.86799376453368,67628.89516847144,67318.07631403404,67896.63110767114,310.81885443739884,169.31618977762392,457.37712160807285,180.3950853113056,170.94495940837078,213.58189026487526,68515.59022184204,67279.17199350025,True,False,69343.938,67893.938,68813.938,68843.938,,False,2024-05-20 22:30:00,2024-05-20 22:23:56,2024-05-23 16:50:25,0.02,success,True,363.98,27916.05000000018,,2,0,21,May
2024-05-22 13:30:00,70140.938,70233.734,70114.102,70219.039,1356,36421,0,2024-05-22 13:00:00,2024-05-22 13:00:00,63.40304761903826,-46.19880458024272,70038.18432142858,0.0015803546047989865,0.0004888817221934984,69921.15888095235,70343.90487745608,70461.90008069857,70080.88120133636,70124.57157147267,-0.00034670267518436274,0.0013443083343024059,69460.32680174829,69985.8624019766,82.96693583204465,72.11075631571693,-61.30962343555121,70026.76432589011,69974.78712343698,70088.4677963536,51.977202453126665,16.941044078147197,176.0796672461008,53.78775782592129,40.08095287242031,29.022530787653523,70327.67534713582,69850.76024557136,True,False,71219.039,69769.039,70689.039,70719.039,,False,,,2024-05-22 14:59:52,0.02,fail,False,-163.84,27752.21000000018,,0,1,21,May
2024-05-22 14:00:00,70208.438,70302.336,70164.688,70214.453,1590,36421,0,2024-05-22 14:00:00,2024-05-22 14:00:00,117.0254404762236,-11.528555215729284,69986.36819047618,0.0010764350313995116,0.0007826375358616793,70038.18432142858,70059.5869994433,70645.09850428264,70343.90487745608,70461.90008069857,0.0004888817221934984,0.0015803546047989865,69471.76649579738,69967.15652981847,90.86932728737196,87.76632324266221,-51.35340979158683,70079.28933392132,70008.56558868053,70173.49199724797,70.72374524078623,35.0061414392977,141.4384257003629,40.73462951493275,44.28957137944235,53.78775782592129,70365.93387194346,69982.55012255248,True,False,71214.453,69764.453,70684.453,70714.453,,False,,,2024-05-22 14:59:52,0.02,fail,False,-163.84,27588.37000000018,,0,2,21,May
2024-05-22 19:00:00,70469.836,70684.336,70309.445,70684.336,2188,36421,0,2024-05-22 19:00:00,2024-05-22 19:00:00,169.76929761901556,24.265594543190673,70131.3014285714,8.545338318649226e-05,0.001021204698214225,70035.46334523805,69490.03744215917,70996.99747288863,69484.12628099429,70848.20028669696,0.0007595420253614783,8.547707267326263e-05,69574.75627502396,69997.81202691066,92.62838452189142,88.06692387152846,-40.20296070710266,70167.82176743653,70039.50796242061,70255.43848538009,128.31380501591775,26.56818543498279,302.38938452519625,155.09721947029175,124.29514275879774,151.3829074647074,70665.1641544891,69847.21281627107,True,False,71684.336,70234.336,71154.336,71184.336,,False,,,2024-05-22 19:42:29,0.02,fail,False,-163.85,27424.520000000182,,0,3,21,May
2024-05-23 21:00:00,67643.773,67695.734,67053.836,67185.734,3608,36421,0,2024-05-23 21:00:00,2024-05-23 21:00:00,-259.5194761903549,-496.2751720242086,67466.74384523815,-0.003074065158896725,-0.005713584539873286,67701.8643928572,65908.2237721723,66174.33344736221,65821.09470747029,66552.25821225223,-0.005713380587581719,-0.003614045269563934,69193.52294289085,68922.17904532325,19.018810357495575,33.699084598155146,-278.44863645084854,67908.35731087692,68328.02690522357,67784.01831269352,-419.6695943466475,-396.21049740887014,787.6015509474909,-92.4713212934148,18.744087719300296,55.20840488480462,68847.28040647262,66719.25621891441,False,True,66185.734,67635.734,66715.734,66685.734,,False,,2024-05-23 23:00:42,2024-05-23 22:34:58,0.02,fail,False,-163.85,27260.670000000184,,0,4,21,May
2024-05-23 21:15:00,67182.734,67255.336,66747.438,67054.195,3578,36421,0,2024-05-23 21:00:00,2024-05-23 21:00:00,-259.5194761903549,-496.2751720242086,67466.74384523815,-0.003074065158896725,-0.005713584539873286,67701.8643928572,65908.2237721723,66174.33344736221,65821.09470747029,66552.25821225223,-0.005713380587581719,-0.003614045269563934,69193.52294289085,68922.17904532325,11.711444685331529,22.437303819315286,-278.44863645084854,67776.94772458817,68233.66898631811,67624.5599291365,-456.7212617299374,-408.3126502730836,759.5298537093965,-159.45838355700835,-92.4713212934148,18.744087719300296,68649.92523164419,66597.69462662883,False,True,66054.195,67504.195,66584.195,66554.195,,False,,,2024-05-23 22:30:56,0.02,fail,False,-163.85,27096.820000000185,,0,5,21,May
2024-05-27 04:15:00,68745.648,68816.938,68741.234,68786.734,797,36421,0,2024-05-27 04:00:00,2024-05-27 04:00:00,-9.661059523830772,239.61338346617413,68750.03817857141,7.293064769422992e-05,0.00015813919032140334,68631.77021428567,68166.2116986378,69358.76196851571,67673.56791536848,68460.7778197626,-0.0013087212905757352,-0.0009327716721319096,68435.294751516,68350.42139902232,91.10591171133366,90.72475290303043,194.79261183867874,68669.54892678437,68614.52419408041,68687.12041038868,55.024732703954214,48.0368913465243,202.3440004286445,56.75162263496895,59.74186446508975,68.41951943591994,68961.78481096735,68413.95600981002,True,False,69786.734,68336.734,69256.734,69286.734,,False,2024-05-27 18:00:00,2024-05-27 18:06:07,2024-05-27 08:30:27,0.02,fail,False,-163.85,26932.970000000187,,0,6,22,May
2024-05-27 08:15:00,68733.141,68752.141,68351.961,68356.734,1418,36421,0,2024-05-27 08:00:00,2024-05-27 08:00:00,-1.735059523867676,227.01546440311358,68820.69372619041,-6.461761188891532e-05,9.758987879965515e-05,68942.29422619042,68290.89174916084,69368.38512638811,69125.66115143942,70105.66443834048,0.0015922596631320922,0.001308160183685637,68491.00328662788,68478.46554719182,1.761354171136423,6.146840597101227,230.39033013151808,68786.6387196495,68797.08723480382,68751.45700550392,-10.448515154319466,61.85156210226187,246.45788136940396,-121.11822944616142,-60.66160130723438,-66.0061778465606,69084.17514535262,68417.23886565522,False,True,67356.734,68806.734,67886.734,67856.734,,False,2024-05-28 06:45:00,2024-05-28 21:36:53,2024-05-27 11:11:37,0.02,fail,False,-163.85,26769.120000000188,,0,7,22,May
2024-05-27 18:00:00,69530.336,69931.734,69524.016,69907.234,2480,36421,0,2024-05-27 18:00:00,2024-05-27 18:00:00,276.5807738095318,152.07538964474224,69511.25061904767,0.0017921115127149912,0.0033431355500743052,68976.48598809521,69266.19130564785,71555.35716820895,68406.41031261989,69942.94731800962,0.0014310541377728504,0.00030023228366537704,68636.42455648308,68769.46449572229,93.91458323703789,89.60424092834853,98.47458221103294,69106.70660826164,68885.2612065583,69321.67588235295,221.4454017033422,99.3151884281896,362.7593909505726,193.78796525626967,135.74607430344622,85.88820571034739,69812.90106013622,68831.95070456968,True,False,70907.234,70377.234,70377.234,70407.234,2024-05-27 19:15:00,True,2024-05-27 19:15:00,,2024-05-27 19:33:46,0.02,even,True,171.07,26940.190000000188,,1,0,22,May
2024-05-27 19:00:00,70403.234,70671.539,70393.852,70583.438,2379,36421,0,2024-05-27 19:00:00,2024-05-27 19:00:00,534.7646309524571,305.8607426538074,69875.93079761903,0.0034616216325448965,0.0045442475325270515,69511.25061904767,70325.35871708626,72240.5988916812,69266.19130564785,71555.35716820895,0.0033431355500743052,0.0017921115127149912,68698.00167191512,68884.43861606451,93.1550390145665,90.68491203590754,139.95181429958785,69702.52355749304,69260.95981900125,70154.09980976951,441.56373849179363,259.88432356556524,674.6945880523554,210.5120381837187,216.92288923282467,247.72475679397758,71066.43750364019,69243.26211589883,True,False,71583.438,70133.438,71053.438,71083.438,,False,,,2024-05-27 20:23:11,0.02,fail,False,-163.84,26776.350000000188,,0,1,22,May
2024-05-29 11:00:00,67979.641,68027.836,67658.844,67792.141,2225,36421,0,2024-05-29 11:00:00,2024-05-29 11:00:00,-250.36777380952844,10.450371108061518,68214.59440476193,-0.0014807931973505196,-0.0012599296471441693,68451.82441666666,67206.81482113992,68248.24866960503,67767.04519567318,68958.9969705629,1.579649302785503e-05,-0.0006818700096740069,68497.43721641808,68416.09220196688,9.383222346959577,9.455653055128714,45.715409498248626,68323.42221226126,68470.60435051227,68136.05738871689,-147.18213825100975,-40.86875623179696,299.59556491559476,-130.11309150318266,-118.5013770210935,-74.40321018232498,68540.51140135294,67730.10337608084,False,True,66792.141,68242.141,67322.141,67292.141,,False,2024-05-29 19:15:00,2024-05-31 19:18:04,2024-05-29 16:14:14,0.02,fail,False,-163.84,26612.510000000188,,0,2,22,May
2024-05-29 18:45:00,67462.227,67600.438,67302.961,67402.836,2341,36421,0,2024-05-29 18:00:00,2024-05-29 18:00:00,-38.624940476205666,-173.29014814313268,67665.25895238093,-0.0006658421644156255,0.0006857491304308933,67814.34455952374,67119.3024033036,68598.35730170073,67473.75414505006,68094.13975879192,-0.0006193641929056327,-0.00021103271595188447,68325.11387417345,68133.7207113563,17.868930510731342,18.476665517142106,-99.47017635630232,67680.76922119208,67832.56590873316,67594.64634124523,-151.79668754107843,-122.08713726837601,182.80421361050725,-67.61672170623206,-66.6059453044727,-17.320156518777367,67841.43202961942,67346.36065287104,False,True,66402.836,67852.836,66932.836,66902.836,,False,2024-05-31 19:15:00,,2024-05-30 01:24:12,0.02,fail,False,-163.84,26448.670000000187,,0,3,22,May
2024-05-29 19:00:00,67402.836,67421.938,67111.227,67231.836,2629,36421,0,2024-05-29 19:00:00,2024-05-29 19:00:00,-149.0856071428134,-214.5100582070736,67597.58432142861,-0.0012572962481406103,-0.0001012972262069485,67665.25895238093,66764.39708827695,68261.88299828267,67119.3024033036,68598.35730170073,0.0006857491304308933,-0.0006658421644156255,68295.86031048038,68089.35489444781,10.065077706893105,15.281952124139005,-122.47815272645659,67611.70257177792,67788.06739697515,67500.1406040591,-176.36482519723359,-132.94267485414753,218.3113314905268,-94.50573718613305,-67.61672170623206,-66.6059453044727,67794.8609015713,67203.92030654689,False,True,66231.836,67681.836,66761.836,66731.836,,False,,,2024-05-29 19:46:01,0.02,fail,False,-163.84,26284.830000000187,,0,4,22,May
2024-05-30 14:15:00,67988.039,68135.836,67870.0,68109.109,1711,36421,0,2024-05-30 14:00:00,2024-05-30 14:00:00,15.88260714293574,2.5087294999684673,67777.10351190479,-0.0014312644238067352,-0.0006690666776401657,67775.8368452381,66467.56033404682,67947.40053625077,66199.38351379528,67728.63282036869,-0.0010534727448349753,-0.0023243477468021536,68027.9384695795,67871.38059678362,91.77897929704231,86.07304592331356,-10.642959169778685,67848.38235669854,67827.48258487259,67860.53134778123,20.899771825948847,-31.924574615506042,238.4167675569036,84.51013381492521,73.53179738561448,63.87539972482773,68183.89398398306,67538.6687115794,True,False,69109.109,68579.109,68579.109,68609.109,2024-05-30 17:00:00,True,2024-05-30 17:00:00,2024-05-30 20:23:25,2024-05-30 17:03:09,0.02,even,True,171.07,26455.900000000187,,1,0,22,May
2024-05-30 15:30:00,68046.336,68303.039,67881.914,68245.234,3022,36421,0,2024-05-30 15:00:00,2024-05-30 15:00:00,1.26666666669189,0.9893794060917571,67911.45511904759,0.0005499097297048975,0.00029215287253217445,67777.10351190479,67449.6994662608,68441.66405396732,66467.56033404682,67947.40053625077,-0.0006690666776401657,-0.0014312644238067352,68033.04503939992,67894.32262904094,85.1566114142525,77.7183362125315,-8.316491454604597,67960.3867545541,67892.91777068697,68099.0059325766,67.46898386713292,19.545927490523606,234.2613765407485,38.703976608259836,44.33066838658124,67.8449786722922,68416.75879090662,67782.75307424659,True,False,69245.234,68715.234,68715.234,68745.234,2024-05-30 20:15:00,True,2024-05-30 20:15:00,2024-05-30 20:36:31,2024-05-30 22:37:28,0.02,success,True,363.99,26819.89000000019,,2,0,22,May
2024-05-31 17:15:00,67836.039,67981.438,67691.836,67784.688,2951,36421,0,2024-05-31 17:00:00,2024-05-31 17:00:00,-46.08166666665056,-31.81138302803447,68076.4267380952,-0.0017447568928099489,0.001782451915293505,68319.0125,66797.67481849613,69819.24748026459,68088.56222118264,69548.3371598794,0.001368992515025173,0.00035895391804117473,68267.72506589738,68276.9643801446,5.672418158017261,19.013724284545802,-12.149016029520386,68273.41797092685,68327.15066101613,68328.54305366357,-53.73269008928037,18.256187786687654,277.69988426836534,-149.05846130021382,-137.7020856554591,-91.01336016507412,68703.43789742586,67952.14820990128,False,True,66784.688,67314.688,67314.688,67284.688,2024-05-31 19:00:00,True,2024-05-31 19:00:00,2024-05-31 19:18:04,2024-05-31 19:00:55,0.02,even,True,171.07,26990.96000000019,,3,0,22,May
2024-05-31 17:30:00,67781.836,67880.836,67362.039,67365.141,2802,36421,0,2024-05-31 17:00:00,2024-05-31 17:00:00,-46.08166666665056,-31.81138302803447,68076.4267380952,-0.0017447568928099489,0.001782451915293505,68319.0125,66797.67481849613,69819.24748026459,68088.56222118264,69548.3371598794,0.001368992515025173,0.00035895391804117473,68267.72506589738,68276.9643801446,3.697693824546851,8.05609484430649,-12.149016029520386,68133.68305232273,68255.89068612605,68127.66096800825,-122.2076338033221,-9.836576531314297,334.52722507816026,-200.88208565532113,-149.05846130021382,-137.7020856554591,68579.27272186376,67674.54921415274,False,True,66365.141,66895.141,66895.141,66865.141,2024-05-31 19:15:00,True,2024-05-31 19:15:00,,2024-05-31 19:15:23,0.02,even,True,171.07,27162.030000000188,,4,0,22,May
2024-06-03 04:45:00,68188.172,68601.438,68175.453,68503.234,1878,36421,0,2024-06-03 04:00:00,2024-06-03 04:00:00,15.993392857097206,-79.4513258827501,68101.16863095232,0.001058070122063169,0.0013912548429991349,67883.06966666666,67991.64980297165,68996.55453288321,67919.07887979248,68104.70876429063,0.00011941369812555651,0.001058157462587307,68076.53035564342,67975.44535691295,83.17441925821545,79.24748437820556,-139.84837921271333,68048.71938023056,67914.37149233505,68101.4970732714,134.34788789550657,78.59247655089581,199.35556481977397,104.10298039217014,54.90372205020685,57.3344341244665,68372.12708577809,67832.3670607647,True,False,69503.234,68973.234,68973.234,69003.234,2024-06-03 09:30:00,True,2024-06-03 09:30:00,2024-06-03 15:30:46,2024-06-03 10:25:02,0.02,even,True,171.07,27333.100000000188,,5,0,23,June
2024-06-03 05:00:00,68503.234,68762.438,68503.234,68715.734,2066,36421,0,2024-06-03 05:00:00,2024-06-03 05:00:00,218.09896428565844,9.611557821845054,68241.78445238093,0.0007626130357378878,0.0016697370945032751,68101.16863095232,67940.32650961255,69306.45845984781,67991.64980297165,68996.55453288321,0.0013912548429991349,0.001058070122063169,68090.86802797114,68012.78100835992,87.36759141846795,83.73024259958713,-109.95639180580166,68151.33701404124,67973.731678088,68238.44342414863,177.60533595323795,98.39504843136424,253.3099179281934,136.94635087723145,104.10298039217014,54.90372205020685,68581.91181335169,67896.47503494557,True,False,69715.734,68265.734,69185.734,69215.734,,False,2024-06-03 11:30:00,2024-06-03 15:39:56,2024-06-03 06:04:01,0.02,fail,False,-163.84,27169.260000000188,,0,1,23,June
2024-06-03 09:15:00,68855.797,69130.336,68767.438,69130.336,1854,36421,0,2024-06-03 09:00:00,2024-06-03 09:00:00,139.35941666668805,172.68307113315677,68820.73459523807,0.002499120840561801,0.0017922496680140357,68597.37405952379,69359.34205093862,69841.62938801033,69167.00118353644,69989.71922310504,0.0023413723032006508,0.002470123261930885,68181.15886760526,68211.5016958834,93.3037998295489,88.5220482446692,29.515681762977557,68667.06228920267,68445.3569873972,68734.33231888546,221.70530180547212,180.99033851110346,334.7718160886237,109.37084210524336,41.01997007225873,28.365664946759352,69187.77427060509,68282.39036716582,True,False,70130.336,69600.336,69600.336,69630.336,2024-06-03 15:45:00,True,2024-06-03 15:45:00,2024-06-03 16:45:52,2024-06-03 15:46:40,0.02,even,True,171.07,27340.330000000187,,1,0,23,June
2024-06-03 09:30:00,69130.336,69236.734,68982.938,69186.789,2049,36421,0,2024-06-03 09:00:00,2024-06-03 09:00:00,139.35941666668805,172.68307113315677,68820.73459523807,0.002499120840561801,0.0017922496680140357,68597.37405952379,69359.34205093862,69841.62938801033,69167.00118353644,69989.71922310504,0.0023413723032006508,0.002470123261930885,68181.15886760526,68211.5016958834,96.10584809505356,93.40676326610186,29.515681762977557,68747.02024470996,68500.27787721963,68864.00444822838,246.7423674903257,194.1407443069479,332.4156859776492,129.6721293429291,109.37084210524336,41.01997007225873,69314.2656242982,68415.24327215856,True,False,70186.789,69656.789,69656.789,69686.789,2024-06-03 16:00:00,True,2024-06-03 16:00:00,2024-06-03 16:46:28,2024-06-03 16:03:04,0.02,even,True,171.07,27511.400000000187,,2,0,23,June
2024-06-03 11:15:00,69059.734,69325.039,69059.734,69294.438,1585,36421,0,2024-06-03 11:00:00,2024-06-03 11:00:00,81.43035714281723,258.18486876359384,68999.5622619048,0.002297954734716865,0.0014715895015137924,68902.16495238089,69594.15033448456,69864.93521666712,69532.48490956344,69761.91336034764,0.0014716730825866811,0.0024990823768586377,68247.79478705123,68340.32937779572,80.09879726259018,72.22282620188001,108.38979687013016,68968.57072176135,68732.68191484571,69194.29258617133,235.88880691563827,227.348272925945,309.7396928337746,63.14349088410381,32.50560749915894,7.316216718187206,69613.94117149693,68776.14400084573,True,False,70294.438,69764.438,69764.438,69794.438,2024-06-03 16:45:00,True,2024-06-03 16:45:00,2024-06-03 16:49:32,2024-06-03 17:02:06,0.02,success,True,363.99,27875.39000000019,,3,0,23,June
2024-06-03 11:30:00,69294.438,69366.734,69246.719,69318.734,1873,36421,0,2024-06-03 11:00:00,2024-06-03 11:00:00,81.43035714281723,258.18486876359384,68999.5622619048,0.002297954734716865,0.0014715895015137924,68902.16495238089,69594.15033448456,69864.93521666712,69532.48490956344,69761.91336034764,0.0014716730825866811,0.0024990823768586377,68247.79478705123,68340.32937779572,89.68790587892147,80.1222424442165,108.38979687013016,69022.44199533653,68776.09318041269,69243.2943147575,246.3488149238401,231.14838132552404,331.4032763758541,49.00172858616861,63.14349088410381,32.50560749915894,69692.1887378649,68795.8998916501,True,False,70318.734,68868.734,69788.734,69818.734,,False,2024-06-03 16:45:00,2024-06-04 18:50:46,2024-06-03 14:02:49,0.02,fail,False,-163.84,27711.55000000019,,0,1,23,June
2024-06-04 21:15:00,70776.734,71103.563,70776.734,70960.734,2149,36421,0,2024-06-04 21:00:00,2024-06-04 21:00:00,245.9138214285631,400.5028463396884,70717.41627380946,0.003782798257200893,0.005498500174078739,70511.3521904762,71383.65671254623,73490.58442983475,71067.19411485313,72862.43203288951,0.004903081566700834,0.0036768574747102238,69131.14632291303,69517.26264951249,82.5911299405159,75.21977283322614,174.50669824619902,70553.87467089266,70156.14834426626,70921.39501788784,397.72632662640535,384.64595172976334,649.0751863396305,57.15429618152848,43.21389748888032,15.226939112559194,71799.14651944634,70045.14351632935,True,False,71960.734,70510.734,71430.734,71460.734,,False,2024-06-05 18:30:00,2024-06-07 15:04:12,2024-06-04 22:29:12,0.02,fail,False,-163.84,27547.71000000019,,0,2,23,June
2024-06-06 23:00:00,70507.555,70518.641,70074.133,70424.641,2021,36421,0,2024-06-06 23:00:00,2024-06-06 23:00:00,-227.42748809524346,-55.49284500509384,70802.3150714286,-0.001890129754017408,-0.002054160693781035,70909.6387142857,69524.41614778925,70358.5344009166,70120.85764058075,70951.58668858952,-0.0012784165037186524,-0.00120601765755709,70789.90055016705,71018.98747630615,19.90972238235592,20.40267273892215,11.063209409036931,70854.20959334553,70995.03116863167,70748.5306105951,-140.82157528614334,-70.24481322821259,282.431584466631,-72.34180839352484,-62.72189955275098,-44.87598658417119,71129.81324962505,70365.74797156516,False,True,69424.641,70874.641,69954.641,69924.641,,False,2024-06-07 21:00:00,2024-06-07 21:04:22,2024-06-07 01:56:00,0.02,fail,False,-163.84,27383.870000000188,,0,3,23,June
2024-06-07 07:00:00,71012.539,71230.539,71010.836,71198.836,1233,36421,0,2024-06-07 07:00:00,2024-06-07 07:00:00,33.02452380952309,-38.73213189668604,71033.56444047616,8.839415605488158e-05,0.0008226123075428024,70924.74526190475,70720.41903180955,71525.38445531331,71168.18129107406,71121.77377772731,0.00026191665603856587,0.0013868587806663306,70827.76624838656,70980.17439032668,87.00032698044585,84.90008346906103,-50.65727221392941,70933.64238115387,70890.6836748783,70963.53787891295,42.958706275574514,2.5763655662376284,99.40758139065905,64.71617750257428,30.941499139968073,26.88222497420793,71099.23811379034,70829.33764403555,True,False,72198.836,71668.836,71668.836,71698.836,2024-06-07 15:00:00,True,2024-06-07 15:00:00,,2024-06-07 15:24:10,0.02,even,True,171.07,27554.940000000188,,1,0,23,June
2024-06-07 13:00:00,71313.336,71396.734,71288.0,71376.141,742,36421,0,2024-06-07 13:00:00,2024-06-07 13:00:00,35.07441666669911,69.48107360432914,71296.1431666667,0.0007641914883656554,-4.764415269672365e-06,71264.30648809523,71363.92720225615,71454.61010685287,71322.1094730675,71674.4327802697,0.0003703994729077727,0.0008069688603382157,70920.34853472223,71091.89700752187,81.59158516539925,64.52203856200721,25.644916019218016,71231.06493874882,71173.09632060699,71218.2073904369,57.96861814183649,53.882960835311835,77.26275523528192,43.80010939114436,27.94947712426074,1.7759267285000533,71324.01211000454,71113.90267086927,True,False,72376.141,71846.141,71846.141,71876.141,2024-06-07 15:15:00,True,2024-06-07 15:15:00,,2024-06-07 15:22:10,0.02,even,True,171.07,27726.010000000188,,2,0,23,June
2024-06-07 14:45:00,71557.938,71749.305,71557.938,71731.734,1487,36421,0,2024-06-07 14:00:00,2024-06-07 14:00:00,31.836678571475204,86.92001950454141,71434.63255952376,0.0001970739400195022,0.0006803155309824207,71296.1431666667,71168.16479798657,71953.66394417868,71363.92720225615,71454.61010685287,-4.764415269672365e-06,0.0007641914883656554,70952.16757257626,71143.08396692012,91.17960238124893,85.88382894684435,37.899936716282696,71406.11034980514,71292.75179164273,71500.32611592706,113.35855816240655,77.49805734701808,142.6328169379802,89.80949432410125,55.55494530434953,38.086945304399705,71694.38041879334,71307.77181306078,True,False,72731.734,71281.734,72201.734,72231.734,,False,,,2024-06-07 15:30:10,0.02,fail,False,-163.84,27562.170000000187,,0,1,23,June
2024-06-07 15:00:00,71731.734,71981.734,71726.641,71905.938,2289,36421,0,2024-06-07 15:00:00,2024-06-07 15:00:00,138.48939285705274,135.21573470706062,71401.08713095236,-0.0010616003953528594,0.0011496654518415284,71434.63255952376,70337.4743557123,72380.91241103355,71168.16479798657,71953.66394417868,0.0006803155309824207,0.0001970739400195022,70963.84880502426,71151.6403695665,91.27971930323292,88.7297413509076,57.36309631443828,71483.00691137358,71338.1729922618,71602.15821121431,144.83391911178478,90.96522969997142,189.77724018441492,101.83209528724547,89.80949432410125,55.55494530434953,71859.85748546326,71345.95893696535,True,False,72905.938,71455.938,72375.938,72405.938,,False,,,2024-06-07 15:30:10,0.02,fail,False,-163.84,27398.330000000187,,0,2,23,June
2024-06-07 20:30:00,70465.539,70555.641,70261.938,70286.836,1768,36421,0,2024-06-07 20:00:00,2024-06-07 20:00:00,-187.9939285715227,24.407475151499966,70689.42297619041,-0.002400979660958412,-0.002440942535670198,71200.01963095235,69114.04856000168,70442.7554198038,70595.15137211379,71535.94652922654,-0.0008500240826311112,-9.478719961522429e-05,70959.33576045292,71066.96448147712,4.151619654406383,8.189966270161625,74.290441566507,70889.16169964884,71089.09148442691,70679.3634183007,-199.929784778069,-93.3846708158921,397.23943386404363,-165.88655658751668,-140.92082628136268,-124.99773856210231,71215.63665401716,70141.59018258423,False,True,69286.836,70736.836,69816.836,69786.836,,False,2024-06-07 21:15:00,2024-06-07 21:04:39,,0.02,success,True,363.98,27762.310000000187,,1,0,23,June
2024-06-07 20:45:00,70281.938,70415.938,69806.141,69819.438,2038,36421,0,2024-06-07 20:00:00,2024-06-07 20:00:00,-187.9939285715227,24.407475151499966,70689.42297619041,-0.002400979660958412,-0.002440942535670198,71200.01963095235,69114.04856000168,70442.7554198038,70595.15137211379,71535.94652922654,-0.0008500240826311112,-9.478719961522429e-05,70959.33576045292,71066.96448147712,3.4132123614608427,5.0621525970816235,74.290441566507,70724.5888227798,70995.04307817307,70456.76288269692,-270.4542553932697,-128.7985877313676,482.8558099336198,-222.60053560377855,-165.88655658751668,-140.92082628136268,71108.6182261073,69803.40753928653,False,True,68819.438,70269.438,69349.438,69319.438,,False,2024-06-07 21:15:00,2024-06-07 21:14:15,,0.02,success,True,363.98,28126.290000000186,,2,0,23,June
2024-06-07 21:00:00,69814.359,69906.539,68385.008,68530.594,6368,36421,0,2024-06-07 21:00:00,2024-06-07 21:00:00,-510.59665476193186,-135.30893049958104,70061.13339285717,-0.005431412620533212,-0.0029204422151790184,70689.42297619041,66862.8979986642,69969.56687268548,69114.04856000168,70442.7554198038,-0.002440942535670198,-0.002400979660958412,70889.10047572928,70915.07420295896,2.4013478413290383,3.322059952398721,32.3705671532894,70387.05115773674,70812.4912946047,70033.14157619535,-425.4401368679537,-188.12689755868485,703.0407955380913,-423.6213065015618,-222.60053560377855,-165.88655658751668,70982.24665017177,69082.53650221894,False,True,67530.594,68980.594,68060.594,68030.594,,False,2024-06-11 07:30:00,2024-06-11 09:56:40,2024-06-07 21:15:44,0.02,fail,False,-163.85,27962.440000000188,,0,1,23,June
2024-06-11 04:45:00,69389.117,69453.438,68481.836,68723.234,2935,36421,0,2024-06-11 04:00:00,2024-06-11 04:00:00,-52.159976190450834,-62.85158267999941,69217.31329761907,-0.002217529352473519,-0.0012247113307705649,69464.50908333335,67856.33534738098,69196.67854075738,68797.6899095059,69192.00048758573,-0.0013517956194379834,-0.000950411590227924,69939.22028066432,69636.13354787562,18.449353126528322,27.869001470099715,-48.29178991180699,69371.09709009975,69486.56217457484,69309.45438906089,-115.46508447508677,-65.87510622038602,176.48392541684984,-142.61662229101057,-11.539972824219149,-6.847174406633712,69547.70768837364,69069.70108974814,False,True,67723.234,68253.234,68253.234,68223.234,2024-06-11 05:30:00,True,2024-06-11 05:30:00,2024-06-11 07:26:30,2024-06-11 05:47:06,0.02,even,True,171.07,28133.510000000188,,1,0,24,June
2024-06-11 05:00:00,68721.836,68956.242,68521.422,68551.836,2442,36421,0,2024-06-11 05:00:00,2024-06-11 05:00:00,-247.19578571428428,-151.31487400707556,68870.62501190482,-0.0031980290148590656,-0.0007361664303014424,69217.31329761907,66971.99737962885,69286.01732020106,67856.33534738098,69196.67854075738,-0.0012247113307705649,-0.002217529352473519,69873.66815201082,69526.65414404558,9.722957484135154,19.379427060027968,-68.8964067308607,69245.05692239209,69417.3231986804,69151.7280894393,-172.26627628831193,-87.15334023397119,257.9140994034272,-157.7262996215868,-142.61662229101057,-11.539972824219149,69499.91212363393,68802.04405524468,False,True,67551.836,68081.836,68081.836,68051.836,2024-06-11 07:15:00,True,2024-06-11 07:15:00,2024-06-11 09:56:40,2024-06-11 07:15:40,0.02,even,True,171.07,28304.580000000187,,2,0,24,June
2024-06-11 12:30:00,67385.836,67440.336,67160.406,67205.688,1962,36421,0,2024-06-11 12:00:00,2024-06-11 12:00:00,-78.40727380960016,-539.5584986022732,67381.2255714286,-0.002104189784228683,-0.002685751318368473,67593.09497619045,66294.10487850747,66928.41205201046,66452.10904303506,66552.58852520859,-0.003959301021255084,-0.0020755318987075787,69347.22670690548,68712.32534859203,19.29294877842869,28.874654215433953,-377.167177130609,67544.16854399719,67845.19051859392,67397.5791320949,-301.02197459673334,-312.1212625016122,293.134537324415,-68.81281286549347,-33.9985565875686,-7.725299277633894,67793.31075748286,67000.34750670695,False,True,66205.688,67655.688,66735.688,66705.688,,False,2024-06-11 18:45:00,2024-06-11 18:44:55,2024-06-12 12:54:30,0.02,success,True,363.98,28668.560000000187,,3,0,24,June
2024-06-11 12:45:00,67205.844,67261.938,66869.836,67082.039,2488,36421,0,2024-06-11 12:00:00,2024-06-11 12:00:00,-78.40727380960016,-539.5584986022732,67381.2255714286,-0.002104189784228683,-0.002685751318368473,67593.09497619045,66294.10487850747,66928.41205201046,66452.10904303506,66552.58852520859,-0.003959301021255084,-0.0020755318987075787,69347.22670690548,68712.32534859203,14.176575723144007,20.661702634175132,-377.167177130609,67473.07169107454,67788.66077647585,67313.23104987961,-315.58908540131233,-312.8148270815522,300.58789504989164,-84.34808221529238,-68.81281286549347,-33.9985565875686,67719.02470819697,66905.93739156226,False,True,66082.039,67532.039,66612.039,66582.039,,False,2024-06-11 18:45:00,2024-06-11 18:44:57,2024-06-11 22:54:08,0.02,success,True,363.98,29032.540000000186,,4,0,24,June
2024-06-12 16:00:00,69316.203,69641.039,69314.758,69361.539,2264,36421,0,2024-06-12 16:00:00,2024-06-12 16:00:00,587.3636428571481,290.294898885797,68774.16185714286,0.0019461681690739,0.005097564121652901,68336.28533333335,68403.78480152688,71316.28885005425,68270.77493174604,70667.929494164,0.004124108894411488,0.001946016244130374,68117.83485975498,67806.41860604023,92.19762306022467,89.79681337522526,62.996131272477086,68400.92833876997,68000.86259240091,68710.14643412453,400.0657463690586,225.3998671600619,612.6178875892354,229.62223907806037,247.97597110428615,305.1081974544795,69538.68058237,67883.11228587906,True,False,70361.539,69831.539,69831.539,69861.539,2024-06-12 18:00:00,True,2024-06-12 18:00:00,,2024-06-12 18:05:42,0.02,even,True,171.07,29203.610000000186,,5,0,24,June
2024-06-13 05:00:00,67963.734,67987.039,67826.914,67898.234,1735,36421,0,2024-06-13 05:00:00,2024-06-13 05:00:00,28.830595238134265,-23.676673737558303,68091.87236904757,0.00100233868809913,-0.0020651030907272027,68171.65545238099,67950.70938433045,67632.20427606675,68337.40455775711,67520.97855655484,-0.0029627393645750414,0.0016613402393691233,68296.99347106724,68241.56712269303,19.395007563988667,24.675871333778858,145.67113940652828,68131.9834806573,68282.4942050624,68044.41103921572,-150.5107244050887,-144.3339763276341,187.9816418157074,-37.0598290333146,-45.87491159274941,-37.92871138625196,68298.18625566692,67789.13582276451,False,True,66898.234,67428.234,67428.234,67398.234,2024-06-13 06:45:00,True,2024-06-13 06:45:00,2024-06-13 18:32:46,2024-06-13 06:59:10,0.02,even,True,171.07,29374.680000000186,,6,0,24,June
2024-06-13 06:15:00,67823.539,67837.734,67401.859,67419.141,2362,36421,0,2024-06-13 06:00:00,2024-06-13 06:00:00,-79.78308333341556,-88.07191684603458,67799.63284523813,-0.0009417316379869596,-0.001066225404568786,68091.87236904757,66680.29788021519,67907.63383082482,67950.70938433045,67632.20427606675,-0.0020651030907272027,0.00100233868809913,68263.89325651558,68178.4767928776,12.176444547089387,17.769098916730673,98.92252815601572,67908.01294869372,68115.92648072948,67789.79382524939,-207.91353203576,-166.1585697827286,256.3607477725062,-106.22973099420778,-43.33565015481145,-67.94781286544458,68135.88083474227,67442.20681575651,False,True,66419.141,67869.141,66949.141,66919.141,,False,2024-06-13 18:45:00,2024-06-13 18:56:52,2024-06-13 13:55:17,0.02,fail,False,-163.84,29210.840000000186,,0,1,24,June
2024-06-13 18:30:00,66957.039,67025.641,66496.039,66587.141,2874,36421,0,2024-06-13 18:00:00,2024-06-13 18:00:00,-111.7354642857099,-149.685643864781,67180.57990476192,-0.0020310928574881963,0.0010344519276742421,67551.42866666667,65786.59803898218,69079.6302752558,67099.84599267748,69646.77733022097,0.002537866907844121,-8.192344401142167e-05,67953.62518429046,67701.99286247145,6.233828652041318,11.19509121489961,-146.23392774260248,67312.86236078292,67479.60521714167,67150.01988132099,-166.74285635874548,-56.505783091445586,344.2722826441809,-180.77707911928883,-126.14027382187487,-91.34011799101427,67614.78746289063,66683.75229975134,False,True,65587.141,67037.141,66117.141,66087.141,,False,2024-06-14 19:15:00,2024-06-14 19:09:24,2024-06-13 20:02:37,0.02,fail,False,-163.84,29047.000000000186,,0,2,24,June
2024-06-13 18:45:00,66586.039,66666.641,66337.273,66442.289,3263,36421,0,2024-06-13 18:00:00,2024-06-13 18:00:00,-111.7354642857099,-149.685643864781,67180.57990476192,-0.0020310928574881963,0.0010344519276742421,67551.42866666667,65786.59803898218,69079.6302752558,67099.84599267748,69646.77733022097,0.002537866907844121,-8.192344401142167e-05,67953.62518429046,67701.99286247145,4.1256900214482775,6.701557830558312,-146.23392774260248,67178.92799758555,67402.76697883487,66969.29433677325,-223.83898124932603,-89.97242272302168,403.41790131168233,-180.7255445477349,-180.77707911928883,-126.14027382187487,67513.90850354402,66423.18017000248,False,True,65442.289000000004,66892.289,65972.289,65942.289,,False,2024-06-14 19:15:00,2024-06-14 19:09:29,2024-06-13 19:57:31,0.02,fail,False,-163.84,28883.160000000185,,0,3,24,June
2024-06-14 19:15:00,65827.336,65954.234,65269.738,65289.184,3589,36421,0,2024-06-14 19:00:00,2024-06-14 19:00:00,-218.52940476190997,-72.55714899518352,66264.38654761907,-0.003657931989524295,-0.002224338242126978,66782.31570238095,64214.79146653505,66293.75919934489,66008.80618944495,67502.2075135281,0.000375630282481834,-0.0011290112576692233,67203.47729202782,66844.19059518924,8.48479065554569,13.151965378815527,-53.39068311061689,66446.72328098779,66702.02440818104,66232.59384107329,-255.30112719324825,-90.21676411080486,435.4644554092674,-285.7682855176972,-205.86579394564615,-111.34973787410127,66820.4708558758,65643.21682627079,False,True,64289.184,65739.18400000001,64819.184,64789.184,,False,2024-06-18 04:45:00,2024-06-18 17:08:25,2024-06-14 23:27:59,0.02,fail,False,-163.84,28719.320000000185,,0,4,24,June
2024-06-14 19:30:00,65291.539,65513.738,65181.84,65271.563,3418,36421,0,2024-06-14 19:00:00,2024-06-14 19:00:00,-218.52940476190997,-72.55714899518352,66264.38654761907,-0.003657931989524295,-0.002224338242126978,66782.31570238095,64214.79146653505,66293.75919934489,66008.80618944495,67502.2075135281,0.000375630282481834,-0.0011290112576692233,67203.47729202782,66844.19059518924,8.365799549717366,9.451062645219983,-53.39068311061689,66265.92939160505,66596.06430387133,65981.39421878227,-330.13491226627957,-138.2003937418998,534.6505485039405,-251.19962229102384,-285.7682855176972,-205.86579394564615,66703.17245926258,65258.11597830195,False,True,64271.563,65721.563,64801.563,64771.563,,False,2024-06-18 04:45:00,2024-06-18 18:11:24,2024-06-14 20:40:07,0.02,fail,False,-163.84,28555.480000000185,,0,5,24,June
2024-06-14 19:45:00,65266.633,65569.734,65181.84,65269.266,2863,36421,0,2024-06-14 19:00:00,2024-06-14 19:00:00,-218.52940476190997,-72.55714899518352,66264.38654761907,-0.003657931989524295,-0.002224338242126978,66782.31570238095,64214.79146653505,66293.75919934489,66008.80618944495,67502.2075135281,0.000375630282481834,-0.0011290112576692233,67203.47729202782,66844.19059518924,3.038407669909103,6.629665958390681,-53.39068311061689,66112.59656212735,66497.78294802901,65761.39650292402,-385.1863859016594,-187.59759217385175,611.7093417225169,-219.99771585824783,-251.19962229102384,-285.7682855176972,66587.20411424941,64934.08889159862,False,True,64269.266,65719.266,64799.266,64769.266,,False,2024-06-18 04:45:00,2024-06-18 18:11:24,2024-06-14 20:40:07,0.02,fail,False,-163.84,28391.640000000185,,0,6,24,June
2024-06-17 21:00:00,66566.891,66966.938,66504.117,66833.336,2402,36421,0,2024-06-17 21:00:00,2024-06-17 21:00:00,344.2999285714104,-77.2450153879181,66313.07646428568,0.000252796787273177,0.0026871782291665513,65837.84051190478,65211.340386417374,68009.38406004901,65194.70474060284,66973.70403113039,0.0014291926261294826,0.0002526947156274139,66438.4446777406,66109.98779738284,95.05833178622784,91.79368335731499,-167.35932422149008,66080.48265561943,65896.1203431563,66319.15792948059,184.36231246312673,31.207983177766284,399.4469388828619,189.4974447884888,181.47553147572035,165.19604334364703,66859.91129697245,65779.90456198872,True,False,67833.336,66383.336,67303.336,67333.336,,False,,,2024-06-17 23:05:08,0.02,fail,False,-163.84,28227.800000000185,,0,7,25,June
2024-06-18 01:00:00,66521.734,66637.234,66445.75,66614.734,1034,56421,0,2024-06-18 01:00:00,2024-06-18 01:00:00,32.24765476191533,131.8772044123907,66701.91644047615,-0.010528712798281499,0.0008287491621683307,66682.01721428573,58021.26878651197,67715.75261682128,59074.699054741075,69054.7916675703,0.0037014474036963,-0.008714041954742173,66452.31225525594,66229.94308505961,89.12808041370965,88.03507721551267,-2.2550541427812725,66518.21831553042,66382.56402354849,66451.92579394564,135.65429198193306,170.7803019308173,408.5279584080828,-21.106005503985216,-74.40329721361923,-60.5579129687103,67003.43853779655,65898.91305009474,True,False,67614.734,66164.734,67084.734,67114.734,,False,,,2024-06-18 03:38:06,0.02,fail,False,-163.84,28063.960000000185,,0,8,25,June
2024-06-18 14:15:00,65265.32,65305.637,65146.535,65148.738,1741,36422,0,2024-06-18 14:00:00,2024-06-18 14:00:00,-55.28438095240563,-151.1979106351937,65434.28278571432,-0.0005023796502560403,-0.0006135770523062719,65507.336499999976,64934.375838079875,65436.22987998784,65354.955241780415,65591.4075610412,-0.0003644824784448594,0.00019176443934223385,66078.12966427696,65755.53085143314,10.018324030611167,20.70750924408355,-132.1911589133356,65417.203893826256,65509.443223805654,65347.21196663223,-92.23932997939846,-57.89139743190029,145.46269316198934,-80.328596491192,-56.39167973860458,-34.04445132440742,65543.58660240092,65149.33733086355,False,True,64148.738,64678.738,64678.738,64648.738,2024-06-18 18:00:00,True,2024-06-18 18:00:00,2024-06-18 22:47:42,2024-06-18 18:03:29,0.02,even,True,171.07,28235.030000000184,,1,0,25,June
2024-06-20 08:15:00,65264.152,65336.738,65216.34,65314.039,1128,36422,0,2024-06-20 08:00:00,2024-06-20 08:00:00,66.0753095238033,32.25050249819469,65313.8729285714,0.0009499730340847319,0.0008407943486491911,65186.5272142857,65347.911671997426,65805.79585903783,68281.36328145674,65823.58117112375,0.0009979634659096031,0.011927229796631853,65254.035943642135,65105.78879599326,83.48031338263428,68.89554282541724,-22.308851544063522,65166.65797096917,65097.97002363506,65183.44287994496,68.6879473341105,52.16664084485117,127.8937632760525,27.572887512942543,16.434942208397842,10.243526659796771,65357.59946036763,65010.78629952229,True,False,66314.03899999999,65784.03899999999,65784.03899999999,65814.03899999999,2024-06-20 14:00:00,True,2024-06-20 14:00:00,2024-06-20 14:08:02,2024-06-20 16:03:27,0.02,success,True,363.98,28599.010000000184,,2,0,25,June
2024-06-20 08:30:00,65314.039,65409.738,65302.738,65349.84,778,36422,0,2024-06-20 08:00:00,2024-06-20 08:00:00,66.0753095238033,32.25050249819469,65313.8729285714,0.0009499730340847319,0.0008407943486491911,65186.5272142857,65347.911671997426,65805.79585903783,68281.36328145674,65823.58117112375,0.0009979634659096031,0.011927229796631853,65254.035943642135,65105.78879599326,86.62533426697279,79.28420018741004,-22.308851544063522,65194.8398215893,65116.62705892135,65220.4051375989,78.2127626679503,57.375865209471,131.01620133280625,36.96225765394047,27.572887512942543,16.434942208397842,65398.77700939819,65043.53326579961,True,False,66349.84,65819.84,65819.84,65849.84,2024-06-20 14:00:00,True,2024-06-20 14:00:00,2024-06-20 14:08:15,2024-06-20 16:03:24,0.02,success,True,363.98,28962.990000000183,,3,0,25,June
2024-06-20 08:45:00,65343.574,65575.539,65343.484,65469.84,1163,36421,0,2024-06-20 08:00:00,2024-06-20 08:00:00,66.0753095238033,32.25050249819469,65313.8729285714,0.0009499730340847319,0.0008407943486491911,65186.5272142857,65347.911671997426,65805.79585903783,68281.36328145674,65823.58117112375,0.0009979634659096031,0.011927229796631853,65254.035943642135,65105.78879599326,86.60542588815669,85.57035784592121,-22.308851544063522,65237.1475413448,65142.790980482736,65285.650278637775,94.3565608620629,64.7720043399894,139.0013488367313,65.24514103887486,36.96225765394047,27.572887512942543,65474.802099567365,65097.998457708185,True,False,66469.84,65939.84,65939.84,65969.84,2024-06-20 14:00:00,True,2024-06-20 14:00:00,,2024-06-20 15:19:40,0.02,even,True,171.07,29134.060000000183,,4,0,25,June
2024-06-20 17:00:00,65096.887,65150.938,64733.039,64786.184,3098,36422,0,2024-06-20 17:00:00,2024-06-20 17:00:00,-272.17045238093124,147.45105897912435,65426.188857142886,-0.001787229128330698,0.00012134642313313531,65748.0059642857,64137.76074435444,66505.85254968939,64935.63282113062,67230.48394988861,0.00192252489124329,-0.0005507374258291019,65367.447497466375,65371.49378380507,7.622835940863354,11.666091256831232,161.41634671105965,65532.97009085315,65631.81648767194,65466.52053594768,-98.84639681878616,55.17353296799271,372.07387369860004,-216.79937495701597,-168.15482284146128,-124.6222813896893,65968.8202654408,64962.72080645457,False,True,63786.184,64316.184,64316.184,64286.184,2024-06-21 11:00:00,True,2024-06-21 11:00:00,2024-06-21 11:49:48,2024-06-21 11:12:22,0.02,even,True,171.07,29305.130000000183,,5,0,25,June
2024-06-21 02:15:00,64939.398,64975.84,64911.84,64917.34,816,36422,0,2024-06-21 02:00:00,2024-06-21 02:00:00,-5.547821428568568,-101.71490886705578,64951.8187857143,0.0006753385116250436,-0.00016204997338382167,65017.88352380952,64992.25489655039,65075.026313327326,65198.88588782559,65239.45072342719,0.0001301971481488162,0.001057071754559864,65238.5104879498,65145.06425281085,19.491592255163425,33.10785188774636,-56.75384843895726,64980.687484801274,65013.87534415538,64975.60426418982,-33.18785935410415,-32.15191446765128,99.7459365274656,-13.288905056760996,-15.001312349508225,-6.37329824565677,65110.261278501894,64839.44724987774,False,True,63917.34,64447.34,64447.34,64417.34,2024-06-21 11:00:00,True,2024-06-21 11:00:00,2024-06-21 11:49:48,,0.02,success,True,363.98,29669.110000000182,,6,0,25,June
2024-06-21 02:30:00,64916.438,64926.34,64883.801,64893.84,906,36422,0,2024-06-21 02:00:00,2024-06-21 02:00:00,-5.547821428568568,-101.71490886705578,64951.8187857143,0.0006753385116250436,-0.00016204997338382167,65017.88352380952,64992.25489655039,65075.026313327326,65198.88588782559,65239.45072342719,0.0001301971481488162,0.001057071754559864,65238.5104879498,65145.06425281085,11.000538096205396,21.604678836066185,-56.75384843895726,64967.326333293386,65004.98383718091,64954.634144822805,-37.65750388752349,-33.25303235162573,85.83775210869032,-20.970119367011648,-13.288905056760996,-15.001312349508225,65070.51511016954,64837.25317947607,False,True,63893.84,64423.84,64423.84,64393.84,2024-06-21 11:00:00,True,2024-06-21 11:00:00,2024-06-21 11:49:48,,0.02,success,True,363.98,30033.090000000182,,7,0,25,June
2024-06-21 02:45:00,64889.262,64909.438,64812.84,64829.676,734,36422,0,2024-06-21 02:00:00,2024-06-21 02:00:00,-5.547821428568568,-101.71490886705578,64951.8187857143,0.0006753385116250436,-0.00016204997338382167,65017.88352380952,64992.25489655039,65075.026313327326,65198.88588782559,65239.45072342719,0.0001301971481488162,0.001057071754559864,65238.5104879498,65145.06425281085,3.914192254613088,11.468774201993929,-56.75384843895726,64946.14935894056,64991.99807146381,64926.60275748194,-45.84871252324956,-35.77216838595049,69.2293624428614,-28.031387340866786,-20.970119367011648,-13.288905056760996,65020.0623967798,64831.643118184074,False,True,63829.676,64359.676,64359.676,64329.676,2024-06-21 11:00:00,True,2024-06-21 11:00:00,2024-06-21 11:49:48,2024-06-21 23:19:48,0.02,success,True,363.98,30397.07000000018,,8,0,25,June
2024-06-21 03:00:00,64829.664,64888.738,64657.504,64679.84,1108,36422,0,2024-06-21 03:00:00,2024-06-21 03:00:00,-66.0647380952214,-114.0537838322416,64879.98277380954,-0.00013131103922730066,-0.00018809440904919746,64951.8187857143,64547.96611595011,65046.769956928496,64992.25489655039,65075.026313327326,-0.00016204997338382167,0.0006753385116250436,65221.005645285106,65116.83007258599,4.655321068305542,6.5233504730413,-68.21383551761414,64905.17868833432,64968.87525135538,64868.78217371862,-63.69656302105432,-41.35704731297126,93.27867436790694,-57.82058376332134,-28.031387340866786,-20.970119367011648,64994.70838411529,64741.35596332194,False,True,63679.84,64209.84,64209.84,64179.84,2024-06-21 11:00:00,True,2024-06-21 11:00:00,2024-06-21 11:49:48,2024-06-21 11:00:12,0.02,even,True,171.07,30568.14000000018,,9,0,25,June
2024-06-24 08:15:00,62698.438,62717.238,62447.738,62591.84,2357,36422,0,2024-06-24 08:00:00,2024-06-24 08:00:00,-61.997690476157004,-340.90183471881755,62615.635345238115,-0.002060534964663648,-0.0018781422638525702,62824.63698809528,61710.15976268961,62506.75255814398,61877.67892985536,62662.0958472339,-0.0017756637743449916,-0.0019775681221822572,64112.83097252622,63570.59911905305,18.295626355821913,22.237846953678623,-267.5934432203618,62822.06284740836,63034.694334533844,62672.205835225286,-212.63148712548718,-206.68778050065418,231.1526387061158,-60.3967715858671,-33.02914138282358,-30.514808393549174,62984.261897478544,62358.64977297203,False,True,61591.84,63041.84,62121.84,62091.84,,False,2024-06-24 12:45:00,2024-06-24 12:32:15,,0.02,success,True,363.98,30932.12000000018,,10,0,26,June
2024-06-24 19:45:00,60502.172,60511.738,59950.973,60126.238,4153,36422,0,2024-06-24 19:00:00,2024-06-24 19:00:00,-147.4487142857397,-595.32948383443,60785.006142857135,-0.0012581799634880262,-0.0037739451598911584,61023.307345238136,59650.22310219435,60275.82279264446,60733.34611166462,60501.05097931478,-0.0037741364371260758,0.0004143359518060047,63141.34486883869,62208.15916939837,15.487987697386124,18.71972181326912,-534.7845997848581,60851.828245776145,61151.2893952448,60735.13215514273,-299.4611494686542,-242.1173315815783,294.4397186555844,-168.73359236329998,-105.53147058819013,-63.297373925066495,61132.62577532777,60336.138534957696,False,True,59126.238,60576.238,59656.238,59626.238,,False,2024-06-24 23:00:00,2024-06-24 22:58:54,2024-06-25 03:54:10,0.02,success,True,363.98,31296.10000000018,,11,0,26,June
2024-06-26 05:00:00,62047.039,62344.969,61952.863,62302.238,1757,36422,0,2024-06-26 05:00:00,2024-06-26 05:00:00,9.61490476191102,194.250331503521,61899.167630952354,-0.0005458535995517508,0.00016091928295481996,61840.895,61386.89577156433,62487.39642593738,62019.75959259534,61992.944658655484,-0.0006156303101560354,0.0013808408022413171,61790.50121182306,61574.93028794137,81.71465265733734,72.80523759414594,189.59199176511416,61929.94525251762,61852.10851688044,61914.13798004817,77.83673563717457,40.52252252110939,155.98727190630265,89.56854798763379,41.72709184728592,21.09238321294106,62126.220797121685,61703.55516297466,True,False,63302.238,61852.238,62772.238,62802.238,,False,,,2024-06-26 06:34:21,0.02,fail,False,-163.84,31132.26000000018,,0,1,26,June
2024-06-26 08:15:00,61722.34,61756.34,61537.938,61557.238,1295,36422,0,2024-06-26 08:00:00,2024-06-26 08:00:00,-69.99845238100534,135.075633986482,61734.664857142874,-0.00022778277674252617,0.0003784483905821522,61841.86945238091,61462.92664290272,62613.13209152434,61732.17038197019,62938.90354657498,0.0013017331803730438,0.0002882859857927961,61778.96290826132,61598.8745323125,4.038419032956322,4.44422855320491,176.73839169859085,61776.11052916863,61821.19068430631,61702.03326487783,-45.08015513767896,2.8654629167443737,180.7184210526943,-82.44857241145655,-59.448656002750795,-55.6188734090174,61946.00313329897,61456.56339645669,False,True,60557.238,61087.238,61087.238,61057.238,2024-06-26 20:15:00,True,2024-06-26 20:15:00,2024-06-28 22:17:51,2024-06-26 20:29:24,0.02,even,True,171.07,31303.33000000018,,1,0,26,June
2024-06-26 08:45:00,61600.637,61645.039,61518.738,61519.637,1133,36422,0,2024-06-26 08:00:00,2024-06-26 08:00:00,-69.99845238100534,135.075633986482,61734.664857142874,-0.00022778277674252617,0.0003784483905821522,61841.86945238091,61462.92664290272,62613.13209152434,61732.17038197019,62938.90354657498,0.0013017331803730438,0.0002882859857927961,61778.96290826132,61598.8745323125,2.925761272826712,4.338131195506151,176.73839169859085,61713.302793073395,61783.45881439155,61581.921343653274,-70.15602131815831,-21.16527665171547,192.56077611797008,-61.17285483315209,-58.939066391401866,-82.44857241145655,61841.87839141253,61320.46429589402,False,True,60519.637,61049.637,61049.637,61019.637,2024-06-26 20:15:00,True,2024-06-26 20:15:00,2024-06-28 22:17:51,2024-06-26 20:29:07,0.02,even,True,171.07,31474.40000000018,,2,0,26,June
2024-06-26 13:30:00,61270.273,61300.637,61203.137,61203.137,779,36422,0,2024-06-26 13:00:00,2024-06-26 13:00:00,-80.22959523817553,-21.83364647012786,61354.047035714284,-0.001263787603400355,-0.0010083929150971722,61437.396452380955,60821.859807858564,61349.328198300136,60862.00473187219,61122.33315100863,-0.0019446507783492687,-0.001337536420637994,61718.09793130907,61542.91300988681,12.492384030960068,12.723670684004473,74.3955344301546,61387.69933693916,61509.12196241205,61307.23238424494,-121.42262547289283,-99.13298331663376,138.3990495392384,-46.12487581698224,-41.30936119710532,-33.78738734088256,61494.071101122914,61118.89366736697,False,True,60203.137,61653.137,60733.137,60703.137,,False,2024-06-27 09:45:00,2024-06-28 22:17:54,2024-06-26 16:33:13,0.02,fail,False,-163.84,31310.56000000018,,0,1,26,June
2024-06-27 17:00:00,61945.137,62329.738,61938.156,62329.738,2462,36422,0,2024-06-27 17:00:00,2024-06-27 17:00:00,289.4360714285067,112.03428208229161,61631.45957142851,0.0017761235687715692,0.003347301182306767,61504.65278571427,61777.959973224475,63206.35630016782,61668.78272932172,62631.7548746159,0.0026256539192539416,0.0017761275149708222,61339.66544739174,61218.863752059944,91.56732408462238,81.38127593474121,-25.764396605071525,61593.67627090903,61344.92802595338,61753.47552356383,248.74824495565554,153.61925977079807,367.0291945415581,165.58260061922192,103.6520880632961,52.48944272445078,62250.464936194934,61257.986110932725,True,False,63329.738,61879.738,62799.738,62829.738,,False,,,2024-06-27 17:49:32,0.02,fail,False,-163.84,31146.72000000018,,0,2,26,June
2024-06-28 10:30:00,61461.617,61487.539,61331.844,61371.738,637,36422,0,2024-06-28 10:00:00,2024-06-28 10:00:00,-47.99313095240359,57.449704727187054,61520.09592857148,-0.0006174335049210326,-0.001438918984391157,61655.08909523807,61023.22113201335,61295.26715327668,61458.41065396293,61422.02221103255,-0.001368737164638272,2.990895714078445e-05,61480.77489448678,61521.55960348911,15.33261820428792,22.179665458380857,93.04296684102128,61544.48981436092,61597.221917570925,61472.28578362574,-52.73210321000806,-29.03440628798451,161.09518793171685,-36.46249329204147,-26.617849673173623,-10.002192638465203,61689.76428733356,61253.30727991792,False,True,60371.738,61821.738,60901.738,60871.738,,False,2024-06-28 17:45:00,2024-06-28 22:17:52,2024-06-28 15:30:07,0.02,fail,False,-163.84,30982.88000000018,,0,3,26,June
2024-06-28 10:45:00,61371.738,61376.34,61174.41,61299.738,1403,36422,0,2024-06-28 10:00:00,2024-06-28 10:00:00,-47.99313095240359,57.449704727187054,61520.09592857148,-0.0006174335049210326,-0.001438918984391157,61655.08909523807,61023.22113201335,61295.26715327668,61458.41065396293,61422.02221103255,-0.001368737164638272,2.990895714078445e-05,61480.77489448678,61521.55960348911,13.907917316761408,17.307178085330815,93.04296684102128,61506.83568907462,61575.18607182493,61436.159234606166,-68.3503827503082,-36.89760158044925,161.47791051658166,-36.12654901957285,-36.46249329204147,-26.617849673173623,61654.15441380355,61216.66405540878,False,True,60299.738,61749.738,60829.738,60799.738,,False,2024-06-28 18:15:00,2024-06-28 22:17:52,2024-06-28 14:36:44,0.02,fail,False,-163.84,30819.04000000018,,0,4,26,June
2024-06-28 17:30:00,61043.137,61144.34,60831.84,60860.238,2251,36422,0,2024-06-28 17:00:00,2024-06-28 17:00:00,-65.1363571428883,-43.98886003813095,61241.99024999998,-0.0010146826071262066,-0.00016805713228135058,61409.08985714286,60494.92666643312,61761.64384854887,61140.7348635849,61771.97363280009,-0.00016800702254847125,-5.4937051204006603e-05,61451.07713237243,61442.93560952929,8.783497059383768,19.117985834861177,7.239222142414155,61314.95758306187,61416.41336818141,61247.78860577916,-101.45578511954227,-36.521982345337186,203.2545125261796,-120.3111658066482,-88.86701547988196,-54.94295493645768,61522.18219768951,60971.895013868816,False,True,59860.238,60390.238,60390.238,60360.238,2024-06-28 23:00:00,True,2024-06-28 23:00:00,2024-07-03 13:33:15,2024-07-01 00:00:02,0.02,even,True,171.07,30990.11000000018,,1,0,26,June
2024-06-28 18:00:00,60887.055,60944.738,60702.84,60779.84,1969,36422,0,2024-06-28 18:00:00,2024-06-28 18:00:00,-167.09960714288172,-101.7824487617545,61118.92072619043,-0.0011698610645922548,-0.00016804140176922153,61241.99024999998,60386.96990171453,61751.24879739374,60494.92666643312,61761.64384854887,-0.00016805713228135058,-0.0010146826071262066,61434.240303651946,61409.23980076695,7.823448218379409,8.188886035142572,-14.565112038419574,61177.421228109386,61333.212229236466,61031.90672067424,-155.79100112707965,-74.97599427780867,264.7733075269553,-112.33971379431023,-103.5421713106116,-120.3111658066482,61389.35068583563,60672.96275551285,False,True,59779.84,60309.84,60309.84,60279.84,2024-06-28 23:00:00,True,2024-06-28 23:00:00,2024-07-03 13:33:16,2024-06-28 23:19:11,0.02,even,True,171.07,31161.18000000018,,2,0,26,June
2024-07-01 01:00:00,61903.34,62097.637,61894.398,62076.938,754,56422,0,2024-07-01 01:00:00,2024-07-01 01:00:00,457.1354523809714,-139.4345681730556,61541.70841666663,-0.0007508380238382435,0.004090641153301621,60851.34673809524,59742.28537819583,63988.12793752681,59787.867623070735,62278.86573092344,0.0011829050314931247,-0.0007508102003180104,61360.51384996529,61309.901759496635,96.5746286944589,95.79448523689443,-165.20382499794474,61286.38800788102,61080.74514164111,61439.88523391815,205.64286623990483,-7.373625521003049,590.7402524098245,237.83103027181642,227.70428173364053,237.55782387348881,62238.88457467141,60642.38589316489,True,False,63076.938,62546.938,62546.938,62576.938,2024-07-01 01:30:00,True,2024-07-01 01:30:00,2024-07-01 04:06:14,2024-07-01 03:12:00,0.02,even,True,171.07,31332.25000000018,,3,0,27,July
2024-07-02 11:00:00,62591.84,62671.738,62368.297,62449.621,1167,36422,0,2024-07-02 11:00:00,2024-07-02 11:00:00,-126.05884523809073,-43.583353567053564,62748.00251190475,-0.0009361724284422622,-0.0009096454786432116,62840.68158333332,62132.557140318386,62747.230173962285,62432.39339958402,63062.35866083463,-0.0004000571308077896,-0.0004567762470884532,62584.2447817464,62865.37865449032,8.585317065961213,8.894400981499814,30.3088811037341,62738.42148575826,62856.55476618111,62604.880920880605,-118.13328042284411,-65.57877818246095,195.28653094288444,-65.34152528379491,-50.25481492947438,-71.73042174061993,62868.5177376535,62339.74410410771,False,True,61449.621,62899.621,61979.621,61949.621,,False,2024-07-02 17:45:00,2024-07-03 04:55:10,2024-07-02 15:45:16,0.02,fail,False,-163.84,31168.410000000178,,0,1,27,July
2024-07-02 17:15:00,62345.41,62421.637,62194.344,62341.238,2335,36422,0,2024-07-02 17:00:00,2024-07-02 17:00:00,-21.084785714221653,-69.30823163026798,62498.878321428565,-0.0013605060357302563,0.0007993068260442368,62711.07894047623,61523.16083575305,63402.49739314911,62619.15894419822,63222.51072154812,0.00029219860152074583,0.0004438312173029825,62585.07405842701,62750.946934236505,11.132621499530211,28.678205247006503,-42.711807093720665,62654.49591983156,62711.74383940608,62679.05462882697,-57.247919574518164,-20.270697091558695,141.93027448498137,-79.6321365668773,-81.36412039914285,-35.33363742686197,62870.660499381695,62485.94875827224,False,True,61341.238,62791.238,61871.238,61841.238,,False,2024-07-03 05:00:00,2024-07-03 04:55:12,,0.02,success,True,363.98,31532.390000000178,,1,0,27,July
2024-07-02 17:30:00,62316.438,62392.34,61869.84,61878.137,2350,36422,0,2024-07-02 17:00:00,2024-07-02 17:00:00,-21.084785714221653,-69.30823163026798,62498.878321428565,-0.0013605060357302563,0.0007993068260442368,62711.07894047623,61523.16083575305,63402.49739314911,62619.15894419822,63222.51072154812,0.00029219860152074583,0.0004438312173029825,62585.07405842701,62750.946934236505,6.779764170097626,14.685342437698148,-42.711807093720665,62535.05608601132,62649.995184635256,62509.710421052594,-114.93909862393775,-39.20437739803451,216.51361318706913,-169.3442077743748,-79.6321365668773,-81.36412039914285,62802.003798855134,62215.917043250054,False,True,60878.137,62328.137,61408.137,61378.137,,False,2024-07-03 05:45:00,2024-07-03 06:12:45,2024-07-02 21:39:12,0.02,fail,False,-163.84,31368.550000000178,,0,1,27,July
2024-07-02 18:00:00,62012.848,62130.438,61972.469,62005.277,1601,36422,0,2024-07-02 18:00:00,2024-07-02 18:00:00,-212.20061904766771,-143.2843728808075,62272.186642857145,-0.0013573987609692827,0.0007843424950975321,62498.878321428565,61441.15837922377,63447.39505799478,61523.16083575305,63402.49739314911,0.0007993068260442368,-0.0013605060357302563,62559.260958096536,62685.01837949759,7.889682151431001,7.9921650850987085,-62.826320251138036,62385.77884264716,62558.64725431692,62271.99764981084,-172.86841166976228,-83.33742447774104,282.1099189659302,-111.70030718948692,-126.01246405226993,-169.3442077743748,62652.84604041484,61889.64925920683,False,True,61005.277,61535.277,61535.277,61505.277,2024-07-03 05:45:00,True,2024-07-03 05:45:00,2024-07-03 06:11:32,,0.02,success,True,363.98,31732.530000000177,,1,0,27,July
2024-07-03 11:00:00,60839.008,60879.938,60732.938,60821.039,755,36422,0,2024-07-03 11:00:00,2024-07-03 11:00:00,-72.36826190473948,-382.7211733166405,60722.97328571432,-0.0009910051619509523,-0.002867489745452267,60844.93584523815,60043.303635498014,60264.052092528385,60012.91548680164,60220.99531629036,-0.0032234672131468854,-0.0011770641372783942,62017.07173524263,61675.10813713644,18.37236757479,22.952577733265723,-313.1194642532279,60939.68210422349,61119.01849168482,60926.35939731684,-179.3363874613351,-200.837645718683,198.6617148420921,-22.15199655997276,-20.71490161685506,-33.69580908145872,61194.55271235367,60656.66608228001,False,True,59821.039,60351.039,60351.039,60321.039,2024-07-03 13:15:00,True,2024-07-03 13:15:00,2024-07-03 13:33:15,2024-07-03 13:59:36,0.02,success,True,363.98,32096.510000000177,,2,0,27,July
2024-07-04 11:15:00,58292.438,58305.137,58039.863,58039.863,1499,36422,0,2024-07-04 11:00:00,2024-07-04 11:00:00,-199.54482142858615,-510.77290270310914,58296.352392857116,-0.0019060592642533227,-0.0046234733312050845,58526.75483333333,56553.538603073524,57491.63761172803,58411.91221914664,57755.60210725832,-0.004623436967004083,0.0014872980046029094,60459.78556647801,59600.6130789146,11.921747163775342,12.889725121466276,-416.60414048545783,58510.127626065325,58825.18078110221,58340.00599896799,-315.05315503688325,-279.40422932400816,279.18742558641696,-101.9365706913959,-73.48431475752295,-109.9082063983733,58716.90902350965,57961.60297442632,False,True,57039.863,58489.863,57569.863,57539.863,,False,2024-07-04 12:15:00,2024-07-04 11:40:22,2024-07-04 22:30:41,0.02,success,True,363.98,32460.490000000176,,3,0,27,July
