time,open,high,low,close,tick_volume,spread,real_volume,support_trendline_15,resistance_trendline_15,support_gradient_15,resistance_gradient_15,fixed_resistance_gradient_15,fixed_support_gradient_15,fixed_support_trendline_15,fixed_resistance_trendline_15,hourly_time,time2,prev_hour_lsma_slope,prev_hour_macd_line,hour_lsma,fixed_support_gradient,fixed_resistance_gradient,prev_hour_lsma,fixed_support_trendline,fixed_resistance_trendline,prev_fixed_support_trendline,prev_fixed_resistance_trendline,prev_fixed_resistance_gradient,prev_fixed_support_gradient,ema_50,ema_24,stoch_k,stoch_d,prev_hour_macd_signal,prev_psar,prev_psar_direction,prev_nadaraya_watson,prev_nadaraya_watson_trend,ema_short,ema_long,lsma,macd_line,macd_signal,lsma_stddev,lsma_slope,prev_lsma_slope_1,prev_lsma_slope_2,lsma_upper_band,lsma_lower_band,ticket,is_buy2,is_sell2,signal,tp,sl,be,be_condition,order_type,lot,sl_updated,time_to_trail,time_tp_hit,time_sl_hit,entry_time,entry_price,exit_time,exit_price,lot_size,type,success,profit,account_balance,win_streak,losing_streak,Week,Month
2024-07-03 10:00:00,1.07463,1.07527,1.07463,1.07517,425,12,0,1.07463,1.0755650134634998,0.00013668063455440064,-6.044769740818253e-05,0.0003099306122613315,0.0001970494870238051,1.073872047600957,1.0742841317981078,2024-07-03 10:00:00,2024-07-03 10:00:00,0.000147261904761109,0.00017511029851258186,1.074752857142857,3.65808551750718e-05,0.00039074777235305764,1.074187380952381,1.0734950578646767,1.0744600698316318,1.074126772929716,1.0746019909164344,3.5061920966982196e-05,-0.00018025703031300871,1.07408240186562,1.0741621169078077,94.19079828083794,90.25495440392787,0.00023773500256189648,,1.0,0.07161057991602768,bullish,1.0742013595844582,1.0740728060770677,1.074300543515652,0.0001285535073904942,-2.3527529034036305e-05,0.0003444696406477076,0.00023619539043706617,0.00013546267629926945,7.888544891576643e-05,1.0746450131562997,1.0739560738750045,,True,False,0.0,1.08517,1.07537,1.0761699999999998,1.0771699999999997,0,0.01,True,2024-07-03 15:40:00,,2024-07-03 12:58:38,2024-07-03 10:05:00,1.07517,2024-07-03 12:58:38,1.07537,0.01,even,True,3.68,703.68,1,0,27,7
2024-07-05 16:05:00,1.08235,1.08321,1.08208,1.08287,1074,12,0,1.08208,1.0835383835908268,8.95726313747103e-05,-0.00017387475305879514,5.0779172403337486e-05,-1.257091106363511e-05,1.0821197259431057,1.0831393767900361,2024-07-05 16:00:00,2024-07-05 16:00:00,0.00016916666666655367,0.00043798551050056034,1.0822963095238094,-0.0007781486006033508,0.0003570786159907788,1.0825220238095241,1.082377687774075,1.0830296587038197,1.0821651316668601,1.0830028139847214,0.00027240494811270035,-0.0005297518667675266,1.0801612645735552,1.0815420767303563,65.56603773584882,62.814465408804246,0.0004906773930288644,,1.0,0.07925677911001489,bullish,1.0825063610732875,1.0824215630607965,1.082682091503268,8.479801249094976e-05,3.0679803473511217e-05,0.0003583187593327629,7.852769177829622e-05,-1.9965600274618467e-05,0.00010813897488759494,1.0830404102626008,1.0823237727439352,,True,False,0.0,1.09287,1.08307,1.08387,1.0848699999999998,0,0.01,True,2024-07-11 12:05:00,,2024-07-08 00:00:01,2024-07-05 16:10:00,1.08287,2024-07-08 00:00:01,1.08009,0.01,even,True,-51.14,652.54,2,0,27,7
2024-07-05 16:10:00,1.08288,1.08335,1.08283,1.083,938,12,0,1.082681659228393,1.08335,-0.0001485695341651229,-0.00011411475967258207,4.590395257457691e-05,4.001473526054013e-05,1.081996857360794,1.0831939646453406,2024-07-05 16:00:00,2024-07-05 16:00:00,0.00016916666666655367,0.00043798551050056034,1.0822963095238094,-0.0007781486006033508,0.0003570786159907788,1.0825220238095241,1.082377687774075,1.0830296587038197,1.0821651316668601,1.0830028139847214,0.00027240494811270035,-0.0005297518667675266,1.0801612645735552,1.0815420767303563,66.43081761006309,64.49161425576493,0.0004906773930288644,,1.0,0.07925677911001489,bullish,1.0825823055235508,1.0824644102414782,1.0827814035087717,0.00011789528207262201,4.812289919333338e-05,0.00038128073640862886,9.931200550372665e-05,7.852769177829622e-05,-1.9965600274618467e-05,1.0831626842451803,1.0824001227723632,,True,False,0.0,1.093,1.0832,1.0839999999999999,1.0849999999999997,0,0.01,True,2024-07-11 12:10:00,,2024-07-08 00:00:01,2024-07-05 16:15:00,1.083,2024-07-08 00:00:01,1.08009,0.01,even,True,-53.54,599.0,3,0,27,7
2024-07-05 16:20:00,1.08261,1.08288,1.08236,1.08284,740,12,0,1.0823191865586683,1.0829237622941439,5.6186505474016377e-05,5.1165481671499814e-05,-0.00017387475305879514,8.95726313747103e-05,1.0820877139990688,1.0835233894649265,2024-07-05 16:00:00,2024-07-05 16:00:00,0.00016916666666655367,0.00043798551050056034,1.0822963095238094,-0.0007781486006033508,0.0003570786159907788,1.0825220238095241,1.082377687774075,1.0830296587038197,1.0821651316668601,1.0830028139847214,0.00027240494811270035,-0.0005297518667675266,1.0801612645735552,1.0815420767303563,68.16037735848987,67.66247379454882,0.0004906773930288644,,1.0,0.07925677911001489,bullish,1.0826229524754418,1.0825008455431053,1.0827974957000348,0.0001221069323364965,7.278421836775937e-05,0.00039609468559447387,2.1303749570433794e-05,-5.211558307349762e-06,9.931200550372665e-05,1.0831935903856293,1.0824014010144403,,True,False,0.0,1.09284,1.08304,1.08384,1.0848399999999998,0,0.01,True,2024-07-11 12:05:00,,2024-07-08 00:00:01,2024-07-05 16:25:00,1.08284,2024-07-08 00:00:01,1.08009,0.01,even,True,-50.59,548.41,4,0,27,7
2024-07-08 00:10:00,1.08053,1.08102,1.0805,1.08102,39,44,0,1.0805,1.0815633175801873,0.00022228666344889034,-3.0673981093045997e-06,-0.0008993995184308562,-0.0002399427367702453,1.079858892338852,1.083854054118658,2024-07-08 00:00:00,2024-07-08 00:00:00,0.0002332142857144337,0.0005082241638598717,1.0830690476190472,-0.0006499760723446679,-0.00010996141765899966,1.0836104761904766,1.082375276750982,1.084408303142233,1.0820169260752313,1.0829921404951426,0.00037860786984572614,0.000328733535363884,1.080916343129594,1.0822162577099197,22.298803525711012,19.261875812702993,0.000425941774437365,,1.0,0.08001324709454662,bullish,1.0825735155270317,1.0830977385614406,1.0821391296869631,-0.0005242230344089105,-0.00011329808928951335,0.0011094543703791615,-0.00041120399036698174,-0.0005581630546960259,-0.0006656002751985746,1.0832485840573423,1.081029675316584,,True,False,0.0,1.09102,1.08202,1.08282,1.0840199999999998,0,0.01,True,2024-07-08 11:15:00,2024-07-12 18:03:02,2024-07-08 03:41:55,2024-07-08 00:15:00,1.08102,2024-07-08 03:41:55,1.08203,0.01,even,True,18.58,566.99,5,0,28,7
2024-07-08 00:15:00,1.08103,1.08156,1.08093,1.08119,99,52,0,1.0809407975127094,1.08156,4.60068955228638e-05,4.9058245135126225e-05,0.0003980465350697,0.00040752225388588975,1.079654345546101,1.0803028043012477,2024-07-08 00:00:00,2024-07-08 00:00:00,0.0002332142857144337,0.0005082241638598717,1.0830690476190472,-0.0006499760723446679,-0.00010996141765899966,1.0836104761904766,1.082375276750982,1.084408303142233,1.0820169260752313,1.0829921404951426,0.00037860786984572614,0.000328733535363884,1.080916343129594,1.0822162577099197,29.179461628672684,22.315512038642833,0.000425941774437365,,1.0,0.08001324709454662,bullish,1.0823606669844115,1.0829564245939265,1.081790945992432,-0.0005957576095150241,-0.0002097899933346155,0.0012011748415421545,-0.0003481836945311567,-0.00041120399036698174,-0.0005581630546960259,1.0829921208339741,1.0805897711508898,,True,False,0.0,1.09119,1.08219,1.08299,1.0841899999999998,0,0.01,True,2024-07-08 16:00:00,2024-07-15 12:38:06,2024-07-08 08:37:22,2024-07-08 00:20:00,1.08119,2024-07-08 08:37:22,1.0822,0.01,even,True,18.58,585.57,6,0,28,7
2024-07-08 00:20:00,1.08119,1.0812599999999999,1.08117,1.08125,18,38,0,1.0810100290430438,1.0812800097489912,3.698763050673952e-05,0.00020803891589623628,0.0003453301288201406,0.0003241101090826546,1.0801573479005604,1.0808424242596137,2024-07-08 00:00:00,2024-07-08 00:00:00,0.0002332142857144337,0.0005082241638598717,1.0830690476190472,-0.0006499760723446679,-0.00010996141765899966,1.0836104761904766,1.082375276750982,1.084408303142233,1.0820169260752313,1.0829921404951426,0.00037860786984572614,0.000328733535363884,1.080916343129594,1.0822162577099197,34.61249059443361,28.69691858293911,0.000425941774437365,,1.0,0.08001324709454662,bullish,1.0821897951406558,1.0828300227721541,1.0814971654626768,-0.0006402276314982913,-0.0002958775209673507,0.0012718447232088696,-0.0002937805297551499,-0.0003481836945311567,-0.00041120399036698174,1.0827690101858858,1.0802253207394679,,True,False,0.0,1.09125,1.08225,1.0830499999999998,1.0842499999999997,0,0.01,True,2024-07-08 16:00:00,2024-07-15 12:56:07,2024-07-08 08:37:03,2024-07-08 00:25:00,1.08125,2024-07-08 08:37:03,1.08225,0.01,even,True,18.4,603.97,7,0,28,7
2024-07-08 00:25:00,1.08122,1.0814300000000001,1.08121,1.08125,36,40,0,1.0808234489138853,1.0815850166883267,0.0002465881209067975,0.00013403809502731003,-3.0673981093045997e-06,0.00022228666344889034,1.0805187625489205,1.0815630584178242,2024-07-08 00:00:00,2024-07-08 00:00:00,0.0002332142857144337,0.0005082241638598717,1.0830690476190472,-0.0006499760723446679,-0.00010996141765899966,1.0836104761904766,1.082375276750982,1.084408303142233,1.0820169260752313,1.0829921404951426,0.00037860786984572614,0.000328733535363884,1.080916343129594,1.0822162577099197,36.34311512415487,33.37835578242039,0.000425941774437365,,1.0,0.08001324709454662,bullish,1.0820452112728627,1.082712984048291,1.0812576814585488,-0.0006677727754282881,-0.00037025657185953814,0.0013280225901522538,-0.00023948400412798776,-0.0002937805297551499,-0.0003481836945311567,1.082585704048701,1.0799296588683966,,True,False,0.0,1.09125,1.08225,1.0830499999999998,1.0842499999999997,0,0.01,True,2024-07-08 16:00:00,2024-07-15 12:56:07,2024-07-08 08:37:03,2024-07-08 00:30:00,1.08125,2024-07-08 08:37:03,1.08225,0.01,even,True,18.4,622.37,8,0,28,7
2024-07-08 00:30:00,1.08128,1.08173,1.08109,1.08166,63,32,0,1.08109,1.0818066579930437,0.0001358733770301373,7.086808859294468e-05,4.9058245135126225e-05,4.60068955228638e-05,1.0809447012278321,1.0815641650091319,2024-07-08 00:00:00,2024-07-08 00:00:00,0.0002332142857144337,0.0005082241638598717,1.0830690476190472,-0.0006499760723446679,-0.00010996141765899966,1.0836104761904766,1.082375276750982,1.084408303142233,1.0820169260752313,1.0829921404951426,0.00037860786984572614,0.000328733535363884,1.080916343129594,1.0822162577099197,39.879608728368396,36.94507148231897,0.000425941774437365,,1.0,0.08001324709454662,bullish,1.0819859480001146,1.082634985229899,1.0811248503611968,-0.0006490372297844882,-0.00042601270344452813,0.0013505909817391388,-0.00013283109735207077,-0.00023948400412798776,-0.0002937805297551499,1.0824754413429358,1.0797742593794577,,True,False,0.0,1.09166,1.08186,1.08266,1.0836599999999998,0,0.01,True,2024-07-08 11:05:00,2024-07-15 13:21:20,2024-07-08 03:51:58,2024-07-08 00:35:00,1.08166,2024-07-08 03:51:58,1.0818699999999999,0.01,even,True,3.86,626.23,9,0,28,7
2024-07-08 00:40:00,1.08173,1.08196,1.08169,1.08179,33,21,0,1.0815499982940553,1.0819491867389732,-2.3114719541232806e-05,1.8735184229386533e-05,0.00013403809502731003,0.0002465881209067975,1.080844402000549,1.0815964141486147,2024-07-08 00:00:00,2024-07-08 00:00:00,0.0002332142857144337,0.0005082241638598717,1.0830690476190472,-0.0006499760723446679,-0.00010996141765899966,1.0836104761904766,1.082375276750982,1.084408303142233,1.0820169260752313,1.0829921404951426,0.00037860786984572614,0.000328733535363884,1.080916343129594,1.0822162577099197,47.85398081522396,43.76672698857155,0.000425941774437365,,1.0,0.08001324709454662,bullish,1.0819237852545198,1.0825110092848929,1.0809849432404535,-0.0005872240303730347,-0.0004893857653084499,0.0013629878942807352,-4.6965944273003046e-05,-9.294117647029587e-05,-0.00013283109735207077,1.0823479311347342,1.0796219553461728,,True,False,0.0,1.09179,1.08199,1.08279,1.0837899999999998,0,0.01,True,2024-07-08 11:05:00,2024-07-15 13:21:21,2024-07-08 03:41:55,2024-07-08 00:45:00,1.08179,2024-07-08 03:41:55,1.08203,0.01,even,True,4.42,630.65,10,0,28,7
2024-07-08 00:50:00,1.08178,1.08193,1.0815,1.08193,53,21,0,1.0811970037013547,1.0819191936685288,0.00025566798897430767,0.0005361694572918694,-9.241962062955812e-06,-2.8489052818874218e-05,1.0815900102264533,1.0819692120522846,2024-07-08 00:00:00,2024-07-08 00:00:00,0.0002332142857144337,0.0005082241638598717,1.0830690476190472,-0.0006499760723446679,-0.00010996141765899966,1.0836104761904766,1.082375276750982,1.084408303142233,1.0820169260752313,1.0829921404951426,0.00037860786984572614,0.000328733535363884,1.080916343129594,1.0822162577099197,51.123015851946626,49.39547559204158,0.000425941774437365,,1.0,0.08001324709454662,bullish,1.0819060237621119,1.0824178337490507,1.081025968352253,-0.0005118099869387827,-0.0005044002476399975,0.0013500040740518262,5.415892672844258e-05,-1.3133814928956156e-05,-4.6965944273003046e-05,1.0823759724263047,1.0796759642782012,,True,False,0.0,1.09193,1.08213,1.08293,1.0839299999999998,0,0.01,True,2024-07-08 11:05:00,2024-07-15 13:21:37,2024-07-08 02:00:38,2024-07-08 00:55:00,1.08193,2024-07-08 02:00:38,1.08213,0.01,even,True,3.68,634.3299999999999,11,0,28,7
2024-07-10 12:55:00,1.0819,1.08193,1.08168,1.08181,208,12,0,1.0816099945271438,1.0820154288425328,-0.00015719528166357178,-0.00012517133767597335,-8.650349974391194e-05,-3.6975258015396535e-05,1.0818068540303258,1.0821926386284493,2024-07-10 12:00:00,2024-07-10 12:00:00,-0.00013833333333357345,1.0130775651706614e-06,1.0817079761904769,-0.000114673641972119,1.884839666687853e-05,1.081713809523809,1.0814822396556312,1.0823799967875398,1.0816570276184367,1.082094969551464,0.00010595411736362707,-0.00012663152482365238,1.081825066590902,1.0817070564660245,51.06227711002907,58.75790663203418,-5.282332707495508e-05,,-1.0,0.07855396484867792,bearish,1.0819086947211836,1.081848264334985,1.0821359408324727,6.043038619862884e-05,4.699794338245461e-05,0.0003198577808331291,-1.488476092270652e-05,-1.500859993064374e-05,3.099415204710354e-05,1.0824557986133059,1.0818160830516395,,False,True,1.0,1.07181,1.08781,1.08161,1.08081,1,0.01,False,,,2024-07-11 15:30:09,2024-07-10 13:00:00,1.08181,2024-07-11 15:30:09,1.0876,0.01,fail,False,-106.5,527.8299999999999,0,1,28,7
2024-07-10 13:20:00,1.0817,1.08192,1.08167,1.08191,155,12,0,1.08167,1.0819333396618787,9.885088974224748e-05,0.00018789694233845426,9.527810965683704e-05,0.00013444260546456694,1.08125606926647,1.0816081131712945,2024-07-10 13:00:00,2024-07-10 13:00:00,-5.833333332150303e-06,2.0573869384810095e-05,1.081803333333334,-3.328863114687315e-05,8.868950536504088e-06,1.0817079761904769,1.0811891408912269,1.0824211574052398,1.0814822396556312,1.0823799967875398,1.884839666687853e-05,-0.000114673641972119,1.0818354561363568,1.0817376919487427,39.49579831933063,30.451810353776057,-3.8143887783002044e-05,,1.0,0.07855780557663555,bullish,1.0817872648650564,1.0817941218112526,1.0818115204678358,-6.856946196176494e-06,1.1691374161286344e-05,0.0003218177537460309,-2.6050911592578885e-05,-5.86205710355614e-05,-7.638114895103243e-05,1.0821333382215819,1.0814897027140897,,True,False,0.0,1.09191,1.0869099999999994,1.0877099999999993,1.089909999999999,0,0.01,True,2024-07-12 17:35:00,2024-07-15 13:21:37,2024-07-11 16:42:52,2024-07-10 13:25:00,1.08191,2024-07-11 16:42:52,1.08693,0.01,even,True,92.36,620.1899999999999,1,0,28,7
2024-07-10 13:25:00,1.0819,1.08192,1.08182,1.08191,111,12,0,1.08182,1.0823266552787774,6.80318687013415e-05,1.2329585426352977e-05,0.00011863495035640786,0.00013444038282036413,1.0814014457325576,1.081673426066943,2024-07-10 13:00:00,2024-07-10 13:00:00,-5.833333332150303e-06,2.0573869384810095e-05,1.081803333333334,-3.328863114687315e-05,8.868950536504088e-06,1.0817079761904769,1.0811891408912269,1.0824211574052398,1.0814822396556312,1.0823799967875398,1.884839666687853e-05,-0.000114673641972119,1.0818354561363568,1.0817376919487427,47.61904761904759,38.56209150327104,-3.8143887783002044e-05,,1.0,0.07855780557663555,bullish,1.0818061471935092,1.0818027053807893,1.0817845854833161,3.4418127199398185e-06,1.0041461873017038e-05,0.0003056414020155581,-2.693498451966647e-05,-2.6050911592578885e-05,-5.86205710355614e-05,1.0820902268853316,1.0814789440813006,,True,False,0.0,1.09191,1.0869099999999994,1.0877099999999993,1.089909999999999,0,0.01,True,2024-07-12 17:35:00,2024-07-15 13:21:37,2024-07-11 16:42:52,2024-07-10 13:30:00,1.08191,2024-07-11 16:42:52,1.08693,0.01,even,True,92.37,712.56,2,0,28,7
2024-07-11 15:40:00,1.08791,1.08966,1.08784,1.08964,1454,12,0,1.08784,1.0898933732992193,0.00018100119431759375,1.2215128647354016e-05,0.0006852189773328977,0.0014762495187452707,1.0830374354956962,1.0886278756156074,2024-07-11 15:00:00,2024-07-11 15:00:00,0.0004259523809519994,0.0005895022737234523,1.086312023809524,0.0001358802634679147,0.001200391348302527,1.0849329761904758,1.0837732959169852,1.0848097748131584,1.0832035873844834,1.0844328206922698,0.0003687044006618323,0.00037842534192988,1.083129526013591,1.0839270841260193,86.09756900147691,61.59296175084367,0.0004386373931385516,,1.0,0.08128740746403393,bullish,1.0865226387601774,1.0857640364686791,1.0869739662882703,0.0007586022914982671,0.0003481207386525305,0.0012804391173592716,0.0007452700378400845,0.0004575782593745359,0.0006593016855862555,1.0882544054056296,1.085693527170911,,True,False,0.0,1.09964,1.08984,1.0906399999999998,1.0916399999999997,0,0.01,True,2024-07-15 17:30:00,,2024-07-15 00:00:05,2024-07-11 15:45:00,1.08964,2024-07-15 00:00:05,1.08821,0.01,even,True,-26.31,686.25,3,0,28,7
2024-07-15 00:10:00,1.0885,1.08917,1.0885,1.0889,58,12,0,1.0885,1.08917,0.00015946570289661677,1.3365034070714937e-05,-0.00044068719033223244,-0.0001068558215826627,1.0878963422436183,1.0905590678759107,2024-07-15 00:00:00,2024-07-15 00:00:00,-2.1547619045714228e-05,0.0008744467567298742,1.0899591666666664,-0.0005167481578983035,-0.0003108463766938675,1.0906409523809535,1.089992853751601,1.0916987300104324,1.0898448865730817,1.0905355941453543,0.00016502007718054504,9.356179663581442e-05,1.0870946673535136,1.0887042423196727,25.342465753423088,29.670318368943214,0.0008489768240539704,,1.0,0.08666337839787808,bullish,1.0897545040763654,1.0901280267569515,1.089477832817337,-0.0003735226805861025,-0.0001431649626032063,0.0007190681468966589,-0.00022906088751351028,-0.00032914344685286423,-0.0004204059167518537,1.0901969009642336,1.0887587646704402,,True,False,0.0,1.0989,1.0906999999999998,1.0914999999999997,1.0928999999999995,0,0.01,True,2024-07-17 11:45:00,,2024-07-15 19:03:31,2024-07-15 00:15:00,1.0889,2024-07-15 19:03:31,1.09073,0.01,even,True,33.67,719.92,4,0,29,7
2024-07-15 00:15:00,1.08889,1.08913,1.08882,1.08913,23,29,0,1.08882,1.08917867071425,5.843406494163694e-05,1.8768747743706417e-05,0.00035513154990567683,0.0003187945797238695,1.08781960833906,1.0884296790182617,2024-07-15 00:00:00,2024-07-15 00:00:00,-2.1547619045714228e-05,0.0008744467567298742,1.0899591666666664,-0.0005167481578983035,-0.0003108463766938675,1.0906409523809535,1.089992853751601,1.0916987300104324,1.0898448865730817,1.0905355941453543,0.00016502007718054504,9.356179663581442e-05,1.0870946673535136,1.0887042423196727,36.07305936072823,31.53319283455971,0.0008489768240539704,,1.0,0.08666337839787808,bullish,1.0896584265261553,1.0900540988490293,1.089313722050224,-0.00039567232287396337,-0.00019366643465735774,0.0007568921102434392,-0.00016411076711286832,-0.00022906088751351028,-0.00032914344685286423,1.0900706141604675,1.0885568299399806,,True,False,0.0,1.09913,1.0901299999999998,1.0909299999999997,1.0921299999999996,0,0.01,True,2024-07-17 11:40:00,,2024-07-15 19:45:21,2024-07-15 00:20:00,1.08913,2024-07-15 19:45:21,1.0901399999999999,0.01,even,True,18.58,738.5,5,0,29,7
2024-07-15 00:25:00,1.08903,1.0891,1.08901,1.08908,24,22,0,1.0889833304345211,1.0892536763878262,-4.285393152764729e-05,-2.254720556115342e-05,1.3365034070714937e-05,0.00015946570289661677,1.0885148121205082,1.089171242180037,2024-07-15 00:00:00,2024-07-15 00:00:00,-2.1547619045714228e-05,0.0008744467567298742,1.0899591666666664,-0.0005167481578983035,-0.0003108463766938675,1.0906409523809535,1.089992853751601,1.0916987300104324,1.0898448865730817,1.0905355941453543,0.00016502007718054504,9.356179663581442e-05,1.0870946673535136,1.0887042423196727,44.40639269406282,40.9436834094351,0.0008489768240539704,,1.0,0.08666337839787808,bullish,1.0894902343767148,1.0899130751449153,1.0890169384244923,-0.0004228407682005386,-0.0002748984656288459,0.0008094870803274316,-0.0001323770209846753,-0.00016440660474703606,-0.00016411076711286832,1.0898264255048198,1.0882074513441649,,True,False,0.0,1.09908,1.0908799999999998,1.0916799999999998,1.0930799999999996,0,0.01,True,2024-07-17 11:45:00,,2024-07-15 19:01:27,2024-07-15 00:30:00,1.08908,2024-07-15 19:01:27,1.09086,0.01,even,True,32.75,771.25,6,0,29,7
2024-07-15 00:45:00,1.08896,1.08902,1.08894,1.08901,45,22,0,1.08894,1.0892082243556005,-5.469615938587325e-05,2.8357246689588177e-05,-3.254047659855081e-05,9.183047011744697e-06,1.0888808533433263,1.0892369776956659,2024-07-15 00:00:00,2024-07-15 00:00:00,-2.1547619045714228e-05,0.0008744467567298742,1.0899591666666664,-0.0005167481578983035,-0.0003108463766938675,1.0906409523809535,1.089992853751601,1.0916987300104324,1.0898448865730817,1.0905355941453543,0.00016502007718054504,9.356179663581442e-05,1.0870946673535136,1.0887042423196727,42.40455317618609,42.562621733563496,0.0008489768240539704,,1.0,0.08666337839787808,bullish,1.0892495004204852,1.0896703107936394,1.0886662779497762,-0.00042081037315422343,-0.0003646226972422503,0.0008507265521621317,-3.7929136567527166e-05,-8.410388716839634e-05,-0.00010244238046075438,1.0895170045019384,1.087815551397614,,True,False,0.0,1.09901,1.0908099999999998,1.0916099999999997,1.0930099999999996,0,0.01,True,2024-07-17 11:45:00,,2024-07-15 19:02:00,2024-07-15 00:50:00,1.08901,2024-07-15 19:02:00,1.09082,0.01,even,True,33.3,804.55,7,0,29,7
2024-07-15 00:50:00,1.089,1.08925,1.089,1.0892,85,20,0,1.0889545871065247,1.0893882407802833,-0.00013278488188592214,-0.00011853964619564617,2.7137544893795576e-05,4.509835162096221e-05,1.0888568694013678,1.0891529681746401,2024-07-15 00:00:00,2024-07-15 00:00:00,-2.1547619045714228e-05,0.0008744467567298742,1.0899591666666664,-0.0005167481578983035,-0.0003108463766938675,1.0906409523809535,1.089992853751601,1.0916987300104324,1.0898448865730817,1.0905355941453543,0.00016502007718054504,9.356179663581442e-05,1.0870946673535136,1.0887042423196727,45.07710557532422,43.23326761483043,0.0008489768240539704,,1.0,0.08666337839787808,bullish,1.0892418849711798,1.0896354729570736,1.0886854901960785,-0.0003935879858938396,-0.0003704157549725682,0.000846878188734557,1.921224630230256e-05,-3.7929136567527166e-05,-8.410388716839634e-05,1.089532368384813,1.087838612007344,,True,False,0.0,1.0992,1.0901999999999998,1.0909999999999997,1.0921999999999996,0,0.01,True,2024-07-17 11:40:00,,2024-07-15 15:20:02,2024-07-15 00:55:00,1.0892,2024-07-15 15:20:02,1.09021,0.01,even,True,18.58,823.13,8,0,29,7
2024-07-15 19:55:00,1.0903100000000001,1.09064,1.0903100000000001,1.09055,450,12,0,1.0896116379800391,1.0907104750836607,1.6851752133708903e-05,-0.00012880056962831374,-0.0003149137771030976,5.423074044472116e-05,1.0898869067661319,1.0916302009213643,2024-07-15 19:00:00,2024-07-15 19:00:00,-9.35714285719147e-05,0.0005544513073176827,1.0910258333333345,-4.79674828630151e-05,0.0002705715133414216,1.0912250000000001,1.0901454672476603,1.09130942440613,1.0899279747506063,1.0914361089475408,0.00016925137424681906,0.00022314488551315308,1.088721296475115,1.0900112525160508,25.433526011556044,18.246278545177862,0.0004475031437316355,,1.0,0.08717245305338503,bullish,1.0904865573647566,1.0907365657754318,1.0901681905744758,-0.0002500084106751288,-0.00023305126072974293,0.0005856426668302218,2.89267285873418e-05,-2.2019263846706494e-05,-3.126934984587493e-05,1.090753833241306,1.0895825479076455,,True,False,0.0,1.10055,1.0923499999999997,1.0931499999999996,1.0945499999999995,0,0.01,True,,,2024-07-17 19:25:28,2024-07-15 20:00:00,1.09055,2024-07-17 19:25:28,1.09234,0.01,even,True,32.94,856.0699999999999,9,0,29,7
2024-07-18 09:40:00,1.09284,1.093,1.09279,1.093,358,12,0,1.09279,1.0930233303608823,6.737933654795397e-05,7.166288570249002e-05,-5.031581019773132e-05,-7.62544999137171e-05,1.092849247105429,1.0931801117755888,2024-07-18 09:00:00,2024-07-18 09:00:00,4.8333333333205886e-05,0.00022253973093944168,1.0932480952380947,-0.00010772256110862791,6.827093433446061e-05,1.093363452380952,1.093150452718757,1.0935326519327488,1.0931841050828481,1.0938377416179785,-2.3067959913418315e-05,-2.329175265006874e-05,1.0919040878430393,1.0929534073324665,19.019857253903755,16.296845923727123,0.0003933881230484937,,1.0,0.08928007801278606,bullish,1.093173704670966,1.0932752251606557,1.093090371517029,-0.00010152048968969929,-3.758008423292207e-05,0.00021901141493180237,-6.838321293267668e-05,-0.0001114275885798488,-8.566563467438115e-05,1.093309382931961,1.0928713601020972,,True,False,0.0,1.103,1.087,1.0932,1.0939999999999999,0,0.01,False,,,2024-07-23 11:07:48,2024-07-18 09:45:00,1.093,2024-07-23 11:07:48,1.08706,0.01,fail,False,-109.29,746.78,0,1,29,7
2024-07-18 09:45:00,1.09302,1.09305,1.09287,1.09304,256,12,0,1.0928809215935384,1.0930390886628747,2.4118378031620942e-05,0.0001222395535961747,-2.772676951083244e-05,3.0505287826421233e-05,1.0926596329804488,1.0931273036329094,2024-07-18 09:00:00,2024-07-18 09:00:00,4.8333333333205886e-05,0.00022253973093944168,1.0932480952380947,-0.00010772256110862791,6.827093433446061e-05,1.093363452380952,1.093150452718757,1.0935326519327488,1.0931841050828481,1.0938377416179785,-2.3067959913418315e-05,-2.329175265006874e-05,1.0919040878430393,1.0929534073324665,25.157232704405278,20.437896026194483,0.0003933881230484937,,1.0,0.08928007801278606,bullish,1.0931531347215866,1.0932578010746812,1.0930333574131414,-0.00010466635309458461,-5.099733800525458e-05,0.0002260162233199821,-5.70141038875871e-05,-6.838321293267668e-05,-0.0001114275885798488,1.0932593736364615,1.0928073411898214,,True,False,0.0,1.10304,1.08704,1.09324,1.09404,0,0.01,False,,,2024-07-23 11:07:35,2024-07-18 09:50:00,1.09304,2024-07-23 11:07:35,1.08704,0.01,fail,False,-110.4,636.38,0,2,29,7
2024-07-18 09:50:00,1.09304,1.09318,1.093,1.0931,287,12,0,1.092920013570056,1.0931733352855615,1.829305803611954e-05,0.00012195330169143013,5.155767279936518e-05,8.735290375151658e-05,1.0926984967404938,1.0930050163844807,2024-07-18 09:00:00,2024-07-18 09:00:00,4.8333333333205886e-05,0.00022253973093944168,1.0932480952380947,-0.00010772256110862791,6.827093433446061e-05,1.093363452380952,1.093150452718757,1.0935326519327488,1.0931841050828481,1.0938377416179785,-2.3067959913418315e-05,-2.329175265006874e-05,1.0919040878430393,1.0929534073324665,34.02332539537324,26.066805117894138,0.0003933881230484937,,1.0,0.08928007801278606,bullish,1.0931449601490348,1.0932461121061863,1.0930053216374274,-0.00010115195715143521,-6.1028261834490707e-05,0.00022958295495068817,-2.8035775714085887e-05,-5.70141038875871e-05,-6.838321293267668e-05,1.0932349045923782,1.0927757386824766,,True,False,0.0,1.1031,1.0871,1.0933,1.0940999999999999,0,0.01,False,,,2024-07-23 11:07:35,2024-07-18 09:55:00,1.0931,2024-07-23 11:07:35,1.08704,0.01,fail,False,-111.5,524.88,0,3,29,7
2024-07-22 11:45:00,1.0887,1.08872,1.08842,1.08853,258,12,0,1.08842,1.0888382283829519,6.511849554451499e-05,6.509800285474256e-05,-0.00019590143306699208,-0.0001405766872835513,1.0888770152144083,1.0893752894803563,2024-07-22 11:00:00,2024-07-22 11:00:00,5.29761904759507e-05,-9.119054709350038e-05,1.0885266666666673,-5.973045542646819e-05,-9.380360640496848e-06,1.0884452380952372,1.0879544353041966,1.089209131230763,1.0888735911471257,1.089308529611743,-0.00010977713600965374,-0.0003289385342736104,1.089419140081128,1.0888504459856674,42.50319284802793,60.917438319209005,-5.567427240545809e-05,,-1.0,0.0848612984914589,bearish,1.0887320565244245,1.0886535215002073,1.088864609563125,7.853502421717451e-05,8.487375657227889e-05,0.00028758361087155245,-7.821465428192731e-05,-2.2824217405625902e-05,1.0220158238816168e-05,1.0891521931739965,1.0885770259522534,,False,True,1.0,1.07853,1.08833,1.08753,1.0865300000000002,1,0.01,True,2024-07-23 13:10:00,,2024-07-22 16:34:11,2024-07-22 11:50:00,1.08853,2024-07-22 16:34:11,1.08832,0.01,even,True,3.86,528.74,1,0,30,7
2024-07-24 08:50:00,1.08518,1.0852,1.08508,1.08512,131,12,0,1.085090006239561,1.085330006806509,-9.216962347682279e-05,-6.45048639438054e-05,5.068580219985425e-05,6.17017474468809e-05,1.084895468349245,1.0850944899920698,2024-07-24 08:00:00,2024-07-24 08:00:00,-3.4523809513409276e-06,-0.0005048600393815494,1.0846854761904765,6.879346025542168e-05,6.432977165316948e-05,1.08445130952381,1.0840523479607163,1.0849757061826124,1.084257720911651,1.085056016837128,-8.628624592123659e-05,-7.100943438002735e-05,1.0867218888275674,1.0856007030015118,93.50641025641653,95.02430107711824,-0.0005894392681992318,,-1.0,0.0811503651614846,bearish,1.0849018262766426,1.084740231994806,1.085070787753698,0.00016159428183648572,0.00010882523230775691,0.00024389683596814005,4.8837289301939535e-05,7.837633298879432e-05,8.000000000096819e-05,1.0853146845896662,1.0848268909177299,,False,True,1.0,1.07512,1.0841200000000002,1.0833200000000003,1.0821200000000004,1,0.01,True,2024-07-29 14:55:00,,2024-07-24 13:05:17,2024-07-24 08:55:00,1.08512,2024-07-24 13:05:17,1.08413,0.01,even,True,18.21,546.95,2,0,30,7
2024-07-24 10:25:00,1.08486,1.08491,1.08459,1.08459,272,12,0,1.0834132178381088,1.08491,-0.00024298191461636452,-0.00048297952176684975,-3.5306218294729634e-05,5.609914159467167e-05,1.0842449391196352,1.0853652078964544,2024-07-24 10:00:00,2024-07-24 10:00:00,-0.00011202380952379798,-0.0004151053278813599,1.0840267857142853,-0.00039477812626338243,3.724646300001887e-05,1.0845734523809527,1.084186678687318,1.0851715311650847,1.0841222303552012,1.0847726887317466,0.00015385827878209224,1.5949856816552346e-05,1.0864780757689312,1.0852835710204796,51.30434782608908,43.99787296972729,-0.0005237000564993329,,-1.0,0.08116974116349104,bearish,1.0845916097518817,1.084625485788339,1.0844438321293441,-3.38760364573254e-05,-4.8306432840241e-05,0.00031388055041361854,4.081527347876701e-05,8.09115927074e-05,8.144822841460453e-05,1.0847577126797578,1.0841299515789304,,False,True,1.0,1.07459,1.08439,1.08359,1.0825900000000002,1,0.01,True,2024-07-29 14:45:00,,2024-07-24 13:24:20,2024-07-24 10:30:00,1.08459,2024-07-24 13:24:20,1.08439,0.01,even,True,3.68,550.63,3,0,30,7
2024-07-24 10:30:00,1.0839,1.0839,1.08315,1.08343,776,12,0,1.08315,1.0839,-3.655141565588258e-05,-0.00019405440661066306,-0.0003195630761386242,-0.0003473381257951869,1.0842598215109343,1.0855758170632133,2024-07-24 10:00:00,2024-07-24 10:00:00,-0.00011202380952379798,-0.0004151053278813599,1.0840267857142853,-0.00039477812626338243,3.724646300001887e-05,1.0845734523809527,1.084186678687318,1.0851715311650847,1.0841222303552012,1.0847726887317466,0.00015385827878209224,1.5949856816552346e-05,1.0864780757689312,1.0852835710204796,35.87554846429919,45.509754719882324,-0.0005237000564993329,,-1.0,0.08116974116349104,bearish,1.0844129005592846,1.084536931285499,1.0842539834881315,-0.00012403072621447464,-6.345129151508773e-05,0.0004062031510567196,-0.000189848641212631,4.081527347876701e-05,8.09115927074e-05,1.0846601866391883,1.0838477803370747,,False,True,1.0,1.0734299999999999,1.08163,1.0808300000000002,1.0794300000000003,1,0.01,True,,,2024-07-29 18:00:25,2024-07-24 10:35:00,1.08343,2024-07-29 18:00:25,1.08164,0.01,even,True,32.93,583.56,4,0,30,7
2024-07-24 10:35:00,1.08344,1.08357,1.08319,1.08335,488,12,0,1.08319,1.0835875767190661,-0.00011979074958788902,-0.00014694458883167215,-0.0006025442113055204,-0.000722663721644052,1.084653883748869,1.0855115384685403,2024-07-24 10:00:00,2024-07-24 10:00:00,-0.00011202380952379798,-0.0004151053278813599,1.0840267857142853,-0.00039477812626338243,3.724646300001887e-05,1.0845734523809527,1.084186678687318,1.0851715311650847,1.0841222303552012,1.0847726887317466,0.00015385827878209224,1.5949856816552346e-05,1.0864780757689312,1.0852835710204796,19.223507512297335,35.46780126756192,-0.0005237000564993329,,-1.0,0.08116974116349104,bearish,1.0842493773963178,1.0844490104495361,1.0840707086343317,-0.000199633053218351,-9.068764385574039e-05,0.0004817305608555669,-0.00018327485379976416,-0.000189848641212631,4.081527347876701e-05,1.0845524391951873,1.0835889780734762,,False,True,1.0,1.07335,1.0815500000000002,1.0807500000000003,1.0793500000000005,1,0.01,True,,,2024-07-29 18:00:17,2024-07-24 10:40:00,1.08335,2024-07-29 18:00:17,1.08155,0.01,even,True,33.11,616.67,5,0,30,7
2024-07-24 10:40:00,1.08335,1.08335,1.08306,1.08315,441,12,0,1.0830708138247414,1.0834400319227513,-0.0001726446268511344,-0.0001477181368008456,-0.00048297952176684975,-0.00024298191461636452,1.083392191367661,1.0848681479664906,2024-07-24 10:00:00,2024-07-24 10:00:00,-0.00011202380952379798,-0.0004151053278813599,1.0840267857142853,-0.00039477812626338243,3.724646300001887e-05,1.0845734523809527,1.084186678687318,1.0851715311650847,1.0841222303552012,1.0847726887317466,0.00015385827878209224,1.5949856816552346e-05,1.0864780757689312,1.0852835710204796,8.6610354443679,21.253363806988194,-0.0005237000564993329,,-1.0,0.08116974116349104,bearish,1.0840802424122689,1.0843527874532743,1.0838843756449954,-0.0002725450410054897,-0.00012705912328569025,0.0005551050950911308,-0.00018633298933634634,-0.00018327485379976416,-0.000189848641212631,1.0844394807400866,1.0833292705499042,,False,True,1.0,1.07315,1.0821500000000002,1.0813500000000003,1.0801500000000004,1,0.01,True,,,2024-07-29 18:05:49,2024-07-24 10:45:00,1.08315,2024-07-29 18:05:49,1.08211,0.01,even,True,19.13,635.8,6,0,30,7
2024-07-26 09:40:00,1.08502,1.08518,1.08502,1.08516,187,12,0,1.08502,1.0851785710751636,1.8824360731383696e-05,2.5011511792934873e-05,-1.8689662847662954e-05,-7.680107130091467e-06,1.0850076519152936,1.0852283423576645,2024-07-26 09:00:00,2024-07-26 09:00:00,9.761904762317641e-06,0.0002569164249688338,1.0855784523809515,-9.694703292123229e-05,6.395134854466023e-06,1.0857785714285717,1.0854022269372763,1.0859797325103673,1.0851390747940695,1.085990261938873,-2.627969922551853e-07,0.00010175230766886707,1.085139567528515,1.0851041149952032,9.627062706273355,11.349834983502362,0.0001903628472931569,,1.0,0.08220707933026865,bullish,1.0852750950318966,1.085437440870268,1.0850426694186457,-0.00016234583837149152,-0.00010805479566962806,0.00030212138828305743,-4.15376676985435e-05,-7.792569659303972e-05,-8.400756794113562e-05,1.0853447908069287,1.0847405480303627,,True,False,0.0,1.09516,1.0853599999999999,1.0861599999999998,1.0871599999999997,0,0.01,True,,,2024-07-26 15:27:04,2024-07-26 09:45:00,1.08516,2024-07-26 15:27:04,1.0854,0.01,even,True,4.42,640.2199999999999,7,0,30,7
2024-07-26 09:50:00,1.08511,1.08524,1.08505,1.08514,138,12,0,1.0850608501998689,1.0852291481810534,2.810829012268738e-06,6.475785582414518e-05,2.8302697110245324e-05,9.875127298077288e-06,1.0850187309425552,1.0851503677547913,2024-07-26 09:00:00,2024-07-26 09:00:00,9.761904762317641e-06,0.0002569164249688338,1.0855784523809515,-9.694703292123229e-05,6.395134854466023e-06,1.0857785714285717,1.0854022269372763,1.0859797325103673,1.0851390747940695,1.085990261938873,-2.627969922551853e-07,0.00010175230766886707,1.085139567528515,1.0851041149952032,16.25860966475552,12.455617691124578,0.0001903628472931569,,1.0,0.08220707933026865,bullish,1.0852328195198786,1.0853929499916561,1.0849790884072934,-0.00016013047177754203,-0.0001273395947470607,0.00032007707393411853,-1.831441348421059e-05,-4.526659786807663e-05,-4.15376676985435e-05,1.0852991654812276,1.0846590113333592,,True,False,0.0,1.09514,1.08534,1.0861399999999999,1.0871399999999998,0,0.01,True,,,2024-07-26 15:27:29,2024-07-26 09:55:00,1.08514,2024-07-26 15:27:29,1.08532,0.01,even,True,3.31,643.5299999999999,8,0,30,7
2024-07-26 09:55:00,1.08515,1.08526,1.08509,1.08517,175,12,0,1.0851008488888765,1.0853066612153726,-8.321275627185382e-05,6.142530917007557e-05,2.5011511792934873e-05,1.8824360731383696e-05,1.0850216694567953,1.0851807895702237,2024-07-26 09:00:00,2024-07-26 09:00:00,9.761904762317641e-06,0.0002569164249688338,1.0855784523809515,-9.694703292123229e-05,6.395134854466023e-06,1.0857785714285717,1.0854022269372763,1.0859797325103673,1.0851390747940695,1.085990261938873,-2.627969922551853e-07,0.00010175230766886707,1.085139567528515,1.0851041149952032,17.909016168823502,15.216268845307958,0.0001903628472931569,,1.0,0.08220707933026865,bullish,1.0852231549783589,1.0853764351774593,1.0849819539043697,-0.00015328019910043622,-0.00013252771561773582,0.000323155277317742,2.865497076287582e-06,-1.831441348421059e-05,-4.526659786807663e-05,1.0853051091816874,1.084658798627052,,True,False,0.0,1.09517,1.08537,1.0861699999999999,1.0871699999999997,0,0.01,True,,,2024-07-26 15:25:00,2024-07-26 10:00:00,1.08517,2024-07-26 15:25:00,1.08539,0.01,even,True,4.05,647.5799999999998,9,0,30,7
