time,open,high,low,close,tick_volume,spread,real_volume,hourly_time,time2,prev_hour_lsma_slope,prev_hour_macd_line,hour_lsma,fixed_support_gradient,fixed_resistance_gradient,prev_hour_lsma,fixed_support_trendline,fixed_resistance_trendline,ema_short,ema_long,lsma,macd_line,macd_signal,lsma_stddev,lsma_slope,prev_lsma_slope_1,prev_lsma_slope_2,lsma_upper_band,lsma_lower_band,stoch_k,stoch_d,is_buy2,is_sell2,tp,sl,be,be_condition,time_updated,sl_updated,time_to_trail,time_tp_hit,time_sl_hit,type,success,profit,account_balance,win_streak,losing_streak,Week,Month
2024-04-11 06:00:00,71015.266,71057.836,70838.125,70876.438,2076,36421,0,2024-04-11 06:00:00,2024-04-11 06:00:00,145.79365476185922,523.2879816811328,70882.2510238095,0.0006324659707728801,0.0010701257375507942,70772.88442857141,67366.69957840769,70286.75910319341,70733.2803924097,70467.29268292611,70813.61877364977,172.78616465050436,175.26061493864637,373.7151582389078,57.21420880628284,97.25704987961217,46.27562641892291,71319.63423727229,70309.10331002725,84.44436630842401,85.07434779703452,True,False,71376.438,70476.438,70976.438,71026.438,,False,2024-04-11 11:45:00,,2024-04-11 07:17:49,fail,False,-0.0,450.0,0,1,15,4
2024-04-11 07:00:00,70888.281,70918.141,70534.992,70643.734,1652,36421,0,2024-04-11 07:00:00,2024-04-11 07:00:00,109.36659523808339,543.2550790163077,70824.24226190474,0.0010669962572823093,0.0011549576235815764,70882.2510238095,67326.00614510721,70291.28555534479,70778.81325602291,70565.26073282266,70911.52926797382,152.5312649821135,167.62247078565542,182.8187618700146,-23.653679050607025,30.262222222198034,51.80998452012136,71158.33459649835,70663.2239394493,62.0681712063187,70.5579235624996,True,False,71143.734,70743.734,70743.734,70793.734,2024-04-11 09:15:00,True,2024-04-11 09:15:00,2024-04-11 10:18:40,2024-04-11 09:21:08,even,True,18.62,468.62,1,0,15,4
2024-04-11 08:00:00,70633.953,70720.539,70586.547,70712.336,1488,36421,0,2024-04-11 08:00:00,2024-04-11 08:00:00,-58.008761904755374,533.0602512416808,70740.75822619049,0.0014546120315861554,0.0011549499847929444,70824.24226190474,67349.96463079208,70372.29495311309,70704.60482509127,70579.75303097587,70763.4339287926,112.33225779500208,140.52823317939806,171.38082590215103,-29.50040660475497,-39.373791881647776,-44.125414860696765,70994.7980437605,70530.5698138247,33.314909238952815,27.844752283871824,True,False,71212.336,70812.336,70812.336,70862.336,2024-04-11 10:15:00,True,2024-04-11 10:15:00,2024-04-11 10:21:51,2024-04-11 10:57:33,success,True,93.08,561.7,2,0,15,4
2024-04-11 09:00:00,70611.484,70884.227,70593.578,70811.836,1836,36421,0,2024-04-11 09:00:00,2024-04-11 09:00:00,-83.48403571425297,517.7853149368602,70740.75311904763,0.0018110549802204546,0.001155043458359322,70740.75822619049,67428.10662718574,70453.74176385989,70680.20951633912,70597.22329647308,70637.12631269355,85.64144297174062,110.97583541938009,175.71999422306314,0.7998527692252537,-37.32884760922752,-48.35677708979347,70875.84830489468,70399.90432049242,35.00167984389885,29.845195198802884,True,False,71311.836,70411.836,70911.836,70961.836,,False,2024-04-11 10:45:00,2024-04-11 10:24:22,2024-04-11 14:01:14,success,True,93.08,654.7800000000001,3,0,15,4
2024-04-11 10:00:00,70744.938,71029.039,70744.938,70915.438,1728,36421,0,2024-04-11 10:00:00,2024-04-11 10:00:00,-0.0051071428606519476,509.8169595420768,70752.68599999994,0.0020803529494733196,0.0011549475318574157,70740.75311904763,67553.63033188958,70535.78094716356,70736.24357714088,70647.7609440047,70675.64614275884,77.9578719905985,91.68475804608165,149.7380695735188,48.65831991744926,7.018202958337497,5.6398906089307275,70879.29253668309,70473.49974883458,66.56030054318528,58.14925481621119,True,False,71415.438,71015.438,71015.438,71065.438,2024-04-11 11:45:00,True,2024-04-11 11:45:00,,2024-04-11 12:01:38,even,True,18.62,673.4000000000001,4,0,15,4
2024-04-11 12:00:00,71081.641,71101.938,70883.25,70956.438,1863,36421,0,2024-04-11 12:00:00,2024-04-11 12:00:00,93.18817857147951,511.1092403448565,70767.24746428571,0.0022457233208850774,0.0015262915853009194,70845.87417857142,67859.35463625034,70519.55810263373,70909.28429059841,70791.51751610986,71014.65503371168,80.28199977366603,81.11692470577087,169.9290076739625,10.298196078365436,39.667453732399736,71.00206914344744,71245.55919407152,70785.25087335183,66.42755702722552,61.678807947019436,True,False,71456.438,70556.438,71056.438,71106.438,,False,2024-04-12 08:00:00,,2024-04-11 13:45:18,fail,False,-74.48,598.9200000000001,0,1,15,4
2024-04-11 13:00:00,70646.734,70806.438,70591.734,70672.039,1589,36421,0,2024-04-11 13:00:00,2024-04-11 13:00:00,-78.62671428571048,479.17509665506077,70699.62082142859,0.002009381210504053,0.0015263533957497858,70767.24746428571,67960.68903368658,70626.82821472062,70821.1945153409,70776.93522931881,70876.68454179565,50.576695676281815,69.33287959993771,167.98675760839222,-58.82356553147838,-55.92456759548804,-18.034297557533137,71103.46666456698,70648.40241902432,10.323888698712823,21.89237764470009,True,False,71172.039,70272.039,70772.039,70822.039,,False,2024-04-11 15:45:00,2024-04-12 07:46:15,2024-04-11 14:40:33,fail,False,-74.48,524.44,0,2,15,4
2024-04-12 18:00:00,69279.641,69521.336,69250.758,69397.938,2462,36421,0,2024-04-12 18:00:00,2024-04-12 18:00:00,-436.7129523809708,-26.039613367029233,69687.31613095237,1.7784557027436673e-05,0.00012102339618139663,70013.01730952383,69228.77198170088,71219.69025586368,69909.50092413076,70253.80833216407,69522.9138937048,-147.62942211565678,-86.81752664295901,528.3600279035435,-140.89791640866315,-192.70046164433006,-138.55948366016673,70236.19993137458,68808.12785603502,7.729535997798585,8.920546515101618,False,True,68897.938,69297.938,69297.938,69247.938,2024-04-12 19:15:00,True,2024-04-12 19:15:00,2024-04-12 19:19:33,,success,True,93.08,617.5200000000001,1,0,15,4
2024-04-12 20:00:00,68863.766,68997.938,68484.695,68597.234,4132,36421,0,2024-04-12 20:00:00,2024-04-12 20:00:00,-402.99639285710873,-208.03137415339006,68750.11229761905,-0.001307929567317394,2.314684522960099e-05,69284.31973809526,68750.34546060003,71270.71906683788,69228.80055316207,69701.69540350369,68805.49810629511,-235.93786858275416,-184.2423219796694,751.64098722458,-121.19497729616705,-61.735792225721525,-114.50815755066287,69820.2134390483,67789.28277354193,7.37592006346198,8.642127122349786,False,True,68097.234,68997.234,68497.234,68447.234,,False,2024-04-12 20:30:00,2024-04-12 20:26:31,,success,True,93.08,710.6000000000001,2,0,15,4
2024-04-12 21:00:00,68172.156,68417.336,67992.039,68189.836,3671,36421,0,2024-04-12 21:00:00,2024-04-12 21:00:00,-534.2074404762097,-340.1471000216261,67825.98514285717,-0.002349883539191879,-0.0004721660517069177,68750.11229761905,67890.96505648723,71408.31904177909,68691.7694555809,69282.07282260802,68214.71374028207,-303.70909722390934,-247.12157228704672,852.3442648064847,-118.4654729962349,-121.1568861368869,-140.56470416240336,69365.37849777083,67062.5489827933,37.349948166901065,30.819185019444678,False,True,67689.836,68589.836,68089.836,68039.836,,False,2024-04-12 21:30:00,2024-04-12 21:27:43,,success,True,93.08,803.6800000000002,3,0,15,4
2024-04-12 22:00:00,66504.438,66915.938,66351.445,66613.734,5053,36421,0,2024-04-12 22:00:00,2024-04-12 22:00:00,-924.1271547618817,-573.1573342486226,67291.76961904766,-0.0023786046368726222,-0.00047225602464293076,67825.98514285717,67761.4435921371,71375.22098309147,67753.30423224537,68623.91992342565,67059.39918128657,-435.36153291279334,-334.29225893504514,1117.1383325097786,-268.45590849670407,-330.3635882353119,-370.8811117991281,68567.53593017477,65549.76243239838,31.701845157591862,29.546165793324707,False,True,66113.734,67013.734,66513.734,66463.734,,False,2024-04-15 00:15:00,2024-04-15 00:00:07,2024-04-12 22:31:07,fail,False,-74.48,729.2000000000002,0,1,15,4
2024-04-12 23:00:00,66844.094,67316.234,66676.938,67279.57,3532,36421,0,2024-04-12 23:00:00,2024-04-12 23:00:00,-534.2155238095147,-721.3592404464434,67041.12711904764,-0.0024675460336948366,-0.0004721717690787163,67291.76961904766,67695.28967169188,71341.39568288645,67403.42703638894,68199.58215711272,66629.57883316134,-443.79597292748804,-402.01924902337316,1140.1323465062078,2.2950908153579803,-97.65475645006518,-117.43810044715065,68170.25750094472,65090.40016537796,48.927476999174274,44.152870901356636,False,True,66779.57,67179.57,67179.57,67129.57,2024-04-13 00:00:00,True,2024-04-13 00:00:00,2024-04-15 00:00:07,,success,True,93.08,822.2800000000002,1,0,15,4
2024-04-15 00:00:00,63764.258,63806.738,63482.84,63649.438,2491,56422,0,2024-04-15 00:00:00,2024-04-15 00:00:00,-250.6425000000163,-807.0428394282499,65732.67,-0.0032835368579563025,-0.0004724961496319424,67041.12711904764,67111.99499470899,71309.80027919475,66771.7397817223,67680.8769166853,66120.91768317852,-497.11457188280474,-426.69545225086154,1342.9734940935089,-618.04502476778,26.812867217027815,40.74033642934228,67933.93190020476,64306.403466152275,41.21258833267519,52.71424515012843,False,True,63149.438,63549.438,63549.438,63499.438,2024-04-15 00:45:00,True,2024-04-15 00:45:00,2024-04-15 21:17:43,2024-04-15 00:52:18,even,True,18.62,840.9000000000002,2,0,16,4
2024-04-15 02:00:00,65274.723,65330.738,64999.258,65287.488,3030,36422,0,2024-04-15 02:00:00,2024-04-15 02:00:00,-472.66613095239154,-1263.6887670325814,65140.916928571394,-0.0037288885436773875,-0.001172871767072553,65260.00386904761,67141.09652289413,71586.82850580495,65320.987294775725,66298.2898319528,64474.914863777085,-599.3177600388153,-597.6938961740232,1605.8996827254318,-25.8378964568401,38.65211317511421,2.0499043687377707,66642.87943545642,62305.450292097754,46.42645109785398,45.18696331034894,False,True,64787.488,65687.488,65187.488,65137.488,,False,2024-04-15 05:15:00,2024-04-15 07:08:34,2024-04-15 02:21:10,fail,False,-74.48,766.4200000000002,0,1,16,4
2024-04-15 03:00:00,65592.672,65822.711,65341.84,65671.336,3166,36421,0,2024-04-15 03:00:00,2024-04-15 03:00:00,-119.08694047621248,-1317.7581334132701,65123.24151190476,-0.0039007573736594215,-0.0016898013570609397,65140.916928571394,67061.9705624811,71721.46757985612,65466.6736246914,66117.21564968182,64866.14493876849,-478.47184433971415,-549.108435351559,1372.7713110770446,165.1605538355725,106.85489301691268,94.48841726858518,66720.8862087225,63012.903668814484,57.770787891353116,55.384822919582895,False,True,65171.335999999996,65571.336,65571.336,65521.335999999996,2024-04-15 03:30:00,True,2024-04-15 03:30:00,2024-04-15 04:47:28,2024-04-15 03:32:12,even,True,18.62,785.0400000000002,1,0,16,4
2024-04-15 05:00:00,65234.125,65321.539,65090.887,65097.84,3057,36422,0,2024-04-15 05:00:00,2024-04-15 05:00:00,21.589714285750233,-1389.172507973315,65051.1235833333,-0.004253831818616873,-0.0028666855245077045,65144.83122619051,66846.43802070021,71810.34028298673,65365.757838850885,65767.1129273047,65563.61248813207,-336.25237962395477,-399.52834901025506,1082.1420424507437,-175.71681527349574,-108.69381768147286,-57.134966976285796,67024.50424544058,64101.22073082357,40.273424102542506,58.93540927819755,False,True,64597.84,64997.84,64997.84,64947.84,2024-04-15 07:15:00,True,2024-04-15 07:15:00,2024-04-15 17:46:55,2024-04-15 08:02:21,even,True,18.62,803.6600000000002,2,0,16,4
2024-04-15 06:00:00,65084.34,65268.797,64981.84,65147.738,2782,36422,0,2024-04-15 06:00:00,2024-04-15 06:00:00,-93.70764285721089,-1410.3033426372276,65093.34097619043,-0.0044206683284933835,-0.0034712937905431044,65051.1235833333,66694.76703965203,71731.15203889435,65241.6827154727,65593.27099920104,65165.092442380555,-294.1855332466657,-345.27710107822213,686.8645217663652,-63.97090608859435,-62.79063501900964,-103.12472205016093,66092.35954676515,64236.325337995964,21.523164384040744,20.62058296153734,False,True,64647.738,65047.738,65047.738,64997.738,2024-04-15 07:15:00,True,2024-04-15 07:15:00,2024-04-15 07:15:16,2024-04-15 08:22:17,success,True,93.08,896.7400000000002,3,0,16,4
2024-04-15 07:00:00,65089.738,65125.84,64664.391,64739.637,2825,36422,0,2024-04-15 07:00:00,2024-04-15 07:00:00,42.217392857135565,-1410.3563972299162,65202.2004880953,-0.0044518001414818814,-0.0040403417039856625,65093.34097619043,66424.75648621719,71561.1512391091,65141.81268496326,65450.520418644606,64987.18362125902,-256.25961989045027,-296.42485938536333,239.87889701308936,-76.59980116964289,-38.275445132370805,-21.372878225010936,65311.020132226695,64661.847110291346,26.12928015050781,31.700682259376975,False,True,64239.637,65139.637,64639.637,64589.637,,False,2024-04-15 18:00:00,2024-04-15 17:49:23,2024-04-15 08:23:45,fail,False,-74.48,822.2600000000002,0,1,16,4
2024-04-15 08:00:00,64858.938,65014.738,64851.719,64907.238,2676,36422,0,2024-04-15 08:00:00,2024-04-15 08:00:00,108.85951190486958,-1412.9603642500442,65129.95963095236,-0.004828944908211001,-0.004466705291024392,65202.2004880953,66376.57315408738,71298.74972015702,65014.383089126684,65299.3117948014,64864.71889886484,-230.6655858414888,-262.73163978146965,272.69258776662315,-8.398993463997613,-39.701670794645906,-32.65671310629841,65232.85389234978,64495.0839053799,27.23056365961453,22.824387980630423,False,True,64407.238,65307.238,64807.238,64757.238,,False,2024-04-15 18:00:00,2024-04-15 17:48:02,2024-04-15 08:42:48,fail,False,-74.48,747.7800000000002,0,2,16,4
2024-04-15 09:00:00,65409.84,65684.57,65300.859,65581.141,3074,36421,0,2024-04-15 09:00:00,2024-04-15 09:00:00,-72.24085714294051,-1354.7872288470098,65522.01180952385,-0.005148404238538845,-0.0036414431584706444,65129.95963095236,66242.96858220063,70981.6698850393,65177.731700497316,65307.39629958979,65135.39133333336,-157.30116073790123,-216.17752939886452,253.22641716046323,115.4793157895183,97.7782414860485,40.098183006550244,65478.74699649999,64793.53567016673,87.58367156760791,75.45653143011819,False,True,65081.141,65981.141,65481.141,65431.141,,False,2024-04-15 17:15:00,2024-04-15 17:39:09,2024-04-15 09:18:05,fail,False,-74.48,673.3000000000002,0,3,16,4
2024-04-15 22:00:00,63131.34,63156.637,62224.34,62977.34,5849,36422,0,2024-04-15 22:00:00,2024-04-15 22:00:00,-465.46145238093595,-1027.8590265983585,63349.956226190465,-0.0007587287814630077,-0.002401523020786451,63663.70532142858,63078.263747954355,68280.97572316714,63743.240828001595,64332.72606896074,63402.34248297206,-317.3334040566624,-273.39582915769176,903.584371208179,-140.87227038185665,-99.69855899552203,-4.891632610975648,64622.1813841031,62181.00358184102,25.290058848951237,26.044768789597327,False,True,62477.34,63377.34,62877.34,62827.34,,False,2024-04-16 05:30:00,2024-04-16 07:11:44,2024-04-15 22:32:37,fail,False,-74.48,598.8200000000002,0,4,16,4
2024-04-16 08:00:00,62446.137,62581.738,62323.84,62490.059,3597,36422,0,2024-04-16 08:00:00,2024-04-16 08:00:00,-273.2114761905468,-989.973167758937,62746.52298809522,-0.0024148572019121123,-0.002397820870170328,62889.195523809445,63431.9872564661,66661.97013166672,62697.259902906546,62969.80625535103,62447.35361300306,-154.73356245346076,-132.66177544798282,419.37482760750805,-88.96462538701599,-90.24431269351771,-164.51733918127138,63013.5096302732,61879.69759573293,28.48980319449336,18.29777561481986,False,True,61990.059,62890.059,62390.059,62340.059,,False,2024-04-16 13:30:00,2024-04-16 13:25:38,2024-04-16 09:04:13,fail,False,-74.48,524.3400000000001,0,5,16,4
2024-04-16 09:00:00,62664.539,62910.137,62594.34,62797.637,2798,36422,0,2024-04-16 09:00:00,2024-04-16 09:00:00,-142.6725357142277,-973.7220014029517,62828.4048452381,-0.002414915734726363,-0.002397584860265372,62746.52298809522,63278.35684053418,66501.42666204945,62711.43984988112,62904.30273433645,62507.35892363254,-129.75577613112546,-136.10596041957083,407.8203163065353,49.78827347775223,21.411664258761448,20.15070450627536,63059.41635064637,61956.80149661872,59.083929092273486,56.376119956514145,False,True,62297.637,63197.637,62697.637,62647.637,,False,2024-04-16 13:30:00,2024-04-16 13:24:30,2024-04-16 09:50:43,fail,False,-74.48,449.8600000000001,0,6,16,4
2024-04-16 10:00:00,63154.039,63222.738,63065.637,63122.461,2606,36422,0,2024-04-16 10:00:00,2024-04-16 10:00:00,81.88185714288556,-910.8446260368364,63025.469869047556,-0.0024671927352705758,-0.0022267827538513187,62828.4048452381,63144.23862325206,66364.16854222896,62873.2369286828,62938.54061998637,62761.87762779499,-78.37169677825295,-112.12955806976042,383.74825071660257,94.4196504987558,67.2310866874177,47.517222910209966,63281.4377662624,62243.81748932757,87.99142704900491,78.34540392785253,False,True,62622.461,63522.461,63022.461,62972.461,,False,2024-04-16 13:30:00,2024-04-16 13:19:59,2024-04-16 10:32:48,fail,False,-74.48,375.3800000000001,0,7,16,4
2024-04-16 18:00:00,62046.637,62373.539,61814.566,61961.938,4933,36422,0,2024-04-16 18:00:00,2024-04-16 18:00:00,-311.575964285752,-662.9138240814718,62200.38324999999,-0.0010588872171703916,-0.002002803748589812,62506.14190476186,62090.74438101495,65342.400353391444,62511.14479137447,62694.21877375462,62468.86028723768,-84.47669408706861,-52.13602212863078,440.0595118664991,-174.53899896798248,-194.82765600282437,-11.022219126185519,63062.94062825746,61873.2799462179,16.603009628084926,25.418443560284643,False,True,61461.938,61861.938,61861.938,61811.938,2024-04-16 19:00:00,True,2024-04-16 19:00:00,2024-04-17 17:19:05,2024-04-16 19:03:19,even,True,18.61,393.9900000000001,1,0,16,4
2024-04-16 19:00:00,61727.793,61968.34,61661.84,61881.34,4693,36422,0,2024-04-16 19:00:00,2024-04-16 19:00:00,-305.7586547618703,-706.0999839297801,62282.089154761925,-0.0010587851858897212,-0.002002831164044233,62200.38324999999,62025.07482442695,65210.99418323371,62218.652429694805,62489.8403688987,61910.8464330925,-128.61027996100893,-88.9843645932254,453.05438104291136,-144.85091916062083,-172.14423082221765,-141.55186068117473,62522.469847500426,61297.72301868457,7.588266241817983,11.036450045207443,False,True,61381.34,62281.34,61781.34,61731.34,,False,2024-04-17 17:30:00,2024-04-17 17:19:09,2024-04-16 19:47:45,fail,False,-74.48,319.5100000000001,0,1,16,4
2024-04-17 20:00:00,60147.84,60531.738,60062.934,60316.34,4700,36422,0,2024-04-17 20:00:00,2024-04-17 20:00:00,-572.9835714286892,-655.1720565259529,60722.63403571426,-0.0008347109007548739,7.372753096218457e-05,60751.39141666661,60458.536929156995,64424.3450456259,60762.23446985257,61469.125730920685,60063.53924389407,-382.6122070424317,-332.0385426496059,1027.2267634213342,-114.16294564842246,-165.5878844168983,-200.70489439287485,61450.29537451287,58675.28311327527,17.06611581658369,22.120246710923535,False,True,59816.34,60716.34,60216.34,60166.34,,False,2024-04-19 05:30:00,2024-04-19 05:22:53,2024-04-17 20:28:13,fail,False,-74.48,245.0300000000001,0,2,16,4
2024-04-19 00:00:00,63432.539,63608.039,63358.586,63559.84,2094,56422,0,2024-04-19 00:00:00,2024-04-19 00:00:00,-21.609428571449826,381.9708931891073,63270.11260714291,0.001285369039945115,0.0016413269057999524,63297.68180952381,60419.33994178035,62837.306559835204,63333.09213486335,63172.80459757621,63368.97103508772,116.90046185829124,123.75785616063993,323.3148840767903,93.8982917096946,87.45789852079906,53.48463501895458,63806.946128591386,62932.49594158406,92.93628655942462,90.47803282022649,True,False,64059.84,63159.84,63659.84,63709.84,,False,2024-04-19 10:00:00,2024-04-19 09:48:18,2024-04-19 01:18:42,fail,False,-74.48,170.55000000000007,0,3,16,4
2024-04-19 01:00:00,63400.109,63529.137,63258.238,63331.938,2105,56422,0,2024-04-19 01:00:00,2024-04-19 01:00:00,-27.569202380902425,396.3645323208184,63366.08941666668,0.0014094925107980228,0.0016412799086842063,63270.11260714291,60467.24995653731,62940.28882927321,63364.95212676497,63233.15122673299,63571.92566563467,102.0076184119971,114.15191123975174,296.2032325828531,17.889699002415,48.640816993465705,90.54875610599993,63973.300029621525,63172.051301647814,65.6940777042348,74.25829879131756,True,False,63831.938,63431.938,63431.938,63481.938,2024-04-19 02:15:00,True,2024-04-19 02:15:00,2024-04-19 09:45:07,2024-04-19 02:28:37,even,True,18.61,189.16000000000008,1,0,16,4
2024-04-19 02:00:00,63451.477,63589.137,63339.844,63589.137,1821,36422,0,2024-04-19 02:00:00,2024-04-19 02:00:00,95.97680952376686,407.3285341212031,63427.99995238099,0.0015975572009529644,0.0016412724838594315,63366.08941666668,60519.30479173347,63043.69947275639,63423.59154917425,63298.05031270561,63523.682547987555,94.10929625453718,102.65650822712962,285.88056983619487,25.081814585493703,-15.953609907192003,-41.573676298590726,63911.12131726642,63137.74377870869,60.29958471769728,53.81905842833945,True,False,64089.137,63189.137,63689.137,63739.137,,False,2024-04-19 10:00:00,2024-04-19 09:48:20,2024-04-19 03:05:53,fail,False,-74.48,114.68000000000008,0,1,16,4
2024-04-19 10:00:00,64572.465,65149.688,64231.848,64234.438,6482,36422,0,2024-04-19 10:00:00,2024-04-19 10:00:00,946.7216904761517,130.40323775480647,63520.34626190473,-0.0009981181321910783,0.001034527323267075,62667.82005952378,60321.11005254747,63953.31609455685,62837.84386234237,62501.44679836088,63207.17678293768,75.99850843360764,-53.90571162045137,1074.131903214208,223.14585999304109,308.2304330925399,263.92408909528604,64658.754852276856,61757.0987135985,87.39668919570242,80.76915479194965,True,False,64734.438,64334.438,64334.438,64384.438,2024-04-19 10:30:00,True,2024-04-19 10:30:00,2024-04-19 11:05:09,2024-04-19 10:30:08,even,True,18.62,133.30000000000007,1,0,16,4
2024-04-19 11:00:00,64501.34,65056.637,64385.238,64599.328,4457,36422,0,2024-04-19 11:00:00,2024-04-19 11:00:00,852.5262023809482,266.8452604823906,64226.56586904767,-0.0009983344130310367,0.001033549350344649,63520.34626190473,60261.15494835091,64019.86635946316,63640.391994907564,63024.61464848914,64314.640686618455,228.14403608672,88.37639544951605,1378.65810810466,246.85684038528416,282.4168396972236,289.416737186104,66177.32913255975,62453.452240677165,81.0177313201703,78.8674737996023,True,False,65099.328,64199.328,64699.328,64749.328,,False,2024-04-19 14:15:00,2024-04-19 13:06:26,2024-04-19 11:32:23,fail,False,-74.48,58.820000000000064,0,1,16,4
2024-04-19 12:00:00,64574.891,64720.938,64431.84,64622.438,3117,36422,0,2024-04-19 12:00:00,2024-04-19 12:00:00,706.2196071429426,376.7375887107628,64627.58714285714,-0.000998169857442215,0.0010337689172498358,64226.56586904767,60200.577403812094,64085.90831795098,64084.89982309588,63428.44583768296,64963.92812521504,293.52207256673864,199.88921241449165,1226.7804628573788,146.53228586180194,148.5419645682632,158.5582163742365,66621.5817500725,63307.77450035758,81.93117522624851,81.86497297837131,True,False,65122.438,64722.438,64722.438,64772.438,2024-04-19 14:15:00,True,2024-04-19 14:15:00,2024-04-19 14:39:56,2024-04-19 14:19:52,even,True,18.62,77.44000000000007,1,0,16,4
2024-04-19 13:00:00,64726.637,65117.738,64617.531,64722.691,2986,36422,0,2024-04-19 13:00:00,2024-04-19 13:00:00,401.0212738094706,470.48039186733513,64855.98785714286,-0.0009980953394295678,0.0010337002280701969,64627.58714285714,60140.54510423925,64152.411347126166,64367.22444115916,63754.07953874636,65113.17306673542,313.5059467680694,264.04883055748354,1204.387380090753,-12.870265565885347,19.396794289612444,44.22854110771732,66739.09602985793,63485.7501036129,81.048023456992,82.9274378464731,True,False,65222.691,64322.691,64822.691,64872.691,,False,2024-04-19 14:45:00,2024-04-19 14:39:57,2024-04-19 17:24:40,success,True,93.08,170.52000000000007,2,0,16,4
2024-04-19 14:00:00,64736.137,64989.539,64707.875,64811.137,3198,36422,0,2024-04-19 14:00:00,2024-04-19 14:00:00,228.40071428572264,539.1943670826877,64967.08200000007,-0.000998326928540026,0.0010336759539649025,64855.98785714286,60080.41371947701,64219.060384730365,64525.11757512032,64000.386836007754,64716.390088407315,301.29526509753487,287.83797971546215,1120.931249260714,-24.309199862320384,-144.44058823531668,-163.24995562442928,66229.64727490928,63201.63290190535,57.33649420570379,55.58769814618592,True,False,65311.137,64411.137,64911.137,64961.137,,False,2024-04-19 14:45:00,2024-04-19 14:39:59,2024-04-19 16:26:59,success,True,93.08,263.6000000000001,3,0,16,4
2024-04-19 15:00:00,64812.984,65088.738,64708.039,65004.84,3773,36422,0,2024-04-19 15:00:00,2024-04-19 15:00:00,111.09414285720413,593.1434773843721,65017.790488095285,-0.0011609952696997935,0.001033597198452283,64967.08200000007,60097.79342701121,64285.446505582186,64733.69013729689,64251.48900932658,64893.072039903716,294.56745363318623,293.3741923424679,796.6512483852812,41.504658754813136,12.148182318538602,104.47303852766345,65970.05122522384,63817.592854583585,69.78236873211799,69.98568268563042,True,False,65504.84,65104.84,65104.84,65154.84,2024-04-19 15:30:00,True,2024-04-19 15:30:00,2024-04-22 04:22:31,2024-04-19 15:33:14,even,True,18.62,282.2200000000001,4,0,16,4
2024-04-19 16:00:00,64901.48,65024.539,64467.434,64663.539,3916,36422,0,2024-04-19 16:00:00,2024-04-19 16:00:00,50.708488095217035,635.8466324368637,64848.79424999998,-0.0009014497855673153,0.001033552891430593,65017.790488095285,59920.575836966236,64351.52924190186,64840.53071300598,64443.428977143645,65005.65412211896,267.31885919750493,287.6176034880036,266.91868040074576,-56.482385965013236,11.088517027863418,68.71069659448403,65365.99434065997,64643.81390357795,52.237789709643856,65.90593575265811,True,False,65163.539,64763.539,64763.539,64813.539,2024-04-19 16:45:00,True,2024-04-19 16:45:00,2024-04-22 04:19:29,2024-04-19 16:45:38,even,True,18.62,300.8400000000001,5,0,16,4
2024-04-19 17:00:00,64852.637,64910.738,64475.813,64516.137,3614,36422,0,2024-04-19 17:00:00,2024-04-19 17:00:00,-168.9962380953075,657.8422481339803,64728.14570238098,-0.0004740280662791283,0.0010336115912909006,64848.79424999998,59715.36763961237,64417.97692174057,64773.95132422256,64514.00777572436,64857.397837633274,209.8094606330851,252.780176192788,230.5904228095021,-78.5754943240172,-15.190021671856812,-9.101656346792879,65168.6949084261,64544.60076684045,34.905080276102176,36.418510662813894,True,False,65016.137,64116.137,64616.137,64666.137,,False,2024-04-22 00:15:00,2024-04-22 00:07:01,2024-04-19 17:25:59,fail,False,-74.48,226.36000000000007,0,1,16,4
2024-04-22 07:00:00,65653.039,65835.938,65522.73,65544.734,3575,36421,0,2024-04-22 07:00:00,2024-04-22 07:00:00,296.09922619053395,464.7883327656309,65314.01582142857,0.0033041282837499224,0.0010185397788365015,65128.479964285725,61160.55508979729,65355.38341702512,65162.19753421743,64950.169826473444,65238.39079188167,106.55891160675674,77.72670028638468,277.37598303154186,112.97942380461609,142.40245958032756,145.68652734775242,65614.34836897426,64863.93321478909,81.68385481245663,78.3439419041705,True,False,66044.734,65644.734,65644.734,65694.734,2024-04-22 08:15:00,True,2024-04-22 08:15:00,2024-04-22 08:42:31,2024-04-22 15:16:26,success,True,93.08,319.44000000000005,1,0,17,4
2024-04-22 08:00:00,65693.234,65831.734,65646.5,65778.539,2405,36421,0,2024-04-22 08:00:00,2024-04-22 08:00:00,185.53585714284418,507.01252586069313,65697.24541666669,0.003304120473870997,0.001018705587073492,65314.01582142857,61363.57992138034,65422.56880468298,65421.244970500935,65145.682023574,65684.2565706914,140.3631219970921,109.01964611296997,383.7771410952053,102.49836807705287,111.86310457516083,116.85775232189917,66203.85571116993,65166.15743021288,78.90217644413167,75.86892778396295,True,False,66278.539,65878.539,65878.539,65928.539,2024-04-22 08:45:00,True,2024-04-22 08:45:00,2024-04-22 08:56:17,2024-04-22 11:54:44,success,True,93.08,412.52000000000004,2,0,17,4
2024-04-22 09:00:00,66318.297,66368.734,66111.727,66136.539,3507,36421,0,2024-04-22 09:00:00,2024-04-22 09:00:00,383.2295952381173,585.2987338313542,66005.12309523813,0.0033045009470986735,0.0010185339831540357,65697.24541666669,61568.30137426285,65489.18893117099,65770.00533241498,65405.94354205378,66187.26975576192,185.96182449605112,146.68624670408445,534.4459414770566,89.97541933259345,160.19087168907572,135.96976470587833,66910.27177675595,65465.7677347679,92.02769475296031,91.96431191296539,True,False,66636.539,65736.539,66236.539,66286.539,,False,2024-04-22 17:30:00,2024-04-22 20:28:04,2024-04-22 14:41:40,fail,False,-74.48,338.04,0,1,17,4
2024-04-22 10:00:00,66250.539,66430.734,66041.836,66059.734,2981,36421,0,2024-04-22 10:00:00,2024-04-22 10:00:00,307.87767857144354,633.6782103459045,66117.31205952381,0.0033044232952549805,0.0010185347292447195,66005.12309523813,61771.47448205457,65555.98852196947,65969.48405013437,65612.3402175571,66330.77941520464,198.10010888559918,177.11082901605945,599.8358028241181,-23.533732026116922,38.17587788091623,56.873161678697215,67140.5577490172,65519.50108139208,80.7419749460584,86.66984546200611,True,False,66559.734,65659.734,66159.734,66209.734,,False,2024-04-22 17:15:00,2024-04-22 20:28:00,2024-04-22 14:42:19,fail,False,-74.48,263.56,0,2,17,4
2024-04-22 11:00:00,65925.539,66086.734,65891.82,66009.641,2525,36421,0,2024-04-22 11:00:00,2024-04-22 11:00:00,112.18896428568405,638.4350285798646,66159.8648690476,0.002329447691255628,0.001018541362948272,66117.31205952381,62698.95814792369,65622.52547707454,65970.81667070542,65707.55515266838,66166.64367629857,170.067237795025,177.9399572299916,525.931766197024,-11.377062951549306,-51.83608565524628,-49.98917199867719,66876.65156066456,65455.13579193259,48.76960301221116,51.847830367497465,True,False,66509.641,65609.641,66109.641,66159.641,,False,2024-04-22 17:15:00,2024-04-22 20:27:59,2024-04-22 15:16:51,fail,False,-74.48,189.07999999999998,0,3,17,4
2024-04-22 12:00:00,65917.641,66017.336,65872.031,65923.773,1996,36421,0,2024-04-22 12:00:00,2024-04-22 12:00:00,42.552809523782344,634.2562277252073,66097.52570238095,0.0021043730931244657,0.001018560130203984,66159.8648690476,62972.61043092341,65689.26258254587,65971.10401988018,65779.11260399384,66033.21804850356,142.10270805032633,162.8605100332635,310.33738934824896,-51.89199140014534,-47.75820433438639,-33.53283316123998,66452.1735241237,65612.76257288342,22.885693539109962,36.1718851649125,True,False,66423.773,66023.773,66023.773,66073.773,2024-04-22 16:15:00,True,2024-04-22 16:15:00,2024-04-22 17:31:50,2024-04-22 16:17:17,even,True,18.62,207.7,1,0,17,4
2024-04-22 13:00:00,65895.336,66030.641,65833.813,65958.336,2107,36421,0,2024-04-22 13:00:00,2024-04-22 13:00:00,-62.339166666642996,621.9562643464815,66015.5226666667,0.001197292391139164,0.0010184960068294075,66097.52570238095,62530.84410460921,65756.25894665284,65939.4380802866,65812.04396407334,65867.74547127621,110.7708660828066,136.94977066938475,200.08323839335162,-11.056323357421206,-39.854822153414716,-59.34546095630503,66137.85784310724,65596.13309944519,21.994600181960323,16.11949500046286,True,False,66458.336,66058.336,66058.336,66108.336,2024-04-22 17:15:00,True,2024-04-22 17:15:00,2024-04-22 20:27:58,2024-04-22 17:21:20,even,True,18.62,226.32,2,0,17,4
2024-04-22 15:00:00,65837.938,65903.234,65742.336,65781.141,1835,36421,0,2024-04-22 15:00:00,2024-04-22 15:00:00,-83.69589285719849,587.4113957758818,65880.86272619046,0.0013356122968528742,0.0008049146221243749,65931.8267738095,63463.733344784254,65791.0239301177,65882.54436028891,65841.53271471741,65849.3868338493,60.29263263712346,87.37262323189206,127.9640140948254,-25.58641210870701,-14.16774578607874,-18.877983144062455,66022.13825287732,65675.13541482128,32.089741761984236,31.008614128074402,True,False,66281.141,65881.141,65881.141,65931.141,2024-04-22 16:00:00,True,2024-04-22 16:00:00,2024-04-22 17:29:19,2024-04-22 16:32:16,even,True,18.62,244.94,3,0,17,4
2024-04-22 16:00:00,65953.234,66220.938,65953.234,66081.734,2537,36421,0,2024-04-22 16:00:00,2024-04-22 16:00:00,-50.964047619039775,569.1131008825832,65942.17453571428,0.0015297678149599658,0.0008049467845438829,65880.86272619046,63537.41398731519,65844.22898471548,65920.09884825425,65870.72063574412,65907.09320227038,53.1673268606246,67.04650880518396,81.78170183720096,42.41898383217631,24.37768627447076,-3.7179772962117568,66018.9984997506,65796.68790479016,66.81778025240305,57.85076516888619,True,False,66581.734,65681.734,66181.734,66231.734,,False,2024-04-22 17:30:00,2024-04-22 20:28:00,2024-04-22 16:35:10,fail,False,-74.48,170.45999999999998,0,1,17,4
2024-04-22 17:00:00,66060.336,66259.641,65999.227,66220.734,2985,36421,0,2024-04-22 17:00:00,2024-04-22 17:00:00,61.31180952381692,557.0574441897334,65980.94519047622,0.0016983171800209588,0.0008049593932152768,65942.17453571428,63636.111980782116,65897.42677036075,65989.71122164106,65919.13533766034,66001.19025008594,54.715631127153756,57.96849434364648,101.59959442255581,50.087368421052815,27.50878603363526,-5.911617819059757,66139.8497025564,65864.03079761549,71.84173845333451,66.52438953883755,True,False,66720.734,66320.734,66320.734,66370.734,2024-04-22 17:30:00,True,2024-04-22 17:30:00,2024-04-22 20:28:04,2024-04-22 17:30:42,even,True,18.62,189.07999999999998,1,0,17,4
2024-04-22 20:00:00,66090.922,66331.734,66073.664,66308.938,2431,36421,0,2024-04-22 20:00:00,2024-04-22 20:00:00,43.61071428573632,493.92898308728036,66183.00121428577,0.0016091309617134507,0.0008648779859638127,66021.83328571434,63943.77189800917,66033.67305370282,66064.77374039113,66002.88342194624,66071.32530237355,41.70554308424471,40.21894427936144,178.68881698048418,39.009682834439445,5.369413484688266,-24.319157206686214,66314.0552052972,65830.09539944989,63.28722540609416,59.850115778381166,True,False,66808.938,66408.938,66408.938,66458.938,2024-04-22 20:30:00,True,2024-04-22 20:30:00,2024-04-23 01:53:23,2024-04-22 21:38:36,even,True,18.62,207.7,2,0,17,4
2024-04-22 22:00:00,66275.492,66398.039,66242.836,66316.641,2351,36421,0,2024-04-22 22:00:00,2024-04-22 22:00:00,70.40939285712375,496.69790725110215,66348.60577380954,0.0016092055102247351,0.0012777117180790608,66253.4106071429,64149.91898784623,66042.12869223506,66326.46348257078,66206.29434152087,66519.63888888889,72.01476846724108,69.17188347751939,262.51717028592566,21.401697626453824,31.38772996213811,35.15692225658859,66875.5370687749,66165.24070900289,54.89683737159152,61.82264332059585,True,False,66816.641,66416.641,66416.641,66466.641,2024-04-22 23:00:00,True,2024-04-22 23:00:00,2024-04-23 01:53:23,2024-04-22 23:01:34,even,True,18.62,226.32,3,0,17,4
2024-04-22 23:00:00,66477.438,66633.57,66389.742,66612.773,2041,36421,0,2024-04-22 23:00:00,2024-04-22 23:00:00,95.19516666664276,497.47091685466876,66417.73966666663,0.0016091112633657085,0.0011628098718290888,66348.60577380954,64253.59157341272,66148.7166882539,66378.19221800072,66262.30706188381,66492.16366838668,70.69076965408749,67.88078633286386,265.54418423674593,24.64387547298975,-4.803850361116929,-29.144226694232202,66852.14831710629,66133.67901966708,64.04319741852295,53.80964898914456,True,False,67112.773,66212.773,66712.773,66762.773,,False,2024-04-23 02:00:00,2024-04-23 01:53:25,2024-04-23 07:30:03,success,True,93.08,319.4,4,0,17,4
2024-04-23 00:00:00,66455.438,66495.734,66373.141,66381.336,1462,56421,0,2024-04-23 00:00:00,2024-04-23 00:00:00,69.13389285709127,491.2344780329149,66475.04617857137,0.0016090491411191834,0.0009906753303352766,66417.73966666663,64356.94765464869,66247.06073375249,66407.19438226073,66309.92712572866,66434.65329549366,64.91299212258309,68.09469950869885,267.8451756160298,-41.70069315440196,-6.204939800547436,-10.193138974849717,66796.2442825753,66071.56230841202,47.855098110764544,54.80854665636389,True,False,66881.336,66481.336,66481.336,66531.336,2024-04-23 01:15:00,True,2024-04-23 01:15:00,2024-04-23 01:53:23,2024-04-23 06:36:27,success,True,93.08,412.47999999999996,5,0,17,4
2024-04-23 01:00:00,66462.539,66715.734,66462.539,66715.734,2262,56421,0,2024-04-23 01:00:00,2024-04-23 01:00:00,57.30651190473873,481.3167270696431,66670.01576190483,0.001609065605693757,0.0008721395228785888,66475.04617857137,64460.89113955307,66320.32572530051,66465.46975395396,66364.55243560763,66491.28100447192,64.84211301137111,64.46338590076687,184.70649799626793,73.57530168554513,26.02352218775195,-15.483315445439075,66742.13477676688,66241.92723217697,72.14886184179117,60.503944705214785,True,False,67215.734,66815.734,66815.734,66865.734,2024-04-23 02:00:00,True,2024-04-23 02:00:00,,2024-04-23 02:34:27,even,True,18.62,431.09999999999997,6,0,17,4
2024-04-23 02:00:00,66981.734,67192.836,66864.125,67148.539,2833,36421,0,2024-04-23 02:00:00,2024-04-23 02:00:00,194.96958333345538,509.4785834138602,66726.03972619044,0.0016090752620316333,0.0007851395880548068,66670.01576190483,64565.12222000837,66377.54880341107,66671.49157290152,66497.60824952014,66787.98753525976,92.21231246180832,73.0712037311061,213.20210285432253,115.60701823189447,97.58723495012964,41.04564258675964,67077.31037411309,66500.16469640643,86.23103136283969,86.52493520961657,True,False,67648.539,66748.539,67248.539,67298.539,,False,,,2024-04-23 02:55:02,fail,False,-74.48,356.61999999999995,0,1,17,4
2024-04-23 03:00:00,66757.695,66821.641,66687.141,66752.234,1764,36421,0,2024-04-23 03:00:00,2024-04-23 03:00:00,56.023964285617694,507.86463515461946,66827.34007142848,0.0016092080670292623,0.0006993757481272679,66726.03972619044,64669.06048449707,66423.18475025553,66735.82000941323,66580.57089378276,66864.63721809421,91.34833044295374,85.65829470127734,236.69203947923862,-2.482478844205616,-1.866994840092957,19.041322669465444,67184.17147139118,66543.60296479725,53.501882012305934,63.59771986970727,True,False,67252.234,66852.234,66852.234,66902.234,2024-04-23 04:00:00,True,2024-04-23 04:00:00,,2024-04-23 04:23:41,even,True,18.62,375.23999999999995,1,0,17,4
2024-04-23 04:00:00,66970.672,67140.641,66903.234,67099.211,2473,36421,0,2024-04-23 04:00:00,2024-04-23 04:00:00,101.30034523803624,518.1660530693916,66848.73490476188,0.0016091796004966072,0.0006992570867691686,66827.34007142848,64773.286958240344,66469.74924053714,66828.0927554294,66667.90019477211,66982.26146714829,94.64725327874476,88.15826380544863,257.9536234494346,51.777732370159356,44.846736842082464,24.507555555566796,67331.99885880502,66634.02407549156,74.28321249141227,62.46670480320622,True,False,67599.211,66699.211,67199.211,67249.211,,False,,,2024-04-23 05:49:22,fail,False,-74.48,300.75999999999993,0,1,17,4
2024-04-23 05:00:00,66726.141,66867.898,66726.141,66832.938,1866,36421,0,2024-04-23 05:00:00,2024-04-23 05:00:00,21.3948333333974,500.27739698473306,66772.60944047623,0.001296420104818416,0.0006992830158845429,66848.73490476188,64974.05144284156,66516.06097434094,66830.92216015693,66713.05032090271,66913.04499656004,80.75109627739585,87.0571639264005,223.76606235010138,-28.459582731331466,-43.202327829407295,-8.472836257322342,67215.12918073268,66609.4608123874,38.52236845442917,51.04833339167263,True,False,67332.938,66432.938,66932.938,66982.938,,False,,,2024-04-23 06:46:04,fail,False,-74.48,226.27999999999992,0,2,17,4
2024-04-23 06:00:00,66564.539,66705.539,66529.93,66683.438,1852,36421,0,2024-04-23 06:00:00,2024-04-23 06:00:00,-76.1254642856511,467.85344823481864,66649.48229761906,0.0011652292810015394,0.000699309702759064,66772.60944047623,64997.576568463584,66562.48925911429,66760.44526805286,66707.28049954862,66726.0550082559,54.02821461384883,72.80285492503651,203.84324340602217,-48.19738630890788,-70.78985311316501,-27.545751290002954,67001.24338685404,66449.36662965777,19.34566930096719,21.377895178939415,True,False,67183.438,66283.438,66783.438,66833.438,,False,2024-04-23 18:00:00,,2024-04-23 07:29:59,fail,False,-74.48,151.7999999999999,0,3,17,4
2024-04-24 18:00:00,65194.539,65202.84,64952.453,64972.969,3537,36422,0,2024-04-24 18:00:00,2024-04-24 18:00:00,-361.79030952387257,-105.8808591075649,65367.80377380953,-0.0007235965401008849,-4.562565317756607e-05,65869.49988095235,65313.2599226592,67055.44437256863,65666.69243661128,66011.69050998731,65365.70029962158,-151.69754853755876,-90.06182630214205,490.4341727623606,-197.74853491574322,-174.37992776055762,-260.92349810800806,66027.78643285077,64702.11416639239,16.319861424192187,15.788387706911317,False,True,64472.969,64872.969,64872.969,64822.969,2024-04-24 18:30:00,True,2024-04-24 18:30:00,2024-04-24 18:44:51,2024-04-24 18:30:31,even,True,18.62,170.4199999999999,1,0,17,4
2024-04-24 19:00:00,64568.852,64923.637,64492.727,64662.637,3807,36422,0,2024-04-24 19:00:00,2024-04-24 19:00:00,-501.69610714282317,-230.2124990599841,65033.40930952382,-0.000794437897774536,-4.558469024757365e-05,65367.80377380953,65219.700860124256,67052.37911796503,65160.63317497376,65645.73433966478,64617.115228070186,-228.22176033891446,-160.43915747558003,723.8626195816092,-132.68333436531248,-177.95807602345303,-228.31713759888225,65594.32976450535,63638.40069163501,5.694239761697958,5.488225406379615,False,True,64162.637,64562.637,64562.637,64512.637,2024-04-24 19:30:00,True,2024-04-24 19:30:00,2024-04-24 21:50:57,2024-04-24 19:34:59,even,True,18.62,189.0399999999999,2,0,17,4
2024-04-24 20:00:00,64749.09,64985.738,64706.641,64922.738,2463,36422,0,2024-04-24 20:00:00,2024-04-24 20:00:00,-334.39446428570955,-310.64459874852037,64803.99811904765,-0.0007944523027361088,-0.0001981984024940628,65033.40930952382,65167.59580112298,67109.88286209795,64947.08008755964,65396.29967764918,64412.04310595119,-240.2902143149986,-210.01623647029342,806.3037098502617,27.09135053330101,-17.021631235067616,-61.54929205359076,65502.05311424904,63323.53309765334,25.265207098930308,17.59928459956957,False,True,64422.738,64822.738,64822.738,64772.738,2024-04-24 21:15:00,True,2024-04-24 21:15:00,2024-04-24 21:46:17,2024-04-25 21:21:25,success,True,93.08,282.1199999999999,3,0,17,4
2024-04-24 23:00:00,63944.137,64195.637,63832.172,63883.777,2912,36422,0,2024-04-24 23:00:00,2024-04-24 23:00:00,-268.18101190475136,-542.5329041936784,64042.937738095236,-0.001442581820619213,-0.0007228158870613802,64154.570416666706,65215.75057004136,67172.76141157585,64356.44429811258,64769.300035561995,64198.999371173035,-245.79111283066595,-231.9222696650478,455.5994258500413,-126.91882834531134,-107.07721018236043,-34.294698314413836,64814.058596070594,63582.440146275476,23.83930294917833,33.6292255207757,False,True,63383.777,64283.777,63783.777,63733.777,,False,2024-04-25 13:30:00,2024-04-25 13:24:46,2024-04-25 00:20:31,fail,False,-74.48,207.63999999999987,0,1,17,4
2024-04-25 00:00:00,64046.379,64171.738,63931.637,64088.438,1787,56422,0,2024-04-25 00:00:00,2024-04-25 00:00:00,-111.63267857147002,-591.8772568056957,64118.567059523826,-0.0015084345438928703,-0.0007226914713699085,64042.937738095236,65193.83849298904,67123.99790316627,64207.01432452176,64577.15128706556,63917.76503061576,-235.30274050403386,-237.56663755069897,355.1136427302976,-39.771991744069965,-80.09878981777001,-44.00616477456788,64397.16844830166,63436.86161292986,36.82591323998229,30.49374700549303,False,True,63588.438,64488.438,63988.438,63938.438,,False,2024-04-25 10:45:00,2024-04-25 13:10:45,2024-04-25 03:30:52,fail,False,-74.48,133.15999999999985,0,2,17,4
2024-04-25 01:00:00,64333.84,64352.09,64242.566,64279.84,1361,56422,0,2024-04-25 01:00:00,2024-04-25 01:00:00,75.62932142859063,-601.2392395438219,64079.77621428569,-0.0015110550871179672,-0.0007226772417788009,64118.567059523826,65098.3420955232,67075.53274669436,64245.399030402405,64499.419347020616,64061.52385070514,-190.2264381155619,-217.80319207805388,335.30804434768083,52.68372480212565,54.9294313725768,35.79921293428197,64515.68971057451,63608.85799083577,66.56305966238115,58.74464580010672,False,True,63779.84,64179.84,64179.84,64129.84,2024-04-25 02:00:00,True,2024-04-25 02:00:00,2024-04-25 02:03:39,2024-04-25 02:15:20,success,True,93.08,226.23999999999984,1,0,17,4
2024-04-25 02:00:00,64041.645,64168.34,63774.738,64153.637,3345,36422,0,2024-04-25 02:00:00,2024-04-25 02:00:00,-38.79084523813799,-625.0248586173548,64082.84303571428,-0.0015104497762558683,-0.0007684615806056207,64079.77621428569,65000.21029659672,67048.38372088363,64198.03924484863,64407.38210021794,64183.328507051934,-164.44741064248228,-190.39957080347352,325.4090710771933,30.94534158926399,9.878899896837538,35.8097282421586,64624.130753006146,63744.02626109772,66.1275813129731,69.121592996655,False,True,63653.637,64553.637,64053.637,64003.637,,False,2024-04-25 10:45:00,2024-04-25 13:10:44,2024-04-25 03:31:09,fail,False,-74.48,151.75999999999982,0,1,17,4
2024-04-25 03:00:00,64229.293,64364.137,64173.438,64344.539,2390,36422,0,2024-04-25 03:00:00,2024-04-25 03:00:00,3.066821428590629,-621.5509834343029,64220.887785714316,-0.0015104853933033686,-0.0009621119005955286,64082.84303571428,64901.4706262729,67073.44445708998,64215.95221511253,64358.99073974652,64268.4387217062,-130.40965647431585,-162.6409352989188,206.85152295486577,51.557276573817944,34.62223976611858,29.105560715470347,64549.18827769527,63989.189165717136,83.0457835039249,74.85627100865929,False,True,63844.539,64244.539,64244.539,64194.539,2024-04-25 05:00:00,True,2024-04-25 05:00:00,2024-04-25 05:01:39,2024-04-25 05:16:43,success,True,93.08,244.8399999999998,1,0,17,4
2024-04-25 04:00:00,64497.883,64616.539,64398.84,64404.586,1478,36422,0,2024-04-25 04:00:00,2024-04-25 04:00:00,138.0447500000373,-590.4285913856511,64223.239119047685,-0.0015105212794580037,-0.001184885872336786,64220.887785714316,64803.75864415575,67082.56367539693,64350.31541862899,64395.06994424495,64409.48104093571,-79.88176177305286,-121.27378146620438,188.6969652319498,20.074680770623672,20.797949432402675,64.86895872028981,64665.72194399884,64154.74013787258,80.95192059109188,89.11372065471255,False,True,63904.586,64304.586,64304.586,64254.586,2024-04-25 05:00:00,True,2024-04-25 05:00:00,2024-04-25 05:00:59,2024-04-25 06:01:04,success,True,93.08,337.9199999999998,2,0,17,4
2024-04-25 06:00:00,64257.539,64374.695,64090.563,64110.738,1883,36422,0,2024-04-25 06:00:00,2024-04-25 06:00:00,26.75669047608244,-577.6241036818683,64239.24494047619,-0.001842587813980991,-0.0017288127019545636,64249.99580952377,64842.649390952574,67030.63547035179,64243.23656116698,64312.31997041977,64276.020771929834,-64.7979461276118,-76.35472113822871,155.58646344223695,-37.5742225662616,-6.85080013753759,-19.618912280719087,64486.06249757685,64064.47904628282,42.17292803220492,46.1042408885284,False,True,63610.738,64010.738,64010.738,63960.738,2024-04-25 10:45:00,True,2024-04-25 10:45:00,2024-04-25 13:10:45,2024-04-25 10:48:45,even,True,18.62,356.5399999999998,3,0,17,4
2024-04-25 07:00:00,64235.59,64303.039,64007.84,64054.961,2399,36422,0,2024-04-25 07:00:00,2024-04-25 07:00:00,-10.750869047580636,-556.7324765686571,64247.03352380955,-0.0018425953436650797,-0.001955857139299612,64239.24494047619,64723.43999209656,66944.27034135537,64232.77986562255,64291.08947478877,64178.14486618506,-53.91170180270274,-63.08438903831602,158.21927830240068,-50.861526315777155,-36.587955624374445,4.250437220551248,64391.7408918933,63963.04884047682,46.65151571365565,51.26267199696779,False,True,63554.961,63954.961,63954.961,63904.961,2024-04-25 10:45:00,True,2024-04-25 10:45:00,2024-04-25 13:10:47,2024-04-25 10:48:31,even,True,18.62,375.1599999999998,4,0,17,4
2024-04-25 10:00:00,64242.238,64303.039,64181.84,64303.039,1330,36422,0,2024-04-25 10:00:00,2024-04-25 10:00:00,-16.93532142855838,-486.07515377430536,64130.1933690476,-0.002432934675617701,-0.0018924992695332561,64222.05905952382,64631.196129073935,66557.18344046567,64228.81656618917,64248.44988507456,64222.0316388029,-27.0332270670624,-37.48075442745626,109.60819923093615,14.179316821486282,12.125755761939217,-11.063309253506304,64371.50270776467,64074.06056984114,59.820553401098955,56.295348699900046,False,True,63803.039,64203.039,64203.039,64153.039,2024-04-25 10:45:00,True,2024-04-25 10:45:00,2024-04-25 10:47:11,2024-04-25 15:30:26,success,True,93.08,468.2399999999998,5,0,17,4
2024-04-25 11:00:00,63977.938,64049.539,63900.82,64045.637,1708,36422,0,2024-04-25 11:00:00,2024-04-25 11:00:00,-91.86569047621742,-482.22566737402667,64070.826440476194,-0.002304098487094443,-0.001892544184305139,64130.1933690476,64425.10907974293,66431.72388033305,64125.39595012696,64187.80905142669,64107.925012039916,-39.832196318442584,-36.6307943152263,115.42647319836125,-8.282883040963497,-33.24848503600515,-73.14699552804814,64263.750750857704,63950.59927322213,28.591788554315954,36.234952908362125,False,True,63545.637,63945.637,63945.637,63895.637,2024-04-25 11:45:00,True,2024-04-25 11:45:00,2024-04-25 13:10:47,2024-04-25 12:04:40,even,True,18.62,486.8599999999998,6,0,17,4
2024-04-25 12:00:00,63909.84,64161.738,63853.438,64103.938,2068,36422,0,2024-04-25 12:00:00,2024-04-25 12:00:00,-59.36692857140588,-478.7317430732437,63983.35274999999,-0.0020750591240263207,-0.0018424459620979647,64070.826440476194,64203.95436727926,66316.27074561015,64035.39368725916,64119.970837819346,63958.69666838662,-49.775878465530695,-44.77571115304067,154.5455915070563,9.399074303342786,-39.906510491869994,-76.75593292056146,64168.83321692114,63750.060119852096,38.60729386111377,30.439838226349682,False,True,63603.938,64003.938,64003.938,63953.938,2024-04-25 12:45:00,True,2024-04-25 12:45:00,2024-04-25 13:10:45,2024-04-25 15:10:02,success,True,93.08,579.9399999999998,7,0,17,4
2024-04-25 13:00:00,63930.039,63930.738,63507.414,63767.039,2990,36422,0,2024-04-25 13:00:00,2024-04-25 13:00:00,-87.47369047620305,-468.99128679116257,63766.03720238096,-0.0018306926378345925,-0.0018425022976461315,63983.35274999999,64010.16353613779,66194.62380994564,63957.365192155776,64056.90824267827,63849.275965256296,-56.6865470251214,-49.757580551623064,167.03356800664642,-38.20565393873403,-28.855431028569,-35.523917440623336,64074.77128206527,63622.280648447326,33.22629542772729,39.35298946522956,False,True,63267.039,63667.039,63667.039,63617.039,2024-04-25 13:30:00,True,2024-04-25 13:30:00,2024-04-25 15:53:55,2024-04-25 14:11:12,even,True,18.62,598.5599999999998,8,0,17,4
2024-04-25 14:00:00,63419.266,63705.738,63409.73,63623.938,2448,36422,0,2024-04-25 14:00:00,2024-04-25 14:00:00,-217.31554761902953,-496.6970912791003,63725.29485714281,-0.0015359118663009822,-0.0018241608986755494,63766.03720238096,63837.455788001345,66078.87032115282,63735.0343483895,63907.919951140764,63571.008809769526,-88.8494392507564,-69.45393906984809,265.9309817194843,-30.118435156502528,-72.90404093565303,-68.74992225664028,63930.01563509083,63210.50198444822,24.789525518042137,20.348555485811957,False,True,63123.938,64023.938,63523.938,63473.938,,False,2024-04-25 16:00:00,2024-04-25 16:04:13,2024-04-25 15:10:04,fail,False,-74.48,524.0799999999998,0,1,17,4
2024-04-25 16:00:00,63370.637,63530.738,62836.863,63048.738,4350,36422,0,2024-04-25 16:00:00,2024-04-25 16:00:00,-152.55313095234305,-499.3632659887444,63456.66327380949,-0.0010498102518296398,-0.0015659625469851524,63572.74172619047,63613.25286224632,65959.141163661,63647.43649294988,63799.13702292839,63558.86070037838,-82.95842108566285,-68.630213428023,284.74940896596826,-135.76335569311777,-72.35485517716006,1.5516467147972435,63943.27240248244,63172.948998274325,26.80274935084057,48.98736797059058,False,True,62548.738,63448.738,62948.738,62898.738,,False,2024-04-29 02:45:00,2024-04-29 05:40:12,2024-04-25 16:43:34,fail,False,-74.48,449.5999999999998,0,2,17,4
2024-04-25 18:00:00,63335.504,63500.539,63204.84,63480.34,3506,36422,0,2024-04-25 18:00:00,2024-04-25 18:00:00,-67.66821428569529,-510.7720592176993,63581.113750000004,-0.0007882502685218712,-0.0014432698224960275,63388.9950595238,63496.80311261015,65825.0982996476,63510.31278589043,63640.95150358796,63407.70988200892,-82.77409101157536,-83.42579411618293,285.1073534822378,-24.163492604042403,-60.48568799452187,-7.498404884740012,63792.604809209945,63021.3149548079,47.55326553034109,52.399420259285364,False,True,62980.34,63880.34,63380.34,63330.34,,False,2024-04-29 01:45:00,2024-04-29 01:32:35,2024-04-25 18:37:13,fail,False,-74.48,375.1199999999998,0,3,17,4
2024-04-29 02:00:00,63097.039,63097.039,62681.84,62911.25,3324,36422,0,2024-04-29 02:00:00,2024-04-29 02:00:00,-211.88382142847695,-217.72124077414628,63355.84827380951,-0.0007078490042539305,-0.0004201644229333334,63588.487928571456,63483.537223116764,65007.862618779705,63416.34085139436,63613.95742566369,63239.226955624385,-93.461696837614,-61.83727653564162,295.1506767505516,-121.59298761605896,-96.96390196080756,-87.33204678363836,63637.68036923763,62839.27354201114,26.62181721434796,25.313777780047356,False,True,62411.25,63311.25,62811.25,62761.25,,False,2024-04-29 05:45:00,2024-04-29 06:09:19,2024-04-29 04:36:32,fail,False,-74.48,300.63999999999976,0,4,18,4
2024-04-29 04:00:00,63204.23,63240.539,63075.496,63145.34,1656,36422,0,2024-04-29 04:00:00,2024-04-29 04:00:00,-139.7568690476037,-276.4254416800686,63139.611190476244,-0.0008270636778468113,-0.00042008113834617245,63216.09140476191,63505.920200255925,64953.134415595574,63206.98895161711,63385.2606936706,62985.83149604405,-105.4820939403653,-102.08566545057194,356.43771825636236,14.616127967041393,16.138974200192024,1.8752879256935557,63468.52241569014,62504.64057639796,50.402579443328484,49.6957654647286,False,True,62645.34,63545.34,63045.34,62995.34,,False,2024-04-29 05:45:00,2024-04-29 05:40:12,2024-04-30 01:30:06,success,True,93.08,393.71999999999974,1,0,18,4
2024-04-29 05:00:00,63184.438,63246.84,63058.738,63117.539,1369,36422,0,2024-04-29 05:00:00,2024-04-29 05:00:00,-76.48021428566426,-289.7527405357105,62943.55341666664,-0.0008376840681296045,-0.00047773292198832924,63139.611190476244,63449.21972303511,64948.143141165005,63178.4917695678,63322.64627896432,63084.25782077738,-94.61933195722668,-99.67648783047272,325.0708328634136,22.308166494665784,28.248552115561324,21.878769865841605,63524.60344514299,62645.412196411766,64.58565814499757,57.35041099896682,False,True,62617.539,63517.539,63017.539,62967.539,,False,2024-04-29 05:45:00,2024-04-29 05:40:12,2024-04-30 01:30:06,success,True,93.08,486.7999999999997,2,0,18,4
2024-04-29 06:00:00,62650.246,62731.738,62378.707,62502.637,2976,36422,0,2024-04-29 06:00:00,2024-04-29 06:00:00,-196.05777380960353,-338.3417440205012,62642.987940476196,-0.0010887213609639065,-0.0006289824707871344,62943.55341666664,63268.73052054973,64966.03036643491,62946.00961066638,63163.15633798001,62906.7668180255,-121.61212767948746,-105.54975817509047,295.021677173195,-92.1099948399933,-51.850790505704936,-57.32567939461296,63305.046082209316,62506.98755384168,19.198424821530693,35.62525631906775,False,True,62002.637,62402.637,62402.637,62352.637,2024-04-29 07:00:00,True,2024-04-29 07:00:00,2024-04-29 09:48:36,2024-04-29 07:08:11,even,True,18.62,505.41999999999973,3,0,18,4
2024-04-29 07:00:00,62232.109,62431.387,62154.727,62425.84,2535,36422,0,2024-04-29 07:00:00,2024-04-29 07:00:00,-300.5654761904443,-406.30595194709895,62546.38089285721,-0.0010886554897248618,-0.0008657089174911559,62642.987940476196,63199.6919366645,64986.091552106205,62706.841466046935,62978.23537949357,62514.86488510488,-147.88054168774397,-125.3768767933206,313.5715212948768,-101.99026246995345,-144.66510939110594,-77.18566976260627,62938.186438852965,62090.04333135679,23.8504044854842,22.512109898031806,False,True,61925.84,62325.84,62325.84,62275.84,2024-04-29 09:30:00,True,2024-04-29 09:30:00,2024-04-29 09:48:41,2024-04-29 10:47:23,success,True,93.08,598.4999999999998,4,0,18,4
2024-04-29 08:00:00,62485.477,62493.137,62391.664,62473.547,984,36422,0,2024-04-29 08:00:00,2024-04-29 08:00:00,-96.60704761898523,-434.39640599845734,62459.460630952446,-0.001088647175821684,-0.0011095435222819663,62546.38089285721,63131.08400785083,64976.78581953398,62608.44001976098,62853.24292022384,62360.69938321286,-145.16728515549767,-137.81571924351636,314.4709743018171,-28.988701066482463,-36.44579876161879,-22.16759373916284,62785.23519852031,61934.6635679054,37.71387033636447,36.827432360978,False,True,61973.547,62373.547,62373.547,62323.547,2024-04-29 08:30:00,True,2024-04-29 08:30:00,2024-04-29 09:48:40,2024-04-29 08:45:35,even,True,18.62,617.1199999999998,5,0,18,4
2024-04-29 09:00:00,62400.684,62420.438,62269.84,62278.637,2001,36422,0,2024-04-29 09:00:00,2024-04-29 09:00:00,-86.92026190476463,-458.92071722389665,62290.18090476189,-0.0010880194999446009,-0.0013585403537471389,62459.460630952446,63062.48602545361,64936.471879776385,62475.36724517071,62716.29447051402,62259.93223770211,-147.30692810394248,-143.50997264394707,361.3144132287248,-16.902061231492553,-10.376570003405504,-27.634372893058753,62747.70669556089,61770.65777984333,33.64834940646957,31.028015839843647,False,True,61778.637,62178.637,62178.637,62128.637,2024-04-29 10:15:00,True,2024-04-29 10:15:00,2024-04-29 16:49:36,2024-04-29 10:18:09,even,True,18.62,635.7399999999998,6,0,18,4
2024-04-29 11:00:00,62343.242,62446.738,62247.938,62289.84,2035,36422,0,2024-04-29 11:00:00,2024-04-29 11:00:00,-54.26364285708405,-498.27561229515413,62247.78277380956,-0.0013943781299051055,-0.0017192042083334336,62235.917261904804,63174.92579355406,64759.254073277625,62306.07506048543,62495.39262985246,62219.03873718604,-131.30839953564282,-142.2400144751964,256.28503197120114,15.129641210842237,20.402828689337184,-6.802884760974848,62566.52353034716,61873.05394402492,59.53072142238667,53.73652138413698,False,True,61789.84,62189.84,62189.84,62139.84,2024-04-29 16:45:00,True,2024-04-29 16:45:00,2024-04-29 16:49:36,2024-04-29 17:13:44,success,True,93.08,728.8199999999998,7,0,18,4
2024-04-29 12:00:00,62352.133,62361.539,62220.32,62333.34,1860,36422,0,2024-04-29 12:00:00,2024-04-29 12:00:00,11.865511904754385,-496.316468291574,62352.384595238094,-0.0013943601555173437,-0.0017766515764379381,62247.78277380956,63086.80950982169,64643.836792925904,62318.4912130026,62451.80069608125,62262.5236842105,-106.41077905517159,-125.55614978058996,139.07589631954284,27.124922256582067,19.720412796705205,4.406963192297553,62451.776144241885,62074.771224179116,78.81077467102118,74.45605458938684,False,True,61833.34,62233.34,62233.34,62183.34,2024-04-29 16:45:00,True,2024-04-29 16:45:00,2024-04-29 16:49:35,2024-04-29 17:14:48,success,True,93.08,821.8999999999999,8,0,18,4
2024-04-29 13:00:00,62486.746,62594.039,62437.969,62594.039,1921,36422,0,2024-04-29 13:00:00,2024-04-29 13:00:00,104.60182142853591,-478.09357805181935,62377.01488095233,-0.0013943572018595182,-0.0016690325895349436,62352.384595238094,62998.735086239205,64543.25020096558,62374.33633988905,62443.179762721986,62393.20212590297,-76.02466781593102,-103.89042797007671,125.48103223676779,63.44156277948787,41.889661162756965,18.08921018230467,62564.101519422606,62223.80273238334,84.82197209463108,77.47957194819826,False,True,62094.039,62494.039,62494.039,62444.039,2024-04-29 13:45:00,True,2024-04-29 13:45:00,2024-04-29 15:33:43,2024-04-29 15:39:24,success,True,93.08,914.9799999999999,9,0,18,4
2024-04-29 15:00:00,62202.723,62302.34,62151.488,62295.641,1436,36422,0,2024-04-29 15:00:00,2024-04-29 15:00:00,-66.48850000000675,-469.279035237334,62401.488833333315,-0.0016807392907997138,-0.0015317283175768982,62310.526380952324,62985.30588614235,64363.92985294769,62321.554570036795,62384.13652472962,62330.40590540075,-56.35237516167399,-66.5715655501934,105.79455534707809,-15.34659889919567,-37.63276470587152,-30.766693154437235,62473.228555119305,62186.0832556822,23.14398166660594,23.66820001884086,False,True,61795.641,62195.641,62195.641,62145.641,2024-04-29 16:45:00,True,2024-04-29 16:45:00,2024-04-29 16:49:36,2024-04-29 17:13:44,success,True,93.08,1008.06,10,0,18,4
2024-04-29 16:00:00,62558.738,62669.637,62462.242,62464.637,2832,36422,0,2024-04-29 16:00:00,2024-04-29 16:00:00,90.96245238099073,-435.31458929612563,62279.82452380953,-0.0016807350891521167,-0.0014295161082775564,62401.488833333315,62879.99998856502,64298.488462134905,62382.68433702982,62399.01891783755,62382.69168730652,-33.96040422387159,-52.09149441624888,110.29434327499442,14.412767801841255,37.40992776064377,10.386997592016996,62533.089050727765,62233.794323885275,75.00585815220684,60.246061853145115,False,True,61964.637,62864.637,62364.637,62314.637,,False,2024-04-29 16:45:00,2024-04-29 16:43:04,2024-04-29 17:34:15,success,True,93.08,1101.1399999999999,11,0,18,4
2024-04-29 17:00:00,61971.738,62236.539,61825.648,62191.84,3212,36422,0,2024-04-29 17:00:00,2024-04-29 17:00:00,-121.66430952378141,-450.510119236249,62421.313452381,-0.0016807976230277851,-0.0011718737837318242,62279.82452380953,62774.23093639034,64305.86745898668,62258.85656722291,62329.16171554377,62200.529970760195,-48.25901771784265,-46.812857958792556,151.77142848168964,-31.500969040258497,-81.19112865501666,-85.67058582729078,62405.42139921048,61994.13854230991,30.023017593672318,39.20451592465626,False,True,61691.84,62591.84,62091.84,62041.84,,False,2024-04-30 12:00:00,2024-04-30 12:34:43,2024-04-29 17:28:09,fail,False,-74.48,1026.6599999999999,0,1,18,4
2024-04-30 15:00:00,61156.539,61255.094,60694.738,61113.637,4248,36422,0,2024-04-30 15:00:00,2024-04-30 15:00:00,-405.1680714285467,-335.60108685866726,61279.17307142855,-0.0006767872036524866,0.0008293777151568583,61566.026464285715,61438.087641036494,64361.91221961981,61576.15768394631,62099.05665188395,61110.40422394221,-277.28423434698925,-236.7670087759036,824.0122739651327,-42.438487444102066,-59.66504781556432,-86.43388648086693,62222.820793795145,59996.48765408928,16.098488621421083,10.952572389005114,False,True,60613.637,61013.637,61013.637,60963.637,2024-04-30 17:00:00,True,2024-04-30 17:00:00,2024-04-30 17:00:43,2024-04-30 17:35:08,success,True,93.08,1119.7399999999998,1,0,18,4
2024-04-30 17:00:00,60773.84,60937.438,60507.84,60536.938,4565,36422,0,2024-04-30 17:00:00,2024-04-30 17:00:00,-307.2619166666773,-503.8540997663804,60964.721488095245,-0.0007925439782630181,-0.00025167732222615576,60971.911154761874,61366.626733790705,64746.44625250149,61145.416316455674,61610.13850759613,60893.81639215683,-277.36424476366665,-265.5048514103483,536.8828843388234,-114.32243894054409,-75.36981148947962,9.98116580669739,61618.60828601424,60167.52449829941,20.742036300868183,34.20318058302556,False,True,60036.938,60936.938,60436.938,60386.938,,False,2024-04-30 19:30:00,2024-04-30 20:16:45,2024-04-30 17:33:20,fail,False,-74.48,1045.2599999999998,0,1,18,4
2024-04-30 18:00:00,61192.563,61353.137,60725.855,60800.84,3804,36422,0,2024-04-30 18:00:00,2024-04-30 18:00:00,-7.189666666628909,-534.9838452028634,60901.67246428571,-0.000792608663334344,-0.0008191892630340463,60964.721488095245,61318.03688833785,64839.597118178164,61074.52670422001,61449.12195148613,60878.203114207055,-247.65413633519347,-260.00504612300756,386.79373960938506,-29.242185070572305,39.03423770212248,34.98360715514718,61400.37466267972,60354.53156573439,54.05305254129158,45.531696850603026,False,True,60300.84,60700.84,60700.84,60650.84,2024-04-30 18:45:00,True,2024-04-30 18:45:00,2024-04-30 19:13:23,2024-04-30 18:45:35,even,True,18.62,1063.8799999999997,1,0,18,4
2024-04-30 19:00:00,60746.738,60869.539,60281.84,60685.137,4067,36422,0,2024-04-30 19:00:00,2024-04-30 19:00:00,-63.049023809537175,-588.8661603430955,60654.58049999999,-0.0009748006007641499,-0.0014118728635558605,60901.67246428571,61169.001495661105,64863.13091806325,60911.90590814345,61263.198192351105,60766.76981320945,-236.04674410189182,-247.58858585510865,347.7424014186436,-48.54919814247842,-37.814122806965315,-39.78567389064119,61236.22205512462,60295.81757129428,24.075985326643252,26.88308741648245,False,True,60185.137,61085.137,60585.137,60535.137,,False,2024-04-30 19:30:00,2024-04-30 19:18:26,2024-05-03 16:04:22,success,True,93.08,1156.9599999999996,2,0,18,4
2024-04-30 20:00:00,60295.738,60469.691,60160.84,60219.883,3655,36422,0,2024-04-30 20:00:00,2024-04-30 20:00:00,-247.09196428571886,-660.3481319162893,60480.27629761902,-0.0009870547621836294,-0.0016253078800968028,60654.58049999999,61101.99132539142,64785.90902676688,60597.17025752349,60999.309353089346,60374.71481664947,-253.54763818968058,-249.2589710114184,378.788927417822,-84.74805641554121,-81.10285964910872,-99.23668455454026,60886.07986866353,59861.849764635415,12.47047723550309,13.597578378377863,False,True,59719.883,60119.883,60119.883,60069.883,2024-04-30 22:15:00,True,2024-04-30 22:15:00,2024-04-30 22:16:59,2024-04-30 22:19:04,success,True,93.08,1250.0399999999995,3,0,18,4
2024-04-30 21:00:00,60334.137,60509.137,60280.168,60417.238,3115,36422,0,2024-04-30 21:00:00,2024-04-30 21:00:00,-174.3042023809685,-705.764022671181,60409.69724999999,-0.000986867625292761,-0.001625119981487957,60480.27629761902,61041.88002769419,64680.62907609738,60466.64581535665,60820.780203368806,60259.11088407296,-236.64275126110442,-246.27726482452962,388.4301218731421,13.807284485767013,-22.854749913996784,-67.74050395604718,60784.9915486017,59734.73021954422,18.457741871885954,16.52124534379895,False,True,59917.238,60317.238,60317.238,60267.238,2024-04-30 21:45:00,True,2024-04-30 21:45:00,2024-04-30 22:14:45,2024-04-30 21:59:42,even,True,18.62,1268.6599999999994,4,0,18,4
2024-04-30 22:00:00,60369.441,60461.539,59916.855,59952.039,3258,36422,0,2024-04-30 22:00:00,2024-04-30 22:00:00,-70.57904761903046,-730.4552758532518,59969.13853571433,-0.0015276813941526855,-0.0026681809394115217,60409.69724999999,60796.51666796719,64575.657865439345,60327.95840708086,60654.27195063034,60091.302592019274,-222.38754553629406,-233.42144379249805,389.7800891375031,-43.66493154455384,-10.223281733691692,-74.43168971448904,60617.505712354905,59563.59947168364,19.828447451914943,21.966396382222978,False,True,59452.039,60352.039,59852.039,59802.039,,False,2024-04-30 23:00:00,2024-04-30 22:55:30,2024-05-01 00:41:29,success,True,93.08,1361.7399999999993,5,0,18,4
2024-05-01 00:00:00,59902.273,60176.238,59897.527,60077.059,2492,56422,0,2024-05-01 00:00:00,2024-05-01 00:00:00,-111.00425000008545,-847.2212443695171,59836.74226190477,-0.0021611668770374036,-0.0030321615097073595,59858.134285714244,61227.00743117274,64185.35060099289,59986.68513460798,60284.84075888475,59806.3660945992,-208.98374082567898,-225.31924757467604,375.24443272499775,19.55426556582097,-27.09642655657808,4.352026487838884,60314.446078777946,59299.78611042046,59.96893315738737,52.73448401521322,False,True,59577.059,60477.059,59977.059,59927.059,,False,2024-05-01 04:15:00,2024-05-01 05:13:41,2024-05-01 01:25:21,fail,False,-74.48,1287.2599999999993,0,1,18,5
2024-05-01 01:00:00,60118.113,60421.738,60092.969,60371.738,2798,56422,0,2024-05-01 01:00:00,2024-05-01 01:00:00,-21.392023809472448,-833.9432958908728,60055.85103571431,-0.0022539694877376656,-0.0026860952295454277,59836.74226190477,61179.40013769578,64055.74223333987,60114.743391330674,60274.702191301294,60007.870725490175,-149.4815623220784,-191.09044130502548,286.0093744197566,67.08854833158694,37.25410801512771,37.56603543176607,60395.483380956844,59621.758070023505,81.69722306526468,78.94464222684543,False,True,59871.738,60771.738,60271.738,60221.738,,False,2024-05-01 04:00:00,2024-05-01 04:09:42,2024-05-01 01:32:13,fail,False,-74.48,1212.7799999999993,0,2,18,5
2024-05-01 02:00:00,60542.738,60563.738,60359.828,60407.539,1952,36422,0,2024-05-01 02:00:00,2024-05-01 02:00:00,219.10877380953752,-780.1485807478821,60277.18358333335,-0.0022933012541764097,-0.0026776548202121875,60055.85103571431,61074.98543120314,63886.50817196239,60334.00332440995,60354.89164855754,60451.94411971104,-79.53883282125753,-134.15648844240528,318.62817424988197,59.65857619531016,98.8842810458882,134.56229308558977,60883.59215494838,60021.7960844737,73.49821701135902,82.88653131543629,False,True,59907.539,60807.539,60307.539,60257.539,,False,2024-05-01 04:00:00,2024-05-01 04:09:11,2024-05-01 02:47:03,fail,False,-74.48,1138.2999999999993,0,3,18,5
2024-05-01 03:00:00,60624.52,60798.438,60569.84,60569.84,3122,36422,0,2024-05-01 03:00:00,2024-05-01 03:00:00,221.3325476190439,-722.5875408979773,60299.53701190471,-0.0022933147033886514,-0.002622116429582187,60277.18358333335,60935.78969398278,63733.659137204944,60459.76186991653,60417.55995699953,60745.83046336431,-35.31379594737518,-82.90908868842341,353.24326747353933,54.22204403166688,68.20404953555408,74.24852459591057,61224.208874453594,60268.95205227503,68.9253280058508,70.37896388280502,False,True,60069.84,60469.84,60469.84,60419.84,2024-05-01 03:30:00,True,2024-05-01 03:30:00,2024-05-01 03:32:34,2024-05-03 15:45:31,success,True,93.08,1231.3799999999992,1,0,18,5
2024-05-01 05:00:00,60091.512,60140.938,59537.34,59537.34,3666,36422,0,2024-05-01 05:00:00,2024-05-01 05:00:00,-2.121107142782421,-688.5377474750421,60245.56329761905,-0.0026946809812934056,-0.002621561324842845,60297.415904761925,60926.18031166431,63402.12786684984,60143.92094439722,60257.6177682966,60061.30579635359,-69.41979801998241,-56.96763836861984,324.6161837954928,-171.4222968696995,-63.18214241478563,-59.765486068223254,60499.5376444775,59621.57394822968,18.124582615965537,23.800498487383877,False,True,59037.34,59937.34,59437.34,59387.34,,False,2024-05-01 10:15:00,2024-05-01 10:07:13,2024-05-01 05:57:43,fail,False,-74.48,1156.8999999999992,0,1,18,5
2024-05-01 08:00:00,60244.438,60294.438,60093.84,60128.637,1573,36422,0,2024-05-01 08:00:00,2024-05-01 08:00:00,-25.287357142893597,-612.3456899509329,60050.67311904759,-0.0034392947846091444,-0.002450737941646051,60143.00636904762,60795.685895366805,63012.681536730146,60134.090296079834,60160.50031340275,60147.129876504965,-36.949353654250444,-53.64347628196248,281.77264594154536,37.33927691773715,62.38237667702924,75.00514826281142,60529.02294852605,59766.73680448388,81.9866745988594,81.5852307425031,False,True,59628.637,60028.637,60028.637,59978.637,2024-05-01 09:15:00,True,2024-05-01 09:15:00,2024-05-01 09:31:38,2024-05-03 15:34:51,success,True,93.08,1249.979999999999,1,0,18,5
2024-05-01 09:00:00,60017.137,60075.539,59839.789,59885.453,1958,36422,0,2024-05-01 09:00:00,2024-05-01 09:00:00,-92.33325000003242,-593.6860989346242,59849.84827380959,-0.0032010419998009555,-0.00245092466306656,60050.67311904759,60487.51563130087,62859.066052600356,60052.86690133065,60110.362198195,60131.359771929885,-43.32781615697604,-46.0138678408553,228.29108305322129,-11.191396972695657,13.510200550299487,-21.525818025467743,60439.55273405174,59821.66680980803,46.821036962263655,57.08425604286197,False,True,59385.453,59785.453,59785.453,59735.453,2024-05-01 09:30:00,True,2024-05-01 09:30:00,2024-05-01 10:01:00,2024-05-01 09:39:03,even,True,18.62,1268.599999999999,2,0,18,5
2024-05-01 10:00:00,59485.84,59535.539,57581.84,58461.84,6181,36422,0,2024-05-01 10:00:00,2024-05-01 10:00:00,-200.8248452379994,-614.299592025156,59048.00489285712,-0.0030521182182638384,-0.0022924825949305885,59849.84827380959,60248.50418708791,62547.89501641276,59669.267317054095,59899.05486481081,59565.94451289991,-106.18333527003415,-63.38614355616931,376.991704704185,-305.4633340212822,-124.59206432749488,-82.05222703816253,60074.883314250554,59055.50571154926,20.88211511456142,15.733273951395518,False,True,57961.84,58861.84,58361.84,58311.84,,False,2024-05-01 10:30:00,2024-05-01 10:25:37,2024-05-01 21:50:35,success,True,93.08,1361.679999999999,3,0,18,5
2024-05-01 11:00:00,57459.238,57552.34,56903.887,57315.539,6246,36422,0,2024-05-01 11:00:00,2024-05-01 11:00:00,-801.8433809524722,-785.1409032268566,58265.97010714291,-0.003495551160775354,-0.0022924680258757245,59048.00489285712,60201.09374528735,62409.502535414285,58639.71824050239,59284.60504071143,58060.33945958035,-282.30281657276646,-162.32395984888973,932.7668190829478,-362.8553914688455,-390.41926659786986,-381.4430309597301,59319.57466534233,56799.60425381837,15.198839587879194,19.452738113906282,False,True,56815.539,57715.539,57215.539,57165.539,,False,2024-05-01 11:30:00,2024-05-01 11:20:42,2024-05-01 13:59:44,success,True,93.08,1454.7599999999989,4,0,18,5
2024-05-01 12:00:00,57126.781,57613.738,56998.637,57310.34,4173,36422,0,2024-05-01 12:00:00,2024-05-01 12:00:00,-782.0347857142115,-935.8575441600697,57630.021261904796,-0.003495674889261903,-0.0022923701096549073,58265.97010714291,59989.37794773382,62266.356822731505,57888.023650474264,58701.174815676444,56932.35532060546,-390.14728568020655,-284.5330969320993,1294.222672594262,-160.6063144134896,-247.5990749913617,-346.2470667354355,58679.55592860771,55183.6547126032,15.912491740718787,13.255232042774528,False,True,56810.34,57210.34,57210.34,57160.34,2024-05-01 13:00:00,True,2024-05-01 13:00:00,2024-05-01 18:17:22,2024-05-01 13:20:13,even,True,18.62,1473.3799999999987,5,0,18,5
2024-05-01 13:00:00,57070.801,57129.84,56836.84,56936.539,3429,36422,0,2024-05-01 13:00:00,2024-05-01 13:00:00,-635.948845238112,-1048.3009802854067,57361.72454761909,-0.003495538309509186,-0.0022924817700722857,57630.021261904796,59780.50365985294,62123.5729355497,57527.909019732986,58294.713325933844,56585.7086047472,-409.50911754330446,-353.84875358366946,1380.0363062543552,-73.66315823869809,-95.62815204684011,-75.42844203642017,58448.757618190575,54721.15959130382,17.776549672462203,20.962861063139563,False,True,56436.539,57336.539,56836.539,56786.539,,False,2024-05-01 20:15:00,,2024-05-01 13:20:37,fail,False,-74.48,1398.8999999999987,0,1,18,5
2024-05-01 14:00:00,57724.539,57825.637,57516.211,57580.84,3298,36422,0,2024-05-01 14:00:00,2024-05-01 14:00:00,-268.29671428570873,-1072.3840828874745,57306.30400000002,-0.003495834014905049,-0.0022925375359811977,57361.72454761909,59570.064076557974,61981.047302129205,57552.042998771416,58102.75961382901,57111.75483935331,-348.79278685977624,-363.0705450097292,1217.3975636042578,179.56818507051503,168.36779944961017,117.2180595115642,58756.741550219056,55468.26812848756,67.67780793660273,49.850850533989835,False,True,57080.84,57980.84,57480.84,57430.84,,False,2024-05-01 17:00:00,2024-05-01 17:12:52,2024-05-01 15:10:44,fail,False,-74.48,1324.4199999999987,0,2,18,5
2024-05-01 15:00:00,57836.238,58193.34,57675.125,58154.438,3757,36422,0,2024-05-01 15:00:00,2024-05-01 15:00:00,-55.42054761906911,-1069.5070027849652,57425.187190476165,-0.003495614233354863,-0.002292379441913881,57306.30400000002,59361.05621611902,61838.08842074463,57686.65990823193,58023.674795151215,57732.109218782294,-267.45117700783885,-324.87056793038835,909.3103057859898,174.1908101135923,139.6611719986031,127.46245889237616,58961.178131593384,56504.540305971204,92.78631660261983,86.21214017365106,False,True,57654.438,58054.438,58054.438,58004.438,2024-05-01 16:00:00,True,2024-05-01 16:00:00,2024-05-01 16:17:58,2024-05-01 21:04:41,success,True,93.08,1417.4999999999986,1,0,18,5
2024-05-01 16:00:00,57928.137,57956.738,57664.637,57808.66,3018,36422,0,2024-05-01 16:00:00,2024-05-01 16:00:00,118.88319047614641,-1048.515398684307,57425.80836904761,-0.0034958842859164813,-0.0022423168465578102,57425.187190476165,59156.10741109616,61666.20265140597,57809.27983825579,58003.35609073432,57994.49019745445,-194.94447168130137,-258.6814043720358,407.4590331177302,-8.74811042312649,41.31095390442351,110.76686274502572,58544.55989216339,57442.92050274551,78.44426319349274,84.3764448904417,False,True,57308.66,57708.66,57708.66,57658.66,2024-05-01 16:30:00,True,2024-05-01 16:30:00,2024-05-01 16:33:13,2024-05-01 16:47:34,success,True,93.08,1510.5799999999986,2,0,18,5
2024-05-01 17:00:00,57256.938,57519.438,57033.09,57232.738,4433,36422,0,2024-05-01 17:00:00,2024-05-01 17:00:00,0.6211785714476719,-1073.4956701304181,57576.56323809523,-0.003495893084863379,-0.0017444403832711994,57425.80836904761,58950.00162330266,61252.74650649779,57598.964580928645,57841.90669265468,57736.26468661855,-192.70503629407904,-218.03934690841066,357.8763756935277,-94.80906948744087,-88.65191503266396,-49.29036222914874,58219.39779380482,57251.63157943229,24.496273371013434,40.18849951170433,False,True,56732.738,57132.738,57132.738,57082.738,2024-05-01 18:15:00,True,2024-05-01 18:15:00,2024-05-01 18:18:30,2024-05-01 18:27:46,success,True,93.08,1603.6599999999985,3,0,18,5
2024-05-01 18:00:00,57441.277,57475.738,56901.848,56961.84,3483,36422,0,2024-05-01 18:00:00,2024-05-01 18:00:00,150.75486904761783,-1066.1483765895537,57360.78172619045,-0.003495680978866718,-0.0017443584291756673,57576.56323809523,58745.583821367436,61146.09744000296,57441.47822104885,57696.007523710505,57349.08951255585,-185.65810835756565,-197.89565616526647,324.0758765144644,-138.0070024079978,-61.152696938406734,-99.27767733067594,57786.59194585038,56910.08707926133,23.572238676796506,27.19744670598371,False,True,56461.84,57361.84,56861.84,56811.84,,False,2024-05-01 20:15:00,,2024-05-01 19:26:11,fail,False,-74.48,1529.1799999999985,0,1,18,5
2024-05-01 19:00:00,56847.039,57012.34,56711.215,56981.34,3718,36418,0,2024-05-01 19:00:00,2024-05-01 19:00:00,-215.78151190478093,-1095.785313255954,57188.11710714283,-0.0034957378212544608,-0.0018006982285520671,57360.78172619045,58540.340207220106,61063.86128659532,57201.89574946171,57499.07541183201,56913.28606363951,-196.48354970997025,-195.81229091839913,380.02749372631683,-89.4934960440296,-131.53746336429322,-119.88510767114349,57426.32318017004,56398.74894710899,18.64208458891746,18.26220345861278,False,True,56481.34,57381.34,56881.34,56831.34,,False,2024-05-01 20:15:00,,2024-05-01 19:26:14,fail,False,-74.48,1454.6999999999985,0,2,18,5
2024-05-01 20:00:00,56998.707,57114.539,56714.043,56731.738,3358,36422,0,2024-05-01 20:00:00,2024-05-01 20:00:00,-172.66461904761672,-1093.873678869153,57137.201690476184,-0.0034959136801877063,-0.001975556449106992,57188.11710714283,58336.61445975975,61017.83698683837,57088.15731808651,57363.42139090676,56840.79008565533,-185.0515134803718,-188.71134982102768,410.6549009305297,-40.91307671136019,-12.048648090829374,-21.868363261091872,57395.17420191155,56284.905969399115,23.893538890657467,32.0252328677026,False,True,56231.738,57131.738,56631.738,56581.738,,False,,,2024-05-01 20:27:24,fail,False,-74.48,1380.2199999999984,0,3,18,5
2024-05-01 21:00:00,57373.738,58128.637,57230.438,57808.539,6788,36422,0,2024-05-01 21:00:00,2024-05-01 21:00:00,-50.915416666648525,-1050.4901399180308,57659.574416666685,-0.003495652670354742,-0.0013495952029959448,57137.201690476184,58130.5923800987,60871.27415572812,57249.07832653284,57371.16103216905,57169.18672721013,-124.35136680523283,-165.48401212349802,409.36836306337756,154.0154760921796,83.53015651871101,47.99700963190844,57723.33401734569,56616.53943707457,69.80827676613252,58.09532854022879,False,True,57308.539,58208.539,57708.539,57658.539,,False,2024-05-01 22:45:00,2024-05-01 22:34:15,2024-05-01 21:34:44,fail,False,-74.48,1305.7399999999984,0,4,18,5
2024-05-01 23:00:00,56919.938,57271.738,56917.438,57058.039,4308,36422,0,2024-05-01 23:00:00,2024-05-01 23:00:00,-177.25553571429919,-901.1570440653086,57500.45872619045,-0.0034357788886825473,-0.0013497486042277616,57482.318880952385,57706.554449789735,60710.033529183886,57594.40508780928,57584.607878947136,57916.810724458206,-23.960303744759585,-35.649222350792215,583.1970452004782,-128.9325115238462,-146.06131922957138,-44.44466288262629,58704.12673547885,57127.99471343756,20.041941635330158,33.90402419826399,False,True,56558.039,57458.039,56958.039,56908.039,,False,,,2024-05-01 23:46:35,fail,False,-74.48,1231.2599999999984,0,5,18,5
2024-05-02 00:00:00,57305.938,57435.238,57199.184,57399.039,2369,56422,0,2024-05-02 00:00:00,2024-05-02 00:00:00,18.13984523806721,-872.4677202776511,57644.557488095226,-0.003040816468853668,-0.0013496499681731465,57500.45872619045,57392.40941637784,60627.16503084894,57471.32932882657,57519.48496557045,57601.536522531824,-38.87492062333331,-35.976385856970325,582.9733006169196,-76.24828654974408,-63.77719401438662,-81.48496697628434,58388.55047836467,56813.02256669898,24.95603835207344,24.274631866210527,False,True,56899.039,57799.039,57299.039,57249.039,,False,2024-05-02 04:45:00,,2024-05-02 00:23:11,fail,False,-74.48,1156.7799999999984,0,6,18,5
2024-05-03 05:00:00,59261.57,59815.895,59209.738,59703.215,3025,36422,0,2024-05-03 05:00:00,2024-05-03 05:00:00,60.8742380952026,264.43660363113304,59249.455654761856,0.0012964100661366643,0.0009297218380026463,59089.91434523807,57376.66787915604,59021.83958008014,59259.347240058734,59155.02228691633,59281.43242208461,58.469364531105384,46.34526417482738,229.91493848146615,107.8953715170137,5.027159270714037,20.58521878223837,59593.31758903459,58971.04725513463,83.44214287241151,85.45740621282359,True,False,60203.215,59303.215,59803.215,59853.215,,False,2024-05-03 15:45:00,2024-05-03 15:35:56,2024-05-03 09:17:25,fail,False,-74.48,1082.2999999999984,0,7,18,5
2024-05-03 06:00:00,59498.438,59779.738,59452.637,59767.266,2396,36422,0,2024-05-03 06:00:00,2024-05-03 06:00:00,159.5413095237891,288.15053442970384,59452.603250000015,0.0015205681252841987,0.0009296307742361499,59249.455654761856,57437.899361103155,59076.7636609133,59423.3667435909,59269.74390484117,59534.194116271065,80.18220645300607,61.77810329273804,258.258459013275,95.77537702099653,46.897691434460285,52.661281389708165,59884.34303593899,59185.54519660314,74.82674503580795,73.06551565964288,True,False,60267.266,59367.266,59867.266,59917.266,,False,2024-05-03 15:45:00,2024-05-03 15:36:36,2024-05-03 09:17:14,fail,False,-74.48,1007.8199999999983,0,8,18,5
2024-05-03 07:00:00,59668.09,59757.738,59587.215,59701.789,2216,36422,0,2024-05-03 07:00:00,2024-05-03 07:00:00,203.14759523815883,316.9754826687058,59503.28483333329,0.001520596794042994,0.0009295923045960923,59452.603250000015,57525.36326942859,59131.533549526575,59555.09605598243,59382.03846975032,59781.870424492576,93.61837202098104,78.88650563251605,277.8295209603967,43.08567354655679,50.11832163744839,78.41392707260093,60158.44027778911,59406.80057119604,77.32234235856065,79.28846238890587,True,False,60201.789,59301.789,59801.789,59851.789,,False,2024-05-03 15:45:00,2024-05-03 15:35:55,2024-05-03 09:17:25,fail,False,-74.48,933.3399999999983,0,9,18,5
2024-05-03 08:00:00,59550.262,59559.34,59411.141,59431.84,1529,36422,0,2024-05-03 08:00:00,2024-05-03 08:00:00,50.68158333327301,326.74907479135436,59531.234214285716,0.0015206841379075652,0.0009712869677852158,59503.28483333329,57612.78718164623,59176.53811762912,59548.4610573733,59426.622246469924,59691.714222222196,79.33919913296268,83.317632012411,285.6354521141968,-63.152234262088314,-37.81222291030281,-15.011307877488434,60077.322082576364,59304.60636186803,42.38842901001102,54.86946625939783,True,False,59931.84,59031.84,59531.84,59581.84,,False,2024-05-03 15:45:00,2024-05-03 15:34:44,2024-05-03 10:50:31,fail,False,-74.48,858.8599999999983,0,10,18,5
2024-05-03 10:00:00,59195.805,59397.969,59163.512,59371.039,1962,36422,0,2024-05-03 10:00:00,2024-05-03 10:00:00,-55.91916666670295,297.34729157117545,59365.693595238125,0.00123037885758181,0.0011929598243773122,59475.31504761901,57719.52122609168,59265.52651399721,59417.991839760936,59409.24628489597,59342.672658066695,30.906498626434768,53.47346666018622,159.33861018234927,-33.43910354322725,-66.33510835911875,-42.97458995522902,59557.77978181287,59126.06553432052,12.256185616362137,8.569153651187277,True,False,59871.039,58971.039,59471.039,59521.039,,False,2024-05-03 15:45:00,2024-05-03 15:33:19,2024-05-03 13:41:40,fail,False,-74.48,784.3799999999983,0,11,18,5
2024-05-03 16:00:00,60583.898,61219.852,60464.137,61105.871,5076,36422,0,2024-05-03 16:00:00,2024-05-03 16:00:00,475.787892857159,287.99504382287705,60391.74866666672,0.0008834717338897622,0.0018038503101805799,59638.58669047622,57986.125239206114,59841.022816086595,59777.709087521325,59527.89111073823,59897.49890780871,86.89073582918354,12.850166896963021,521.5703327909177,328.8955569314785,249.67877158589545,225.10080632951576,60603.11885707645,59193.37895854097,95.43791444677926,77.65819182582474,True,False,61605.871,60705.871,61205.871,61255.871,,False,2024-05-03 16:45:00,2024-05-03 16:36:00,,success,True,93.08,877.4599999999983,1,0,18,5
2024-05-03 17:00:00,61629.746,62173.809,61481.84,61551.84,5227,36422,0,2024-05-03 17:00:00,2024-05-03 17:00:00,753.1619761904949,442.9842138487147,60956.68995238092,0.0008836509386503919,0.001969044199196093,60391.74866666672,58037.955579074944,60013.24271829544,60612.893813255825,60044.80292322594,61167.46948022019,234.74475171560334,119.73338643683667,929.1831453493361,293.8211530788176,335.4453168214386,335.67258789126936,62423.366726441796,59913.07223399859,88.34195732555146,92.29713544705054,True,False,62051.84,61651.84,61651.84,61701.84,2024-05-03 17:45:00,True,2024-05-03 17:45:00,2024-05-03 19:39:42,2024-05-03 17:49:36,even,True,18.62,896.0799999999983,2,0,18,5
2024-05-03 18:00:00,61574.422,61711.738,61406.441,61431.938,3000,36422,0,2024-05-03 18:00:00,2024-05-03 18:00:00,564.9412857142015,554.4664614319408,61394.69779761902,0.0008836484967193905,0.001969140659705553,60956.68995238092,58089.23209424347,60130.63769357366,61088.560306707695,60456.69687565155,61967.202070519445,299.8345770074666,219.22984621119207,1120.9020315421326,88.26735947711131,176.93205331956415,253.16296732028422,63481.919813101325,60453.984327937564,81.88244339649786,83.6431180766304,True,False,61931.938,61531.938,61531.938,61581.938,2024-05-03 19:00:00,True,2024-05-03 19:00:00,2024-05-03 19:27:39,2024-05-03 19:52:44,success,True,93.08,989.1599999999984,3,0,18,5
2024-05-03 19:00:00,61643.938,61850.063,61643.938,61727.738,2477,36422,0,2024-05-03 19:00:00,2024-05-03 19:00:00,438.0078452380985,641.037151573415,61685.60495238095,0.0007684553649305182,0.00196899754694613,61394.69779761902,58227.69452682098,60249.98340166764,61329.68027255725,60751.52736147453,62058.02365084282,308.7233735061236,269.57117083948924,1173.7103820740329,-0.47931200543098385,30.02423116612772,25.26400103195192,63642.532666642765,60472.01463504288,79.58926495812675,78.465309594879,True,False,62227.738,61827.738,61827.738,61877.738,2024-05-03 19:30:00,True,2024-05-03 19:30:00,2024-05-03 23:15:30,2024-05-03 19:31:43,even,True,18.62,1007.7799999999984,4,0,18,5
2024-05-03 20:00:00,61636.039,61690.438,61477.637,61681.438,1662,36422,0,2024-05-03 20:00:00,2024-05-03 20:00:00,290.90715476193145,700.592841552374,61905.98136904768,0.0004989323189590071,0.001969152043332022,61685.60495238095,58460.81173786775,60368.2017443531,61529.173210339664,61015.616118504186,61810.7410392157,302.44651235822676,292.9177336897394,1080.5307249878615,-50.559024079761,-138.5892383901737,-68.53598727205099,63269.45751794932,60350.52456048209,55.55161913991824,67.64805709255936,True,False,62181.438,61781.438,61781.438,61831.438,2024-05-03 20:30:00,True,2024-05-03 20:30:00,2024-05-03 23:15:30,2024-05-03 20:31:47,even,True,18.62,1026.3999999999983,5,0,18,5
2024-05-03 21:00:00,61750.621,61924.539,61735.84,61899.438,1184,36422,0,2024-05-03 21:00:00,2024-05-03 21:00:00,220.37641666673153,748.9055463330078,61931.806809523805,0.00049911687902762,0.001979072643278092,61905.98136904768,58489.943854410114,60478.857849502296,61672.62995051233,61229.191255470876,61798.1058011696,282.62800267595594,290.7825406146716,763.3320735605087,31.36189095287409,-14.858521499794733,-8.078395940829068,62830.10410047629,60767.60750186291,62.433234108134315,58.9508735991161,True,False,62399.438,61999.438,61999.438,62049.438,2024-05-03 23:15:00,True,2024-05-03 23:15:00,2024-05-03 23:17:28,,success,True,93.08,1119.4799999999982,6,0,18,5
2024-05-03 22:00:00,61773.367,61773.367,61544.445,61597.539,1903,36422,0,2024-05-03 22:00:00,2024-05-03 22:00:00,25.82544047612464,779.8500353054987,61909.61219047619,0.00047205663978069353,0.0019791561369708814,61931.806809523805,58534.89184540708,60598.841264151815,61688.2387819562,61356.14053854013,61805.58304747161,239.50992710371065,269.0377394201185,202.18703008257165,-12.71039766085596,12.730671826720936,11.460311661445303,62078.53553808309,61531.13055686014,46.04466889664604,53.79009773176289,True,False,62097.539,61697.539,61697.539,61747.539,2024-05-03 22:45:00,True,2024-05-03 22:45:00,2024-05-03 23:11:31,,success,True,93.08,1212.5599999999981,7,0,18,5
2024-05-03 23:00:00,62012.715,62141.773,61902.938,62102.84,2527,36422,0,2024-05-03 23:00:00,2024-05-03 23:00:00,-22.19461904761556,814.3636601664984,62193.302869047664,0.00046754115765327534,0.0021080991581950057,61909.61219047619,58565.06486092289,60807.99051736057,61804.79695026857,61503.25152981656,61854.219905400685,218.52766740808875,240.5518761375512,170.1839199007945,43.502102511127305,22.71206467148295,-10.088580323361384,62085.46819726676,61624.47161353461,74.52356629020242,54.23906230359332,True,False,62602.84,61702.84,62202.84,62252.84,,False,2024-05-03 23:30:00,2024-05-03 23:23:06,,success,True,93.08,1305.639999999998,8,0,18,5
2024-05-06 00:00:00,63679.039,63683.938,63533.074,63616.84,1170,52422,0,2024-05-06 00:00:00,2024-05-06 00:00:00,283.69067857147456,899.0175866511418,62814.82741666661,0.0007994558002673818,0.0025556719283262182,62193.302869047664,58438.93837466639,60960.630040395474,62421.68574450762,61910.091449238185,62669.50742311666,292.5868711076255,255.10993237485113,525.8381372400014,295.34517819061875,177.81490092881722,183.13305297556508,63380.88890839066,61959.625937842655,91.65243607278579,91.69821286952687,True,False,64116.84,63716.84,63716.84,63766.84,2024-05-06 01:00:00,True,2024-05-06 01:00:00,2024-05-06 02:26:05,2024-05-06 01:02:00,even,True,18.62,1324.259999999998,9,0,19,5
2024-05-06 01:00:00,63820.039,63825.34,63673.152,63701.738,1806,56422,0,2024-05-06 01:00:00,2024-05-06 01:00:00,621.5245476189448,1032.3400579806985,63292.8652142857,0.0023888211466183895,0.0025723977458482605,62814.82741666661,57844.87265536717,61099.38025990833,63057.756360118205,62391.065660659726,63608.34457929134,365.5845908641786,310.37591694281406,798.9287758924003,187.90730822152545,247.7602769177829,236.12683006533916,64688.398426746084,62529.7907318366,96.64520566504638,96.647955418476,True,False,64201.738,63801.738,63801.738,63851.738,2024-05-06 02:15:00,True,2024-05-06 02:15:00,2024-05-06 03:20:40,2024-05-06 05:59:02,success,True,93.08,1417.3399999999979,10,0,19,5
2024-05-06 02:00:00,63809.137,63917.738,63771.27,63897.438,1760,36422,0,2024-05-06 02:00:00,2024-05-06 02:00:00,478.0377976190939,1123.9055604983732,63702.6058690476,0.0023888309989670595,0.002593900836971053,63292.8652142857,57983.479797366046,61272.67102123456,63419.887616977365,62762.574496704634,64126.19657275542,380.3260745974185,349.69173353564656,923.2072227943963,105.30311867901764,109.5915376677367,149.63071895416942,65374.026323527854,62879.866821982985,98.05184102134187,96.52533686436982,True,False,64397.438,63997.438,63997.438,64047.438,2024-05-06 02:30:00,True,2024-05-06 02:30:00,2024-05-06 04:21:18,2024-05-06 02:43:10,even,True,18.62,1435.9599999999978,11,0,19,5
2024-05-06 04:00:00,64165.539,64363.738,64165.539,64285.039,1984,36422,0,2024-05-06 04:00:00,2024-05-06 04:00:00,334.83889285713667,1254.3031367533404,64213.59095238091,0.0025144151474659664,0.0028574106659139723,64037.444761904735,58225.583805882074,61333.97527098197,63951.606521834154,63388.95723084712,64246.15117956655,361.6050501950158,367.7586758888715,881.6245967760938,12.579712418373674,-3.194071207472007,-25.335543515640893,65437.844385214274,63055.95797391883,82.43445514156264,80.88264218918646,True,False,64785.039,63885.039,64385.039,64435.039,,False,2024-05-06 11:00:00,2024-05-06 11:18:28,2024-05-06 05:51:25,fail,False,-74.48,1361.4799999999977,0,1,19,5
2024-05-06 05:00:00,64090.137,64180.738,63969.906,64139.938,1577,36422,0,2024-05-06 05:00:00,2024-05-06 05:00:00,176.14619047617452,1279.7487790505475,64146.74857142861,0.0030222931627159996,0.0028571036340147506,64213.59095238091,58255.04279901575,61508.60546581263,64047.65697245103,63591.334856564805,64238.85762985896,320.1260549733197,348.20008682619505,549.3457098459586,0.8816580667335074,-0.6277364981142455,8.62154179571371,64981.974338151005,63497.24092156692,59.883921073534395,67.63988602659153,True,False,64639.938,63739.938,64239.938,64289.938,,False,2024-05-06 09:15:00,2024-05-06 11:18:23,2024-05-06 06:12:07,fail,False,-74.48,1286.9999999999977,0,2,19,5
2024-05-06 07:00:00,63814.34,63814.34,63715.457,63783.738,1696,36422,0,2024-05-06 07:00:00,2024-05-06 07:00:00,-137.3939642858022,1232.7213873481523,63981.49121428569,0.003948582118154687,0.0033144865566298518,64009.354607142806,58502.97977034653,61548.86069260305,63879.69706798694,63702.572858241714,63821.41869109043,185.42383577478904,244.88293585725128,193.66164424704985,-47.41424974205438,-33.51004884753638,-61.40804953558836,64082.86191082395,63558.47547135691,18.935347746630583,17.61439333927228,True,False,64283.738,63883.738,63883.738,63933.738,2024-05-06 07:45:00,True,2024-05-06 07:45:00,2024-05-06 08:28:38,2024-05-06 13:48:24,success,True,93.08,1380.0799999999977,1,0,19,5
2024-05-06 08:00:00,64102.238,64129.438,63981.84,63995.637,1685,36422,0,2024-05-06 08:00:00,2024-05-06 08:00:00,-27.863392857114377,1220.8193377732096,64026.05601190476,0.004330419496994388,0.0033624687808861717,63981.49121428569,58714.47237004317,61724.007065451435,63933.67813775417,63777.362224108925,63832.82738080502,156.13822143926518,196.79295099776488,167.98280253341815,15.465661506757897,31.39918816647696,-2.6038046095491154,64061.10416422514,63606.05059738491,59.83479319804699,45.029192796253675,True,False,64495.637,64095.637,64095.637,64145.637,2024-05-06 08:30:00,True,2024-05-06 08:30:00,2024-05-06 10:59:17,2024-05-06 08:40:06,even,True,18.62,1398.6999999999975,2,0,19,5
2024-05-06 09:00:00,64131.34,64351.438,64081.84,64340.738,1779,36422,0,2024-05-06 09:00:00,2024-05-06 09:00:00,44.56479761906667,1199.624223858118,64066.94755952377,0.004591957283098254,0.0033626481321921025,64026.05601190476,58970.72825846973,61932.432667122164,64070.1882267028,63891.794736199394,64082.24001926386,148.7336618962363,169.3174288639238,184.02949164431837,83.17010663916881,52.7225314757452,51.23380323363381,64332.17983298369,63833.80020554403,81.90260633911916,79.1233994098241,True,False,64840.738,64440.738,64440.738,64490.738,2024-05-06 11:00:00,True,2024-05-06 11:00:00,2024-05-06 11:18:31,2024-05-06 11:12:56,even,True,18.62,1417.3199999999974,3,0,19,5
2024-05-06 10:00:00,64177.602,64304.637,64093.211,64147.637,1864,36422,0,2024-05-06 10:00:00,2024-05-06 10:00:00,40.891547619008634,1173.3350807752577,64213.606797619104,0.0044008668370338596,0.0033625288474152313,64066.94755952377,59230.10002859082,62141.30095824786,64132.340837266056,63974.205852709696,64274.9804709322,131.67844192026678,151.2439030678014,192.94538656696204,30.641104919151985,42.26771895425918,52.611068455422355,64536.9567427976,64014.504199066796,66.01832478665354,74.67996852695889,True,False,64647.637,64247.637,64247.637,64297.637,2024-05-06 10:30:00,True,2024-05-06 10:30:00,2024-05-06 11:18:23,2024-05-06 10:33:13,even,True,18.62,1435.9399999999973,4,0,19,5
2024-05-06 11:00:00,64491.34,64569.738,64432.738,64456.738,2601,36422,0,2024-05-06 11:00:00,2024-05-06 11:00:00,146.65923809533706,1164.3763381231547,64557.023202380915,0.004400801913874474,0.0034702270640750914,64213.606797619104,59492.59151230618,62307.55383471092,64270.82063955787,64089.73924635608,64419.853319573434,132.01782945056038,139.33354164680168,230.9995583303114,33.41895596838731,52.62979153764172,26.495311317507003,64733.20272331935,64108.00391582752,87.92115441084563,84.19252947985494,True,False,64956.738,64056.738,64556.738,64606.738,,False,2024-05-06 11:30:00,2024-05-06 11:19:28,2024-05-06 13:43:24,success,True,93.08,1529.0199999999973,5,0,19,5
2024-05-06 12:00:00,65090.84,65280.738,65090.688,65276.137,2101,36422,0,2024-05-06 12:00:00,2024-05-06 12:00:00,343.41640476181055,1191.9114960096995,64843.72311904762,0.004400750250349636,0.0037347005823450473,64557.023202380915,59757.62662119577,62426.12110059802,64754.88996637956,64402.1903188686,65007.50501169594,196.84947160372394,164.92046277314938,494.5844097991256,125.03298796011222,99.17293601650454,174.09615101476084,65676.69396492477,64339.81605846712,84.72479346255564,87.09529426560611,True,False,65776.137,64876.137,65376.137,65426.137,,False,,,2024-05-06 13:20:30,fail,False,-74.48,1454.5399999999972,0,1,19,5
2024-05-06 13:00:00,65111.805,65230.738,65055.84,65129.738,1845,36422,0,2024-05-06 13:00:00,2024-05-06 13:00:00,286.6999166667083,1202.0871838580351,64637.61050000002,0.003563765383426514,0.003734485365413368,64843.72311904762,59812.64632264137,62659.46820676287,64933.11994495161,64592.73045505718,65268.12226281389,201.36363957839058,186.72496362925688,517.1357067034776,44.657641898877046,66.44188888886129,50.13689439283189,65967.75546686359,64569.9890587642,73.13970058380163,75.29835189310424,True,False,65629.738,64729.738,65229.738,65279.738,,False,,,2024-05-06 13:29:14,fail,False,-74.48,1380.0599999999972,0,2,19,5
2024-05-06 14:00:00,63961.309,64301.238,63954.605,64301.238,2201,36422,0,2024-05-06 14:00:00,2024-05-06 14:00:00,-206.11261904760613,1104.018185062756,64492.53288095239,0.0035385286944337457,0.003624608201095678,64637.61050000002,60018.63144792868,62917.71617679775,64601.51576303478,64506.446251540074,64776.64656553145,110.28184260423586,158.55209938099281,479.9676387937362,-118.89672205022362,-179.9767058823345,-155.08395252841729,65424.602877902995,64127.19025315991,16.814019259666086,27.765413775106527,True,False,64801.238,63901.238,64401.238,64451.238,,False,,,2024-05-06 15:22:25,fail,False,-74.48,1305.5799999999972,0,3,19,5
2024-05-06 15:00:00,64159.84,64276.84,64063.039,64117.438,2071,36422,0,2024-05-06 15:00:00,2024-05-06 15:00:00,-145.07761904762447,1030.491098427563,64168.85907142854,0.0029680111603693085,0.003207983349799282,64492.53288095239,60021.845037945015,63223.17350051349,64365.56120390016,64403.32026615531,64178.7806463708,43.104191437290865,100.98917033840267,479.61459110313587,-135.83837220500573,-136.24011076716124,-177.01902683175285,64826.26034436003,63529.80094838156,19.891371557710983,21.42032590349757,True,False,64617.438,63717.438,64217.438,64267.438,,False,,,2024-05-06 15:29:47,fail,False,-74.48,1231.0999999999972,0,4,19,5
2024-05-06 16:00:00,63559.438,63638.238,63433.492,63611.438,2779,36422,0,2024-05-06 16:00:00,2024-05-06 16:00:00,-323.6738095238543,913.4290778623545,63971.49330952382,0.002910648069207431,0.002883909413575555,64168.85907142854,60176.222934082645,63465.01633732475,64021.56558812024,64208.225461292815,63602.61669453045,-35.22676041633531,33.88500159238365,580.4176270025664,-83.44346611625224,-125.50432748531603,-182.55383625737886,64386.18049098391,62817.55289807699,12.508877390682466,10.90946194283264,True,False,64111.438,63711.438,63711.438,63761.438,2024-05-06 16:45:00,True,2024-05-06 16:45:00,2024-05-06 17:21:34,2024-05-06 16:47:09,even,True,18.62,1249.719999999997,1,0,19,5
2024-05-06 17:00:00,63833.336,64097.738,63810.762,64031.84,3261,36422,0,2024-05-06 17:00:00,2024-05-06 17:00:00,-197.36576190471533,832.9572261048597,63590.99078571429,0.0026407384825903077,0.0026466498361112432,63971.49330952382,60219.46067373301,63693.888694612615,63932.54875122259,64105.970570877114,63576.13711179909,-56.11161300198728,-19.22168654957604,633.766302027784,59.64010319917725,12.739437564479886,1.7319559683892294,64433.2216195366,62720.55260406159,45.55209155911086,29.792647725323604,True,False,64531.84,63631.84,64131.84,64181.84,,False,2024-05-07 11:30:00,,2024-05-06 17:44:03,fail,False,-74.48,1175.239999999997,0,1,19,5
2024-05-08 03:00:00,62276.844,62465.137,62231.34,62419.84,2379,36422,0,2024-05-08 03:00:00,2024-05-08 03:00:00,-232.39691666666477,-180.64360541690257,62573.105833333335,-0.0003303676245589326,-0.00017280701268224377,62645.20172619047,62413.082016570894,64394.203668964175,62623.64276470301,62867.253093855026,62454.28014069487,-129.83319344230404,-107.9502292049809,281.75901272201855,-55.12496112832014,-94.37694220845151,-70.58542380455765,62834.6548078696,62072.40547352014,19.644212893338846,17.623234686387207,False,True,61919.84,62819.84,62319.84,62269.84,,False,2024-05-08 09:30:00,2024-05-08 16:09:28,2024-05-08 06:43:57,fail,False,-74.48,1100.759999999997,0,2,19,5
2024-05-08 08:00:00,62485.137,62502.137,62309.406,62448.988,2178,36422,0,2024-05-08 08:00:00,2024-05-08 08:00:00,-38.99527380953077,-238.6322734661153,62605.965916666675,-0.0006003963110079343,-0.0006147423248071269,62577.83355952382,62487.67548729827,64451.094694353575,62631.644610258896,62688.92959798124,62681.7033092535,-48.291685932425025,-54.219215805682445,170.9339796656806,-46.620767113876354,-53.09090402477159,-45.5616504987629,62912.46418180217,62449.44243670483,27.182665927765598,42.92049999869994,False,True,61948.988,62348.988,62348.988,62298.988,2024-05-08 09:30:00,True,2024-05-08 09:30:00,2024-05-08 16:09:27,2024-05-08 09:36:59,even,True,18.62,1119.379999999997,1,0,19,5
2024-05-08 10:00:00,62447.555,62559.637,62261.551,62301.938,1841,36422,0,2024-05-08 10:00:00,2024-05-08 10:00:00,-17.146416666691948,-250.16549518220563,62424.90836904767,-0.0005687631586229321,-0.0010561448524733228,62588.81949999998,62432.06167881798,64427.60385738029,62468.19671083048,62569.67619479598,62363.432791193685,-60.56932229956874,-54.176212019477056,176.29029396763468,-42.98304884756362,-25.236349157254153,-43.55245029240905,62601.42468804999,62123.94089433738,32.785658289932364,27.47051755120197,False,True,61801.938,62201.938,62201.938,62151.938,2024-05-08 10:30:00,True,2024-05-08 10:30:00,2024-05-08 16:09:28,2024-05-08 10:31:04,even,True,18.62,1137.9999999999968,2,0,19,5
2024-05-08 11:00:00,62166.008,62274.34,61989.762,62166.738,2994,36422,0,2024-05-08 11:00:00,2024-05-08 11:00:00,-163.91113095231412,-276.68917290394165,62363.34128571433,-0.0005687645075679004,-0.00124692546005859,62424.90836904767,62396.583597884346,64371.554083054754,62331.00802693425,62468.37080325036,62175.15367389064,-76.3807835681655,-65.01501336411519,232.6900808791784,-27.1575245957647,-53.41542758861033,-36.768444788467605,62489.28528307754,61859.52206470375,21.797683346199364,18.26703202745242,False,True,61666.738,62066.738,62066.738,62016.738,2024-05-08 16:15:00,True,2024-05-08 16:15:00,2024-05-08 23:19:42,2024-05-08 16:17:25,even,True,18.62,1156.6199999999967,3,0,19,5
2024-05-08 15:00:00,62206.738,62412.039,62181.84,62380.438,1625,36422,0,2024-05-08 15:00:00,2024-05-08 15:00:00,-22.08025000001362,-281.9435846606648,62226.39295238098,-0.001282276286591134,-0.0014155551322166068,62265.929464285706,62519.67182497895,64018.4159928153,62278.712432079104,62327.608381548445,62297.618605779135,-42.84224767812702,-52.53725130043302,113.4584051687051,27.625584451256145,-17.44312349503889,11.927361541173013,62452.287452756886,62144.449758801384,55.19213707689942,45.44749888669653,False,True,61880.438,62280.438,62280.438,62230.438,2024-05-08 15:45:00,True,2024-05-08 15:45:00,2024-05-08 16:09:28,2024-05-08 16:56:19,success,True,93.08,1249.6999999999966,4,0,19,5
2024-05-08 16:00:00,62188.938,62229.238,61781.84,61859.84,2846,36422,0,2024-05-08 16:00:00,2024-05-08 16:00:00,-39.53651190472738,-283.97291840048274,62286.92523809523,-0.0012066485390958513,-0.0013436348878567536,62226.39295238098,62416.49227740397,63946.42852347946,62187.42980302056,62268.84656872985,62171.16758066732,-51.302867066340696,-48.06148008868922,121.44269595782778,-79.51225558998703,-13.799619539022387,-34.51095975230419,62335.11522021039,62005.719941124255,20.603201251871564,35.80905250796759,False,True,61359.84,62259.84,61759.84,61709.84,,False,2024-05-08 23:30:00,2024-05-09 00:21:52,2024-05-08 16:56:16,fail,False,-74.48,1175.2199999999966,0,1,19,5
2024-05-08 17:00:00,62399.137,62408.137,62146.738,62170.539,2815,36422,0,2024-05-08 17:00:00,2024-05-08 17:00:00,60.532285714252794,-265.5586822319601,62377.54077380959,-0.0010629011509297242,-0.0010356837386840555,62286.92523809523,62305.253775197016,63959.411799464055,62154.98391961149,62226.4106957952,62082.42748606811,-48.83052113199665,-51.27401614272556,154.16182455521192,-19.56857550735731,36.81573030617437,-68.20176436193287,62290.545949217645,61872.80902291858,53.63328123632118,38.39944542263385,False,True,61670.539,62570.539,62070.539,62020.539,,False,2024-05-08 22:30:00,2024-05-08 23:19:42,2024-05-08 17:24:36,fail,False,-74.48,1100.7399999999966,0,2,19,5
2024-05-09 00:00:00,61512.121,61602.039,61412.414,61453.738,1748,56422,0,2024-05-09 00:00:00,2024-05-09 00:00:00,-306.3799880952647,-242.38225589258946,61799.38317857142,-0.0005698283583111976,-0.0006886116026454349,62062.336047619036,61936.53500780885,63373.549198917644,61917.314149654405,62106.92904845672,61710.683372548985,-74.48471239898208,-30.493625600918833,336.3970989448601,-149.74157000340347,-146.52563880293746,-141.2778716890607,62164.81945612455,61255.04728897342,8.987097893892484,11.606766629093322,False,True,60953.738,61353.738,61353.738,61303.738,2024-05-09 01:15:00,True,2024-05-09 01:15:00,2024-05-09 02:07:02,2024-05-09 01:31:03,even,True,18.62,1119.3599999999965,1,0,19,5
2024-05-09 01:00:00,61425.227,61524.938,61089.238,61161.137,2314,56422,0,2024-05-09 01:00:00,2024-05-09 01:00:00,-262.9528690476145,-289.7537451757162,61534.10284523812,-0.0007356724083416226,-0.0005686880167780208,61799.38317857142,61860.734499567116,63224.53885533946,61672.357696127234,61927.995081665526,61326.99748503609,-113.4250202508847,-70.76519715923732,444.716923562179,-127.02334434125078,-89.75880839352612,-72.03068524257105,61927.36533184503,60725.12963822715,11.545956002060118,14.592426589539043,False,True,60661.137,61061.137,61061.137,61011.137,2024-05-09 02:30:00,True,2024-05-09 02:30:00,2024-05-09 14:03:38,2024-05-09 02:39:17,even,True,18.62,1137.9799999999964,2,0,19,5
2024-05-09 02:00:00,61193.672,61214.137,60901.863,61141.84,2688,36422,0,2024-05-09 02:00:00,2024-05-09 02:00:00,-265.2803333332995,-341.6983963784369,61282.18799999998,-0.0008620943702107335,-0.00041941435081238945,61534.10284523812,61776.159467110076,63066.47733786865,61447.38714271204,61739.54500831813,61111.57073168211,-142.59184432522306,-108.1927101748258,534.2413095749681,-43.14147815618344,-39.398622979046195,-65.08231269347743,61832.79649960832,60388.84496375591,13.670507158400545,13.481932899032104,False,True,60641.84,61041.84,61041.84,60991.84,2024-05-09 02:30:00,True,2024-05-09 02:30:00,2024-05-09 14:03:38,2024-05-09 02:39:17,even,True,18.62,1156.5999999999963,3,0,19,5
2024-05-09 03:00:00,61135.285,61293.738,61094.84,61234.039,2335,36422,0,2024-05-09 03:00:00,2024-05-09 03:00:00,-251.91484523814142,-384.3575231454888,61189.49791666664,-0.0008620819511326361,-0.00035332878111598594,61282.18799999998,61722.67764920499,62990.07960876624,61279.797130508276,61568.10460332994,61007.46050292395,-155.45408636220964,-136.78453447672211,538.6671314412591,31.190372548975574,-26.6056449948519,-46.5813797728988,61736.16113036965,60280.259875478245,32.157492357639995,21.778629547814003,False,True,60734.039,61634.039,61134.039,61084.039,,False,2024-05-09 12:30:00,2024-05-09 13:59:54,2024-05-09 05:44:44,fail,False,-74.49,1082.1099999999963,0,1,19,5
2024-05-09 04:00:00,61346.441,61492.84,61323.523,61481.84,1468,36422,0,2024-05-09 04:00:00,2024-05-09 04:00:00,-92.69008333334205,-396.5099498359632,61236.76333333335,-0.0008621007712852516,-0.0003065446799948239,61189.49791666664,61669.31048821293,62935.47136852985,61336.737359188104,61521.38353253843,61213.36565806673,-123.42853673836362,-135.33259148367333,374.97798329352037,57.94881768147752,35.57228207773733,62.29757825942943,61721.08593551298,60707.14538062048,69.24370861314088,61.66110166492484,False,True,60981.84,61381.84,61381.84,61331.84,2024-05-09 11:00:00,True,2024-05-09 11:00:00,2024-05-09 12:23:39,2024-05-09 11:34:31,even,True,18.62,1100.7299999999962,1,0,19,5
2024-05-09 05:00:00,61511.438,61527.738,61441.938,61496.34,1131,36422,0,2024-05-09 05:00:00,2024-05-09 05:00:00,47.265416666712554,-388.43948129049386,61367.83946428571,-0.0008621420571827354,-0.0002972632089097499,61236.76333333335,61616.10385689162,62910.32427309275,61405.28144273216,61509.184959737424,61427.691420364565,-90.07240234357596,-114.57754248466551,228.0073086652117,64.09210698313109,65.72852941171732,35.13637254908099,61737.0012870626,61119.88155366653,93.34641701943383,91.37127543165838,False,True,60996.34,61396.34,61396.34,61346.34,2024-05-09 11:00:00,True,2024-05-09 11:00:00,2024-05-09 12:23:27,2024-05-09 11:34:31,even,True,18.62,1119.349999999996,2,0,19,5
2024-05-09 06:00:00,61616.238,61760.738,61482.84,61504.738,1506,36422,0,2024-05-09 06:00:00,2024-05-09 06:00:00,131.07613095235865,-369.6567554353096,61505.73411904768,-0.0008620974665039795,-0.0002862638532205843,61367.83946428571,61563.02767263924,62885.38775427384,61487.169612444995,61526.88303095815,61613.341996560055,-57.44450775133009,-85.64357440689787,191.85549478563726,18.850007911976718,53.30616615062172,49.51131888551754,61873.84691452066,61354.33707859945,86.31033863051626,93.85653837468509,False,True,61004.738,61404.738,61404.738,61354.738,2024-05-09 11:00:00,True,2024-05-09 11:00:00,2024-05-09 12:23:07,2024-05-09 11:34:33,even,True,18.62,1137.969999999996,3,0,19,5
2024-05-09 10:00:00,61559.07,61600.438,61443.453,61531.738,1649,36422,0,2024-05-09 10:00:00,2024-05-09 10:00:00,13.113749999996799,-311.0174396635048,61446.401523809516,-0.0012055045529368133,-0.0006200286612282101,61583.88658333333,61561.991857552086,62917.78367880043,61560.66149899832,61551.77184003285,61567.54633505331,-8.696345770324115,-17.874747167271234,76.5249566290812,0.1591503268064116,-0.48998348812165204,-6.187652218854055,61672.35502650257,61464.23764360405,48.19792030059225,60.84940826601069,False,True,61031.738,61431.738,61431.738,61381.738,2024-05-09 11:00:00,True,2024-05-09 11:00:00,2024-05-09 12:22:48,2024-05-09 15:31:27,success,True,93.1,1231.0699999999958,4,0,19,5
2024-05-09 11:00:00,61198.719,61356.938,61104.07,61175.137,2274,36422,0,2024-05-09 11:00:00,2024-05-09 11:00:00,-137.48505952381674,-322.0811728408589,61358.0849761905,-0.0012054862403823266,-0.0007584561534416144,61446.401523809516,61487.76921221401,62913.51322857979,61427.75445764623,61484.95497290355,61394.05594014448,-29.949124162929365,-19.740999111601745,125.66665631996062,-58.215729618146725,-69.33279669762851,-33.15991124880384,61563.70592617642,61222.90595411253,22.03127367625393,26.000615651948447,False,True,60675.137,61075.137,61075.137,61025.137,2024-05-09 13:30:00,True,2024-05-09 13:30:00,2024-05-09 14:03:38,2024-05-09 13:38:21,even,True,18.62,1249.6899999999957,5,0,19,5
2024-05-09 12:00:00,61269.168,61322.84,61131.84,61206.938,2286,36422,0,2024-05-09 12:00:00,2024-05-09 12:00:00,-88.31654761901882,-321.56616979929095,61291.28727380949,-0.0012054466491776877,-0.0008873464880842723,61358.0849761905,61413.94154448507,62889.9993856376,61353.530208129916,61430.41659638314,61281.57022875811,-39.64289342612756,-29.44688071001702,150.15627462308936,-41.52407808744465,-34.20637014101521,-3.299424836608523,61484.28119949928,61077.359258016935,32.8756931557336,33.228637545714996,False,True,60706.938,61106.938,61106.938,61056.938,2024-05-09 12:30:00,True,2024-05-09 12:30:00,2024-05-09 13:59:54,2024-05-09 12:54:36,even,True,18.62,1268.3099999999956,6,0,19,5
2024-05-09 13:00:00,61252.969,61287.84,61054.637,61146.938,1835,36422,0,2024-05-09 13:00:00,2024-05-09 13:00:00,-66.797702381009,-318.99821961231646,61090.524892857204,-0.0011765697958103277,-0.00100021833365789,61291.28727380949,61327.79429947403,62848.27123966193,61243.79429716151,61348.84712427186,61097.54324079807,-54.4021911883101,-43.14028724025672,194.73813322211114,-29.77997213623894,-19.18892122467514,-61.91082284136792,61360.43972064792,60833.14676094822,32.560723258898214,24.832802568837916,False,True,60646.938,61046.938,61046.938,60996.938,2024-05-09 13:30:00,True,2024-05-09 13:30:00,2024-05-09 14:03:38,2024-05-09 13:35:05,even,True,18.62,1286.9299999999955,7,0,19,5
2024-05-09 14:00:00,60763.738,60922.238,60523.141,60922.238,3293,36422,0,2024-05-09 14:00:00,2024-05-09 14:00:00,-200.76238095228473,-352.50320200584974,61025.8182261905,-0.0011099589090950894,-0.0011291607547183734,61090.524892857204,61231.46572648101,62793.50674208658,61083.10023741262,61234.85333108792,60930.933115927066,-76.64051825513889,-59.02280609942011,253.2868261301003,-29.306485380111553,-61.632636738846486,-21.72169625051174,61272.8703312027,60587.49590065143,24.549169878580216,20.857819334226757,False,True,60422.238,61322.238,60822.238,60772.238,,False,2024-05-10 20:15:00,2024-05-10 19:05:48,2024-05-09 15:30:09,fail,False,-74.5,1212.4299999999955,0,1,19,5
2024-05-09 15:00:00,61009.934,61188.438,60978.07,61171.738,1613,36422,0,2024-05-09 15:00:00,2024-05-09 15:00:00,-64.7066666667015,-354.70548505484476,61122.91145238094,-0.0010030552810646881,-0.0010173761466728505,61025.8182261905,61130.46601473723,62722.33766366495,61075.037156750754,61188.30338610348,60974.92093842447,-68.22132645973034,-67.40038688286731,252.04757755601224,35.762480908146244,5.7492184382426785,22.483243894013867,61316.685168125085,60634.65670872385,64.96957420447175,57.423108190260365,False,True,60671.738,61571.738,61071.738,61021.738,,False,2024-05-09 16:45:00,2024-05-10 17:55:27,2024-05-09 15:33:05,fail,False,-74.5,1137.9299999999955,0,2,19,5
2024-05-10 02:00:00,63226.414,63297.785,62958.109,63042.84,2133,36422,0,2024-05-10 02:00:00,2024-05-10 02:00:00,282.0821190476054,206.86332453863724,62933.007178571424,-9.884916218746314e-05,0.000384282273111209,62733.67330952378,60558.76067934882,62991.1856915194,62706.36441377839,62427.58739805204,62887.3081609907,154.95092812342773,134.35352061482718,347.5998034959793,65.04368214647548,120.32653594776639,79.9498145854086,63358.06789571027,62418.04842627113,83.32828124024898,87.09627389859212,True,False,63542.84,62642.84,63142.84,63192.84,,False,2024-05-10 10:30:00,,2024-05-10 04:12:58,fail,False,-74.5,1063.4299999999955,0,3,19,5
2024-05-10 08:00:00,62888.34,62929.738,62732.074,62735.723,1325,36422,0,2024-05-10 08:00:00,2024-05-10 08:00:00,-20.31880952384381,312.20231478747155,62780.50670238094,0.0017069378563847842,0.0013818838968275877,62888.59432142852,60527.771545246294,62451.05031736546,62831.04201081579,62769.96441405924,62858.51130753355,59.3472350578304,74.83004408767744,88.43778465192273,-16.992478156054858,16.624423804532853,6.907987272061291,62977.90231681364,62737.62029825345,46.85244039502811,62.16452981794064,True,False,63235.723,62835.723,62835.723,62885.723,2024-05-10 09:45:00,True,2024-05-10 09:45:00,2024-05-10 10:02:00,2024-05-10 11:16:08,success,True,93.1,1156.5299999999954,1,0,19,5
2024-05-10 09:00:00,62708.711,62869.539,62684.863,62869.539,1113,36422,0,2024-05-10 09:00:00,2024-05-10 09:00:00,-108.08761904758285,297.1322836805557,62897.78351190477,0.0018332103106350754,0.0013819290562008728,62780.50670238094,60639.293898661796,62537.723527746224,62789.024921688804,62761.173940975365,62775.907586859226,39.673885756827076,55.82060242490635,81.82730696416118,3.1718603370245546,-18.601685930487292,-34.47752218783717,62887.87445126085,62665.440722457606,37.22729829712832,22.269181883954335,True,False,63369.539,62969.539,62969.539,63019.539,2024-05-10 10:00:00,True,2024-05-10 10:00:00,2024-05-10 15:02:40,2024-05-10 10:08:45,even,True,18.62,1175.1499999999953,2,0,19,5
2024-05-10 10:00:00,63121.738,63280.738,62942.922,63041.137,2534,36422,0,2024-05-10 10:00:00,2024-05-10 10:00:00,117.27680952382798,313.3294697514284,62967.65304761905,0.0018475854066236387,0.001381920279415747,62897.78351190477,60752.80825336369,62624.43687722049,62884.39415659275,62817.86693383743,62890.03236532513,48.07253705018957,48.4771409334386,110.26334310642417,47.86341830063611,56.93944891650608,8.259408324796823,63040.387878518806,62741.17685213146,78.2234972885027,74.23765405867063,True,False,63541.137,63141.137,63141.137,63191.137,2024-05-10 10:30:00,True,2024-05-10 10:30:00,,2024-05-10 10:33:50,even,True,18.62,1193.7699999999952,3,0,19,5
2024-05-10 11:00:00,63035.738,63100.84,62855.84,62878.039,1679,36422,0,2024-05-10 11:00:00,2024-05-10 11:00:00,69.86953571428603,316.2983594679026,62994.44490476192,0.0017649901478728608,0.0013819470190084846,62967.65304761905,60849.59674868616,62710.69185759561,62964.853039483016,62882.73015575436,63023.687277949815,54.11800579095143,53.51747630754189,145.0379323266602,-13.140261781845766,26.067618851120642,47.667385964872665,63219.48848659081,62826.38606930882,55.741608764383464,67.11608838155159,True,False,63378.039,62978.039,62978.039,63028.039,2024-05-10 12:45:00,True,2024-05-10 12:45:00,2024-05-10 15:02:44,2024-05-10 13:05:17,even,True,18.62,1212.389999999995,4,0,19,5
2024-05-10 12:00:00,63006.34,63017.738,62812.34,62870.738,1342,36422,0,2024-05-10 12:00:00,2024-05-10 12:00:00,26.79185714286723,312.6827903344529,63041.57735714287,0.0016879691498896253,0.0015001697324648732,62994.44490476192,60938.09602432802,62745.976028007295,62945.49158653656,62894.292108060064,63027.85585517714,41.70590515350341,48.918171952955355,142.80345543373588,-15.413591331292992,22.80198486414156,-6.850655658759933,63220.64052001268,62833.5711903416,40.10494006346964,41.48769928392841,True,False,63370.738,62970.738,62970.738,63020.738,2024-05-10 12:45:00,True,2024-05-10 12:45:00,2024-05-10 15:02:40,2024-05-10 13:05:17,even,True,18.62,1231.009999999995,5,0,19,5
2024-05-10 13:00:00,63089.066,63099.438,62817.219,62899.645,1145,36422,0,2024-05-10 13:00:00,2024-05-10 13:00:00,47.1324523809526,313.0112898414736,63042.861238095196,0.0016178442632164812,0.0016027140980097176,63041.57735714287,61019.44845807497,62801.74131418236,62973.53625799103,62923.436472121946,63014.663274509774,38.98716247652919,44.01058366199494,150.84028921620924,-36.59888200899877,3.3498596491626813,27.873544547590427,63218.29766495166,62809.52888406789,47.80482566810762,47.32571624303184,True,False,63399.645,62999.645,62999.645,63049.645,2024-05-10 15:00:00,True,2024-05-10 15:00:00,2024-05-10 15:02:46,2024-05-10 15:48:13,success,True,93.1,1324.109999999995,6,0,19,5
2024-05-10 14:00:00,62988.84,63002.539,62852.438,62862.648,1274,36422,0,2024-05-10 14:00:00,2024-05-10 14:00:00,1.2838809523236705,301.5810226194444,63126.37119047619,0.0014995157338449695,0.0014716127928873488,63042.861238095196,61074.412888495055,62943.554557376425,62965.324755829504,62933.81149994192,62937.7830385277,30.250305851477606,38.47297643527952,150.9234734107492,-36.018582731361676,-18.00693532846344,-11.795216374310257,63141.52972763221,62732.536349423186,29.546324743179976,33.01920780126008,True,False,63362.648,62962.648,62962.648,63012.648,2024-05-10 15:00:00,True,2024-05-10 15:00:00,2024-05-10 15:02:39,2024-05-10 15:48:32,success,True,93.1,1417.2099999999948,7,0,19,5
2024-05-10 15:00:00,63258.34,63427.738,63144.539,63231.738,2042,36422,0,2024-05-10 15:00:00,2024-05-10 15:00:00,83.50995238099131,310.5677816606403,63095.33011904761,0.0014995907483341358,0.0013240016590533989,63126.37119047619,61166.30405652906,63073.1602546312,63052.416489132025,62986.77299695133,63082.92038218095,40.15250886211288,36.25163461677317,128.05612397946183,58.625689370484906,70.2648314413018,6.489481940217956,63257.29614955322,62910.04461480868,76.03161474306017,64.30151049181744,True,False,63731.738,62831.738,63331.738,63381.738,,False,,,2024-05-10 16:25:39,fail,False,-74.5,1342.7099999999948,0,1,19,5
2024-05-10 21:00:00,60347.242,60453.137,60231.84,60339.738,2826,36422,0,2024-05-10 21:00:00,2024-05-10 21:00:00,-523.1995238095042,-286.8449513388914,60530.726809523774,-0.00041663632101935087,2.8195988625374135e-05,60801.11742857143,60550.84338054537,63406.30603004461,60818.827740246285,61417.45664279944,60221.392187478545,-315.8325081960138,-269.737402357438,1072.7888375536081,-26.31718782245298,-70.44590780870203,-55.93284072929964,61669.65711817591,58771.627256781176,12.872837840242651,12.519113251327825,False,True,59839.738,60739.738,60239.738,60189.738,,False,,,2024-05-10 22:03:36,fail,False,-74.5,1268.2099999999948,0,2,19,5
2024-05-13 06:00:00,61005.039,61069.539,60831.84,60831.84,2447,36422,0,2024-05-13 06:00:00,2024-05-13 06:00:00,-79.65560714284948,-324.8368434181393,61286.764011904794,-0.002033409489420498,-0.0015457784926985153,61347.787226190514,61042.82030585951,63720.481918176854,61166.39210978167,61208.44431335004,61103.44312693496,-19.50192367080308,-4.007081598688275,194.75585928891428,-100.36492707260186,-71.94396869622142,-78.12325249403511,61366.36353697499,60839.02271689493,8.036043483715938,10.658408468192059,False,True,60331.84,61231.84,60731.84,60681.84,,False,,,2024-05-13 09:40:14,fail,False,-74.5,1193.7099999999948,0,3,20,5
2024-05-13 08:00:00,60933.039,60972.238,60861.738,60953.539,593,36422,0,2024-05-13 08:00:00,2024-05-13 08:00:00,-177.48007142861752,-320.2977591572271,60967.621892857154,-0.0019291224567233873,-0.001963827248417274,61109.283940476176,60763.44542542413,63550.1533345881,61012.334167191824,61093.117394331595,60859.59746646028,-41.596450210301555,-31.940855099958064,257.8838866028406,3.0245916752319317,3.0773474372908822,-32.76876367397199,61209.24071337412,60511.454219546446,25.588336741816324,27.935080614856986,False,True,60453.539,61353.539,60853.539,60803.539,,False,,,2024-05-13 09:43:06,fail,False,-74.5,1119.2099999999948,0,4,20,5
2024-05-14 00:00:00,63036.543,63071.738,62984.82,63045.039,977,56422,0,2024-05-14 00:00:00,2024-05-14 00:00:00,47.690440476173535,342.32280544213427,62958.776547619,0.001758126319861662,0.0019029520691907923,63000.1148095238,60433.329623489575,62545.67925594021,62975.98630795813,62886.57916679673,63042.77155039557,61.477476420746825,61.765515811625434,171.683051035525,46.073410732693446,54.072344685177086,39.91683144140552,63276.043669293525,62810.999431497614,85.63077656920403,84.36439305323204,True,False,63545.039,62645.039,63145.039,63195.039,,False,2024-05-15 15:45:00,2024-05-15 15:30:23,2024-05-14 04:44:10,fail,False,-74.5,1044.7099999999948,0,5,20,5
2024-05-14 01:00:00,62853.34,62901.34,62803.84,62823.738,1036,56422,0,2024-05-14 01:00:00,2024-05-14 01:00:00,-41.338261904798856,326.64538067347166,62864.84225000006,0.0018708223190343214,0.0018160709297714438,62958.776547619,60526.13896110535,62691.450479851264,62921.65003406095,62881.82373516151,63010.025315101404,41.12438048502372,53.66133421391957,171.71729133564526,-33.496527003808296,-26.48343653253687,-8.040711042391194,63241.84365840453,62776.70697179828,46.607028762332476,57.50515364306898,True,False,63323.738,62923.738,62923.738,62973.738,2024-05-14 04:30:00,True,2024-05-14 04:30:00,2024-05-15 15:30:19,2024-05-14 04:31:05,even,True,18.62,1063.3299999999947,1,0,20,5
2024-05-14 02:00:00,62721.238,62870.738,62666.25,62821.137,1402,36422,0,2024-05-14 02:00:00,2024-05-14 02:00:00,-93.93429761894367,300.3572629125774,62860.451119047626,0.0018293661159396464,0.0015778394717086651,62864.84225000006,60641.87959783212,62864.60484567532,62833.57372314297,62843.22818674032,62805.39947196423,16.577442452653486,34.76311713926402,159.6517693520967,-35.40519883036177,-57.33737014109647,-63.178662882652134,63020.92936058956,62588.3695833389,16.09550679205952,12.659617936451005,True,False,63321.137,62921.137,62921.137,62971.137,2024-05-14 04:30:00,True,2024-05-14 04:30:00,2024-05-15 15:30:19,2024-05-14 04:31:06,even,True,18.62,1081.9499999999946,2,0,20,5
2024-05-14 20:00:00,61388.738,61422.84,61218.195,61287.438,1955,36422,0,2024-05-14 20:00:00,2024-05-14 20:00:00,-90.6526785714741,-227.87507308971544,61475.10211904766,-0.0009683052501111337,-0.0009281374180225754,61588.38365476189,61720.175506092055,63137.126694774735,61546.28431627173,61670.18784754494,61491.77278637771,-70.65535154497775,-59.672171543470824,191.32449409245655,-64.51260853118583,-39.18800928784913,-49.56875644998945,61750.06085340253,61231.98471935289,22.342203508465627,27.11029026022918,False,True,60787.438,61687.438,61187.438,61137.438,,False,,,2024-05-15 00:39:16,fail,False,-74.5,1007.4499999999946,0,1,20,5
2024-05-14 22:00:00,61390.039,61459.738,61347.918,61421.738,1084,36422,0,2024-05-14 22:00:00,2024-05-14 22:00:00,-55.0616904762137,-263.5396904342997,61444.542773809575,-0.0011059408682465527,-0.0009281550803455416,61420.04042857145,61693.647985915835,63019.88540433867,61393.8339656239,61514.33694426523,61235.104629170964,-76.24450204247842,-76.69378263393598,232.85711955488293,7.535257997922599,14.658555555572093,-40.73245201238751,61550.961740570056,60920.74751777187,34.893853548456,27.587568246983995,False,True,60921.738,61821.738,61321.738,61271.738,,False,,,2024-05-15 05:11:53,fail,False,-74.5,932.9499999999946,0,2,20,5
2024-05-14 23:00:00,61545.438,61626.738,61497.203,61590.637,867,36422,0,2024-05-14 23:00:00,2024-05-14 23:00:00,24.502345238128328,-254.9548107309529,61453.24332142861,-0.0011060418543000626,-0.0009281406870490535,61444.542773809575,61625.35259521539,62961.391553341215,61487.260570312654,61533.42235092063,61453.37090952869,-47.0258707362882,-63.79064948076694,206.73652671252484,52.940650498749164,53.7457227382547,62.92204712757666,61733.9652205906,61174.27659846678,90.38629860480022,82.3519099411432,False,True,61090.637,61490.637,61490.637,61440.637,2024-05-15 04:00:00,True,2024-05-15 04:00:00,,2024-05-15 04:02:46,even,True,18.62,951.5699999999946,1,0,20,5
2024-05-15 00:00:00,61561.34,61592.137,61528.516,61554.84,368,56422,0,2024-05-15 00:00:00,2024-05-15 00:00:00,8.700547619031568,-244.0547618382334,61504.226178571465,-0.0011060041454002225,-0.0009280875126658916,61453.24332142861,61557.29869930083,62902.87028859019,61529.691709602164,61544.70663303804,61602.47605435155,-29.456682450203516,-46.07485331680411,177.83048345332378,16.27428895766934,29.48288544897514,45.384520811756374,61844.04720701354,61362.404901689566,84.13704870189116,87.20147444406147,False,True,61054.84,61454.84,61454.84,61404.84,2024-05-15 04:00:00,True,2024-05-15 04:00:00,,2024-05-15 04:01:15,even,True,18.62,970.1899999999946,2,0,20,5
2024-05-15 16:00:00,63704.887,63806.137,63494.102,63688.137,2929,36422,0,2024-05-15 16:00:00,2024-05-15 16:00:00,459.2685119047528,245.82821198953025,63420.037452380915,0.0004903366281684826,0.0014227595696661884,62943.760083333356,61146.53548122085,62981.70406989394,62937.33763422049,62577.91071815909,63205.777151014794,173.75694950197067,122.60984757356269,526.0096934707765,167.95596009631117,200.0359542483202,205.49798555222515,63917.39023720034,62495.664064829245,76.50114515080367,72.53193114704094,True,False,64188.137,63288.137,63788.137,63838.137,,False,2024-05-15 16:30:00,2024-05-15 16:29:39,,success,True,93.1,1063.2899999999945,3,0,20,5
2024-05-15 18:00:00,64444.172,64850.754,64281.84,64830.008,2971,36422,0,2024-05-15 18:00:00,2024-05-15 18:00:00,469.20339285714726,482.0852206884374,64310.09171428564,0.0010346655888418684,0.001725307840598486,63889.24084523806,61109.93227050772,63045.51425523486,63982.29785256717,63376.94242599865,64608.150496732036,311.498631781782,251.3089671410009,891.6752874373491,207.8550161679741,173.94634330926056,144.66170588224486,65813.41213477246,63404.388858691615,93.20088289602893,86.62034077663024,True,False,65330.008,64930.008,64930.008,64980.008,2024-05-15 19:15:00,True,2024-05-15 19:15:00,2024-05-15 21:31:46,2024-05-15 19:15:59,even,True,18.62,1081.9099999999944,4,0,20,5
2024-05-15 19:00:00,64667.238,65017.938,64657.859,64984.137,2232,36422,0,2024-05-15 19:00:00,2024-05-15 19:00:00,420.8508690475792,585.5030981676828,64592.44233333337,0.0010346044965747084,0.0017252555417327292,64310.09171428564,61173.603320110116,63154.52964778004,64372.55865674998,63747.575338274095,65003.614020295834,341.80397050360625,300.0673399312169,937.470305237245,78.11874991403602,53.99320983821963,93.95531613359344,66270.69893236611,63738.02910822555,88.95088192094052,89.43539544354987,True,False,65484.137,65084.137,65084.137,65134.137,2024-05-15 21:15:00,True,2024-05-15 21:15:00,2024-05-15 21:57:41,2024-05-15 21:16:19,even,True,18.62,1100.5299999999943,5,0,20,5
2024-05-15 20:00:00,64710.637,64951.738,64710.637,64943.84,1732,36422,0,2024-05-15 20:00:00,2024-05-15 20:00:00,282.3506190477274,664.0104711423919,64883.17896428574,0.0010347637739160818,0.001725371274151039,64592.44233333337,61236.881472162866,63263.45781544322,64592.36519083633,64031.35993102399,64959.97648950804,333.79398801030766,321.7618479225045,920.2878800790667,38.03738665286073,-66.32103611968341,-16.17779910560057,66203.86512761477,63717.587851401295,80.57147142030605,81.7832627401523,True,False,65443.84,65043.84,65043.84,65093.84,2024-05-15 21:15:00,True,2024-05-15 21:15:00,2024-05-15 21:56:16,2024-05-15 21:17:15,even,True,18.62,1119.1499999999942,6,0,20,5
2024-05-15 21:00:00,64983.891,65166.039,64900.059,65151.34,1934,36422,0,2024-05-15 21:00:00,2024-05-15 21:00:00,290.73663095237134,739.7409716651237,65262.59751190472,0.0010418657840838743,0.0019499912914699474,64883.17896428574,61296.582386126225,63503.440664591464,64818.03046276512,64301.50850968639,65128.952128654964,323.86405936868687,325.14234938656614,708.4736195640783,66.34229067766864,41.57773546609678,23.030572411495086,66086.89151506647,64172.51274224346,95.25630771024657,94.00574863739074,True,False,65651.34,65251.34,65251.34,65301.34,2024-05-15 21:45:00,True,2024-05-15 21:45:00,2024-05-15 21:57:44,2024-05-15 21:47:14,even,True,18.62,1137.769999999994,7,0,20,5
2024-05-15 22:00:00,65666.836,65735.141,65242.16,65542.234,2664,36421,0,2024-05-15 22:00:00,2024-05-15 22:00:00,379.4185476189814,845.1329253890217,65524.521297619074,0.0012838589535354417,0.002197835300018995,65262.59751190472,61243.410797558856,63803.86009229154,65142.790659127626,64611.83535649347,65383.651875129,331.39845596936357,327.1029833590769,498.34702820671157,61.80369625039748,92.77669040251203,43.73326281394111,66057.92036320806,64710.88338704994,89.22277673728338,93.06077387097588,True,False,66042.234,65642.234,65642.234,65692.234,2024-05-15 22:30:00,True,2024-05-15 22:30:00,2024-05-15 22:40:20,2024-05-16 09:01:39,success,True,93.1,1230.869999999994,8,0,20,5
2024-05-16 02:00:00,66060.438,66177.156,66011.141,66100.539,1410,36421,0,2024-05-16 02:00:00,2024-05-16 02:00:00,150.21732142855763,1058.1943780911533,66122.12355952385,0.002601156588481125,0.0030751262506770885,66005.49266666664,61244.60763654633,63587.782560024534,65926.9717161753,65565.74354391906,66027.33555383552,262.17702258963254,287.50712343205635,404.25702507701203,-1.228657034705975,-5.117863433173625,4.120514619891765,66573.0825376895,65480.088569981555,62.32880955939402,66.0197971672673,True,False,66600.539,66200.539,66200.539,66250.539,2024-05-16 02:45:00,True,2024-05-16 02:45:00,2024-05-16 03:10:37,2024-05-16 02:50:28,even,True,18.62,1249.4899999999939,9,0,20,5
2024-05-16 03:00:00,66155.188,66625.734,66151.836,66318.938,2806,36421,0,2024-05-16 03:00:00,2024-05-16 03:00:00,116.63089285721071,1078.2727962433055,66117.28965476189,0.0026013409827902604,0.0030750427461040813,66122.12355952385,61403.74942705183,63784.379778396134,66080.66758742771,65744.17246119773,66202.31619470242,243.77802088164026,265.03795157753615,308.8362696129677,93.07974922603171,21.327951496379683,29.30744134845736,66620.74515867993,65785.38723072491,72.50149569921409,73.83323824643723,True,False,66818.938,65918.938,66418.938,66468.938,,False,2024-05-17 18:00:00,2024-05-17 18:13:40,2024-05-16 03:43:12,fail,False,-74.5,1174.9899999999939,0,1,20,5
2024-05-16 04:00:00,66031.953,66166.539,65981.836,66070.336,1389,36421,0,2024-05-16 04:00:00,2024-05-16 04:00:00,-4.833904761966551,1072.2154452657196,66042.32198809525,0.0026550855970293255,0.003195503703548679,66117.28965476189,61547.258841485236,63887.812226094946,66073.0795939053,65829.76165572728,66190.39850636393,199.28428244542738,234.35799796259596,195.00543312262582,-16.042459580334253,-1.7605184038402513,-20.171765393810347,66453.65584107947,65925.64117164839,32.46665888636621,39.27171679943374,True,False,66570.336,65670.336,66170.336,66220.336,,False,2024-05-16 12:00:00,2024-05-16 15:30:13,2024-05-16 09:01:35,fail,False,-74.5,1100.4899999999939,0,2,20,5
2024-05-16 05:00:00,65948.836,66069.734,65865.625,66065.906,1104,36421,0,2024-05-16 05:00:00,2024-05-16 05:00:00,-74.96766666663461,1048.0387236136012,65983.19145238092,0.0029535310409593155,0.0032826970323595953,66042.32198809525,61638.76694099802,64031.09951571182,66032.40883800875,65871.2722421952,66069.37828138979,154.14061185326136,194.07825265356047,153.70164347932413,-12.02752528381825,-39.37101995179546,-44.74650601990288,66276.87550008687,65860.3810626927,20.611672664922537,20.954041087561396,True,False,66565.906,65665.906,66165.906,66215.906,,False,2024-05-16 11:15:00,2024-05-16 15:30:13,2024-05-16 09:01:36,fail,False,-74.5,1025.9899999999939,0,3,20,5
2024-05-16 06:00:00,65871.602,65959.734,65761.836,65811.234,1269,36421,0,2024-05-16 06:00:00,2024-05-16 06:00:00,-59.13053571432829,1011.322605810783,65968.92042857141,0.003206886586248006,0.003457040082857387,65983.19145238092,61775.708158567664,64130.72549912616,65952.07548171584,65871.64083209897,65891.19560268316,108.03626257188444,151.8355092066161,144.5966895953743,-44.11171826624195,-36.957231510124984,-56.60613347098115,66086.40113363691,65694.49007172941,10.84938856901397,14.992495169920327,True,False,66311.234,65911.234,65911.234,65961.234,2024-05-16 06:30:00,True,2024-05-16 06:30:00,2024-05-16 11:11:15,2024-05-16 06:57:25,even,True,18.62,1044.6099999999938,1,0,20,5
2024-05-16 07:00:00,65924.602,65968.938,65850.039,65871.781,853,36421,0,2024-05-16 07:00:00,2024-05-16 07:00:00,-14.271023809516919,975.3390650158544,65892.40094047622,0.003316778598548976,0.0036631280680818083,65968.92042857141,61961.122030290586,64234.617374289235,65941.21176260643,65888.08523492668,65862.538251462,81.40760900026362,115.49059145371831,128.36780819011227,-3.717254557966953,-5.657239422100247,-5.576663226718665,66035.83479251865,65687.74171040535,40.32455726515,34.84061941908908,True,False,66371.781,65971.781,65971.781,66021.781,2024-05-16 10:30:00,True,2024-05-16 10:30:00,2024-05-16 11:12:09,2024-05-16 14:15:06,success,True,93.1,1137.7099999999937,2,0,20,5
2024-05-16 08:00:00,65771.734,65861.734,65733.742,65792.836,577,36421,0,2024-05-16 08:00:00,2024-05-16 08:00:00,-76.51948809518944,923.3013499769149,65801.12267857147,0.003076648964055599,0.0037875695004270615,65892.40094047622,62180.36048905492,64406.57837789577,65879.07766227795,65869.21911909174,65823.98795046439,50.98894276014471,82.92931625589526,148.28040537003938,-18.954613691137638,-16.432131406923872,7.498342621256597,66024.16649771394,65622.30940321484,24.32535818747935,28.90289093008329,True,False,66292.836,65892.836,65892.836,65942.836,2024-05-16 10:15:00,True,2024-05-16 10:15:00,2024-05-16 11:11:15,2024-05-16 15:38:08,success,True,93.1,1230.8099999999936,3,0,20,5
2024-05-16 09:00:00,65739.141,65741.539,65614.836,65741.539,952,36421,0,2024-05-16 09:00:00,2024-05-16 09:00:00,-91.27826190475025,869.2395008725944,65810.42058333335,0.0028312278483560286,0.0037732468844153344,65801.12267857147,62370.907873171745,64657.704946734586,65810.348204384,65834.38342378405,65746.62018747845,24.728375129052438,52.71089041534853,144.1031714642944,-18.7008462332451,-18.951127278996864,-14.134993120038416,65941.15946895524,65550.58090600165,17.365818680146273,13.507351041471942,True,False,66241.539,65841.539,65841.539,65891.539,2024-05-16 09:30:00,True,2024-05-16 09:30:00,2024-05-16 11:09:39,2024-05-16 09:49:54,even,True,18.62,1249.4299999999935,4,0,20,5
2024-05-16 10:00:00,65913.219,66039.734,65886.836,66010.93,1238,36421,0,2024-05-16 10:00:00,2024-05-16 10:00:00,9.297904761886457,831.352017946163,65897.99976190476,0.0028312510871611185,0.0035033131757357385,65810.42058333335,62548.45235094362,65006.55276436627,65871.74373671741,65860.26838632254,65841.75098796013,27.069954383856384,36.52812957376879,101.19076904358299,30.891263845944195,24.350389748899033,24.32186859297508,65979.85852616896,65705.1434497513,76.28991617028117,66.14251347945122,True,False,66510.93,66110.93,66110.93,66160.93,2024-05-16 11:15:00,True,2024-05-16 11:15:00,2024-05-16 14:59:45,2024-05-16 11:26:17,even,True,18.62,1268.0499999999934,5,0,20,5
2024-05-16 11:00:00,66078.906,66392.438,66035.836,66219.539,1312,36421,0,2024-05-16 11:00:00,2024-05-16 11:00:00,87.57917857141001,805.5402633120975,66026.01963095233,0.0028322563708249268,0.003171725625247421,65897.99976190476,62725.72647691346,65341.31042898496,65994.34740230664,65928.4522254234,66036.20971620225,42.84198043389188,36.932703122343355,129.8610150605458,71.04141210865055,45.605621947092004,39.366108703106875,66213.022086534,65860.89734587051,78.8537358521106,84.1289721642948,True,False,66719.539,66319.539,66319.539,66369.539,2024-05-16 15:00:00,True,2024-05-16 15:00:00,2024-05-16 15:30:17,2024-05-16 15:04:29,even,True,18.62,1286.6699999999933,6,0,20,5
2024-05-16 12:00:00,66240.734,66299.641,66172.641,66180.039,940,36421,0,2024-05-16 12:00:00,2024-05-16 12:00:00,128.01986904756632,788.8130565382744,66149.39844047626,0.00273586311355242,0.002766885619781766,66026.01963095233,62884.88717637214,65652.1716916884,66087.96970768431,65996.29782305093,66215.70725593394,53.16132688187645,44.82648131345488,163.04560800981108,34.63140075675619,52.45063261096948,45.57718851053505,66437.31882674719,65995.5956851207,75.02998534811816,73.46390284204308,True,False,66680.039,66280.039,66280.039,66330.039,2024-05-16 15:00:00,True,2024-05-16 15:00:00,2024-05-16 15:30:16,2024-05-16 15:04:29,even,True,18.62,1305.2899999999931,7,0,20,5
2024-05-16 13:00:00,66301.555,66301.734,66123.211,66219.039,1179,36421,0,2024-05-16 13:00:00,2024-05-16 13:00:00,123.3788095239288,771.5844693902472,66178.26396428574,0.002607707391502188,0.002301529183656895,66149.39844047626,63024.714280677224,65922.87056787858,66163.43119191226,66061.51568697797,66301.84226969384,59.205909927230095,52.59694743960458,194.09033858883805,4.39007120745373,26.95763054692361,23.706857585159014,66565.36422678876,66039.82031259891,75.31906691341906,76.31448664836745,True,False,66719.039,66319.039,66319.039,66369.039,2024-05-16 15:00:00,True,2024-05-16 15:00:00,2024-05-16 15:30:17,2024-05-16 15:04:29,even,True,18.62,1323.909999999993,8,0,20,5
2024-05-16 14:00:00,66110.125,66140.938,65990.047,65999.938,1251,36421,0,2024-05-16 14:00:00,2024-05-16 14:00:00,28.865523809479782,734.2163800931885,66318.30723809525,0.002453443185987954,0.0018501650617559632,66178.26396428574,63110.1333403194,66131.84918464265,66137.2558787433,66076.36782603106,66205.86560509111,45.62472952782991,52.24030593910888,186.2419174920817,-48.41689680083073,-22.69022463033616,-18.522577227311558,66457.29219370542,65952.9390164768,26.418304662137402,44.63771276789405,True,False,66499.938,66099.938,66099.938,66149.938,2024-05-16 14:30:00,True,2024-05-16 14:30:00,2024-05-16 14:59:43,2024-05-16 14:35:35,even,True,18.62,1342.529999999993,9,0,20,5
2024-05-16 15:00:00,66465.641,66530.359,66113.891,66186.406,2330,36421,0,2024-05-16 15:00:00,2024-05-16 15:00:00,140.04327380951145,724.7243741756174,66233.96322619048,0.002307306052275875,0.0014294954666681228,66318.30723809525,63180.8969265551,66279.51576444224,66183.79461540843,66116.56975109068,66200.97737048498,46.02995143125008,47.95247795643064,151.76780155667035,-7.119009287998779,46.961277261783835,-25.69404231167573,66405.86390258648,65994.59083838348,55.266736426644506,47.311035417165705,True,False,66686.406,65786.406,66286.406,66336.406,,False,2024-05-17 13:30:00,2024-05-16 15:30:16,2024-05-16 16:10:59,success,True,93.1,1435.6299999999928,10,0,20,5
2024-05-17 19:00:00,67151.734,67224.734,67056.055,67059.039,1828,36421,0,2024-05-17 19:00:00,2024-05-17 19:00:00,292.7875476190238,346.629102620238,66756.9332380952,0.0009287266543085922,0.0003578106509898972,66637.82895238097,64862.25545121084,66975.8308463664,66745.75857622459,66475.08937587087,66963.66821947024,134.70657440193463,98.17279322509141,397.6847430795882,105.06081252152217,134.7204361884651,144.18102063982224,67502.04262262769,66426.7938163128,83.67636283817832,89.02131845065328,True,False,67559.039,66659.039,67159.039,67209.039,,False,2024-05-20 18:45:00,2024-05-20 19:01:39,2024-05-17 20:52:27,fail,False,-74.5,1361.1299999999928,0,1,20,5
2024-05-20 08:00:00,67075.992,67251.734,67061.836,67088.133,2155,36421,0,2024-05-20 08:00:00,2024-05-20 08:00:00,258.5676666666841,228.44624501591898,66918.42974999997,0.0006033720715074731,0.0007763614399914598,66758.45701190479,65441.77244903691,67179.27407342162,66757.95925939234,66614.83299536898,66907.80179084968,56.91459634696366,26.58546944022055,278.4409807445365,72.97123942209873,71.98643790853384,70.97478328170837,67285.1971148548,66531.90646684456,91.87132484650623,90.92785232846182,True,False,67588.133,66688.133,67188.133,67238.133,,False,2024-05-20 18:45:00,2024-05-20 19:01:49,2024-05-20 09:52:33,fail,False,-74.5,1286.6299999999928,0,2,21,5
2024-05-20 20:00:00,68143.68,68410.961,67985.836,68343.938,2557,36421,0,2024-05-20 20:00:00,2024-05-20 20:00:00,353.51682142858044,311.2217744536465,67804.25804761903,0.0006701603279663259,0.0006785159128646357,67476.37504761906,65909.6579927236,67754.47324904561,67628.89516847144,67318.07631403404,67896.63110767114,136.11459699994884,77.83934156134,457.37712161604946,180.3950853113056,170.94495940837078,213.58189026487526,68515.5902218528,67279.17199348948,97.29736088534837,92.02052051590253,True,False,68843.938,68443.938,68443.938,68493.938,2024-05-20 21:45:00,True,2024-05-20 21:45:00,2024-05-20 22:21:12,2024-05-23 16:46:42,success,True,93.1,1379.7299999999927,1,0,21,5
2024-05-20 21:00:00,68271.297,68493.234,68228.594,68358.438,1804,36421,0,2024-05-20 21:00:00,2024-05-20 21:00:00,327.8829999999725,380.4269049732684,68207.78222619051,0.000683893827932285,0.0007298610850602039,67804.25804761903,65953.21291539665,67832.48706744377,67950.5444080946,67574.34435737466,68398.85496491229,180.84056594851427,131.80376001145376,603.651337679648,102.76428551769641,116.22907361539546,130.24828586181684,69215.28427077981,67583.92565904476,84.11437904834895,84.62928249935226,True,False,68858.438,68458.438,68458.438,68508.438,2024-05-20 21:45:00,True,2024-05-20 21:45:00,2024-05-20 22:21:13,2024-05-23 16:46:42,success,True,93.1,1472.8299999999927,2,0,21,5
2024-05-20 22:00:00,68662.094,68751.836,68532.484,68648.203,1691,36421,0,2024-05-20 22:00:00,2024-05-20 22:00:00,403.5241785714752,461.61578039491724,68939.51052380959,0.000680000725659796,0.0014031693485725436,68207.78222619051,65999.13870617552,68349.03756220556,68270.10317786186,67845.88960175726,68745.41458101133,217.54628096958913,176.472008271868,698.7206066651607,49.27639766079665,83.81969315440801,101.88692569661362,69690.1874000093,67802.14176201336,94.62921396546058,93.3032254070268,True,False,69148.203,68248.203,68748.203,68798.203,,False,2024-05-20 22:30:00,2024-05-20 22:23:13,2024-05-23 16:49:20,success,True,93.1,1565.9299999999926,3,0,21,5
2024-05-20 23:00:00,69978.234,70418.039,69614.586,69616.039,3781,36421,0,2024-05-20 23:00:00,2024-05-20 23:00:00,731.7282976190763,624.8089246096642,69307.80796428569,0.0009030281202992328,0.0015198087768762158,68939.51052380959,65988.24877130668,68534.64805070797,68942.2510053946,68319.58683477645,69451.4076339869,311.8731068469351,240.5891216100085,932.0384582245699,132.007886136882,232.23213691089768,211.09214482281823,70711.15955259008,68193.15571538373,84.53598515167293,88.50240164554411,True,False,70116.039,69216.039,69716.039,69766.039,,False,2024-05-21 02:15:00,2024-05-21 02:15:35,2024-05-20 23:46:29,fail,False,-74.5,1491.4299999999926,0,1,21,5
2024-05-21 02:00:00,69555.711,70072.234,69550.852,70041.727,1287,36421,0,2024-05-21 02:00:00,2024-05-21 02:00:00,101.66823809522612,812.675684954389,70351.97501190477,0.0009030936592333856,0.0023809078472433478,69716.43953571426,66167.57248235462,68660.08245132459,69501.01357257745,69048.60612795163,69703.09379944962,284.4238512689044,284.27595342539917,591.0942733501873,65.83095424842031,-24.863461988352356,-7.1633137255121255,70502.57106847237,68905.11653042687,58.329268244502394,56.6164784968245,True,False,70541.727,69641.727,70141.727,70191.727,,False,2024-05-21 02:30:00,2024-05-21 02:17:59,2024-05-21 20:00:29,success,True,93.1,1584.5299999999925,1,0,21,5
2024-05-21 03:00:00,71448.336,71519.039,71117.836,71284.539,2464,36421,0,2024-05-21 03:00:00,2024-05-21 03:00:00,635.5354761905037,983.9203551530081,70816.6865833333,0.0010389344641472571,0.002509431621007445,70351.97501190477,66158.30076926343,68923.75672471678,70421.36886678009,69670.32010506361,70798.6743140694,406.3132391809195,340.22223512307437,913.6283339217705,255.32656415535894,269.7359442724701,259.15445373242255,72033.57256486379,69565.27606327501,90.8024686221684,90.20715826620726,True,False,71784.539,70884.539,71384.539,71434.539,,False,2024-05-21 03:30:00,2024-05-21 03:17:52,2024-05-21 04:23:08,success,True,93.1,1677.6299999999924,2,0,21,5
2024-05-21 04:00:00,71313.539,71319.336,71081.836,71086.836,2048,36421,0,2024-05-21 04:00:00,2024-05-21 04:00:00,464.7115714285319,1097.3490129422134,71035.51654761905,0.0021677734705074143,0.00261335419022066,70816.6865833333,65718.43047858184,68974.39861114147,70843.87418985774,70102.54248517986,71552.03676367392,426.7065465985215,392.4673776120123,949.0197864135515,83.12008083939145,167.41904127973248,216.87138149293605,72834.71347533222,70270.86005201563,73.60512683843079,77.9854478835649,True,False,71586.836,71186.836,71186.836,71236.836,2024-05-21 05:45:00,True,2024-05-21 05:45:00,,2024-05-21 06:37:00,even,True,18.62,1696.2499999999923,3,0,21,5
2024-05-21 06:00:00,71284.672,71351.039,71196.094,71279.234,961,36421,0,2024-05-21 06:00:00,2024-05-21 06:00:00,167.14546428568428,1203.3465536153526,71405.25179761909,0.0021676823483889997,0.0031486530099351976,71202.66201190473,66004.83497256422,68788.08836408884,71074.72739267995,70575.62737814581,71322.29424114202,343.6369710429426,369.20385421859186,885.8033970521662,-71.25843068458198,-36.2179291365901,-9.294486756101833,72518.12882716245,70124.9596551216,48.535186345053596,53.7136789632223,True,False,71779.234,70879.234,71379.234,71429.234,,False,,,2024-05-21 07:55:06,fail,False,-74.5,1621.7499999999923,0,1,21,5
2024-05-21 07:00:00,71299.023,71314.336,71128.617,71153.383,1126,36421,0,2024-05-21 07:00:00,2024-05-21 07:00:00,202.58978571435728,1227.7023400547914,71333.3340119048,0.002277149325276243,0.0033380770418676106,71405.25179761909,66112.51188158825,68824.23117645692,71167.78134743977,70760.11992754834,71188.02951221186,301.5528272181691,338.3388536052022,651.8130971887625,1.0327856896910816,30.178272101809853,-72.00091056071687,72069.47719341668,70308.08183100703,55.92120119925509,50.55693195517049,True,False,71653.383,71253.383,71253.383,71303.383,2024-05-21 09:45:00,True,2024-05-21 09:45:00,,2024-05-21 09:52:16,even,True,18.62,1640.3699999999922,1,0,21,5
2024-05-21 08:00:00,70935.367,71067.734,70857.836,70925.234,1879,36421,0,2024-05-21 08:00:00,2024-05-21 08:00:00,-71.91778571429313,1203.748505042342,71296.54686904764,0.0026270918823771898,0.00338908380767127,71333.3340119048,66174.46970577027,69008.96387150623,71069.21799390308,70815.6646063111,71102.17009735125,229.38142767795944,287.0152162435751,295.40680458015754,-21.54838011690299,-20.774934640547144,-29.35104919159494,71500.96928353446,70701.87091116804,26.071430138521546,35.9906374561017,True,False,71425.234,71025.234,71025.234,71075.234,2024-05-21 08:45:00,True,2024-05-21 08:45:00,2024-05-21 09:40:36,2024-05-21 10:14:22,success,True,93.1,1733.469999999992,2,0,21,5
2024-05-21 09:00:00,71218.539,71305.734,71172.234,71259.836,1411,36421,0,2024-05-21 09:00:00,2024-05-21 09:00:00,-36.7871428571525,1193.6711413711455,71156.42971428565,0.002964587996962123,0.003479591443993743,71296.54686904764,66285.8873438262,69169.83690452926,71115.22063949914,70905.29229230764,71109.75206467151,192.14836999248655,235.9227081562554,165.1436658045228,14.739118335113744,1.3664671482838457,-4.072642930899747,71334.19601350762,70886.8081158354,59.74647412339459,44.13670878317132,True,False,71759.836,70859.836,71359.836,71409.836,,False,,,2024-05-21 16:31:10,fail,False,-74.5,1658.969999999992,0,1,21,5
2024-05-21 10:00:00,71219.391,71259.734,71025.039,71047.039,1212,36421,0,2024-05-21 10:00:00,2024-05-21 10:00:00,-140.1171547619888,1173.1779687926028,71078.98233333335,0.0032175027608690567,0.0035028883964205067,71156.42971428565,66451.31617044978,69392.81425584918,71163.33337792468,70989.79148373324,71137.6760330237,162.3215525557025,199.76226052384072,149.99808801779847,-14.535278637806186,-5.2326288268959615,22.85400412789022,71340.17345184773,70933.67861419967,61.5602245957806,72.22833235055317,True,False,71547.039,71147.039,71147.039,71197.039,2024-05-21 13:15:00,True,2024-05-21 13:15:00,,2024-05-21 13:24:41,even,True,18.62,1677.589999999992,1,0,21,5
2024-05-21 11:00:00,70905.016,71087.438,70886.422,71032.438,1364,36421,0,2024-05-21 11:00:00,2024-05-21 11:00:00,-77.44738095230423,1117.9861330824351,71031.05155952382,0.003436799938964628,0.0035690083694319623,71078.98233333335,66653.26004428757,69590.57878813306,71083.66862687563,70993.30468874493,71086.86349741995,115.04477628192399,158.0922994461475,153.9717431146679,3.1068424491822952,-28.648162366705947,-30.76615892672271,71296.22535062475,70879.00164421515,19.306470178818557,25.989354677515895,True,False,71532.438,71132.438,71132.438,71182.438,2024-05-21 13:15:00,True,2024-05-21 13:15:00,,2024-05-21 13:24:53,even,True,18.62,1696.2099999999919,2,0,21,5
2024-05-21 12:00:00,70951.531,71105.641,70907.102,71050.492,1457,36421,0,2024-05-21 12:00:00,2024-05-21 12:00:00,-47.93077380952309,1065.4547844994668,70996.38369047621,0.003278698984003221,0.0035692684595822186,71031.05155952382,66881.01410055338,69839.24560784281,71041.00906502175,70993.76564701064,71030.51353388376,81.51258617530402,118.20396042848,150.47706599965525,-11.277034055630793,-27.854210182384122,-22.857716890299344,71233.6575729833,70825.86949478422,18.306380549775753,20.69796004355973,True,False,71550.492,71150.492,71150.492,71200.492,2024-05-21 13:15:00,True,2024-05-21 13:15:00,,2024-05-21 13:24:30,even,True,18.62,1714.8299999999917,3,0,21,5
2024-05-21 13:00:00,71014.805,71313.234,70986.891,71301.836,1725,36421,0,2024-05-21 13:00:00,2024-05-21 13:00:00,-34.66786904761102,1017.5516733931581,71017.12036904767,0.003165375712464738,0.0036456773922651136,70996.38369047621,67092.00600486917,70047.7978617837,71067.29981313621,71017.6307875936,70993.09020399036,66.93917620508,88.39340205282001,133.5486964476482,42.16233505336277,-19.10525662197324,-36.00929102169175,71174.88094419468,70812.79946378604,39.42208587080394,27.471014231443473,True,False,71801.836,70901.836,71401.836,71451.836,,False,,,2024-05-21 16:16:16,fail,False,-74.5,1640.3299999999917,0,1,21,5
2024-05-21 14:00:00,71091.141,71176.641,71002.734,71143.734,1682,36421,0,2024-05-21 14:00:00,2024-05-21 14:00:00,20.73667857145483,974.176441917909,71069.29182142857,0.003018185579159419,0.003961072807662569,71017.12036904767,67283.26285304755,70153.07156220826,71098.67648227049,71048.01309270033,71099.92649501198,57.57480185935856,72.0066762078299,129.8700184206202,39.43131578945031,19.95756518744747,26.43845545234217,71276.75101987983,70924.60197014414,55.450270343950166,59.2510624014692,True,False,71643.734,71243.734,71243.734,71293.734,2024-05-21 14:45:00,True,2024-05-21 14:45:00,,2024-05-21 14:45:40,even,True,18.62,1658.9499999999916,1,0,21,5
2024-05-21 15:00:00,71144.836,71275.734,71060.828,71232.938,2211,36421,0,2024-05-21 15:00:00,2024-05-21 15:00:00,52.171452380905976,933.3746344439423,71153.7544880952,0.0029133807072508036,0.003706662791020351,71069.29182142857,67464.38293159433,70535.86850301351,71165.18532995772,71098.2515017548,71234.15869625044,57.36532227099815,64.09359188157568,135.52832639902877,16.34296697625541,18.262071895427653,50.22543446852069,71418.62193688913,71051.19545561174,60.86032676875661,68.03570984866445,True,False,71732.938,70832.938,71332.938,71382.938,,False,,,2024-05-21 16:31:11,fail,False,-74.5,1584.4499999999916,0,1,21,5
2024-05-21 16:00:00,71369.734,71369.734,71001.836,71031.938,1920,36421,0,2024-05-21 16:00:00,2024-05-21 16:00:00,84.46266666662996,908.7112395917648,70997.5946190476,0.0024489741706716856,0.0032920055338726394,71153.7544880952,67529.63118710625,70939.21841540362,71199.40734119642,71137.0860612579,71277.65068317857,52.55493159574689,60.06762044839018,138.19737484299947,-41.67103095968196,35.955115927019506,25.716664602674427,71464.21713921662,71089.58422714051,54.823632690554554,63.90685936428182,True,False,71531.938,70631.938,71131.938,71181.938,,False,,,2024-05-21 16:50:47,fail,False,-74.5,1509.9499999999916,0,2,21,5
2024-05-23 17:00:00,68044.539,68229.734,67686.047,68229.734,3207,36421,0,2024-05-23 17:00:00,2024-05-23 17:00:00,-559.0649999999587,-163.0939130022889,68580.26861904767,-0.0010638619485675907,-0.00041373021199362406,69129.59188095242,68917.2623145727,70574.63361417364,69138.65903160584,69405.98478159029,68956.42574372201,-90.38149609904212,-13.116424145360654,503.9215681764892,-248.74492260065745,-301.6055696594558,-176.22648675610253,69636.71986076026,68274.63162668375,15.67400270612026,20.249645370272564,False,True,67729.734,68129.734,68129.734,68079.734,2024-05-23 17:30:00,True,2024-05-23 17:30:00,2024-05-23 17:49:48,2024-05-23 18:12:51,success,True,93.11,1603.0599999999915,1,0,21,5
2024-05-23 18:00:00,67779.336,68173.734,67731.313,68136.141,2409,36421,0,2024-05-23 18:00:00,2024-05-23 18:00:00,-549.3232619047485,-279.4094368707156,68263.76410714284,-0.0010638250607915287,-0.0004136833141529168,68580.26861904767,68843.81826308992,70545.40746230542,68549.12393164598,69012.39948388384,68014.75843240453,-193.48817814228823,-106.08421677550587,790.7821014739542,-146.5437915376824,-244.00300206395332,-262.2363680770941,69082.31426939437,66945.7025954147,11.271860063246836,10.33313500700366,False,True,67636.141,68036.141,68036.141,67986.141,2024-05-23 19:15:00,True,2024-05-23 19:15:00,2024-05-23 20:56:51,2024-05-23 19:26:12,even,True,18.62,1621.6799999999914,2,0,21,5
2024-05-23 19:00:00,68080.805,68160.938,67931.836,67932.461,1984,36421,0,2024-05-23 19:00:00,2024-05-23 19:00:00,-316.50451190483,-343.25637509388616,67961.38386904755,-0.0010637530917159796,-0.00041381383986651934,68263.76410714284,68770.46031655428,70516.41497901465,68321.42452019287,68768.78206276544,67658.889621259,-217.03965664962016,-166.8717755725858,870.7277240097228,-67.90178775372624,-69.53644960436213,-96.18503371173574,68834.37204867213,66481.90719384588,18.61161448085439,21.07145624580409,False,True,67432.461,67832.461,67832.461,67782.461,2024-05-23 21:00:00,True,2024-05-23 21:00:00,2024-05-23 21:05:21,2024-05-23 23:55:27,success,True,93.11,1714.7899999999913,3,0,21,5
2024-05-23 20:00:00,67838.75,68045.539,67789.922,67988.641,2119,36421,0,2024-05-23 20:00:00,2024-05-23 20:00:00,-302.38023809528386,-408.56861016794574,67701.8643928572,-0.0010637583162523808,-0.0004137186141884209,67961.38386904755,68697.55165370971,70487.17188682056,68155.06610231237,68560.704914419,67736.11083591326,-220.9641649273981,-198.5903772813368,882.7846175047938,57.82018163053726,8.645102855123696,29.768163054643082,68929.37006954473,66544.3516022818,23.612260444148777,21.11510056391759,False,True,67488.641,67888.641,67888.641,67838.641,2024-05-23 21:00:00,True,2024-05-23 21:00:00,2024-05-23 21:02:08,2024-05-23 23:57:14,success,True,93.11,1807.8999999999912,4,0,21,5
2024-05-23 21:00:00,67643.773,67695.734,67053.836,67185.734,3608,36421,0,2024-05-23 21:00:00,2024-05-23 21:00:00,-259.5194761903549,-469.9524683009804,67466.74384523815,-0.0013674149923772515,-0.0004138253953458988,67701.8643928572,68400.54454389238,70458.29560125782,67908.35731087692,68328.02690522357,67784.01831269352,-235.37953993171686,-212.93188705412092,787.601550952123,-92.4713212934148,18.744087719300296,55.20840488480462,68847.28040647888,66719.25621890815,19.018810357495557,33.69908459815514,False,True,66685.734,67585.734,67085.734,67035.734,,False,2024-05-23 23:15:00,2024-05-23 23:00:29,2024-05-23 22:33:19,fail,False,-74.5,1733.3999999999912,0,1,21,5
2024-05-23 22:00:00,67397.336,67457.836,67241.602,67351.938,2244,36421,0,2024-05-23 22:00:00,2024-05-23 22:00:00,-235.12054761905165,-532.15403842456,67358.39965476189,-0.001419510482265486,-0.00041374499214616456,67466.74384523815,68366.6584119982,70429.07877293737,67590.82871343961,68040.78816060664,67352.80042655663,-258.8711413700803,-239.83955407095706,572.2365888244775,-81.72955177153926,-74.06588235293748,-115.96406845540332,68125.31982146967,66578.78103164358,35.9561136495355,27.395969339466365,False,True,66851.938,67751.938,67251.938,67201.938,,False,2024-05-23 23:15:00,2024-05-23 23:00:23,2024-05-23 23:36:00,success,True,93.11,1826.5099999999911,1,0,21,5
2024-05-23 23:00:00,67220.539,67225.734,66183.836,66764.336,5251,36421,0,2024-05-23 23:00:00,2024-05-23 23:00:00,-108.34419047625852,-589.9635302487441,67529.9519285714,-0.0017188436849761377,-0.0004138147115869601,67358.39965476189,68251.76105072782,70399.88838073138,67400.56911737927,67825.70617248755,67114.83672721019,-255.57729202699556,-245.45135588425657,418.0790822896695,-125.33773202617886,-50.05195940827252,-3.1901558307145024,67679.24348830125,66548.92996611913,39.86875394916296,45.39425807377318,False,True,66264.336,67164.336,66664.336,66614.336,,False,,,2024-05-23 23:17:17,fail,False,-74.5,1752.0099999999911,0,1,21,5
2024-05-24 00:00:00,67803.234,68351.141,67722.836,67830.938,4871,56421,0,2024-05-24 00:00:00,2024-05-24 00:00:00,171.55227380951692,-582.1613653788227,67660.67747619042,-0.0017189397604383705,-0.0004137870393042857,67529.9519285714,68133.01011525572,70370.5730598321,67546.69861669933,67788.93097942378,67374.16583969732,-189.26841284931288,-225.8655204082597,404.87398490717766,108.64838011696702,90.29389336088207,33.921305125564686,67922.24571932202,66827.58596007263,76.49251625424624,68.68553081718193,False,True,67330.938,68230.938,67730.938,67680.938,,False,2024-05-24 00:30:00,2024-05-24 00:16:41,2024-05-24 18:11:04,success,True,93.11,1845.119999999991,1,0,21,5
2024-05-24 01:00:00,67990.938,67996.234,67697.484,67775.641,2344,56421,0,2024-05-24 01:00:00,2024-05-24 01:00:00,130.72554761901847,-554.711847427985,67659.02395238089,-0.0017189400350775777,-0.00026456777115505377,67660.67747619042,68015.26614405558,70259.02531938444,67661.41520594849,67784.16488498895,67741.90747884414,-132.86435421105125,-182.15849890950824,359.9721387340144,95.36726659783744,147.80399140002555,109.18710870317591,68229.36986613505,67255.94509155322,77.63951082104282,73.42119975422622,False,True,67275.641,67675.641,67675.641,67625.641,2024-05-24 02:15:00,True,2024-05-24 02:15:00,2024-05-24 08:37:46,2024-05-24 02:26:25,even,True,18.62,1863.739999999991,2,0,21,5
2024-05-24 02:00:00,67694.438,67748.836,67487.555,67517.836,1995,36421,0,2024-05-24 02:00:00,2024-05-24 02:00:00,-1.6535238095384557,-550.3298849601997,67801.15783333336,-0.0017189665504647234,-0.000366254080686281,67659.02395238089,67898.5720737552,70289.5404093776,67640.69775380036,67741.47446184017,67751.4587340902,-108.0800173986936,-141.95190191731888,323.00557221285544,-41.53077399378526,-4.503381148853805,8.383228414168116,68187.51625657757,67313.90121160285,66.38499580508187,68.03892391703043,False,True,67017.836,67917.836,67417.836,67367.836,,False,2024-05-24 08:45:00,2024-05-24 09:47:14,2024-05-24 02:50:42,fail,False,-74.5,1789.239999999991,0,1,21,5
2024-05-24 10:00:00,66892.102,67127.234,66831.836,67099.141,2424,36421,0,2024-05-24 10:00:00,2024-05-24 10:00:00,-300.9411904761655,-474.81332966822083,67233.74248809525,-0.002416427353309344,-0.0019810201831759514,67354.71853571429,67294.9775365898,69957.81421553917,67343.74425849091,67524.03175940074,67114.28865806673,-83.49678276668419,-53.90176242646967,300.15359689002156,-85.77274165807466,-132.14278740969894,-76.66228173377749,67519.49601386825,66707.5813022652,15.534444783053402,18.55935916644345,False,True,66599.141,66999.141,66999.141,66949.141,2024-05-24 11:30:00,True,2024-05-24 11:30:00,,2024-05-24 11:39:34,even,True,18.62,1807.8599999999908,1,0,21,5
2024-05-24 11:00:00,67162.602,67193.141,67008.781,67012.438,1327,36421,0,2024-05-24 11:00:00,2024-05-24 11:00:00,-120.97604761904222,-480.88202190537413,67147.88071428573,-0.0022140261877803104,-0.001981027360178929,67233.74248809525,67053.04461724318,69819.57691913284,67224.47184015145,67413.0135600639,66984.77736704508,-96.0182994245406,-76.17848053097077,350.2436446716007,-33.20326522187679,-16.27220949428738,-59.620520123804454,67457.60628735175,66510.44844673842,24.128343321382403,26.869582009697094,False,True,66512.438,66912.438,66912.438,66862.438,2024-05-24 11:30:00,True,2024-05-24 11:30:00,,2024-05-24 11:38:03,even,True,18.62,1826.4799999999907,2,0,21,5
2024-05-27 04:00:00,68833.336,68836.734,68745.641,68745.641,1120,36421,0,2024-05-27 04:00:00,2024-05-27 04:00:00,-9.661059523830772,184.31502471222484,68750.03817857141,0.000940426610029447,0.0006038967967913685,68631.77021428567,66567.06123149912,68771.23974045474,68648.24254983607,68600.74740960685,68630.36878775372,48.78343467699597,58.85021904620716,203.65786189807793,59.74186446508975,68.41951943591994,57.47247162014537,68906.80690131611,68355.43067419132,91.70102648150714,84.9063021121557,True,False,69245.641,68345.641,68845.641,68895.641,,False,2024-05-27 04:45:00,2024-05-27 04:40:58,2024-05-27 08:30:26,success,True,93.11,1919.5899999999906,3,0,22,5
2024-05-27 05:00:00,69078.938,69135.641,69011.836,69135.641,1844,36421,0,2024-05-27 05:00:00,2024-05-27 05:00:00,118.26796428574016,218.85106177684793,68879.48940476189,0.0009403058703545302,0.000603977999199638,68750.03817857141,66629.93715042835,68812.82634453365,68845.31536711424,68717.78400957712,68935.07380288956,74.71577075321693,62.75913516557968,229.1434021865476,66.17770381836453,81.9666384589218,99.80905022358638,69245.9173958414,68625.73020993771,81.29219546951515,83.99221583683837,True,False,69635.641,68735.641,69235.641,69285.641,,False,2024-05-27 18:00:00,2024-05-27 18:00:13,2024-05-27 08:05:16,fail,False,-74.5,1845.0899999999906,0,1,22,5
2024-05-27 07:00:00,68882.336,68916.836,68802.75,68822.234,1209,36421,0,2024-05-27 07:00:00,2024-05-27 07:00:00,64.53988095240493,247.11512167462206,68942.29422619042,0.0009403572363971539,0.0009319808705810738,68944.02928571429,66755.13049148193,68718.94337112407,68944.45522688355,68849.23308737014,69097.81799690399,68.71312946689432,76.68167816552267,250.79634888684436,-49.75777089786425,-36.97966701067344,-13.814340557262767,69436.39306790123,68757.74292590676,36.75926317918622,51.690665222778705,True,False,69322.234,68422.234,68922.234,68972.234,,False,2024-05-27 17:15:00,2024-05-27 17:37:09,2024-05-27 08:29:10,fail,False,-74.5,1770.5899999999906,0,2,22,5
2024-05-27 08:00:00,68766.539,68791.734,68718.25,68732.539,1071,36421,0,2024-05-27 08:00:00,2024-05-27 08:00:00,-1.735059523867676,235.42025195559836,68820.69372619041,0.0009403442281812459,0.0009780916293011918,68942.29422619042,66817.52507487407,68761.1438586781,68864.80321413124,68832.31549358813,68872.57523495008,42.036520525449305,61.35194176024474,236.68449818267862,-60.66160130723438,-66.0061778465606,-51.45682146544277,69192.0993074967,68551.55116240347,5.605080641970084,10.95106919971999,True,False,69232.539,68332.539,68832.539,68882.539,,False,2024-05-27 16:45:00,2024-05-27 17:35:52,2024-05-27 08:30:28,fail,False,-74.5,1696.0899999999906,0,3,22,5
2024-05-27 18:00:00,69530.336,69931.734,69524.016,69907.234,2480,36421,0,2024-05-27 18:00:00,2024-05-27 18:00:00,276.5807738095318,173.5321194704884,69511.25061904767,0.0008916504505848918,0.0009150216500511437,68976.48598809521,67422.58452220984,69424.33717702418,69106.70660826164,68885.2612065583,69321.67588235295,85.52758622351394,34.15201870083027,362.75939096062973,193.78796525626967,135.74607430344622,85.88820571034739,69812.9010601498,68831.9507045561,93.91458323703785,89.60424092834853,True,False,70407.234,69507.234,70007.234,70057.234,,False,2024-05-27 18:45:00,2024-05-27 18:36:20,2024-05-27 22:48:26,success,True,93.11,1789.1999999999905,1,0,22,5
2024-05-27 19:00:00,70403.234,70671.539,70393.852,70583.438,2379,36421,0,2024-05-27 19:00:00,2024-05-27 19:00:00,534.7646309524571,289.373166233112,69875.93079761903,0.0008915920705189605,0.0009763245471639438,69511.25061904767,67483.27539637474,69505.66349594558,69702.52355749304,69260.95981900125,70154.09980976951,187.94341845561576,105.2480289506393,674.6945880577626,210.5120381837187,216.92288923282467,247.72475679397758,71066.4375036475,69243.26211589153,93.15503901456646,90.68491203590753,True,False,71083.438,70183.438,70683.438,70733.438,,False,,,2024-05-27 20:23:03,fail,False,-74.5,1714.6999999999905,0,1,22,5
2024-05-27 20:00:00,70209.539,70399.234,70209.539,70373.711,1225,36421,0,2024-05-27 20:00:00,2024-05-27 20:00:00,364.68017857136147,361.59023516414163,70146.71905952378,0.0008915380418186204,0.0009763325967548123,69875.93079761903,67543.31816232773,69573.23231056803,70018.03537009403,69550.75418244614,70562.9763302374,227.02175929372606,172.84918210791375,790.6434589136815,74.50135706923902,57.529970760209835,111.74713725486072,71631.84499977088,69495.60766070393,79.27575977104858,83.30785250445147,True,False,70873.711,69973.711,70473.711,70523.711,,False,,,2024-05-27 21:47:05,fail,False,-74.5,1640.1999999999905,0,2,22,5
2024-05-27 21:00:00,70226.438,70297.734,70157.539,70174.141,1210,36421,0,2024-05-27 21:00:00,2024-05-27 21:00:00,270.788261904745,415.1342152649304,70254.07246428568,0.0008915727958494841,0.0009761910400262703,70146.71905952378,67603.45191582547,69641.25014268396,70109.0245242655,69724.4052024101,70557.73585104922,215.90235786848643,201.23188358732335,747.7639880339516,-31.282928448505118,-8.494703474454582,17.89423116609396,71567.21723489506,69546.75446720338,69.03808582412297,71.74206724963578,True,False,70674.141,69774.141,70274.141,70324.141,,False,,,2024-05-27 22:43:37,fail,False,-74.5,1565.6999999999905,0,3,22,5
2024-05-27 22:00:00,70026.438,70163.336,69918.25,69918.25,1714,36421,0,2024-05-27 22:00:00,2024-05-27 22:00:00,107.35340476190322,436.8942428052542,70006.2394642857,0.0008893069419572327,0.0009763174584756991,70254.07246428568,67664.56869402087,69709.00548571986,70061.22788746092,69802.06181032598,70184.18927347778,175.74539429736615,194.4131955073751,593.6045811609158,-125.71852459578076,-98.89002373589028,-87.04908049534424,70985.55545804501,69381.32308891055,19.19871738577567,34.224514058506095,True,False,70418.25,69518.25,70018.25,70068.25,,False,,,2024-05-27 22:48:26,fail,False,-74.5,1491.1999999999905,0,4,22,5
2024-05-28 07:00:00,68045.039,68135.539,67868.836,67877.547,1485,36421,0,2024-05-28 07:00:00,2024-05-28 07:00:00,-427.41672619043675,19.951338577651768,68179.84260714287,-0.0004334739633016754,0.0009517906175468361,68562.88491666672,68006.89841192565,70332.3404935792,68465.80428848359,68880.46951924636,68076.11648606816,-192.08790577898617,-132.83145668400476,592.6152452911502,-150.08965359475405,-138.03723942209035,-193.06875644993852,68876.14706721122,67274.5859049251,9.451212004082082,8.93560265720702,False,True,67377.547,67777.547,67777.547,67727.547,2024-05-28 07:45:00,True,2024-05-28 07:45:00,2024-05-28 21:36:53,2024-05-28 07:49:41,even,True,18.62,1509.8199999999904,1,0,22,5
2024-05-28 09:00:00,68054.688,68054.688,67866.289,67954.734,1770,36421,0,2024-05-28 09:00:00,2024-05-28 09:00:00,-162.54079761904723,-143.16707741587015,67904.17145238098,-0.0005301908619020284,0.00014533000265016434,68017.30180952382,68052.24705719875,70686.65720434295,68046.1478442872,68418.61674074458,67718.01746336423,-216.5386055984709,-208.47823239918165,647.3392258710323,48.571084967275965,52.79954798759718,15.72361541108694,68593.42541829012,66844.10950843834,38.233596536533106,33.187924052413756,False,True,67454.734,67854.734,67854.734,67804.734,2024-05-28 11:00:00,True,2024-05-28 11:00:00,2024-05-28 21:36:50,2024-05-28 11:10:04,even,True,18.62,1528.4399999999903,2,0,22,5
2024-05-28 10:00:00,67968.961,68034.141,67849.836,67932.734,1576,36421,0,2024-05-28 10:00:00,2024-05-28 10:00:00,-113.13035714284342,-194.35824154839793,67769.82585714287,-0.0005301976493322443,-0.0002471130283538856,67904.17145238098,68016.24137931356,70776.65509001858,67997.02080950278,68292.56897020995,67825.9927241142,-192.84806660067989,-204.16683606557942,541.4776431441243,40.81847265221586,44.52067217064905,41.58530787748168,68558.48754235877,67094.99790586963,59.36953090141402,47.67505197060732,False,True,67432.734,67832.734,67832.734,67782.734,2024-05-28 11:00:00,True,2024-05-28 11:00:00,2024-05-28 21:36:50,2024-05-28 11:09:30,even,True,18.62,1547.0599999999902,3,0,22,5
2024-05-28 11:00:00,67693.836,67938.039,67584.734,67931.836,1862,36421,0,2024-05-28 11:00:00,2024-05-28 11:00:00,-134.34559523810458,-254.834005566212,67885.71316666667,-0.0005302084718142665,-0.0006110389469776362,67769.82585714287,67980.2455188245,70807.2536720311,67912.35444942159,68167.57113849753,67884.78065737875,-176.2606661082973,-191.59244784584547,338.12044409565124,7.254108359178645,-9.903599243232748,24.832155830736156,68342.74325690788,67428.31805784962,51.82772920222508,52.83370167431483,False,True,67431.836,68331.836,67831.836,67781.836,,False,2024-05-28 20:00:00,2024-05-28 21:36:50,2024-05-28 12:40:39,fail,False,-74.5,1472.5599999999902,0,1,22,5
2024-05-30 17:00:00,68628.336,68849.734,68491.836,68491.836,3144,36421,0,2024-05-30 17:00:00,2024-05-30 17:00:00,288.42399999996996,47.79601682751672,68331.95933333329,3.44040157950133e-05,0.00031450720088842764,68199.87911904756,67121.42236113954,68464.07553550063,68218.57326794506,68060.60049362651,68389.01898520815,67.75357963060378,38.884145517877236,333.618605416893,51.17709322330484,92.46670622634701,42.52390436868882,68840.90410252096,67938.63386789535,80.42600443603956,82.04838608676252,True,False,68991.836,68591.836,68591.836,68641.836,2024-05-30 17:30:00,True,2024-05-30 17:30:00,2024-05-30 20:23:22,2024-05-30 17:38:58,even,True,18.62,1491.17999999999,1,0,22,5
2024-05-30 20:00:00,68690.508,68901.539,68685.383,68901.539,951,36421,0,2024-05-30 20:00:00,2024-05-30 20:00:00,134.6803809524572,144.542612682053,68890.33935714292,3.439479489306119e-05,0.0006419975483221071,68591.32577380954,67128.37007033886,68757.25838285497,68526.5532237092,68351.06191015917,68630.89398864811,95.33558486904076,82.12800219936099,262.38538763946474,74.21207774338836,29.364203646357055,-11.132299621531274,68986.61426196138,68276.67371533484,77.79105148418716,62.528253337474865,True,False,69401.539,68501.539,69001.539,69051.539,,False,2024-05-30 20:45:00,2024-05-30 20:40:26,2024-05-30 22:49:03,success,True,93.11,1584.28999999999,2,0,22,5
2024-05-30 21:00:00,69362.938,69461.539,69171.938,69171.938,899,36421,0,2024-05-30 21:00:00,2024-05-30 21:00:00,299.013583333377,223.5984817911085,69139.5354880952,6.446432457276227e-05,0.0006414317188148554,68890.33935714292,67114.8363821854,68801.38610805105,68881.2927273669,68589.86708009719,69039.03386756107,146.69125392382557,112.704645503676,383.3347756326436,65.11993395253376,112.73226762987906,150.7556494667806,69558.03581466514,68521.531920457,84.65544949249382,89.51843119646799,True,False,69671.938,69271.938,69271.938,69321.938,2024-05-30 22:00:00,True,2024-05-30 22:00:00,2024-06-03 15:39:54,2024-05-30 22:03:48,even,True,18.62,1602.9099999999899,3,0,22,5
2024-05-31 19:00:00,67233.289,67382.734,66834.305,66841.289,3476,36421,0,2024-05-31 19:00:00,2024-05-31 19:00:00,-304.08321428569616,-136.97491335392988,67514.3724523809,-0.0005805637643194598,-0.0003701644574127093,67772.3435238095,67378.11218035966,69417.5258787945,67578.64957160805,67897.72830042266,67190.06000378393,-138.89477855006407,-81.34639333502176,551.0444687752613,-198.7133997247729,-151.575353285225,-116.68879704161373,67933.97003663053,66444.64997093733,4.289148382360131,7.282840238373944,False,True,66341.289,67241.289,66741.289,66691.289,,False,,,2024-05-31 19:59:24,fail,False,-74.5,1528.4099999999899,0,1,22,5
2024-05-31 20:00:00,67221.844,67419.938,67175.273,67295.039,1844,36421,0,2024-05-31 20:00:00,2024-05-31 20:00:00,-257.9710714285902,-193.79612709181674,67331.36395238091,-0.0005806514543345068,-0.0003700703642784081,67514.3724523809,67338.81771810539,69391.7129222731,67369.26072098014,67696.02766313966,66884.3283343653,-162.73521824373165,-128.70551027943577,645.8596703402112,17.037468180191354,-46.179400412758696,-129.75997867215483,67757.73888932458,66012.41777940602,24.45092199651482,17.391945257714426,False,True,66795.039,67695.039,67195.039,67145.039,,False,,,2024-05-31 22:40:25,fail,False,-74.5,1453.9099999999899,0,2,22,5
2024-06-03 10:00:00,69085.938,69218.641,69010.898,69144.141,1224,36421,0,2024-06-03 10:00:00,2024-06-03 10:00:00,223.36053571428056,152.42785274251946,68902.16495238089,0.0001145808159743716,0.00014109081926139792,68820.73459523807,66659.98291703554,69072.27897912232,68851.88321662665,68587.95471503741,69047.45800687996,140.83130902182893,117.62114465271631,299.67375514399595,86.69208118339884,96.7614774681715,129.6721293429291,69453.51757632435,68642.89843743556,89.38734362241728,92.74006139619256,True,False,69644.141,69244.141,69244.141,69294.141,2024-06-03 11:30:00,True,2024-06-03 11:30:00,2024-06-03 15:39:11,2024-06-03 11:47:32,even,True,18.62,1472.5299999999897,1,0,23,6
2024-06-03 12:00:00,69157.102,69217.641,69067.938,69116.141,1553,36421,0,2024-06-03 12:00:00,2024-06-03 12:00:00,97.39730952390528,230.21392660720448,69070.27078571422,0.0008501464549278211,0.00021989770679375076,68999.5622619048,66633.15162289399,69109.51228273349,69054.66447003385,68827.56042765148,69239.81803164777,138.1692729814822,134.7693161826284,335.7508635266086,-7.706470588236698,4.2301874785043765,49.00172858616861,69693.08169740869,68785.05436588684,77.21633209603662,84.80238350529417,True,False,69616.141,69216.141,69216.141,69266.141,2024-06-03 15:15:00,True,2024-06-03 15:15:00,2024-06-03 15:39:10,2024-06-03 17:36:18,success,True,93.11,1565.6399999999896,2,0,23,6
2024-06-03 16:00:00,69774.438,69793.734,69577.516,69584.539,1950,36421,0,2024-06-03 16:00:00,2024-06-03 16:00:00,219.69385714289092,334.81901808029215,69495.6809047619,0.0016702587076176298,0.0007206452884252583,69312.31110714287,67033.55701869671,69419.04004492468,69370.73044129155,69169.06476345145,69473.62150498795,119.22404609128716,107.58837075414883,226.00552947128384,79.74627106977277,120.14484829721914,91.26790849672398,69780.22896977418,69168.51404020173,85.91635812680335,88.46999249976996,True,False,70084.539,69684.539,69684.539,69734.539,2024-06-03 16:45:00,True,2024-06-03 16:45:00,2024-06-03 16:45:38,2024-06-03 17:02:12,success,True,93.11,1658.7499999999895,3,0,23,6
2024-06-03 17:00:00,69803.836,70114.734,69647.836,70082.773,2985,36421,0,2024-06-03 17:00:00,2024-06-03 17:00:00,183.36979761903058,381.83630174788414,69330.63198809522,0.0012496680177504337,0.0007206436524263014,69495.6809047619,67027.31229289855,69468.9389176141,69638.82307079408,69365.55954666882,69864.67775541799,150.22535449617135,126.76793656811466,330.5277699426602,110.3120158239326,67.2999748881848,130.04481527347525,70312.39024484057,69418.4652659954,82.68604087155067,84.98992629785788,True,False,70582.773,69682.773,70182.773,70232.773,,False,2024-06-04 19:00:00,2024-06-04 19:00:39,2024-06-03 17:30:46,fail,False,-74.5,1584.2499999999895,0,1,23,6
2024-06-04 00:00:00,69103.617,69215.539,69041.836,69041.836,824,56421,0,2024-06-04 00:00:00,2024-06-04 00:00:00,-25.16040476191847,272.5481987226958,69202.04192857146,0.0011366494312790916,0.0018375939094474995,69191.4036904762,67531.59721891089,69055.77457413625,69227.33965874692,69254.38360490913,69238.61810010318,-2.578315244143596,8.146173780171482,137.4023448846415,-42.82786962504906,-21.432556931540603,12.807966288251919,69424.11126569744,69051.62493450892,20.850198058213557,48.058240412586805,True,False,69541.836,68641.836,69141.836,69191.836,,False,2024-06-04 05:00:00,2024-06-04 16:41:26,2024-06-04 03:19:57,fail,False,-74.5,1509.7499999999895,0,2,23,6
2024-06-04 19:00:00,70473.836,70670.539,70426.836,70547.211,2937,36421,0,2024-06-04 19:00:00,2024-06-04 19:00:00,454.93082142852654,203.94282454432687,70265.43836904764,2.8316795503263175e-05,0.00037911782362208286,69799.92409523808,68556.29366100403,70561.97463620559,69917.65818740625,69575.83222540923,70266.68790918478,153.70915559401328,99.21540479296385,526.3972758926237,139.185408668709,152.469581355399,111.64002614381025,70978.82423163982,69556.05158672974,95.3689451527235,91.55257272617712,True,False,71047.211,70647.211,70647.211,70697.211,2024-06-04 19:30:00,True,2024-06-04 19:30:00,2024-06-04 21:22:35,2024-06-04 20:04:08,even,True,18.62,1528.3699999999894,1,0,23,6
2024-06-04 20:00:00,70839.836,70874.734,70552.539,70709.898,2220,36421,0,2024-06-04 20:00:00,2024-06-04 20:00:00,465.5142738095601,307.02015080362617,70511.3521904762,2.8350771152318083e-05,0.0003791023728172543,70265.43836904764,68558.21101082371,70588.68683434404,70367.31237063881,69913.09228572594,70817.55089370492,218.85255569769652,162.26497090472267,691.7984920808614,72.65423735811783,122.81494736850436,169.71210044715554,71752.97885801407,69883.62292939576,88.55245146624152,92.75167787572006,True,False,71209.898,70809.898,70809.898,70859.898,2024-06-04 21:30:00,True,2024-06-04 21:30:00,2024-06-05 04:35:24,2024-06-04 21:52:37,even,True,18.62,1546.9899999999893,2,0,23,6
2024-06-05 00:00:00,70416.234,70450.438,70351.805,70431.438,1213,56421,0,2024-06-05 00:00:00,2024-06-05 00:00:00,-82.58010714284319,431.96297755981504,70629.3657261905,0.00032466572700725704,0.0007739443594327354,70648.18295238097,68447.46136267565,70338.36270712147,70447.03939341409,70325.03732927896,70374.9868851049,115.66134096622409,150.07725732689028,283.8382075397351,4.567853801097954,-11.953329893338378,-56.26726522187528,70759.66846528354,69991.80530492625,30.28532519164463,25.74143481956439,True,False,70931.438,70531.438,70531.438,70581.438,2024-06-05 01:00:00,True,2024-06-05 01:00:00,2024-06-05 03:54:19,2024-06-05 01:02:23,even,True,18.62,1565.6099999999892,3,0,23,6
2024-06-05 02:00:00,70592.039,70619.234,70532.492,70585.781,1040,36421,0,2024-06-05 02:00:00,2024-06-05 02:00:00,-74.47113095239911,449.58287837986427,70530.50774999996,0.0007394602617989559,0.0010116711179279524,70554.8945952381,68383.00070220738,70266.11413627602,70557.3212868905,70448.55048765248,70569.66353869965,91.85991152015049,107.8599105189997,171.16055919964478,44.92568386650237,46.85049707609869,22.33648434803763,70802.23029361917,70338.59678378013,72.01060572304516,75.14117722236526,True,False,71085.781,70685.781,70685.781,70735.781,2024-06-05 03:45:00,True,2024-06-05 03:45:00,2024-06-05 04:35:02,2024-06-05 03:48:06,even,True,18.62,1584.229999999989,4,0,23,6
2024-06-05 03:00:00,70559.234,70632.539,70501.734,70501.734,1170,36421,0,2024-06-05 03:00:00,2024-06-05 03:00:00,-24.386845238142996,444.89903554171906,70633.20252380957,0.0009767073210278454,0.0010790305935827855,70530.50774999996,68387.54786916317,70290.96519346512,70537.61957366212,70466.15304113393,70599.11054626762,70.62774156472005,89.2057312529735,168.67293152144464,-11.552217062344425,14.278532851749333,21.287806329593877,70826.81900382157,70369.90208871367,56.011359422018124,57.660727671774396,True,False,71001.734,70601.734,70601.734,70651.734,2024-06-05 03:30:00,True,2024-06-05 03:30:00,2024-06-05 04:25:56,2024-06-05 03:31:04,even,True,18.62,1602.849999999989,5,0,23,6
2024-06-05 04:00:00,70803.641,70877.141,70693.055,70695.039,1515,36421,0,2024-06-05 04:00:00,2024-06-05 04:00:00,102.69477380960598,455.3127195227571,70768.94870238089,0.0011998916801406808,0.001078182213657242,70633.20252380957,68426.56652879325,70367.26982079307,70630.73659857802,70535.34748837019,70680.85933677325,73.05484979639004,79.43148142251448,137.31417895237303,5.948941176422522,25.49917027859192,27.483536979707424,70867.73347835896,70495.48519518755,66.05539971570447,66.85634568010671,True,False,71195.039,70795.039,70795.039,70845.039,2024-06-05 04:30:00,True,2024-06-05 04:30:00,2024-06-05 04:35:22,2024-06-05 05:13:10,success,True,93.11,1695.959999999989,6,0,23,6
2024-06-05 06:00:00,70873.938,70981.141,70810.141,70859.938,855,36421,0,2024-06-05 06:00:00,2024-06-05 06:00:00,87.47942857150338,473.48594805639004,70928.61842857143,0.001387944884523745,0.0014856277319996454,70856.4281309524,68593.2918130395,70323.44897786513,70852.93727059149,70722.09719186743,70991.03231785349,85.97384470306861,87.04407112095643,197.38846195009663,4.989337117338437,19.3589339525206,51.34127622983942,71259.00674148613,70724.55789422085,50.91470088600678,53.8572294632928,True,False,71359.938,70959.938,70959.938,71009.938,2024-06-05 07:30:00,True,2024-06-05 07:30:00,2024-06-05 10:44:47,2024-06-05 08:08:59,even,True,18.62,1714.5799999999888,7,0,23,6
2024-06-05 07:00:00,70972.477,71006.438,70854.547,70989.938,797,36421,0,2024-06-05 07:00:00,2024-06-05 07:00:00,72.19029761903221,475.5925186000386,71040.83082142858,0.0013878804588496707,0.0016245410351693112,70928.61842857143,68688.62970424163,70371.4195144305,70894.47192635866,70778.16850945113,71003.88384485728,79.47145892131084,83.11974589353508,188.06127740240282,6.392286893751589,0.4966081871825736,-4.5477939457050525,71259.26656935053,70750.00112036403,47.22437068909088,47.15624455121269,True,False,71489.938,71089.938,71089.938,71139.938,2024-06-05 07:45:00,True,2024-06-05 07:45:00,2024-06-05 18:27:35,2024-06-05 08:03:00,even,True,18.62,1733.1999999999887,8,0,23,6
2024-06-05 08:00:00,71201.938,71226.734,70917.898,70918.438,1559,36421,0,2024-06-05 08:00:00,2024-06-05 08:00:00,112.21239285715274,489.85973462596303,71073.5454285714,0.001387854938065401,0.001518527185908549,71040.83082142858,68784.09007373198,70521.78731554246,70992.72593711063,70864.18018070179,71057.66758823527,83.82034880270658,84.57928808181192,215.67313032715543,-23.627883384921006,28.72094633638335,33.80626590982138,71348.82631417693,70765.00886229362,65.2201134747556,66.33132803699878,True,False,71418.438,71018.438,71018.438,71068.438,2024-06-05 09:45:00,True,2024-06-05 09:45:00,2024-06-05 18:19:00,2024-06-05 09:49:18,even,True,18.62,1751.8199999999886,9,0,23,6
2024-06-05 09:00:00,71015.008,71025.141,70854.273,70892.648,1359,36421,0,2024-06-05 09:00:00,2024-06-05 09:00:00,32.7146071428142,480.59895248530665,71121.55792857139,0.0013879064756012912,0.0013764238972909413,71073.5454285714,68879.56308895118,70667.30977578033,70978.36805417306,70891.64494479093,71023.50099484008,67.40110340910906,78.11612315177004,165.0034765823787,-12.463519779819762,9.054081871392555,-36.47394840043853,71246.2556882263,70799.24630145387,28.02335417958319,37.12792571477417,True,False,71392.648,70992.648,70992.648,71042.648,2024-06-05 09:45:00,True,2024-06-05 09:45:00,2024-06-05 10:44:48,2024-06-05 11:47:57,success,True,93.11,1844.9299999999885,10,0,23,6
2024-06-05 10:00:00,71139.609,71231.234,71098.305,71169.438,1364,36421,0,2024-06-05 10:00:00,2024-06-05 10:00:00,48.01249999999709,478.1994000675768,71159.30352380947,0.0013878828147632397,0.0012405454306822683,71121.55792857139,68975.48881090706,70792.11719329149,71047.22643945056,70950.53852105307,71101.44123116613,67.63562737341272,71.1855156852883,129.260492038236,30.89407671142544,29.67735087715846,11.43283178533602,71277.44289541774,70926.93956691452,68.05558430852227,55.425791086115986,True,False,71669.438,71269.438,71269.438,71319.438,2024-06-05 10:45:00,True,2024-06-05 10:45:00,2024-06-05 18:36:18,2024-06-05 10:51:07,even,True,18.62,1863.5499999999884,11,0,23,6
2024-06-05 11:00:00,71215.734,71263.938,71054.953,71084.734,1419,36421,0,2024-06-05 11:00:00,2024-06-05 11:00:00,37.745595238084206,477.29963221815706,71101.12492857147,0.001387821970983432,0.0010827597131765191,71159.30352380947,69071.06369626269,70900.23332616597,71117.4777193374,71015.1951804252,71157.55269246646,68.76515330171969,70.58505972589288,143.70992884035397,-17.477308565517887,18.69976780185243,52.0184509804094,71351.56109640094,70962.04428853198,68.1371521536818,71.30721987589901,True,False,71584.734,70684.734,71184.734,71234.734,,False,2024-06-05 18:30:00,2024-06-05 18:28:48,2024-06-05 15:26:38,fail,False,-74.5,1789.0499999999884,0,1,23,6
2024-06-05 12:00:00,70944.352,71023.438,70881.836,70931.234,1323,36421,0,2024-06-05 12:00:00,2024-06-05 12:00:00,-58.178595238001435,449.449231399165,71054.56814285718,0.0013587372392089955,0.0009058607485759339,71101.12492857147,69154.5063235632,70987.22900997418,71062.31138667479,71014.34649010446,71096.08090230484,47.066817707251175,61.66264909543251,134.5911659179536,-15.744814241421409,-29.10470278642606,-15.76881596140447,71277.77897629407,70912.8828283156,22.73940837714782,33.34710609551342,True,False,71431.234,71031.234,71031.234,71081.234,2024-06-05 16:30:00,True,2024-06-05 16:30:00,2024-06-05 18:19:00,2024-06-05 16:30:57,even,True,18.62,1807.6699999999882,1,0,23,6
2024-06-05 19:00:00,71611.734,71796.438,71438.992,71670.609,2345,36421,0,2024-06-05 19:00:00,2024-06-05 19:00:00,262.8134047618951,321.3712635617121,71221.30946428576,0.0008526523208088382,0.000512254838994734,71110.61241666663,69462.79002191585,71265.8489199179,71233.40246976141,71088.92248435543,71321.9123945648,55.370992041163845,18.697560575434128,300.7040738735759,122.83801410387969,114.77210216716048,116.35818851046497,71729.36289429413,70915.96189483548,88.22569672474246,86.81774671438309,True,False,72170.609,71270.609,71770.609,71820.609,,False,2024-06-07 15:15:00,,2024-06-05 20:00:20,fail,False,-74.5,1733.1699999999882,0,1,23,6
2024-06-05 20:00:00,71337.641,71580.539,71264.18,71564.641,1875,36421,0,2024-06-05 20:00:00,2024-06-05 20:00:00,110.69704761913454,324.92773874056,71408.06084523808,0.0008526391244179,0.0005122430174809297,71221.30946428576,69522.01578269101,71302.32790659879,71373.01682286253,71204.41543305341,71577.25633608534,76.58921257656766,50.69773769876835,347.9927686531272,68.23636119716684,9.274546955581172,66.50528620572004,72048.54657376706,71107.46609840362,77.41385592712493,81.80032761996107,True,False,72064.641,71164.641,71664.641,71714.641,,False,2024-06-07 15:00:00,,2024-06-05 21:23:36,fail,False,-74.5,1658.6699999999882,0,2,23,6
2024-06-05 21:00:00,71641.133,71769.734,71320.844,71352.234,1826,36421,0,2024-06-05 21:00:00,2024-06-05 21:00:00,186.7513809523225,348.46763537650986,71361.85910714285,0.0008275569591851332,0.0005122011268395195,71408.06084523808,69605.2117352903,71338.85394254857,71428.76496934736,71280.24477906388,71699.37306742341,78.35407367782318,67.78694900485469,367.21267061496724,-21.531612659207894,68.08423288613267,42.266026143872296,72195.11017275362,71202.1359620932,73.898224978301,78.02658829994137,True,False,71852.234,70952.234,71452.234,71502.234,,False,2024-06-06 16:45:00,2024-06-07 15:00:27,2024-06-05 21:47:51,fail,False,-74.5,1584.1699999999882,0,3,23,6
2024-06-07 15:00:00,71731.734,71981.734,71726.641,71905.938,2289,36421,0,2024-06-07 15:00:00,2024-06-07 15:00:00,138.48939285705274,116.09843426286534,71401.08713095236,0.0002855708872684196,0.00022475103535740868,71434.63255952376,70037.43201330639,71746.56756705554,71483.00691137358,71338.1729922618,71602.15821121431,70.58905889488233,49.48696119461075,189.77724020363905,101.83209528724547,89.80949432410125,55.55494530434953,71859.85748548922,71345.9589369394,91.27971930323291,88.72974135090764,True,False,72405.938,71505.938,72005.938,72055.938,,False,,,2024-06-07 15:30:08,fail,False,-74.5,1509.6699999999882,0,4,23,6
2024-06-07 21:00:00,69814.359,69906.539,68385.008,68530.594,6368,36421,0,2024-06-07 21:00:00,2024-06-07 21:00:00,-510.59665476193186,-52.975920847500674,70061.13339285717,-0.0011093806856358197,0.0002247427094027844,70689.42297619041,69754.01802217151,71842.90644924573,70387.05115773674,70812.4912946047,70033.14157619535,-164.63572566323273,-65.95278024476876,703.0407955432805,-423.6213065015618,-222.60053560377855,-165.88655658751668,70982.24665017879,69082.53650221192,2.4013478413290197,3.3220599523987495,False,True,68030.594,68930.594,68430.594,68380.594,,False,2024-06-11 05:30:00,2024-06-11 05:18:16,2024-06-07 21:15:41,fail,False,-74.5,1435.1699999999882,0,5,23,6
2024-06-07 22:00:00,69159.594,69169.938,68914.938,69096.836,2245,36421,0,2024-06-07 22:00:00,2024-06-07 22:00:00,-628.2895833332441,-196.22438088714262,69647.75002380958,-0.001109401731361824,0.00022471919977862584,70061.13339285717,69676.22183233283,71858.97088814517,69780.958027885,70370.36318966914,69155.13866150675,-262.2048185244639,-167.6606689860654,936.7004907717071,-176.02692982454028,-204.4930460955802,-219.8368809769745,70419.68432404855,67889.09299896494,27.13022850024917,23.95801832525429,False,True,68596.836,69496.836,68996.836,68946.836,,False,2024-06-11 05:00:00,2024-06-11 04:57:18,2024-06-10 00:00:02,fail,False,-74.5,1360.6699999999882,0,6,23,6
2024-06-07 23:00:00,69277.039,69287.734,69013.648,69108.734,1380,36421,0,2024-06-07 23:00:00,2024-06-07 23:00:00,-413.3833690475876,-298.1946742984146,69325.78074999999,-0.0011094300901907724,0.00022464416930098293,69647.75002380958,69598.80901716829,71875.14176494729,69523.43630048893,70075.98512574022,68830.07248366016,-281.38270982020185,-231.72882630143647,989.1994180290146,-88.203672514559,-74.20974785006547,-44.85651771585981,70165.49169799933,67493.15326932099,31.98091189307284,31.769688846095224,False,True,68608.734,69508.734,69008.734,68958.734,,False,2024-06-11 05:00:00,2024-06-11 04:57:17,2024-06-10 00:00:02,fail,False,-74.5,1286.1699999999882,0,7,23,6
2024-06-11 06:00:00,68261.914,68401.734,68193.938,68343.938,1287,36421,0,2024-06-11 06:00:00,2024-06-11 06:00:00,-346.6882857142482,-271.782891252602,68629.83364285715,-0.000879510847793791,-0.0002575414885520698,68870.62501190482,68877.10407541187,70308.07987825859,68749.85540438861,69100.16223060044,68439.98626350188,-156.08993160372484,-97.38603904722333,524.1406775682697,-129.1407155142806,-153.3901375989226,-212.06623632609262,69147.57617821904,67730.89634878472,21.459225054400406,17.141433539316093,False,True,67843.938,68243.938,68243.938,68193.938,2024-06-11 07:15:00,True,2024-06-11 07:15:00,2024-06-11 07:26:26,2024-06-12 15:30:04,success,True,93.11,1379.2799999999881,1,0,24,6
2024-06-11 07:00:00,68451.609,68454.039,67885.039,68042.734,2125,36421,0,2024-06-11 07:00:00,2024-06-11 07:00:00,-240.79136904767074,-318.2046333586477,68323.88341666663,-0.0009619202601121469,-0.0002575329995255506,68629.83364285715,68759.81897420339,70289.98160958718,68529.79517095529,68891.26622620817,68095.24500515999,-179.819855291149,-140.640988106054,593.6426115272299,-109.74303577568207,-53.43449776401394,-97.38045614039584,68896.66253072175,67292.32747959823,24.301909098941334,28.920106178102255,False,True,67542.734,67942.734,67942.734,67892.734,2024-06-11 08:30:00,True,2024-06-11 08:30:00,2024-06-11 09:56:40,2024-06-11 09:02:05,even,True,18.62,1397.899999999988,2,0,24,6
2024-06-11 08:00:00,68016.961,68062.039,67892.133,67907.336,1423,36421,0,2024-06-11 08:00:00,2024-06-11 08:00:00,-305.9502261905145,-385.50746112425986,68069.460452381,-0.0009618982737744331,-0.00025748970923699077,68323.88341666663,68693.62032623412,70271.96497752919,68262.887691886,68650.96833672706,67835.1239528724,-205.80393011754495,-175.51068518140502,658.2428211027562,-50.07898589607794,-47.458171310659964,-54.51361919505871,68723.75176136111,66944.99614438368,21.694618703141334,20.45987552690632,False,True,67407.336,67807.336,67807.336,67757.336,2024-06-11 09:30:00,True,2024-06-11 09:30:00,2024-06-11 09:56:43,2024-06-11 10:06:47,success,True,93.11,1491.009999999988,3,0,24,6
2024-06-11 09:00:00,67891.336,67989.234,67866.078,67925.141,1031,36421,0,2024-06-11 09:00:00,2024-06-11 09:00:00,-254.42296428563714,-443.1520759135601,67837.80051190472,-0.0011216058375018232,-0.0002575300688893044,68069.460452381,68664.48811198954,70253.90901179255,68077.02771474748,68446.2595689644,67855.48783040933,-211.5594450788485,-197.4354626355981,642.8593352898254,46.15759305123356,24.530045751671423,-15.861798417652608,68724.8479330506,66987.62772776806,31.46527313231179,25.8650456274263,False,True,67425.141,67825.141,67825.141,67775.141,2024-06-11 09:30:00,True,2024-06-11 09:30:00,2024-06-11 09:56:42,2024-06-11 10:13:42,success,True,93.1,1584.1099999999878,4,0,24,6
2024-06-11 11:00:00,67563.836,67647.734,67340.891,67357.602,1857,36421,0,2024-06-11 11:00:00,2024-06-11 11:00:00,-166.29826190466702,-548.7985019673652,67593.09497619045,-0.001228200956694926,-0.0007009006961919774,67671.50225000005,68626.74641087765,70338.65801092038,67749.77245281676,68082.41194663255,67571.25330787756,-207.254065891364,-205.36726784795343,300.50036257261064,-63.288739250114304,-26.68173030608159,-24.048782593774376,67976.92879735059,67164.07781840453,27.7404496886154,37.90815977813983,False,True,66857.602,67257.602,67257.602,67207.602,2024-06-11 12:45:00,True,2024-06-11 12:45:00,2024-06-11 13:02:35,2024-06-11 12:46:09,even,True,18.62,1602.7299999999877,5,0,24,6
2024-06-11 12:00:00,67523.539,67672.539,67507.125,67542.984,1055,36421,0,2024-06-11 12:00:00,2024-06-11 12:00:00,-78.40727380960016,-584.8033235852636,67381.2255714286,-0.0013377402646569832,-0.0009748667619111971,67593.09497619045,68489.43389368457,70344.79161954748,67645.19618128533,67936.97565768794,67500.39050154797,-193.2682373264688,-201.52776896719652,302.1537077711957,-7.725299277633894,-32.4569349844387,-10.88293945651094,67908.29800703908,67090.98299605686,38.81543046692045,32.44747377578131,False,True,67042.984,67442.984,67442.984,67392.984,2024-06-11 12:30:00,True,2024-06-11 12:30:00,2024-06-11 12:49:22,2024-06-11 22:48:36,success,True,93.1,1695.8299999999876,6,0,24,6
2024-06-11 13:00:00,67086.641,67198.789,66671.336,67156.141,2754,36421,0,2024-06-11 13:00:00,2024-06-11 13:00:00,-211.86940476184827,-641.2163396837714,67162.46163095237,-0.0013961567948027555,-0.001227412389554608,67381.2255714286,68357.80911047319,70310.06823688892,67424.31312321693,67741.80745969986,67248.61491228071,-201.40236494924466,-199.6429697349321,280.7913569018854,-64.61613759890315,-84.34808221529238,-68.81281286549347,67627.68324409825,66868.04658046317,22.815900607627942,18.761808369733554,False,True,66656.141,67056.141,67056.141,67006.141,2024-06-11 14:00:00,True,2024-06-11 14:00:00,2024-06-11 16:48:46,2024-06-11 14:14:19,even,True,18.62,1714.4499999999875,7,0,24,6
2024-06-11 14:00:00,66951.875,67130.641,66762.391,67115.836,1987,36421,0,2024-06-11 14:00:00,2024-06-11 14:00:00,-218.76394047623035,-687.560254408425,67027.21676190474,-0.0013959997128455376,-0.001224721509889682,67162.46163095237,68262.12629186324,70223.16169186812,67266.52621858545,67573.40436515296,67066.17577330582,-197.82269673379778,-199.07833578173216,301.0979161733937,-37.315226350168814,-76.6362146542524,-43.96975335398747,67472.6579601399,66658.19358647174,34.335151830342944,38.01680361225942,False,True,66615.836,67015.836,67015.836,66965.836,2024-06-11 14:30:00,True,2024-06-11 14:30:00,2024-06-11 16:56:49,2024-06-11 14:43:36,even,True,18.62,1733.0699999999874,8,0,24,6
2024-06-11 15:00:00,66901.336,67180.734,66801.828,67171.836,2147,36421,0,2024-06-11 15:00:00,2024-06-11 15:00:00,-135.24486904763035,-720.9962074900395,66963.7405952381,-0.0014035998005308534,-0.0012248141059187335,67027.21676190474,68175.43801608199,70137.19115858983,67144.51111145652,67423.79373874782,66964.97216546266,-187.67147171167016,-196.1648967621524,313.4414478182858,20.109063639494707,-30.275195046444423,-28.438568627505447,67389.61812001735,66541.82621090798,35.46074072890278,32.23619920695592,False,True,66671.836,67071.836,67071.836,67021.836,2024-06-11 15:30:00,True,2024-06-11 15:30:00,2024-06-11 16:48:45,2024-06-11 15:45:56,even,True,18.62,1751.6899999999873,9,0,24,6
2024-06-11 16:00:00,67022.625,67221.734,66849.836,67197.938,1826,36421,0,2024-06-11 16:00:00,2024-06-11 16:00:00,-63.47616666664544,-729.1079404458433,66872.76701190475,-0.0014803179362232611,-0.0012248847880118772,66963.7405952381,68158.25387029085,70051.25426539901,67097.00086743584,67320.65297334299,66946.6691606467,-164.52365833005751,-184.05680186090333,291.58799086313996,49.027692122530425,-5.064630890992703,-9.515527691852185,67341.81294831194,66553.02537298147,58.83330242680106,43.248381861683676,False,True,66697.938,67097.938,67097.938,67047.938,2024-06-11 16:45:00,True,2024-06-11 16:45:00,2024-06-11 16:48:45,2024-06-11 17:49:20,success,True,93.1,1844.7899999999872,10,0,24,6
2024-06-11 17:00:00,66809.992,67023.938,66776.438,67023.938,2012,36421,0,2024-06-11 17:00:00,2024-06-11 17:00:00,-90.97358333333977,-743.9308316169627,66826.49213095242,-0.0014802782253953888,-0.00132897703479085,66872.76701190475,68056.8163771176,70001.31403120492,67048.87086573048,67237.27375253341,66996.1867997936,-144.05803431929962,-163.0163867853218,223.69443928274322,7.4226074992038775,-23.877645338929142,10.954919160722056,67299.67429282531,66694.1993067619,49.32252824944845,59.74892888235909,False,True,66523.938,66923.938,66923.938,66873.938,2024-06-11 18:00:00,True,2024-06-11 18:00:00,2024-06-11 18:38:19,2024-06-11 18:09:24,even,True,18.62,1863.4099999999871,11,0,24,6
2024-06-11 18:00:00,66846.734,67065.539,66610.102,67043.836,1885,36421,0,2024-06-11 18:00:00,2024-06-11 18:00:00,-46.27488095233275,-744.967959097281,66614.01504761908,-0.0017239292064769195,-0.0015954177918929729,66826.49213095242,68050.35242511958,69980.81205781584,67009.57773583419,67165.42771513556,66990.12843102854,-124.86450606948347,-144.44582137852709,175.72059212947937,15.014765393847483,-14.259020639830851,15.017128311053966,67228.85123040334,66752.90563165375,62.223302896761545,61.07716161851886,False,True,66543.836,66943.836,66943.836,66893.836,2024-06-11 18:30:00,True,2024-06-11 18:30:00,2024-06-11 18:38:19,2024-06-11 21:17:46,success,True,93.1,1956.509999999987,12,0,24,6
2024-06-11 19:00:00,66234.367,66681.641,66162.0,66632.539,2442,36421,0,2024-06-11 19:00:00,2024-06-11 19:00:00,-212.47708333334594,-784.6118970479729,66553.68696428572,-0.0017771448844413782,-0.0018751720885865771,66614.01504761908,67993.87046466769,69926.34240968796,66737.02297252718,66976.64833433783,66626.62057447535,-151.2465159062558,-144.88840588106376,276.11845036514137,-41.60548022024159,-130.97324974199,-158.9595534914988,66999.38048246829,66252.36066648242,26.600191423027127,31.03848555375734,False,True,66132.539,66532.539,66532.539,66482.539,2024-06-11 20:30:00,True,2024-06-11 20:30:00,2024-06-14 19:08:09,2024-06-11 20:40:28,even,True,18.62,1975.129999999987,13,0,24,6
2024-06-11 20:00:00,66494.734,66641.734,66416.695,66571.234,1757,36421,0,2024-06-11 20:00:00,2024-06-11 20:00:00,-60.32808333335561,-787.5371943364444,66584.45977380953,-0.0018346652417167604,-0.002103100855682981,66553.68696428572,67935.55448888222,69825.30440703864,66657.2954836585,66870.54865609677,66470.55474097004,-141.7140645871259,-144.6425630819013,287.82100356868904,-23.916769177885726,-68.85091572061356,-12.64274716208456,66859.11309578776,66080.49638615231,48.29869808833692,48.46315837923603,False,True,66071.234,66471.234,66471.234,66421.234,2024-06-11 20:30:00,True,2024-06-11 20:30:00,2024-06-14 19:08:16,2024-06-11 20:39:35,even,True,18.62,1993.7499999999868,14,0,24,6
2024-06-11 21:00:00,66766.891,66831.734,66651.836,66811.438,1210,36421,0,2024-06-11 21:00:00,2024-06-11 21:00:00,30.77280952381261,-758.7911088007677,66732.74709523805,-0.0018518410519626162,-0.0020009684636888045,66584.45977380953,67827.36094301024,69670.87960794025,66645.85990736472,66802.66112145242,66502.00345407629,-119.88957561321149,-137.42852466059463,303.90354012819665,49.053868592964136,57.68059614721278,-3.1843422772508347,66913.77323324935,66091.73367490323,64.12946094152448,51.91710533201009,False,True,66311.438,67211.438,66711.438,66661.438,,False,2024-06-13 18:45:00,2024-06-13 19:02:26,2024-06-11 21:40:25,fail,False,-74.5,1919.2499999999868,0,1,24,6
2024-06-11 22:00:00,67112.039,67258.234,67094.266,67249.836,1048,36421,0,2024-06-11 22:00:00,2024-06-11 22:00:00,148.28732142852095,-699.9636388363433,66960.19447619043,-0.001965118385897168,-0.0016001447716985269,66732.74709523805,67807.55163027107,69534.15825746796,66889.65080787531,66891.55071558902,66924.56518507059,-53.47595047086361,-99.86079574120902,318.40563241281706,133.46538630900613,97.2744392844761,121.92736016510753,67355.91278882789,66494.71758131329,95.594419894757,92.14580399181473,False,True,66749.836,67149.836,67149.836,67099.836,2024-06-12 04:30:00,True,2024-06-12 04:30:00,2024-06-13 18:37:57,2024-06-12 04:59:43,even,True,18.62,1937.8699999999867,1,0,24,6
2024-06-11 23:00:00,67394.828,67481.734,67275.555,67425.336,1160,36421,0,2024-06-11 23:00:00,2024-06-11 23:00:00,227.447380952377,-622.715021185184,67131.95828571431,-0.002080914216820245,-0.0015872291378898813,66960.19447619043,67774.9501343375,69424.31916057228,67107.00690074236,67006.57300378209,67337.5908218094,1.6328218339913292,-50.278812649611176,359.74841477318006,57.83130443755363,131.73138699687843,130.1300075679319,67824.75118175319,66851.9304618656,92.42000386134451,93.94491505897629,False,True,66925.336,67325.336,67325.336,67275.336,2024-06-11 23:45:00,True,2024-06-11 23:45:00,2024-06-12 04:25:48,2024-06-12 00:54:59,even,True,18.62,1956.4899999999866,2,0,24,6
2024-06-12 00:00:00,67269.234,67312.641,67226.047,67227.836,687,56421,0,2024-06-12 00:00:00,2024-06-12 00:00:00,171.7638095238799,-565.5145256330143,67296.19496428568,-0.002081010593626212,-0.0015806583926114034,67131.95828571431,67634.08981521588,69315.10435365766,67176.93497523788,67071.70861323905,67442.20217131067,22.021103536870214,-10.336699459057051,389.25420970343515,15.62789852079004,29.93542105272354,28.846917096627294,67969.1953544103,66916.70898821103,73.04026409373249,77.29795441006122,False,True,66727.836,67127.836,67127.836,67077.836,2024-06-12 04:30:00,True,2024-06-12 04:30:00,2024-06-13 18:38:52,2024-06-12 04:59:25,even,True,18.62,1975.1099999999865,3,0,24,6
2024-06-12 01:00:00,67383.336,67507.234,67379.227,67507.234,507,56421,0,2024-06-12 01:00:00,2024-06-12 01:00:00,164.23667857136752,-505.3519889396266,67419.17747619047,-0.00208094747299141,-0.0013756310525400548,67296.19496428568,67493.19505948927,69249.76445841129,67278.78845028036,67152.6680908897,67431.99654213963,42.78720774424437,16.392745276930675,357.1346781923061,6.288645338805509,-20.475515995858586,2.462617819037405,67915.62835769924,66949.86472658002,75.24268063460114,70.56042787623677,False,True,67007.234,67407.234,67407.234,67357.234,2024-06-12 01:45:00,True,2024-06-12 01:45:00,2024-06-12 04:23:09,2024-06-12 02:00:54,even,True,18.62,1993.7299999999864,4,0,24,6
2024-06-12 02:00:00,67351.039,67586.734,67351.039,67474.836,963,36421,0,2024-06-12 02:00:00,2024-06-12 02:00:00,122.98251190478913,-455.12946601529256,67411.33183333333,-0.0020810834566854014,-0.0013000716792642428,67419.17747619047,67353.00403130396,69176.10403874255,67329.9661684309,67212.73573487891,67401.05855452354,49.907085784943774,34.43782474010722,317.45657233909384,22.506181974546053,-12.646842105314136,-28.994775713785202,67831.12492718131,66972.49218186576,57.075589184408905,58.5676617523857,False,True,66974.836,67374.836,67374.836,67324.836,2024-06-12 02:45:00,True,2024-06-12 02:45:00,2024-06-12 04:25:46,2024-06-12 03:13:32,even,True,18.62,2012.3499999999863,5,0,24,6
2024-06-12 04:00:00,67199.266,67243.438,67135.539,67146.539,782,36421,0,2024-06-12 04:00:00,2024-06-12 04:00:00,-70.28185714282154,-385.8687911511515,67257.67271428573,-0.0020809506727495525,-0.0012999860318615442,67341.04997619051,67073.97902340196,68996.83280638063,67271.69268815598,67236.39379372071,67277.41396560031,27.974845492222812,37.259400746619264,92.54393058092886,-42.743141726823524,-24.58783625731303,-4.582671138632577,67402.34827188456,67150.97965931606,9.970556883190161,17.680306533899678,False,True,66646.539,67046.539,67046.539,66996.539,2024-06-12 04:30:00,True,2024-06-12 04:30:00,2024-06-13 18:40:01,2024-06-12 04:33:18,even,True,18.62,2030.9699999999862,6,0,24,6
2024-06-12 17:00:00,69301.875,69591.336,69272.234,69543.734,1613,36421,0,2024-06-12 17:00:00,2024-06-12 17:00:00,437.8765238095075,220.14092793883174,69303.9388095238,0.0011218007610411798,0.0011513104508946686,68774.16185714286,66363.82167854572,68546.83630378076,68884.64050264106,68367.12014052473,69354.1212201582,246.8796575486922,176.96180385439666,792.7096724681035,154.3566408668703,131.09432473336346,196.95498383215454,70425.77927799014,68283.96316232625,89.59452391685768,85.88747006946687,True,False,70043.734,69643.734,69643.734,69693.734,2024-06-12 17:30:00,True,2024-06-12 17:30:00,,2024-06-12 18:43:14,even,True,18.62,2049.589999999986,7,0,24,6
2024-06-12 20:00:00,69595.234,69657.836,69467.477,69589.836,1189,36421,0,2024-06-12 20:00:00,2024-06-12 20:00:00,135.9337499999965,492.92875084314437,69877.17991666663,0.0011209095501685926,0.0015647443478886054,69760.6694047619,66587.84710471358,68362.97144985665,69511.14168644176,69133.70601005788,69670.64167457868,249.3999267907202,265.9063590692473,779.6036012449882,-8.145681802459876,-111.00517303068773,-125.78784829714277,70723.10653625942,68616.67681289795,49.27521820812209,46.10716222033697,True,False,70089.836,69689.836,69689.836,69739.836,2024-06-12 21:00:00,True,2024-06-12 21:00:00,,2024-06-12 21:00:01,even,True,18.62,2068.209999999986,8,0,24,6
2024-06-12 21:00:00,69779.234,69783.938,68792.469,69162.141,5417,36421,0,2024-06-12 21:00:00,2024-06-12 21:00:00,116.51051190473663,542.2990656613256,69585.73799999998,0.0011208671393441493,0.001574276370040257,69877.17991666663,66661.5724840333,68460.89412895056,69517.70289160722,69241.49900145992,69541.89800584795,208.68257505194924,242.4609819030074,510.60702308644295,-103.32920295836811,-5.267672170593869,-10.127861713190214,70231.21748701464,68851.07852468126,50.7807440239819,52.52041126915574,True,False,69662.141,68762.141,69262.141,69312.141,,False,,,2024-06-12 21:49:01,fail,False,-74.5,1993.709999999986,0,1,24,6
2024-06-13 19:00:00,66442.328,66840.734,66232.938,66686.078,3254,36421,0,2024-06-13 19:00:00,2024-06-13 19:00:00,-370.8487619047519,-253.4383493433852,67037.03514285719,-0.0009346330498180485,-0.0009763184856057949,67180.57990476192,67003.48098808118,69509.92342456251,67103.10492103393,67349.67890632858,66850.61195046437,-104.18289594007365,-53.55032396394299,436.00162579971305,-118.68238630887936,-180.7255445477349,-180.77707911928883,67439.21414529398,66260.50975563476,10.545919109078275,6.968479260855953,False,True,66186.078,66586.078,66586.078,66536.078,2024-06-13 23:45:00,True,2024-06-13 23:45:00,2024-06-14 19:08:07,2024-06-13 23:50:16,even,True,18.62,2012.3299999999858,1,0,24,6
2024-06-13 20:00:00,66965.539,67062.336,66817.875,66927.93,2134,36421,0,2024-06-13 20:00:00,2024-06-13 20:00:00,-143.5447619047336,-275.02324580399727,66886.63371428566,-0.0011099583478070133,-0.0009763775235997769,67037.03514285719,66892.33866481367,69442.09714953788,66969.15921084197,67208.2665158778,66606.63672583424,-118.4939164188836,-92.38985335959575,501.7045628742838,-21.067671826531296,-16.060089439270087,-89.10472101827327,67283.93788571452,65927.83556595395,32.225875572536744,26.83198901452695,False,True,66427.93,66827.93,66827.93,66777.93,2024-06-13 20:30:00,True,2024-06-13 20:30:00,2024-06-14 18:51:11,2024-06-13 20:39:50,even,True,18.62,2030.9499999999857,2,0,24,6
2024-06-13 22:00:00,66850.094,66876.734,66695.867,66700.703,1001,36421,0,2024-06-13 22:00:00,2024-06-13 22:00:00,-82.57032142850221,-309.4459078840009,66685.70660714278,-0.0006879400179646611,-0.000976385084559459,66804.06339285716,66915.64030290254,69306.81930624024,66860.20401633537,67032.94237005993,66772.08324423798,-106.84324601244589,-107.35768083453344,445.1719929410339,22.3735631233576,20.497807361651212,20.279371860990068,67374.56543470838,66171.10105376758,62.05276538626814,57.5897929285318,False,True,66200.703,66600.703,66600.703,66550.703,2024-06-13 23:45:00,True,2024-06-13 23:45:00,2024-06-14 19:08:05,2024-06-13 23:50:41,even,True,18.62,2049.5699999999856,3,0,24,6
2024-06-13 23:00:00,66604.836,66801.391,66553.898,66642.039,1104,36421,0,2024-06-13 23:00:00,2024-06-13 23:00:00,-118.35678571437893,-337.84323957898596,66664.82428571426,-0.0006880750703748418,-0.0009764303153274353,66685.70660714278,66869.60849567832,69239.28936694484,66772.04723578188,66941.02700258103,66780.37836876506,-106.11840268799278,-106.04683920179116,278.68572216782695,-38.22554454760393,-17.237431028624997,21.318982800192316,67156.60409369163,66402.65264383849,19.21586581421884,36.32071410503412,False,True,66142.039,67042.039,66542.039,66492.039,,False,2024-06-14 19:00:00,2024-06-14 19:08:08,2024-06-14 08:37:42,fail,False,-74.5,1975.0699999999856,0,1,24,6
2024-06-14 00:00:00,66697.234,66785.539,66660.242,66719.555,835,56421,0,2024-06-14 00:00:00,2024-06-14 00:00:00,-20.88232142852212,-348.69591552713246,66768.27405952383,-0.0006879454563381064,-0.0009712873477863592,66664.82428571426,66823.57527558395,69168.39746155498,66718.38423497365,66866.07833807179,66637.00797660828,-98.8490480898763,-104.09637467378448,175.69549471607687,-18.084683866400155,-24.306448572519002,-55.012042655594996,66874.19689447498,66398.31905874157,31.366696810020162,23.545059799768836,False,True,66219.555,67119.555,66619.555,66569.555,,False,2024-06-14 19:00:00,2024-06-14 19:08:05,2024-06-14 08:37:44,fail,False,-74.5,1900.5699999999856,0,2,24,6
2024-06-14 20:00:00,65267.766,65411.738,65036.852,65391.84,2661,36422,0,2024-06-14 20:00:00,2024-06-14 20:00:00,-517.9291547618777,-250.75062334573886,65861.22088095243,-0.0007293355845956838,-0.0007220317905787006,66264.38654761907,65892.3125038182,68026.77626604943,66001.71093718467,66415.861248175,65581.27877708977,-171.43261156244262,-89.41845588119702,664.0203811160314,-180.11772583425045,-219.99771585824783,-251.19962229102384,66477.70629159642,64683.35126258313,8.167415509964409,6.523874243196958,False,True,64891.84,65291.84,65291.84,65241.84,2024-06-14 21:15:00,True,2024-06-14 21:15:00,2024-06-18 04:43:56,2024-06-14 21:32:34,even,True,18.62,1919.1899999999855,1,0,24,6
2024-06-14 21:00:00,65379.172,65409.137,65098.031,65115.738,2244,36422,0,2024-06-14 21:00:00,2024-06-14 21:00:00,-403.1656666666386,-331.4994229377189,65579.15219047619,-0.0007292079238342929,-0.0005499167234085108,65861.22088095243,65844.11723306484,67826.82645717684,65682.04593863383,66136.25271878978,65134.60544134845,-214.16665425378596,-154.62388642444944,789.4430813807572,-117.24264774680341,-84.01372549022199,-112.73333195733721,66200.35360121247,64067.35728148443,14.643010984723594,18.707629136691207,False,True,64615.738,65515.738,65015.738,64965.738,,False,2024-06-18 04:45:00,2024-06-18 04:44:08,2024-06-14 22:29:50,fail,False,-74.5,1844.6899999999855,0,1,24,6
2024-06-14 22:00:00,65492.438,65502.137,65311.047,65322.238,1638,36422,0,2024-06-14 22:00:00,2024-06-14 22:00:00,-282.0686904762406,-381.9512354620674,65403.20135714279,-0.0007292661216935243,-0.00023638489802455,65579.15219047619,65796.02423588115,67537.47916150672,65533.230473286574,65934.35117818395,65028.89346164431,-216.20092446399212,-191.95935413076447,793.6792028337514,-8.012315789404965,-7.92055968358909,-16.4025417956218,66100.36038546987,63955.92653781874,19.94691989364507,16.2089219473332,False,True,64822.238,65722.238,65222.238,65172.238,,False,2024-06-17 17:00:00,2024-06-18 04:43:56,2024-06-14 23:24:51,fail,False,-74.5,1770.1899999999855,0,2,24,6
2024-06-14 23:00:00,65505.137,65626.734,65443.438,65611.336,1227,36421,0,2024-06-14 23:00:00,2024-06-14 23:00:00,-175.95083333340153,-416.78326823229145,65400.6798095238,-0.0007292393460325429,-0.00011530914917997599,65403.20135714279,65747.90409243012,67432.36811580947,65539.99420032173,65831.58650170782,65384.48366322668,-184.9284913459269,-193.69668809272264,662.983026830429,114.39240006883483,96.39051117983036,57.85097248029342,66281.01074944776,64489.4565770056,64.78763276298751,49.877960414568726,False,True,65111.335999999996,66011.336,65511.335999999996,65461.335999999996,,False,2024-06-17 16:45:00,2024-06-17 17:01:25,2024-06-17 00:00:02,fail,False,-74.5,1695.6899999999855,0,3,24,6
2024-06-20 14:00:00,66166.156,66409.836,66061.875,66369.539,2096,36421,0,2024-06-20 14:00:00,2024-06-20 14:00:00,197.65283333336993,183.25494450511178,66001.31794047623,-0.000274547221747321,0.0004555444080983727,65877.46577380957,59888.29727656239,65909.22358502468,65827.37943020933,65642.31754506973,65895.40823116615,100.42568811085948,83.40611026695714,242.43482011533965,106.62922119018913,83.00170485043782,8.648950120303198,66224.19523832186,65568.12122401044,77.20541044664678,63.20388104379893,True,False,66869.539,65969.539,66469.539,66519.539,,False,,,2024-06-20 15:16:06,fail,False,-74.5,1621.1899999999855,0,4,25,6
2024-06-20 15:00:00,66137.336,66267.836,66013.25,66060.227,1800,36421,0,2024-06-20 15:00:00,2024-06-20 15:00:00,123.85216666666383,219.85294635187165,66020.17641666663,0.0009479864865741728,0.00045554954990184425,66001.31794047623,59659.640214695144,65939.16738698751,65992.06750700937,65783.7390207471,66129.17014241486,116.23594134408631,102.75362650897354,275.410101551515,38.00764155485376,55.208438940535416,48.36030374949041,66502.47377950941,65757.36650532031,64.05569927641255,75.61877205548079,True,False,66560.227,65660.227,66160.227,66210.227,,False,,,2024-06-20 16:16:25,fail,False,-74.5,1546.6899999999855,0,5,25,6
2024-06-21 07:00:00,64459.039,64529.738,64281.84,64502.738,2029,36422,0,2024-06-21 07:00:00,2024-06-21 07:00:00,-137.61926190477243,-150.95558713523496,64638.76835714284,-0.0002568414210453853,-0.0008439159490565052,64679.71527380952,64568.976849827544,66500.543626361,64703.65434178496,64799.52602585111,64671.20283178533,-51.13184238491522,-40.74663117015656,145.32752685795396,-42.07242449258774,-55.98473237017606,-11.436025799826893,64867.39499304357,64473.510670527095,26.085300002279556,29.264038119287232,False,True,64002.738,64402.738,64402.738,64352.738,2024-06-21 11:00:00,True,2024-06-21 11:00:00,2024-06-21 11:49:47,2024-06-21 23:19:59,success,True,93.11,1639.7999999999854,1,0,25,6
2024-06-21 11:00:00,64161.238,64327.938,64131.84,64253.938,1844,36422,0,2024-06-21 11:00:00,2024-06-21 11:00:00,-160.29100000001927,-208.63420478067565,64110.59740476191,-0.0008425489611058899,-0.0013419783194073814,64425.63247619045,64433.54279404492,66175.37618590698,64494.41858019118,64599.243890344456,64480.669220846234,-58.552705345537106,-49.603752029475594,163.80138249094776,-44.49240729276062,-67.26619848635892,-4.674175094543898,64701.801087209016,64258.03735448345,14.461550065411581,39.987665813570764,False,True,63753.938,64653.938,64153.938,64103.938,,False,2024-06-21 12:00:00,2024-06-21 11:49:48,,success,True,93.11,1732.9099999999853,2,0,25,6
2024-06-21 12:00:00,63594.398,63766.539,63510.281,63647.922,2743,36422,0,2024-06-21 12:00:00,2024-06-21 12:00:00,-315.0350714285378,-280.0054998487176,64042.851559523806,-0.0008707465026930749,-0.0013418741479488392,64110.59740476191,64410.001165562564,66086.76230697408,64186.39118240186,64410.58330203692,64044.68291709661,-106.72873869432078,-71.8549595443298,302.3515951813899,-136.81251221193088,-165.86073168210714,-62.86925249404885,64452.857570591485,63635.00826360173,14.51956135556675,15.153625331315167,False,True,63147.922,64047.922,63547.922,63497.922,,False,2024-06-21 18:45:00,2024-06-24 02:57:18,2024-06-21 12:37:25,fail,False,-74.5,1658.4099999999853,0,1,25,6
2024-06-21 14:00:00,63841.012,64016.637,63825.34,63947.738,1438,36422,0,2024-06-21 14:00:00,2024-06-21 14:00:00,-112.75977380949917,-320.9158271348351,63786.37654761906,-0.0009889374469586056,-0.0013418353280868697,63930.09178571431,64411.96705169565,65909.98547001855,63999.7574142855,64193.63499627355,63769.443364981096,-112.7696681292,-106.2733065320076,349.22588885582394,2.670251118048327,-25.670389748876914,-13.186145166881033,64242.39831493646,63297.988415025735,38.491160625761104,36.52104174277218,False,True,63447.738,63847.738,63847.738,63797.738,2024-06-21 14:45:00,True,2024-06-21 14:45:00,2024-06-21 16:33:09,2024-06-21 15:02:13,even,True,18.62,1677.0299999999852,1,0,25,6
2024-06-21 15:00:00,63722.992,63892.438,63518.266,63559.039,1986,36422,0,2024-06-21 15:00:00,2024-06-21 15:00:00,-143.7152380952466,-347.4482832375361,63732.88127380958,-0.000988923269596314,-0.0013419067426998026,63786.37654761906,64348.45302308677,65821.74274305809,63856.03184001098,64067.3391812889,63736.064955624315,-122.28725348312582,-112.62047701758794,367.98379709812457,-27.723002751998138,4.721238390106009,-22.060051943619328,64232.843081706786,63237.786829541845,23.19261777862528,34.25421553057377,False,True,63059.039,63959.039,63459.039,63409.039,,False,2024-06-24 02:45:00,2024-06-24 03:05:17,2024-06-21 17:16:03,fail,False,-74.5,1602.5299999999852,0,1,25,6
2024-06-21 16:00:00,63788.039,63822.039,63615.91,63699.738,1584,36422,0,2024-06-21 16:00:00,2024-06-21 16:00:00,-53.49527380947984,-359.08736100190436,63656.74986904764,-0.000988944346047654,-0.001341898292384968,63732.88127380958,64284.97622339452,65733.5498414956,63789.40746695147,63974.93207213779,63736.500586515285,-116.20732158492319,-116.31779415641176,312.43285615258833,7.0560361197640304,17.58706432741019,-8.126935672516993,64159.78494232128,63314.71623070929,30.931731215122497,28.05922479297435,False,True,63199.738,64099.738,63599.738,63549.738,,False,2024-06-21 18:45:00,2024-06-24 02:36:52,2024-06-21 17:31:43,fail,False,-74.5,1528.0299999999852,0,2,25,6
2024-06-21 17:00:00,63575.938,63780.738,63408.988,63780.738,2186,36422,0,2024-06-21 17:00:00,2024-06-21 17:00:00,-76.13140476193803,-381.0338708058698,63837.995238095275,-0.0009889654048890917,-0.0012090597656326991,63656.74986904764,64221.363971662504,65723.90345126961,63738.964950024034,63897.22071525686,63634.115050223576,-106.7617789191936,-113.41437860161685,203.95070395155244,22.95376539393328,-41.47398417619843,-24.250947712418565,63910.948500558174,63358.78159988898,53.14060077498997,42.0530693801329,False,True,63280.738,64180.738,63680.738,63630.738,,False,2024-06-21 18:45:00,2024-06-24 02:36:49,2024-06-21 17:33:06,fail,False,-74.5,1453.5299999999852,0,3,25,6
2024-06-21 18:00:00,64174.34,64296.738,64114.629,64138.438,1988,36422,0,2024-06-21 18:00:00,2024-06-21 18:00:00,181.24536904763227,-346.1503913553461,63824.38505952381,-0.0009888346932310024,-0.0011760416949625073,63837.995238095275,64157.94899645274,65666.34269406101,63914.68948857889,63949.17163232646,63918.601790849614,-56.594262746570166,-89.01766710161132,180.2245405684252,75.0452614378737,81.1060110078979,65.85849019607849,64163.40492061699,63675.29866108224,83.39374969579869,81.8994547727329,False,True,63638.438,64038.438,64038.438,63988.438,2024-06-21 18:30:00,True,2024-06-21 18:30:00,2024-06-21 18:35:29,2024-06-21 21:45:07,success,True,93.11,1546.639999999985,1,0,25,6
2024-06-21 19:00:00,63698.738,63804.039,63542.738,63617.738,1912,36422,0,2024-06-21 19:00:00,2024-06-21 19:00:00,-13.61017857146362,-352.8150568416313,63732.398738095224,-0.000988888799034998,-0.001176099729821973,63824.38505952381,64094.391754956545,65589.71297737668,63787.22557453463,63872.107568075335,63839.65763811491,-66.25773837300221,-73.52622805303693,183.8600542632275,-37.324681114529085,-2.6195249398078886,-54.846870313012914,64087.86871137027,63589.94656485956,25.15695830688355,36.223360395387736,False,True,63117.738,64017.738,63517.738,63467.738,,False,2024-06-24 02:45:00,2024-06-24 03:04:37,2024-06-21 21:35:13,fail,False,-74.5,1472.139999999985,0,1,25,6
2024-06-21 20:00:00,63618.98,63859.738,63512.938,63735.438,1455,36422,0,2024-06-21 20:00:00,2024-06-21 20:00:00,-91.98632142858696,-359.9589963896724,63708.36936904763,-0.0009898416969272184,-0.001118719807447025,63732.398738095224,64031.11257581714,65452.62759863473,63738.340872194996,63822.64316723291,63736.20691572062,-62.914266979343665,-68.35762571381964,182.73862036379492,-15.721653938795498,-34.2269480564355,-30.09901547991467,63982.90405321174,63488.0097782295,35.31098387649299,33.7038943948074,False,True,63235.438,63635.438,63635.438,63585.438,2024-06-21 20:30:00,True,2024-06-21 20:30:00,2024-06-24 02:36:50,2024-06-21 20:43:06,even,True,18.62,1490.759999999985,1,0,25,6
2024-06-21 21:00:00,63631.84,63791.637,63611.84,63761.738,1525,36422,0,2024-06-21 21:00:00,2024-06-21 21:00:00,-24.029369047595537,-360.7120430852592,63845.65027380949,-0.0009898923828780127,-0.0009571476047741044,63708.36936904763,63967.60357189877,65261.6326572574,63705.09034199806,63780.561253475666,63636.69568283452,-57.56872426956397,-64.22075226760512,180.44866145370744,-0.5102136222049012,-38.81384107335907,-21.0660443756351,63880.301375797026,63391.589989872016,31.72739353499814,28.423538991727572,False,True,63261.738,64161.738,63661.738,63611.738,,False,2024-06-24 02:30:00,2024-06-24 02:36:50,2024-06-21 22:00:09,fail,False,-74.5,1416.259999999985,0,1,25,6
2024-06-24 02:00:00,63612.938,63654.738,63555.766,63637.938,746,36422,0,2024-06-24 02:00:00,2024-06-24 02:00:00,-68.72141666668176,-253.51954040623968,63661.69880952383,-0.0008663943134144551,-0.0005260146471063175,63910.228333333325,63629.100781087225,64928.84931438626,63756.037888098785,63822.88865400216,63634.61197282415,-28.420403514261125,-13.399663907212037,226.2655538314679,-43.465546955631,-60.60920364638878,-70.22285689722048,63940.07047049663,63327.65347515167,16.74087679559683,17.93362436317336,False,True,63137.938,63537.938,63537.938,63487.938,2024-06-24 02:45:00,True,2024-06-24 02:45:00,2024-06-24 02:57:18,,success,True,93.11,1509.3699999999849,1,0,26,6
2024-06-24 03:00:00,63175.563,63269.137,62881.84,63065.238,2415,36422,0,2024-06-24 03:00:00,2024-06-24 03:00:00,-248.52952380949864,-294.5042785625119,63387.29852380947,-0.0007754018733535907,-0.0005259938639486185,63661.69880952383,63562.93426084298,64894.88296251819,63504.18369117519,63672.54111402319,63276.15672411426,-71.92314433187858,-38.59503633091382,319.86017514711386,-104.84237358098471,-107.83273443406506,-92.63186996903823,63707.96796056286,62842.84548766566,10.245088998864523,9.037311626508961,False,True,62565.238,62965.238,62965.238,62915.238,2024-06-24 06:00:00,True,2024-06-24 06:00:00,2024-06-24 08:21:57,2024-06-24 06:15:34,even,True,18.62,1527.9899999999848,2,0,26,6
2024-06-24 04:00:00,63035.516,63113.039,62963.434,63015.539,1278,36422,0,2024-06-24 04:00:00,2024-06-24 04:00:00,-274.40028571435687,-334.3388366215586,63227.33092857144,-0.0006935113421947908,-0.000526008314965502,63387.29852380947,63508.722580563575,64860.7624841392,63295.1335976505,63515.335738472015,63061.00065049876,-103.08810635804548,-71.51676867866038,401.0035865498918,-49.79671861031238,-51.18704059162701,-33.0542229102648,63602.355492341114,62518.14580865641,23.386996259200984,23.879269675619806,False,True,62515.539,62915.539,62915.539,62865.539,2024-06-24 06:00:00,True,2024-06-24 06:00:00,2024-06-24 08:23:07,2024-06-24 06:03:45,even,True,18.62,1546.6099999999847,3,0,26,6
2024-06-24 05:00:00,63272.438,63338.637,63171.855,63195.84,1331,36422,0,2024-06-24 05:00:00,2024-06-24 05:00:00,-159.96759523802757,-343.0237486436381,63018.00544047616,-0.0007444119701939384,-0.0005259484875082887,63227.33092857144,63464.72037531997,64826.58806919297,63254.88761427124,63434.866326423115,63045.38462882699,-98.57502335822937,-88.77684790638722,382.61674010125995,3.607947368436726,1.4462910216971068,-27.591616099096427,63563.41722796369,62528.85202969029,41.63319066673779,36.734322345708854,False,True,62695.84,63095.84,63095.84,63045.84,2024-06-24 05:45:00,True,2024-06-24 05:45:00,2024-06-24 05:55:06,,success,True,93.11,1639.7199999999846,4,0,26,6
2024-06-24 06:00:00,62848.438,62945.039,62731.84,62938.738,1522,36422,0,2024-06-24 06:00:00,2024-06-24 06:00:00,-209.3254880952809,-379.8699019527485,62886.634678571434,-0.0007444536178223763,-0.0005260289241174839,63018.00544047616,63417.408225779785,64792.71595042339,63120.0866553883,63316.28580946337,62967.67687237703,-109.40434541354625,-98.19764826085147,296.9971069099574,-16.05499999998574,-45.02590540080564,-23.3079790161064,63368.62296670547,62565.230778048586,29.792718554077698,30.51048469418353,False,True,62438.738,62838.738,62838.738,62788.738,2024-06-24 07:15:00,True,2024-06-24 07:15:00,2024-06-24 08:36:34,2024-06-24 07:32:54,even,True,18.62,1658.3399999999845,5,0,26,6
2024-06-24 07:00:00,62814.84,62844.34,62607.84,62645.637,1294,36422,0,2024-06-24 07:00:00,2024-06-24 07:00:00,-131.37076190472726,-406.4032710473184,62824.63698809528,-0.0007444526251380166,-0.0005260643377334101,62886.634678571434,63370.307948368354,64758.7370982818,62961.73387323764,63181.00525686507,62870.24042036456,-122.71183906363149,-109.21628316606132,293.7514631074168,-56.67764671486657,-18.577418300650606,-14.887821465541492,63266.804895559566,62472.17594516955,21.27407357585641,31.97052992814868,False,True,62145.637,62545.637,62545.637,62495.637,2024-06-24 08:45:00,True,2024-06-24 08:45:00,2024-06-24 09:09:34,2024-06-24 10:49:01,success,True,93.1,1751.4399999999844,6,0,26,6
2024-06-24 08:00:00,62796.477,62847.938,62660.098,62695.438,1280,36422,0,2024-06-24 08:00:00,2024-06-24 08:00:00,-61.997690476157004,-424.0512465938082,62615.635345238115,-0.0009403143229629436,-0.0005260703967115236,62824.63698809528,63285.763786325915,64724.71777352659,62863.921546937156,63070.12268129655,62732.60260681115,-122.85647740784043,-117.45201950259127,247.27184007912064,-33.02914138282358,-30.514808393549174,-24.598974888205703,63066.41959091797,62397.28562270434,24.02874304811533,21.87421556343446,False,True,62195.438,62595.438,62595.438,62545.438,2024-06-24 08:45:00,True,2024-06-24 08:45:00,2024-06-24 09:04:57,2024-06-24 11:22:45,success,True,93.1,1844.5399999999843,7,0,26,6
2024-06-24 09:00:00,62271.777,62356.039,62106.695,62254.137,2199,36422,0,2024-06-24 09:00:00,2024-06-24 09:00:00,-209.00164285716164,-474.9267345963963,62501.31855952384,-0.0009843988733111533,-0.0005260910703357088,62615.635345238115,63215.14644349719,64690.93347253807,62599.84967405577,62874.563743996914,62387.590908496684,-152.34348076694732,-132.4308055772067,299.74873231827934,-77.36666288270499,-86.01160440321837,-121.2366594426785,62792.25169712636,61981.43011986701,7.391175834944043,8.308833572632873,False,True,61754.137,62654.137,62154.137,62104.137,,False,2024-06-24 12:45:00,2024-06-24 12:30:39,2024-06-24 11:23:50,fail,False,-74.5,1770.0399999999843,0,1,26,6
2024-06-24 10:00:00,62367.738,62382.438,62186.238,62253.656,1151,36422,0,2024-06-24 10:00:00,2024-06-24 10:00:00,-114.3167857142762,-502.2345757996154,62414.771297619045,-0.0009842842312719846,-0.0006297669769010964,62501.31855952384,63152.95165474657,64703.46900531857,62455.75873932462,62723.628191078205,62253.8301737186,-156.88006628720177,-146.67975904201415,345.00498327499184,-35.879359133126854,-14.007472652177967,-33.493220502263284,62719.58690113984,61786.573446297356,24.067273897813653,22.313539103825878,False,True,61753.656,62653.656,62153.656,62103.656,,False,2024-06-24 12:45:00,2024-06-24 12:30:39,2024-06-24 11:23:50,fail,False,-74.5,1695.5399999999843,0,2,26,6
2024-06-24 11:00:00,62415.438,62524.539,62284.098,62343.039,1227,36422,0,2024-06-24 11:00:00,2024-06-24 11:00:00,-86.54726190479414,-514.09295194687,62445.99760714284,-0.0009843849831780768,-0.0007211625881870436,62414.771297619045,63090.63918465013,64697.66062785065,62422.420508681476,62634.32928211019,62256.53474716199,-139.3022883188969,-145.7191384626498,310.1963244082033,-0.38035397319617914,14.762440316531865,28.236174062563805,62675.299785113064,61836.269709210916,39.88184589144222,35.26817779088935,False,True,61843.039,62743.039,62243.039,62193.039,,False,2024-06-24 12:30:00,2024-06-24 12:30:37,2024-06-24 11:31:13,fail,False,-74.5,1621.0399999999843,0,3,26,6
2024-06-24 12:00:00,62693.039,62831.738,62416.637,62454.039,1847,36422,0,2024-06-24 12:00:00,2024-06-24 12:00:00,31.226309523794043,-495.43604491754377,62084.47005952385,-0.0019271266136323669,-0.0008567361978359161,62445.99760714284,62615.44499123493,64694.513899971345,62529.650694569704,62639.13868020777,62493.41167492262,-96.80949887997122,-121.96578401574719,245.34744123546017,28.747755074029556,59.59291365665558,78.53912521502207,62826.130720590496,62162.19262925475,65.72373206214856,69.2358514282163,False,True,61954.039,62354.039,62354.039,62304.039,2024-06-24 12:30:00,True,2024-06-24 12:30:00,2024-06-24 12:30:35,2024-06-25 22:03:15,success,True,93.1,1714.1399999999842,1,0,26,6
2024-06-24 13:00:00,61348.07,61531.738,61276.637,61450.637,2434,36422,0,2024-06-24 13:00:00,2024-06-24 13:00:00,-361.5275476189927,-582.1072881861037,61700.59677380952,-0.0019273173687662495,-0.0011410301091223003,62084.47005952385,62493.90685407102,64713.31606897115,62006.43917647124,62329.7504800122,61913.237759545926,-173.26443119758915,-138.67852771450657,455.4677980669332,-153.13162848295178,-158.68802201577637,-234.69973959409253,62528.119286936286,61296.856232155566,32.45867051795424,27.21494885977641,False,True,60950.637,61350.637,61350.637,61300.637,2024-06-24 13:45:00,True,2024-06-24 13:45:00,2024-06-24 14:15:24,2024-06-24 15:15:06,success,True,93.1,1807.239999999984,2,0,26,6
2024-06-24 14:00:00,61124.238,61253.738,60982.844,61033.637,1457,36422,0,2024-06-24 14:00:00,2024-06-24 14:00:00,-383.8732857143259,-661.5346920211741,61453.98755952379,-0.0019273187648467206,-0.001443766045174346,61700.59677380952,62374.14850314066,64698.00816881364,61581.39763666242,62015.409999410585,61238.555007911935,-227.15700278150325,-181.92158640580962,587.5876355515625,-161.32397488816787,-166.37003130379162,-182.43098933601868,62031.79831590654,60443.81169991733,25.185684164541556,29.12949111984287,False,True,60533.637,60933.637,60933.637,60883.637,2024-06-24 14:30:00,True,2024-06-24 14:30:00,2024-06-24 19:38:44,2024-06-24 14:31:28,even,True,18.62,1825.859999999984,3,0,26,6
2024-06-24 15:00:00,61233.918,61349.637,61162.539,61346.438,1567,36422,0,2024-06-24 15:00:00,2024-06-24 15:00:00,-246.60921428573056,-707.0595503874429,61278.08323809524,-0.0019271877166700607,-0.0017052630703185074,61453.98755952379,62253.381866265205,64637.82744787659,61381.95392942734,61787.36871398285,60883.98046061229,-232.8868407346672,-215.25920560109128,650.6660770842519,-7.3966969384782715,-67.96677640170674,-107.71269246651354,61762.37966467603,60004.081256548554,30.839812113332105,25.342068451267068,False,True,60846.438,61246.438,61246.438,61196.438,2024-06-24 15:45:00,True,2024-06-24 15:45:00,2024-06-24 18:50:52,2024-06-24 16:30:38,even,True,18.62,1844.4799999999839,4,0,26,6
2024-06-24 16:00:00,61168.902,61168.902,60981.984,60994.238,1671,36422,0,2024-06-24 16:00:00,2024-06-24 16:00:00,-175.90432142854843,-739.655270755451,61239.727809523836,-0.0019272328141240246,-0.001911413369558179,61278.08323809524,62133.92015581951,64540.38221657694,61255.343533025654,61613.49077914114,60899.87538183696,-221.7124719186977,-220.17302839755698,668.2384987479162,30.859837289346615,30.558171654607577,-35.988050911597384,61803.49735514665,59997.75340852727,33.44823111945992,34.25864429740492,False,True,60494.238,61394.238,60894.238,60844.238,,False,2024-06-24 19:00:00,2024-06-24 19:38:44,2024-06-24 16:33:43,fail,False,-74.5,1769.9799999999839,0,1,26,6
2024-06-24 17:00:00,61519.297,61657.738,61366.188,61396.078,2776,36422,0,2024-06-24 17:00:00,2024-06-24 17:00:00,-38.355428571405355,-729.067003000986,61170.756059523876,-0.0020360853377345903,-0.0019217790178885918,61239.727809523836,62101.6548852846,64417.0030099395,61311.07258446934,61546.73178471366,61249.74741589264,-176.34876061558316,-203.55436154204295,600.6652235205864,21.760998624027707,135.29541898857133,102.88789680088667,62062.14546764543,60438.84936413985,75.51934758933311,65.73445615233541,False,True,60896.078,61296.078,61296.078,61246.078,2024-06-24 17:30:00,True,2024-06-24 17:30:00,2024-06-24 18:49:42,2024-06-24 17:30:34,even,True,18.62,1788.5999999999838,1,0,26,6
2024-06-24 19:00:00,60795.352,60902.738,60610.438,60866.84,2669,36422,0,2024-06-24 19:00:00,2024-06-24 19:00:00,-147.4487142857397,-764.9904178184006,60785.006142857135,-0.0023056923394274547,-0.0019204268092978098,61023.307345238136,62035.2525902724,64170.8614564038,61116.099495094066,61329.16354320662,61072.69459201929,-151.53236593865586,-161.40288355250408,176.33016092193805,-69.14494736836787,-106.22252562782523,-30.979625730979024,61310.74030926391,60833.14887477467,23.45953306954975,29.806719360295517,False,True,60366.84,61266.84,60766.84,60716.84,,False,2024-06-24 19:45:00,2024-06-24 19:39:29,2024-06-25 06:21:27,success,True,93.11,1881.7099999999837,2,0,26,6
2024-06-24 20:00:00,60111.832,60447.637,59790.137,60159.539,3746,36422,0,2024-06-24 20:00:00,2024-06-24 20:00:00,-238.30120238100062,-835.0197467107428,60537.3164404762,-0.002305487129700689,-0.0019203178352975446,60785.006142857135,61892.63948865679,64048.652948554954,60745.32220796443,61077.826403004445,60572.47352046783,-193.0788557104097,-170.0409662789468,346.49269006434173,-162.65863467490271,-168.73359236329998,-105.53147058819013,61040.23865205469,60103.208388880965,15.424033564751554,17.045930805625744,False,True,59659.539,60059.539,60059.539,60009.539,2024-06-24 20:30:00,True,2024-06-24 20:30:00,2024-06-24 22:49:27,2024-06-24 20:32:00,even,True,18.62,1900.3299999999836,3,0,26,6
2024-06-24 21:00:00,60214.34,60262.539,59888.84,59928.84,2651,36422,0,2024-06-24 21:00:00,2024-06-24 21:00:00,-247.68970238093607,-873.3420557094578,60376.75283333334,-0.0023152285457699266,-0.0019204041588585545,60537.3164404762,61755.785259924494,63925.95284318419,60417.9388170865,60812.24257182568,60041.28774613002,-224.05006527504156,-197.59351082455237,498.23511549257404,-127.62842518054094,-95.5441076711868,-125.50687134505279,60713.905152045,59367.170340215045,20.81402846298801,19.75697330181922,False,True,59428.84,60328.84,59828.84,59778.84,,False,2024-06-24 23:00:00,2024-06-24 22:55:35,2024-06-24 21:26:06,fail,False,-74.5,1825.8299999999836,0,1,26,6
2024-06-24 22:00:00,60367.59,60441.738,60157.449,60165.34,1891,36422,0,2024-06-24 22:00:00,2024-06-24 22:00:00,-160.56360714285984,-880.9857900451025,59918.55800000006,-0.002489312896322044,-0.0019204102364327798,60376.75283333334,61698.66433528981,63803.33683475293,60350.352893980016,60672.629165720005,59999.2881004472,-203.87952338891046,-204.22925933993685,512.3104115587093,-28.99897901614895,6.033035087690223,-19.798567939418717,60690.90715605146,59306.16904484294,36.922279249975226,35.244610357939884,False,True,59665.34,60065.34,60065.34,60015.34,2024-06-24 22:30:00,True,2024-06-24 22:30:00,2024-06-24 22:49:26,2024-06-24 22:36:11,even,True,18.62,1844.4499999999834,1,0,26,6
2024-06-24 23:00:00,59290.105,59615.438,59195.344,59281.84,3978,36422,0,2024-06-24 23:00:00,2024-06-24 23:00:00,-458.1948333332766,-962.8330828716571,59624.02151190483,-0.0029579771876770715,-0.00192029802424517,59918.55800000006,61377.22028655079,63682.55921029092,59958.97973231894,60382.31700329741,59677.87163811488,-242.9669718315272,-216.80234325314697,605.9599485407274,-109.98544066048635,-127.39195906431269,-53.49576917786908,60495.91756864486,58858.325707584896,15.262155947140103,18.52343711712155,False,True,58781.84,59681.84,59181.84,59131.84,,False,2024-06-24 23:30:00,2024-06-24 23:29:14,2024-06-25 00:19:32,success,True,93.11,1937.5599999999833,2,0,26,6
2024-06-25 00:00:00,59461.84,59610.582,59352.738,59578.238,1797,56422,0,2024-06-25 00:00:00,2024-06-25 00:00:00,-294.5364880952329,-1002.4010520905067,59677.61740476196,-0.0031309223507870426,-0.0020303535669782577,59624.02151190483,61372.62160599949,63601.45718366859,59644.48973624459,60092.084307422745,59369.41456897147,-264.02153700045164,-247.36761493516255,642.2656039559998,-3.876893704851682,-17.6850908151755,-100.22422497429943,60236.47313431207,58500.85600363087,52.81714197341341,37.20598839889979,False,True,59078.238,59978.238,59478.238,59428.238,,False,,,2024-06-25 00:52:27,fail,False,-74.5,1863.0599999999833,0,1,26,6
2024-06-25 01:00:00,60053.34,60060.039,59926.137,60028.039,851,56422,0,2024-06-25 01:00:00,2024-06-25 01:00:00,53.59589285712718,-974.9363892039619,59766.46625000001,-0.0031911769467772243,-0.0022593919844288456,59677.61740476196,61237.93375831145,63544.700862704274,59790.097483503974,60049.71105703362,59549.464607843096,-197.3981806391821,-231.0727809337302,490.5099740791234,77.6851630546953,57.61006019949855,37.11287753700162,60213.15307284991,58887.27614283628,79.1970591924234,74.02361600778015,False,True,59528.039,60428.039,59928.039,59878.039,,False,,,2024-06-25 03:19:47,fail,False,-74.5,1788.5599999999833,0,2,26,6
2024-06-25 03:00:00,60255.738,60300.539,60215.145,60221.32,1268,36422,0,2024-06-25 03:00:00,2024-06-25 03:00:00,180.11235714283248,-892.559046280403,60100.172571428564,-0.0035128921943429893,-0.0023999190059167414,59946.578607142845,61121.9759327228,63283.51130373974,60091.89340177637,60112.36362852711,60380.70610354317,-77.41724398678343,-130.36049136568718,412.47016348267476,82.77670450635196,109.33794186448358,146.7786013071891,60939.04082424478,59823.87138284156,92.0815340828653,94.85760121325909,False,True,59721.32,60621.32,60121.32,60071.32,,False,,,2024-06-25 05:32:39,fail,False,-74.5,1714.0599999999833,0,3,26,6
2024-06-25 04:00:00,60374.938,60470.137,60293.137,60413.738,1411,36422,0,2024-06-25 04:00:00,2024-06-25 04:00:00,153.59396428571927,-831.6738404804928,60279.76319047617,-0.003512650601506217,-0.0023940605665967785,60100.172571428564,60907.38143414931,63131.44725368064,60226.7878170725,60179.432082397485,60439.734235294105,-32.053663086400775,-80.10975444498057,425.9289584072904,-5.726978328180849,-15.856199174377252,32.22804127962445,61014.73832914395,59863.23014144426,78.6760509685487,83.22310776117432,False,True,59913.738,60813.738,60313.738,60263.738,,False,2024-06-28 23:00:00,,2024-06-25 06:04:38,fail,False,-74.5,1639.5599999999833,0,4,26,6
2024-06-25 05:00:00,60452.039,60600.34,60414.855,60414.938,1632,36422,0,2024-06-25 05:00:00,2024-06-25 05:00:00,179.59061904760893,-767.8330229394705,60525.39544047618,-0.0035126306541767923,-0.0020475374275217622,60279.76319047617,60693.333811402204,62958.20142551361,60302.71310086336,60231.84825652239,60425.10915411082,-5.065551825289731,-40.9587401973665,433.0049886299329,5.053533195794444,12.813403852771444,-12.676892328832764,61011.16588876123,59840.55241946041,68.2390574082788,64.28934922274867,False,True,59914.938,60814.938,60314.938,60264.938,,False,2024-06-28 23:00:00,,2024-06-25 06:04:38,fail,False,-74.5,1565.0599999999833,0,5,26,6
2024-06-25 22:00:00,62109.844,62377.137,61861.953,61877.773,1956,36422,0,2024-06-25 22:00:00,2024-06-25 22:00:00,248.51895238090947,84.79648410694062,61836.53785714282,0.002204935678755805,0.00039975646088894883,61710.463226190455,58838.95530271155,61930.477762137096,61731.72408292558,61577.17679938442,61768.55043274857,89.46795540482708,79.66179747368321,300.8773866119641,59.39456725152559,121.47395080839487,38.40447058823338,62176.23490467472,61362.36596082242,84.058321731103,84.13395061377553,True,False,62377.773,61977.773,61977.773,62027.773,2024-06-26 01:15:00,True,2024-06-26 01:15:00,2024-06-26 05:17:00,2024-06-26 01:41:35,even,True,18.62,1583.6799999999832,1,0,26,6
2024-06-26 01:00:00,61877.277,62059.637,61877.277,62028.039,554,56422,0,2024-06-26 01:00:00,2024-06-26 01:00:00,1.7682738095027162,163.20591639901977,61906.07596428572,0.0022051029014302508,0.0008417219954891564,61870.65011904759,59229.628831221125,61601.47781832097,61880.440420437546,61771.6276395521,61971.5495730994,75.38548008909856,80.45006330895396,229.8848355151928,13.830520811854512,-0.7258864810501109,0.6931479189661331,62283.39410104491,61661.20504515389,38.92326925624486,46.25477331827468,True,False,62528.039,61628.039,62128.039,62178.039,,False,2024-06-26 05:15:00,,2024-06-26 02:21:39,fail,False,-74.5,1509.1799999999832,0,1,26,6
2024-06-26 02:00:00,61863.566,61904.84,61681.84,61687.438,616,36422,0,2024-06-26 02:00:00,2024-06-26 02:00:00,35.42584523813275,173.54805957106873,61904.94152380951,0.002123005167781318,0.0008417146473552717,61906.07596428572,59315.990357644594,61653.16736754775,61876.092245636566,61802.05152501977,61875.34468386649,61.37562389039522,74.344697963921,204.07269545463933,-38.41470588239463,-10.853237702001934,-47.06401444791118,62150.84282273025,61598.34654500273,26.41265324565883,40.42828922914925,True,False,62187.438,61787.438,61787.438,61837.438,2024-06-26 04:15:00,True,2024-06-26 04:15:00,2024-06-26 05:09:20,2024-06-26 07:08:13,success,True,93.11,1602.2899999999831,1,0,26,6
2024-06-26 03:00:00,61758.461,61799.84,61681.84,61701.84,1149,36422,0,2024-06-26 03:00:00,2024-06-26 03:00:00,-1.134440476213058,171.40929357115238,61831.280095238086,0.0020281443988078105,0.0008418457455171026,61904.94152380951,59385.46499340204,61705.02027710762,61792.93324457704,61775.971131415994,61760.483491915984,34.528479699431045,54.858290420583174,168.35994276291504,-32.1010237358787,-17.141630202946544,-39.17087719307165,61987.76941464592,61531.69756918605,18.13347715786705,13.684472002873571,True,False,62201.84,61801.84,61801.84,61851.84,2024-06-26 04:15:00,True,2024-06-26 04:15:00,2024-06-26 05:09:21,2024-06-26 07:08:03,success,True,93.11,1695.399999999983,2,0,26,6
2024-06-26 04:00:00,61728.137,61874.938,61676.34,61869.637,1266,36422,0,2024-06-26 04:00:00,2024-06-26 04:00:00,-73.66142857142404,164.7170718496127,61840.895,0.0020067866480419838,0.0008418404643697501,61831.280095238086,59492.18353596256,61757.27845911954,61777.92073295237,61771.15858524535,61730.70156346746,23.222526223951718,37.17265792320602,119.42491068923749,23.55861403502786,-11.540139662894944,-38.61820777429239,61893.42519289793,61569.47793403699,28.461611007952417,23.43336408298023,True,False,62369.637,61969.637,61969.637,62019.637,2024-06-26 05:00:00,True,2024-06-26 05:00:00,2024-06-26 05:17:00,2024-06-26 05:02:22,even,True,18.62,1714.019999999983,3,0,26,6
2024-06-26 05:00:00,62047.039,62344.969,61952.863,62302.238,1757,36422,0,2024-06-26 05:00:00,2024-06-26 05:00:00,9.61490476191102,183.44291441136738,61899.167630952354,0.0013678314641376646,0.0008417975257580138,61840.895,60255.33294499377,61809.52656778597,61929.94525251762,61852.10851688044,61914.13798004817,44.98248860871536,36.13921461075881,155.9872719296911,89.56854798763379,41.72709184728592,21.09238321294106,62126.220797153255,61703.55516294309,81.71465265733731,72.80523759414594,True,False,62802.238,61902.238,62402.238,62452.238,,False,,,2024-06-26 06:20:08,fail,False,-74.5,1639.519999999983,0,1,26,6
2024-06-26 06:00:00,61988.039,62035.637,61928.84,62019.84,1065,36422,0,2024-06-26 06:00:00,2024-06-26 06:00:00,58.27263095235685,190.9662507271496,61911.867904761915,0.0009820434866602175,0.0008418085874955183,61899.167630952354,60546.69267286615,61861.23967179849,61985.12874381535,61904.031656564744,62086.132943928395,48.3701015675324,43.89296182836881,171.17086335224795,32.47113347092818,39.29242690055253,45.82231785344629,62318.71360945393,61855.05227840286,50.07888170698607,58.94418284588696,True,False,62519.84,61619.84,62119.84,62169.84,,False,2024-06-27 17:15:00,,2024-06-26 08:20:51,fail,False,-74.5,1565.019999999983,0,2,26,6
2024-06-27 02:00:00,60901.039,60947.34,60837.488,60885.176,559,36422,0,2024-06-27 02:00:00,2024-06-27 02:00:00,-19.28358333338838,-152.18958762053808,60887.93298809524,-0.00026248852100067117,-0.0006783795759692558,60914.82664285712,60905.49535558703,62319.13019173809,60914.409116482595,60991.863947508704,60933.13159133122,-56.87098128123034,-63.718721643460555,111.8900570166847,5.470134846844303,12.351362229128426,-10.444623667033738,61085.683168303745,60782.0800143587,41.904586213506946,44.57705000259202,False,True,60385.176,61285.176,60785.176,60735.176,,False,2024-06-27 09:15:00,2024-06-28 22:17:52,2024-06-27 06:23:44,fail,False,-74.5,1490.519999999983,0,3,26,6
2024-06-27 04:00:00,60959.34,61011.039,60851.621,60987.438,1078,36422,0,2024-06-27 04:00:00,2024-06-27 04:00:00,17.543857142816705,-167.201534489177,60960.39363095242,-0.000769634758549999,-0.0006783532649082111,60905.47684523806,61244.10689678906,62234.52154124431,60904.68801932365,60944.375653024836,60874.04670003431,-38.815924456772336,-50.599669969590366,84.8582934209656,8.616008599783527,0.5004664602965931,3.601027863820491,60990.10539615262,60759.488003916005,77.51257843982098,58.96199957401726,False,True,60487.438,60887.438,60887.438,60837.438,2024-06-27 09:00:00,True,2024-06-27 09:00:00,2024-06-28 22:17:51,2024-06-27 12:11:49,even,True,18.62,1509.1399999999828,1,0,26,6
2024-06-27 05:00:00,61029.039,61059.238,60823.738,60969.949,1354,36422,0,2024-06-27 05:00:00,2024-06-27 05:00:00,54.91678571436205,-159.8337500249254,60969.38270238098,-0.0007696253793585395,-0.0006784141517233152,60960.39363095242,61197.00471904901,62192.33349711114,60960.51926924539,60964.795672702756,60972.89085242523,-20.661683063284727,-35.40298737991413,93.47007901124124,13.352414516717545,28.28253044374287,34.97429342975374,61100.57545909041,60846.706245760055,78.52200038215541,83.2688414312292,False,True,60469.949,60869.949,60869.949,60819.949,2024-06-27 09:00:00,True,2024-06-27 09:00:00,2024-06-28 22:17:52,2024-06-27 10:30:42,even,True,18.62,1527.7599999999827,2,0,26,6
2024-06-27 06:00:00,61001.738,61022.34,60909.23,61015.84,910,36422,0,2024-06-27 06:00:00,2024-06-27 06:00:00,8.989071428557509,-154.41765963241778,60987.029500000004,-0.0007696298603200288,-0.0006783952703110587,60969.38270238098,61149.86070284911,62150.01323160595,60968.71638489625,60967.41184757953,61014.06354145159,-13.49502161759301,-24.152891755377297,80.83874514862329,6.942749913898297,15.887822497512389,-2.1965369797544554,61124.69584740223,60904.93123550095,60.61446534282635,57.675130924062195,False,True,60515.84,60915.84,60915.84,60865.84,2024-06-27 09:00:00,True,2024-06-27 09:00:00,2024-06-28 22:17:51,2024-06-27 12:13:45,even,True,18.62,1546.3799999999826,3,0,26,6
2024-06-27 07:00:00,61013.938,61060.238,60981.543,61060.238,740,36422,0,2024-06-27 07:00:00,2024-06-27 07:00:00,17.646797619025165,-147.84799724931509,61023.889273809524,-0.0007695761047888093,-0.0006783680422756729,60987.029500000004,61102.73075061826,62107.96036320973,61001.237916223734,60985.5400012772,61049.78428207781,-3.6098651222055196,-13.555420619254098,88.49407868892578,5.679272101879178,1.0521603027373203,2.1053003095439635,61170.75128830786,60930.31727584776,47.23140377929115,53.07924495044856,False,True,60560.238,60960.238,60960.238,60910.238,2024-06-27 09:00:00,True,2024-06-27 09:00:00,2024-06-28 22:17:51,2024-06-27 12:24:24,even,True,18.62,1564.9999999999825,4,0,26,6
2024-06-27 08:00:00,61078.84,61125.438,60981.84,60997.438,340,36422,0,2024-06-27 08:00:00,2024-06-27 08:00:00,36.85977380951954,-135.43190282095748,60961.15450000001,-0.0007818317107962031,-0.0006783476978348777,61023.889273809524,61061.86671869335,62065.884558602025,61034.32510617386,61008.93948068913,61060.19266873064,4.620458708544902,-3.208356242600022,96.59233141973525,-9.548398004772025,-3.010102511230798,6.958406604731863,61190.59231614728,60928.293021314,51.54261066461212,57.24774464114714,False,True,60497.438,60897.438,60897.438,60847.438,2024-06-27 09:00:00,True,2024-06-27 09:00:00,2024-06-28 22:17:51,2024-06-27 12:12:56,even,True,18.62,1583.6199999999824,5,0,26,6
2024-06-27 09:00:00,60770.84,60828.738,60691.637,60733.84,1191,36422,0,2024-06-27 09:00:00,2024-06-27 09:00:00,-62.73477380951226,-148.6430208292877,60877.40917857144,-0.0008219965869746009,-0.0006783894531610402,60961.15450000001,61031.41467932651,62023.97536752014,60935.91930974026,60964.426613554824,60932.236348813225,-12.764397863284103,-4.637913181719744,103.26039301571467,-43.11404403163033,-47.324932920550054,-12.058434468490304,61071.63787938444,60791.33481824201,10.599156289604446,17.528119008781367,False,True,60233.84,61133.84,60633.84,60583.84,,False,2024-06-28 22:30:00,2024-06-28 22:17:54,2024-06-27 12:50:45,fail,False,-74.5,1509.1199999999824,0,1,26,6
2024-06-27 10:00:00,60714.203,60768.637,60684.773,60712.539,1097,36422,0,2024-06-27 10:00:00,2024-06-27 10:00:00,-83.7453214285706,-161.55942358988978,60812.79436904755,-0.00078000646789623,-0.0006783662050697715,60877.40917857144,60965.85944340165,61981.890270032614,60829.198815514406,60899.12946167844,60751.67099862402,-30.946912548570253,-17.310172334967078,136.93745059037423,-46.9665060199186,-41.87618335054867,-53.669488820080005,60936.53655692102,60565.305440327014,17.77996596094896,15.870390541387701,False,True,60212.539,61112.539,60612.539,60562.539,,False,2024-06-28 22:30:00,2024-06-28 22:17:54,2024-06-27 12:46:12,fail,False,-74.5,1434.6199999999824,0,2,26,6
2024-06-27 11:00:00,60771.438,60835.039,60741.867,60821.738,909,36422,0,2024-06-27 11:00:00,2024-06-27 11:00:00,-64.61480952388956,-165.8814437175388,60793.94797619044,-0.0006654573368730629,-0.000815706334663755,60812.79436904755,60883.51922644843,61940.32593036798,60813.02805951985,60871.56357944935,60705.85489817684,-30.706958026341454,-25.574325365453824,141.37748268876283,-3.732977296145691,-8.756716546311509,-12.956507395931112,60896.71449980667,60513.49529654701,37.51787434289943,34.25188272153793,False,True,60321.738,61221.738,60721.738,60671.738,,False,2024-06-28 22:30:00,2024-06-28 22:17:52,2024-06-27 12:52:08,fail,False,-74.5,1360.1199999999824,0,3,26,6
2024-06-27 12:00:00,60843.039,60919.039,60794.438,60879.137,964,36422,0,2024-06-27 12:00:00,2024-06-27 12:00:00,-18.84639285711455,-161.40216668116773,60930.5977619047,-0.0005412887509924481,-0.0005266746229312646,60793.94797619044,60812.865818153565,61907.7421236034,60818.09291353349,60857.61965470183,60754.24279566568,-25.62180923642154,-27.33059427216951,143.55988019400712,33.925773305840266,23.617132094994304,-1.4915978671997436,60949.548633927596,60560.43695740377,61.014100992625025,49.76420184914631,False,True,60379.137,61279.137,60779.137,60729.137,,False,2024-06-28 21:30:00,2024-06-28 22:17:52,2024-06-27 12:55:57,fail,False,-74.5,1285.6199999999824,0,4,26,6
2024-06-27 17:00:00,61945.137,62329.738,61938.156,62329.738,2462,36422,0,2024-06-27 17:00:00,2024-06-27 17:00:00,289.4360714285067,21.76622657944972,61631.45957142851,-0.00013675854647087211,0.00028078238511331644,61504.65278571427,60669.518405622024,62045.77186383215,61593.67627090903,61344.92802595338,61753.47552356383,110.8679016367314,68.39507717300289,367.02919455149816,165.58260061922192,103.6520880632961,52.48944272445078,62250.46493620835,61257.98611091931,91.56732408462237,81.38127593474121,True,False,62829.738,61929.738,62429.738,62479.738,,False,2024-07-01 01:30:00,2024-07-01 01:28:10,2024-06-27 17:49:00,fail,False,-74.5,1211.1199999999824,0,5,26,6
2024-06-28 05:00:00,62053.137,62096.938,61884.469,61893.637,1559,36422,0,2024-06-28 05:00:00,2024-06-28 05:00:00,174.78278571421833,140.3243861725132,61756.74580952383,0.0007496902804294989,0.001026085299530416,61709.91438095234,60679.00491010272,61979.01890305865,61759.869307594374,61678.56359177608,61826.212149982865,34.74540309567237,17.390702444942143,167.21059785606076,37.467342965370335,69.5137633299164,68.01826934975543,62053.44645708855,61600.47784287718,72.07320158371319,70.97605456082385,True,False,62393.637,61493.637,61993.637,62043.637,,False,2024-07-01 01:15:00,2024-07-01 01:26:03,2024-06-28 07:27:10,fail,False,-74.5,1136.6199999999824,0,6,26,6
2024-06-28 22:00:00,60805.539,60826.738,60647.949,60718.133,986,36422,0,2024-06-28 22:00:00,2024-06-28 22:00:00,-75.12883333327045,-154.39321876374743,60553.01997619048,-0.000843570496453899,-0.0004992435355721693,60798.80461904768,60977.486492910095,62184.68076697311,60839.50834087373,60984.249841890676,60788.49512762294,-86.98341730159154,-84.25494571894426,249.41737504771413,-29.25234606130107,0.16220089450507658,12.266328861362126,61125.208583937354,60450.28167130853,31.373925672017958,31.378109683268644,False,True,60218.133,61118.133,60618.133,60568.133,,False,2024-06-28 22:30:00,2024-06-28 22:17:54,2024-07-01 00:00:02,success,True,93.11,1229.7299999999823,1,0,26,6
2024-06-28 23:00:00,60113.238,60252.238,60014.238,60171.844,1575,36422,0,2024-06-28 23:00:00,2024-06-28 23:00:00,-245.7846428572011,-225.36603401171305,60394.21128571427,-0.0007511740961236667,-0.0004992897089642956,60553.01997619048,60831.102486203235,62153.924813998005,60556.689134089575,60795.23314063564,60409.302146542825,-125.26343442391953,-100.98516581768634,264.3602061836336,-98.82045442035451,-118.8416666666817,-81.64468696245603,60766.18842489073,60050.91586819492,18.028933397549427,23.79805969139917,False,True,59671.844,60571.844,60071.844,60021.844,,False,,,2024-07-01 00:00:02,fail,False,-74.5,1155.2299999999823,0,1,26,6
2024-07-01 03:00:00,62754.773,62791.137,62543.953,62603.637,1348,36422,0,2024-07-01 03:00:00,2024-07-01 03:00:00,547.9268571428984,109.31769675381656,62571.526678571434,-0.0007510962743357981,0.0006130734789920471,62089.63527380953,60646.65100367207,62378.03347028351,62393.18591124699,61873.215867104984,63254.14792019262,235.23029087643954,163.70683474043938,1087.9911775306196,46.42690505673818,108.88491400070052,186.79649432407314,64724.43600985895,61785.359830526286,89.52522501323868,92.1396221155157,True,False,63103.637,62703.637,62703.637,62753.637,2024-07-01 03:45:00,True,2024-07-01 03:45:00,2024-07-01 04:06:14,2024-07-01 14:11:53,success,True,93.11,1248.3399999999822,1,0,27,7
2024-07-01 04:00:00,62910.637,63647.738,62863.137,63624.438,2589,36422,0,2024-07-01 04:00:00,2024-07-01 04:00:00,481.8914047619037,211.08021352894139,63153.8772142857,-0.0007511088153326833,0.0010085467577529029,62571.526678571434,60600.894775819776,62566.72803662121,62720.12048277607,62179.73574817502,63275.18117612658,269.5102735805049,215.70307022874812,1163.1914741463263,64.68637839698204,-26.38928482968913,-19.402454764400318,64846.989666224115,61704.87268602904,89.27173312678661,83.12995994902377,True,False,64124.438,63224.438,63724.438,63774.438,,False,,,2024-07-01 05:11:33,fail,False,-74.5,1173.8399999999822,0,1,27,7
2024-07-01 05:00:00,63618.109,63781.637,63144.953,63486.84,1953,36422,0,2024-07-01 05:00:00,2024-07-01 05:00:00,582.350535714264,344.81794361169887,63501.79622619047,-0.0007511015342494612,0.0010138569081962678,63153.8772142857,60555.18528450082,62632.22987872715,63119.27275061533,62539.771604413036,63481.18897144819,308.0637049873985,265.5845064995326,1094.7126085740074,33.78037770889205,86.78956312351511,106.67951805989287,64960.5509930231,62003.32694987328,88.17766316782642,91.76877261419783,True,False,63986.84,63086.84,63586.84,63636.84,,False,2024-07-01 21:00:00,,2024-07-01 11:23:40,fail,False,-74.5,1099.3399999999822,0,2,27,7
2024-07-01 06:00:00,63408.938,63491.738,63361.84,63420.84,1196,36422,0,2024-07-01 06:00:00,2024-07-01 06:00:00,347.91901190477074,429.33940229634027,63591.09848809522,-0.0007510573006718094,0.001013962800816289,63501.79622619047,60509.579422649615,62695.360155224414,63269.28679387133,62775.67075510516,63556.84938734089,293.13521216832305,285.96806393946457,586.3266726051266,30.96698073616426,45.30800378393178,-22.10983384931751,64349.89039535781,62765.308379323964,68.88562293229364,71.76282475979303,True,False,63920.84,63020.84,63520.84,63570.84,,False,2024-07-01 20:45:00,,2024-07-01 11:36:07,fail,False,-74.5,1024.8399999999822,0,3,27,7
2024-07-01 07:00:00,63399.84,63435.438,63328.438,63362.238,1017,36422,0,2024-07-01 07:00:00,2024-07-01 07:00:00,89.30226190474787,489.8136003849213,63449.61889285712,-0.0007511186386750524,0.0010138821863938578,63591.09848809522,60464.27086841739,62758.98736213436,63322.51481072337,62935.74285747797,63575.51306329548,257.8681621119322,276.2376302175442,402.3578318175467,-12.289473340242694,5.900108015157457,-1.5968964567873627,64118.69613624917,63030.829990341794,62.47253054435567,65.77164397604899,True,False,63862.238,62962.238,63462.238,63512.238,,False,2024-07-01 20:45:00,,2024-07-01 11:36:08,fail,False,-74.5,950.3399999999822,0,4,27,7
2024-07-01 08:00:00,63242.785,63331.539,63225.438,63301.539,561,36422,0,2024-07-01 08:00:00,2024-07-01 08:00:00,-141.4795952380955,519.3667344955174,63416.81351190475,-0.0007511020055527482,0.0010139713345126199,63449.61889285712,60418.83207127346,62822.55240627886,63293.39041524459,63022.166643289354,63316.35878740968,209.13909864463494,244.93594888756613,321.6481675596277,-64.35311627110787,-72.76842621258402,-82.70270657034416,63750.58381361517,62880.63376120418,15.898415331100397,25.96393999715723,True,False,63801.539,62901.539,63401.539,63451.539,,False,2024-07-01 20:45:00,2024-07-01 21:19:25,2024-07-01 11:38:00,fail,False,-74.5,875.8399999999822,0,5,27,7
2024-07-01 09:00:00,63388.77,63422.34,63336.738,63336.738,957,36422,0,2024-07-01 09:00:00,2024-07-01 09:00:00,-32.80538095236989,548.1405035622738,63425.974357142906,-0.0004852133834542111,0.0010138364653236673,63416.81351190475,60246.044515264584,62886.40383661087,63326.25870185205,63112.0735042891,63287.60336016522,176.43601235681854,210.5033521391246,271.9033840633853,7.585280701874581,3.2546945304056862,9.39833711731626,63656.17292865079,62920.533791679656,49.000626791173325,42.316295930895,True,False,63836.738,62936.738,63436.738,63486.738,,False,2024-07-01 20:45:00,,2024-07-01 11:37:23,fail,False,-74.5,801.3399999999822,0,6,27,7
2024-07-01 12:00:00,62886.148,62969.738,62832.84,62851.738,1002,36422,0,2024-07-01 12:00:00,2024-07-01 12:00:00,-202.38046428580128,519.4356497188128,63048.723130952414,0.0007140431710688738,0.0014531679432596355,63145.80657142855,59802.35558085447,62794.43411490553,63109.87227008863,63124.04191318345,63038.60326969385,51.093831705642515,99.58957024248738,168.29051003839814,-79.74703921557375,-68.15110319920495,-77.55261644318671,63265.79545824569,62809.91108114201,10.597854652721985,10.95747217954753,True,False,63351.738,62951.738,62951.738,63001.738,2024-07-01 19:00:00,True,2024-07-01 19:00:00,2024-07-01 20:28:41,2024-07-01 19:04:32,even,True,18.62,819.9599999999822,1,0,27,7
2024-07-01 13:00:00,62900.438,62951.738,62857.316,62866.137,801,36422,0,2024-07-01 13:00:00,2024-07-01 13:00:00,-97.08344047613355,484.3884118675778,62938.653666666665,0.001180431551548845,0.0016021109076645886,63048.723130952414,59734.835103440375,62801.95302918809,62987.87855755637,63053.31368962742,62830.332572755375,13.021916622732533,54.04285843185401,213.41640223769514,-35.45171998626756,-35.71793257652462,-58.57645029237756,63118.44471577626,62540.72042973449,18.82039148966352,15.11304535966496,True,False,63366.137,62966.137,62966.137,63016.137,2024-07-01 19:00:00,True,2024-07-01 19:00:00,2024-07-01 20:32:24,2024-07-01 19:04:31,even,True,18.62,838.5799999999822,2,0,27,7
2024-07-01 21:00:00,63665.34,63711.738,63540.539,63618.238,1577,36422,0,2024-07-01 21:00:00,2024-07-01 21:00:00,276.4934880952642,339.65933835256146,63425.074047619055,0.002320850096373198,0.001130466644040142,63219.70100000001,60582.02580949228,63641.561446419204,63282.92190431636,63111.242517720704,63492.705552459534,69.00297495492123,33.10845293996911,303.1093257688891,78.99248366014945,121.11881905738119,105.323700034387,63903.40314224754,63083.50796267153,95.92052804388742,93.47665296795175,True,False,64118.238,63218.238,63718.238,63768.238,,False,,,2024-07-01 22:40:21,fail,False,-74.5,764.0799999999822,0,1,27,7
