time,open,high,low,close,tick_volume,spread,real_volume,hourly_time,time2,prev_hour_lsma_slope,prev_hour_macd_line,hour_lsma,fixed_support_gradient,fixed_resistance_gradient,prev_hour_lsma,fixed_support_trendline,fixed_resistance_trendline,prev_fixed_support_trendline,prev_fixed_resistance_trendline,prev_fixed_resistance_gradient,prev_fixed_support_gradient,ema_50,ema_24,stoch_k,stoch_d,prev_hour_macd_signal,ema_short,ema_long,lsma,macd_line,macd_signal,lsma_stddev,lsma_slope,prev_lsma_slope_1,prev_lsma_slope_2,lsma_upper_band,lsma_lower_band,is_buy2,is_sell2,tp,sl,be,be_condition,time_updated,sl_updated,time_to_trail,time_tp_hit,time_sl_hit,lot_size,type,success,profit,account_balance,position_close_time,win_streak,losing_streak,Week,Month
2024-05-02 05:15:00,1.07164,1.07191,1.07159,1.07175,388,12,0,2024-05-02 05:00:00,2024-05-02 05:00:00,-0.00020309523809514118,0.001225197338744044,1.0717598809523807,0.0003601338408058653,0.0002472447120019363,1.071323214285714,1.064300229073707,1.071362574773172,1.064680333166536,1.0697865505950992,0.0004016785824309929,0.00026968817299497487,1.068051,1.0688815917527075,76.01190476190177,61.38975155279607,0.0011020438421059779,1.0713425884205745,1.070974587355532,1.0712846233230133,0.0003680010650424226,0.00042714374477076454,0.0002872066619225114,5.8156174750356726e-05,1.9927760577465037e-05,2.1503267974010143e-05,2.5716723523166087,1.070896894329418,True,False,1.0747499999999999,1.07205,1.07205,1.07225,2024-05-02 10:45:00,True,2024-05-02 10:45:00,2024-05-03 14:08:24,2024-05-02 10:55:36,0.02,even,True,10.92,710.92,,1,0,18,5
2024-05-02 05:30:00,1.07175,1.072,1.07166,1.07193,414,12,0,2024-05-02 05:00:00,2024-05-02 05:00:00,-0.00020309523809514118,0.001225197338744044,1.0717598809523807,0.0003601338408058653,0.0002472447120019363,1.071323214285714,1.064300229073707,1.071362574773172,1.064680333166536,1.0697865505950992,0.0004016785824309929,0.00026968817299497487,1.068051,1.0688815917527075,81.66666666666374,73.86904761904596,0.0011020438421059779,1.0714329594327938,1.0710453586625297,1.0714214585483322,0.0003876007702641182,0.0004192351498694353,0.0003129286393400946,0.00013683522531882097,5.8156174750356726e-05,1.9927760577465037e-05,2.5718439122114414,1.070999004885223,True,False,1.07493,1.07223,1.07223,1.07243,2024-05-02 10:45:00,True,2024-05-02 10:45:00,2024-05-03 15:20:12,2024-05-02 10:45:18,0.02,even,True,10.92,721.8399999999999,,2,0,18,5
2024-05-02 05:45:00,1.07193,1.072,1.07167,1.07181,442,12,0,2024-05-02 05:00:00,2024-05-02 05:00:00,-0.00020309523809514118,0.001225197338744044,1.0717598809523807,0.0003601338408058653,0.0002472447120019363,1.071323214285714,1.064300229073707,1.071362574773172,1.064680333166536,1.0697865505950992,0.0004016785824309929,0.00026968817299497487,1.068051,1.0688815917527075,85.7142857142827,81.13095238094941,0.0011020438421059779,1.0714909656739025,1.0711019987616017,1.0715086412108714,0.00038896691230072555,0.0004131815023556934,0.0003180869901760001,8.718266253926465e-05,0.00013683522531882097,5.8156174750356726e-05,2.571938058647609,1.0710792237741338,True,False,1.0748099999999998,1.07211,1.07211,1.0723099999999999,2024-05-02 10:45:00,True,2024-05-02 10:45:00,2024-05-03 14:11:35,2024-05-02 10:55:16,0.02,even,True,10.92,732.7599999999999,,3,0,18,5
2024-05-02 16:30:00,1.06934,1.06975,1.06823,1.06873,2085,12,0,2024-05-02 16:00:00,2024-05-02 16:00:00,-0.00018940476190598687,0.00012415197530923905,1.0694963095238101,-0.00019824406763702015,-5.607699150456576e-06,1.0700905952380948,1.071126386501787,1.07280374308799,1.070404945109126,1.0721880503388062,5.2754932558556286e-05,-6.974924253448872e-05,1.0693327632774288,1.0698365300860169,15.558832300606214,29.764101470570534,0.0005290764708248567,1.0698354712689726,1.0702493990935251,1.0697712968696254,-0.000413927824552518,-0.000324062919037112,0.0007553392173873065,-0.00018781905744780225,-0.00012880288957739516,-8.860337117266859e-05,1.0707910048130982,-0.4312484110738475,False,True,1.06573,1.06843,1.06843,1.06823,2024-05-02 17:15:00,True,2024-05-02 17:15:00,,2024-05-02 17:23:06,0.02,even,True,10.9,743.6599999999999,,4,0,18,5
2024-05-02 16:45:00,1.06873,1.06885,1.06796,1.06861,1648,12,0,2024-05-02 16:00:00,2024-05-02 16:00:00,-0.00018940476190598687,0.00012415197530923905,1.0694963095238101,-0.00019824406763702015,-5.607699150456576e-06,1.0700905952380948,1.071126386501787,1.07280374308799,1.070404945109126,1.0721880503388062,5.2754932558556286e-05,-6.974924253448872e-05,1.0693327632774288,1.0698365300860169,16.342610617759163,18.4748251165604,0.0005290764708248567,1.069646937227592,1.0701279621236344,1.0694968317853455,-0.0004810248960422925,-0.0003554553144381481,0.0006632679197155591,-0.0002744650842798624,-0.00018781905744780225,-0.00012880288957739516,1.0703922434769615,-0.4313985799062705,False,True,1.0656100000000002,1.06831,1.06831,1.0681100000000001,2024-05-02 17:15:00,True,2024-05-02 17:15:00,,2024-05-02 17:22:43,0.02,even,True,10.9,754.5599999999998,,5,0,18,5
2024-05-02 17:00:00,1.06859,1.0686,1.06734,1.06758,1746,12,0,2024-05-02 17:00:00,2024-05-02 17:00:00,-0.0005942857142846592,-0.00010425137494474157,1.069148452380952,-0.00023750031191096407,-9.472106368517122e-05,1.0694963095238101,1.0711322677128692,1.0735564420312071,1.071126386501787,1.07280374308799,-5.607699150456576e-06,-0.00019824406763702015,1.0692958108079174,1.0697504076791355,14.553356309824238,15.484933076063205,0.00040241090167093704,1.0693289468848857,1.0699392241885504,1.0690480254557964,-0.0006102773036646969,-0.0004064197122834579,0.0007763744800831428,-0.000448806329549134,-0.0002744650842798624,-0.00018781905744780225,1.0700961310039085,-0.43200008009231583,False,True,1.06458,1.07838,1.06728,1.06708,,False,,,2024-05-03 15:30:01,0.02,fail,False,-392.42,362.1399999999998,,0,1,18,5
2024-05-03 01:30:00,1.07276,1.07281,1.07257,1.0728,122,13,0,2024-05-03 01:00:00,2024-05-03 01:00:00,3.452380952384537e-05,0.0006110273258423948,1.0727938095238094,0.00024390792698984946,1.7738187568661712e-05,1.0728077380952386,1.0655374938950624,1.0727513375372264,1.0669320474221144,1.072674840647411,6.459462711906189e-05,4.8206894151152946e-05,1.0705074423647296,1.0709655311091764,85.24064171123388,70.63576945929883,0.0004081063148981875,1.0725138278995,1.0720835512482143,1.0725723632610935,0.00043027665128558823,0.00048641210951523225,0.0004244592638293467,3.029583763169974e-05,-2.8001375980135634e-06,1.654626763025746e-05,2.573145383267263,1.071999343254924,True,False,1.0757999999999999,1.0731,1.0731,1.0733,2024-05-03 04:30:00,True,2024-05-03 04:30:00,2024-05-03 15:30:01,2024-05-03 06:20:21,0.02,even,True,10.92,373.05999999999983,,1,0,18,5
2024-05-03 01:45:00,1.07279,1.07286,1.07276,1.07282,112,12,0,2024-05-03 01:00:00,2024-05-03 01:00:00,3.452380952384537e-05,0.0006110273258423948,1.0727938095238094,0.00024390792698984946,1.7738187568661712e-05,1.0728077380952386,1.0655374938950624,1.0727513375372264,1.0669320474221144,1.072674840647411,6.459462711906189e-05,4.8206894151152946e-05,1.0705074423647296,1.0709655311091764,88.10457516340962,81.01406219053773,0.0004081063148981875,1.0725609312995767,1.0721381030076058,1.0725908771929822,0.00042282829197093363,0.00047369534600637253,0.0004034959726982706,1.8513931888675117e-05,3.029583763169974e-05,-2.8001375980135634e-06,2.573135596756125,1.0720461576298395,True,False,1.07582,1.07312,1.07312,1.07332,2024-05-03 04:45:00,True,2024-05-03 04:45:00,2024-05-03 15:30:01,2024-05-03 06:19:17,0.02,even,True,10.92,383.97999999999985,,2,0,18,5
2024-05-03 02:00:00,1.07281,1.07298,1.07278,1.07293,151,12,0,2024-05-03 02:00:00,2024-05-03 02:00:00,-1.3928571429122627e-05,0.0006506383283058081,1.072806785714286,0.00041108773504632034,0.00010251404414457764,1.0727938095238094,1.0647414244098647,1.0718677328365889,1.0655374938950624,1.0727513375372264,1.7738187568661712e-05,0.00024390792698984946,1.0706624460831342,1.0711210886204423,93.26974032856886,88.87165240107079,0.0004566127175797117,1.0726177110996418,1.0721967620440795,1.072649504643963,0.0004209490555622253,0.00046314608791754315,0.00038346012393756417,5.8627450980841544e-05,1.8513931888675117e-05,3.029583763169974e-05,2.5731671758112786,1.0721318334766474,True,False,1.0759299999999998,1.07323,1.07323,1.0734299999999999,2024-05-03 04:45:00,True,2024-05-03 04:45:00,2024-05-03 15:30:01,2024-05-03 05:53:01,0.02,even,True,10.92,394.89999999999986,,3,0,18,5
2024-05-03 02:15:00,1.07293,1.07304,1.07287,1.0729,218,12,0,2024-05-03 02:00:00,2024-05-03 02:00:00,-1.3928571429122627e-05,0.0006506383283058081,1.072806785714286,0.00041108773504632034,0.00010251404414457764,1.0727938095238094,1.0647414244098647,1.0718677328365889,1.0655374938950624,1.0727513375372264,1.7738187568661712e-05,0.00024390792698984946,1.0706624460831342,1.0711210886204423,92.22231281055001,91.19887610084282,0.0004566127175797117,1.0726611401612354,1.072248853744518,1.0727371929824563,0.00041228641671731125,0.0004529741536774968,0.0003513654317801088,8.768833849326363e-05,5.8627450980841544e-05,1.8513931888675117e-05,2.5732115363153594,1.0722628496495532,True,False,1.0758999999999999,1.0732,1.0732,1.0734,2024-05-03 04:45:00,True,2024-05-03 04:45:00,2024-05-03 15:30:01,2024-05-03 05:57:57,0.02,even,True,10.92,405.8199999999999,,4,0,18,5
2024-05-03 03:45:00,1.07295,1.0731,1.07283,1.07308,471,12,0,2024-05-03 03:00:00,2024-05-03 03:00:00,1.2976190476576832e-05,0.0006719585688159668,1.072894523809524,0.0004720656133291887,0.00022072714821166163,1.072806785714286,1.0648591534447622,1.0708466714022684,1.0647414244098647,1.0718677328365889,0.00010251404414457764,0.00041108773504632034,1.070818417303577,1.071277801530807,82.0130770322394,73.16443076341234,0.0004996818878269627,1.0727678764801298,1.0724577398263009,1.072917196422429,0.00031013665382895184,0.00035938821242564417,0.0002249814806808656,7.240110079087536e-05,5.375988992151193e-05,-7.371861025839976e-06,2.573220921421348,1.07261347142351,True,False,1.07608,1.07338,1.07338,1.07358,2024-05-03 05:00:00,True,2024-05-03 05:00:00,2024-05-03 15:30:01,2024-05-03 05:24:32,0.02,even,True,10.92,416.7399999999999,,5,0,18,5
2024-05-03 04:00:00,1.07307,1.07334,1.07302,1.07313,553,12,0,2024-05-03 04:00:00,2024-05-03 04:00:00,8.773809523798803e-05,0.0006889958074696168,1.0731288095238103,0.00047208523600345383,0.0002471007746796108,1.072894523809524,1.0653621498071013,1.0708698505509924,1.0648591534447622,1.0708466714022684,0.00022072714821166163,0.0004720656133291887,1.0710023903807657,1.0714691774083425,88.45182347098292,79.66641560511617,0.0005375446717554935,1.0728235877908792,1.0725075368762045,1.0729852597179212,0.0003160509146746815,0.00035072075287545165,0.0002365713422683771,6.806329549213785e-05,7.240110079087536e-05,5.375988992151193e-05,2.5733046310299836,1.0726658884058589,True,False,1.0761299999999998,1.0734299999999999,1.0734299999999999,1.0736299999999999,2024-05-03 05:00:00,True,2024-05-03 05:00:00,2024-05-03 15:30:01,2024-05-03 05:24:00,0.02,even,True,10.92,427.6599999999999,,6,0,18,5
2024-05-03 04:15:00,1.07312,1.0734,1.07311,1.0733,475,12,0,2024-05-03 04:00:00,2024-05-03 04:00:00,8.773809523798803e-05,0.0006889958074696168,1.0731288095238103,0.00047208523600345383,0.0002471007746796108,1.072894523809524,1.0653621498071013,1.0708698505509924,1.0648591534447622,1.0708466714022684,0.00022072714821166163,0.0004720656133291887,1.0710023903807657,1.0714691774083425,89.33080385373849,86.59856811898692,0.0005375446717554935,1.0728968819768978,1.0725662378483374,1.073070653594771,0.00033064412856043113,0.00034670542801244753,0.0002680037312847955,8.539387684969313e-05,6.806329549213785e-05,7.240110079087536e-05,2.5734324586320056,1.0727088485575365,True,False,1.0762999999999998,1.0735999999999999,1.0735999999999999,1.0737999999999999,2024-05-03 11:15:00,True,2024-05-03 11:15:00,2024-05-03 15:30:01,,0.02,success,True,109.18,536.8399999999999,,7,0,18,5
2024-05-03 14:00:00,1.07425,1.07481,1.07419,1.07474,639,12,0,2024-05-03 14:00:00,2024-05-03 14:00:00,0.00021571428571531825,0.0006186445417921682,1.074299047619047,4.7507836586926345e-05,9.532802141187751e-05,1.074048928571429,1.0718333881494249,1.0733756182054848,1.0717824531521332,1.0732732598819295,9.533108232345697e-05,4.750825074323681e-05,1.0723478742356984,1.0727809613703105,78.82246801487334,74.62509314899866,0.0006005605775804609,1.074163757756973,1.073856196934977,1.0745871929824569,0.0003075608219960113,0.00027827962066187734,0.0005507419238131616,0.00013171998623984216,5.672858617233878e-05,-8.531131750810772e-06,2.5753306945796046,1.073843691385309,True,False,1.07774,1.06394,1.07504,1.07524,,False,2024-05-03 15:45:00,2024-05-03 15:30:01,,0.02,success,True,109.18,646.02,,8,0,18,5
2024-05-03 14:15:00,1.07474,1.0749,1.07462,1.07479,566,12,0,2024-05-03 14:00:00,2024-05-03 14:00:00,0.00021571428571531825,0.0006186445417921682,1.074299047619047,4.7507836586926345e-05,9.532802141187751e-05,1.074048928571429,1.0718333881494249,1.0733756182054848,1.0717824531521332,1.0732732598819295,9.533108232345697e-05,4.750825074323681e-05,1.0723478742356984,1.0727809613703105,88.3161495366835,79.39905870337215,0.0006005605775804609,1.0742601027174388,1.0739253675323859,1.0746636050911584,0.00033473518505289235,0.00028957073354008036,0.0005788327334488266,7.641210870157344e-05,0.00013171998623984216,5.672858617233878e-05,2.5754450292813145,1.0738821809010026,True,False,1.0777899999999998,1.06399,1.0750899999999999,1.0752899999999999,,False,2024-05-03 15:45:00,2024-05-03 15:30:01,,0.02,success,True,109.18,755.2,,9,0,18,5
2024-05-03 14:30:00,1.0748,1.07486,1.07445,1.07451,662,12,0,2024-05-03 14:00:00,2024-05-03 14:00:00,0.00021571428571531825,0.0006186445417921682,1.074299047619047,4.7507836586926345e-05,9.532802141187751e-05,1.074048928571429,1.0718333881494249,1.0733756182054848,1.0717824531521332,1.0732732598819295,9.533108232345697e-05,4.750825074323681e-05,1.0723478742356984,1.0727809613703105,84.49765214020873,83.87875656392185,0.0006005605775804609,1.0742985484532175,1.073968673641098,1.0746522669418652,0.00032987481211943503,0.0002976315492559513,0.0005833789505787059,-1.1338149293216304e-05,7.641210870157344e-05,0.00013171998623984216,1.0754398285251465,-0.4261352946414161,True,False,1.07751,1.07481,1.07481,1.07501,2024-05-03 15:30:00,True,2024-05-03 15:30:00,2024-05-03 15:30:01,2024-05-07 21:39:25,0.02,success,True,109.18,864.3800000000001,,10,0,18,5
2024-05-03 15:15:00,1.07487,1.07525,1.07471,1.07513,1234,12,0,2024-05-03 15:00:00,2024-05-03 15:00:00,0.00025011904761806925,0.0006340623416574154,1.0760550000000002,4.750837723471434e-05,0.0005361363441451474,1.074299047619047,1.0718845320173387,1.0725638524421819,1.0718333881494249,1.0733756182054848,9.532802141187751e-05,4.7507836586926345e-05,1.0727963984785567,1.0733024844606858,83.15494393476122,76.748722809407,0.0006072609303958518,1.0745195393678801,1.0741483038989055,1.0747247953216368,0.0003712354689746622,0.0003217880216301988,0.000646165097564895,7.702098383188805e-05,3.724114207082074e-05,-4.173374613114511e-05,2.5755971182033495,1.073852472439924,True,False,1.0781299999999998,1.06433,1.0754299999999999,1.0756299999999999,,False,2024-05-03 15:45:00,2024-05-03 15:30:01,,0.02,success,True,109.18,973.5600000000002,,11,0,18,5
2024-05-03 15:30:00,1.07513,1.08118,1.07504,1.07948,4656,12,0,2024-05-03 15:00:00,2024-05-03 15:00:00,0.00025011904761806925,0.0006340623416574154,1.0760550000000002,4.750837723471434e-05,0.0005361363441451474,1.074299047619047,1.0718845320173387,1.0725638524421819,1.0718333881494249,1.0733756182054848,9.532802141187751e-05,4.7507836586926345e-05,1.0727963984785567,1.0733024844606858,88.31015204765338,81.82373739679092,0.0006072609303958518,1.075282687157437,1.0745432443508385,1.0756354282765739,0.0007394428065985448,0.00040531897862386803,0.0012557903221916372,0.0009106329549370962,7.702098383188805e-05,3.724114207082074e-05,2.5773307452115324,1.0739401113416152,True,False,1.0824799999999999,1.06868,1.07978,1.07998,,False,,,,0.02,running,False,0.0,973.5600000000002,2024-05-03 18:30:00,0,1,18,5
2024-05-06 15:00:00,1.07719,1.07788,1.0771600000000001,1.07783,642,12,0,2024-05-06 15:00:00,2024-05-06 15:00:00,0.00023321428571376757,0.0003270868614251299,1.0776708333333336,2.548696285472032e-05,0.00016025983352986863,1.077016428571429,1.0753905410949598,1.0764323495192438,1.0753631207778567,1.076634457826529,7.127605263934083e-05,2.548498199896282e-05,1.0759285005380563,1.076290846920548,75.98394167775633,73.12716908025531,0.0003183700704046075,1.0771093502901985,1.0768635351190339,1.0772651565187477,0.0002458151711646206,0.00017323684119885626,0.0004342015660586018,0.00013056071551531545,5.163054695356273e-05,4.8118335055136185e-05,2.577851328632927,1.0766789844045686,True,False,1.08083,1.07813,1.07813,1.07833,2024-05-06 15:45:00,True,2024-05-06 15:45:00,,2024-05-06 16:32:28,0.02,even,True,10.92,984.4800000000001,,1,0,19,5
2024-05-06 15:15:00,1.07783,1.07837,1.07778,1.07827,586,12,0,2024-05-06 15:00:00,2024-05-06 15:00:00,0.00023321428571376757,0.0003270868614251299,1.0776708333333336,2.548696285472032e-05,0.00016025983352986863,1.077016428571429,1.0753905410949598,1.0764323495192438,1.0753631207778567,1.076634457826529,7.127605263934083e-05,2.548498199896282e-05,1.0759285005380563,1.076290846920548,85.05353716189366,77.74909348832546,0.0003183700704046075,1.0772879117840142,1.0769677177028092,1.0774327210182317,0.00032019408120498305,0.00020262828920008163,0.0005152594815244552,0.00016756449948407415,0.00013056071551531545,5.163054695356273e-05,2.5781283213182897,1.0767371207181737,True,False,1.08127,1.0674700000000001,1.07857,1.07877,,False,,,,0.02,running,False,0.0,984.4800000000001,2024-05-06 18:15:00,0,1,19,5
2024-05-06 15:30:00,1.07827,1.07881,1.07819,1.07871,706,12,0,2024-05-06 15:00:00,2024-05-06 15:00:00,0.00023321428571376757,0.0003270868614251299,1.0776708333333336,2.548696285472032e-05,0.00016025983352986863,1.077016428571429,1.0753905410949598,1.0764323495192438,1.0753631207778567,1.076634457826529,7.127605263934083e-05,2.548498199896282e-05,1.0759285005380563,1.076290846920548,95.45324379922204,85.49690754629067,0.0003183700704046075,1.0775066945864735,1.0770967756507492,1.0777228414172682,0.00040991893572428495,0.0002440864185049223,0.0006082283014081963,0.00029012039903641984,0.00016756449948407415,0.00013056071551531545,2.5785439496241693,1.0769017332103672,True,False,1.08171,1.0679100000000001,1.07901,1.07921,,False,,,,0.02,running,False,0.0,984.4800000000001,2024-05-06 18:30:00,0,2,19,5
2024-05-06 15:45:00,1.07871,1.07901,1.07849,1.07867,841,12,0,2024-05-06 15:00:00,2024-05-06 15:00:00,0.00023321428571376757,0.0003270868614251299,1.0776708333333336,2.548696285472032e-05,0.00016025983352986863,1.077016428571429,1.0753905410949598,1.0764323495192438,1.0753631207778567,1.076634457826529,7.127605263934083e-05,2.548498199896282e-05,1.0759285005380563,1.076290846920548,92.07117455361056,90.85931850490874,0.0003183700704046075,1.077685664650093,1.0772133107877309,1.078025799793602,0.0004723538623621071,0.00028973990727635925,0.0006837402040495055,0.0003029583763338728,0.00029012039903641984,0.00016756449948407415,2.578948849069069,1.0771027505181352,True,False,1.08167,1.06787,1.07897,1.07917,,False,,,,0.02,running,False,0.0,984.4800000000001,2024-05-06 18:45:00,0,3,19,5
2024-05-06 16:45:00,1.07829,1.0787,1.07807,1.07859,777,12,0,2024-05-06 16:00:00,2024-05-06 16:00:00,0.0006544047619045923,0.0005044073166229346,1.0781233333333333,2.5497208457227452e-05,0.00016857854491232017,1.0776708333333336,1.075417838500675,1.0764801606866283,1.0753905410949598,1.0764323495192438,0.00016025983352986863,2.548696285472032e-05,1.0761002101807624,1.0764747791669043,74.09282700421751,73.17833462498773,0.0003555775196482729,1.0780219213662692,1.0775182794824962,1.0785503680770558,0.0005036418837729428,0.00040930955812600473,0.000758270400296721,0.00012868937048593487,9.758513931790169e-05,0.0001297592019269267,2.5795740331174564,1.0775267030366553,True,False,1.0815899999999998,1.06779,1.07889,1.0790899999999999,,False,,,,0.02,running,False,0.0,984.4800000000001,2024-05-06 19:45:00,0,4,19,5
2024-05-06 17:00:00,1.07859,1.07861,1.07821,1.07857,730,12,0,2024-05-06 17:00:00,2024-05-06 17:00:00,0.0004524999999997448,0.0006056558457319117,1.0782342857142857,6.134508054960734e-05,0.00016858960276701005,1.0781233333333333,1.0751012203510864,1.0766613875185234,1.075417838500675,1.0764801606866283,0.00016857854491232017,2.5497208457227452e-05,1.0762201966207132,1.0765935968335518,77.58387364708908,73.9149092873963,0.0004055931848650007,1.078106241156074,1.077596184706015,1.0786524492604062,0.0005100564500590821,0.00042945893651262024,0.000745687602126996,0.00010208118335031102,0.00012868937048593487,9.758513931790169e-05,2.5796591275232776,1.0776457709975347,True,False,1.08157,1.06777,1.07887,1.07907,,False,,,,0.02,running,False,0.0,984.4800000000001,2024-05-06 20:00:00,0,5,19,5
2024-05-06 17:15:00,1.07858,1.07862,1.07819,1.07837,691,12,0,2024-05-06 17:00:00,2024-05-06 17:00:00,0.0004524999999997448,0.0006056558457319117,1.0782342857142857,6.134508054960734e-05,0.00016858960276701005,1.0781233333333333,1.0751012203510864,1.0766613875185234,1.075417838500675,1.0764801606866283,0.00016857854491232017,2.5497208457227452e-05,1.0762201966207132,1.0765935968335518,77.77459833879362,76.4837663300334,0.0004055931848650007,1.078146819439755,1.0776535043574211,1.0787049363605097,0.0004933150823338561,0.00044223016567686746,0.0007567205560613316,5.248710010352653e-05,0.00010208118335031102,0.00012868937048593487,2.5797265091111923,1.0776833636098269,True,False,1.08137,1.0675700000000001,1.07867,1.07887,,False,,,,0.02,running,False,0.0,984.4800000000001,2024-05-06 20:15:00,0,6,19,5
2024-05-07 04:45:00,1.07651,1.0765500000000001,1.07635,1.07648,400,12,0,2024-05-07 04:00:00,2024-05-07 04:00:00,0.00021357142857159062,2.8902297229960183e-05,1.0767878571428575,-2.612214379353941e-05,-9.920130436522435e-05,1.0769019047619048,1.0765579275061148,1.0792162096907483,1.0765382015073814,1.0793688249423392,-0.00011365744579619214,-2.2398076409535127e-05,1.0766198252567476,1.0768236289696373,9.052342333600043,28.960690838759287,0.00014036959485500079,1.0768080877622666,1.0768870294876354,1.0768315927072598,-7.89417253688196e-05,-7.000920139553388e-05,0.00022620271137506636,-8.03199174399527e-05,-7.74922600610406e-05,-4.3298933609658974e-05,1.0771369663676162,-0.4234737809530966,False,True,1.0734800000000002,1.0761800000000001,1.0761800000000001,1.0759800000000002,2024-05-07 09:00:00,True,2024-05-07 09:00:00,2024-05-08 11:01:18,2024-05-07 09:50:33,0.02,even,True,10.9,995.3800000000001,,1,0,19,5
2024-05-07 05:00:00,1.07649,1.0765500000000001,1.07635,1.07645,361,12,0,2024-05-07 05:00:00,2024-05-07 05:00:00,-0.00011404761904731942,-3.837836429965158e-05,1.0766754761904762,-5.28891042879185e-05,-9.768602144934745e-05,1.0767878571428575,1.0768158118387772,1.0790970277278469,1.0765579275061148,1.0792162096907483,-9.920130436522435e-05,-2.612214379353941e-05,1.076599836530506,1.0767825386520664,7.414084757841344,13.74142061642722,0.00010462000302407032,1.0767529973373025,1.0768546569329958,1.0767635500515995,-0.00010165959569330418,-7.633928025508794e-05,0.00023535434271211187,-6.804265566029422e-05,-8.03199174399527e-05,-7.74922600610406e-05,1.077081278414261,-0.4235541783110619,False,True,1.07345,1.07615,1.07615,1.07595,2024-05-07 09:00:00,True,2024-05-07 09:00:00,2024-05-08 11:01:27,2024-05-07 09:50:03,0.02,even,True,10.9,1006.2800000000001,,2,0,19,5
2024-05-07 09:00:00,1.07574,1.07593,1.07548,1.07575,879,12,0,2024-05-07 09:00:00,2024-05-07 09:00:00,-0.00031011904761868436,-0.0002060737642697319,1.0762275000000003,-9.30222563905176e-05,-2.8691463879827864e-05,1.076297142857143,1.076844154084797,1.0779369580973794,1.0768937531257925,1.0786027918611858,-8.2576186394512e-05,-8.76657374714261e-05,1.0765359083996282,1.0766520463332687,23.74277933838876,49.57327416574601,-3.83561175195183e-05,1.0763725738942937,1.0765462017428662,1.0763668524251802,-0.00017362784857244407,-0.00010414714314934691,0.00039088574626567013,-0.00014051943584436621,-0.00013606811145749909,1.2872377022743464e-05,1.0768945481826389,-0.42416084333227855,False,True,1.07275,1.07545,1.07545,1.07525,2024-05-07 21:30:00,True,2024-05-07 21:30:00,2024-05-09 11:30:01,2024-05-07 22:09:03,0.02,even,True,10.9,1017.1800000000001,,3,0,19,5
2024-05-07 09:15:00,1.07575,1.07598,1.07558,1.07588,531,12,0,2024-05-07 09:00:00,2024-05-07 09:00:00,-0.00031011904761868436,-0.0002060737642697319,1.0762275000000003,-9.30222563905176e-05,-2.8691463879827864e-05,1.076297142857143,1.076844154084797,1.0779369580973794,1.0768937531257925,1.0786027918611858,-8.2576186394512e-05,-8.76657374714261e-05,1.0765359083996282,1.0766520463332687,18.707201889017384,30.777079648549392,-3.83561175195183e-05,1.0762967932951715,1.076496853465617,1.0762596800825592,-0.00020006017044549296,-0.00012332974860857613,0.0004156520980744495,-0.00010717234262092035,-0.00014051943584436621,-0.00013606811145749909,1.0768208104149597,-0.4243014502498412,False,True,1.07288,1.07558,1.07558,1.07538,2024-05-07 21:30:00,True,2024-05-07 21:30:00,2024-05-09 11:29:04,2024-05-07 22:57:36,0.02,even,True,10.9,1028.0800000000002,,4,0,19,5
2024-05-07 12:45:00,1.07559,1.07603,1.07545,1.07588,527,12,0,2024-05-07 12:00:00,2024-05-07 12:00:00,7.369047619176783e-05,-0.0001853560121589659,1.0761311904761912,-9.302933500869053e-05,-6.766859184672086e-05,1.0762746428571435,1.0765438145670676,1.0781352369177089,1.0766439402944763,1.0779627875773001,-3.895395329428289e-05,-9.303018771228544e-05,1.076472887447838,1.0765487774551603,24.675324675324898,33.621933621935504,-0.00011393609701691791,1.0760102089571326,1.0761923416162353,1.0759712762297902,-0.00018213265910271836,-0.00015865078462862423,0.0003988943050911891,2.636050911553056e-05,-5.466460268310769e-05,-6.750945992473056e-05,2.5765097835416633,1.075432768917917,False,True,1.07288,1.07558,1.07558,1.07538,2024-05-07 21:30:00,True,2024-05-07 21:30:00,2024-05-09 11:29:04,2024-05-07 22:57:36,0.02,even,True,10.9,1038.9800000000002,,5,0,19,5
2024-05-07 16:30:00,1.07795,1.07867,1.07793,1.07846,1201,12,0,2024-05-07 16:00:00,2024-05-07 16:00:00,0.0004141666666670485,2.0344892581958263e-05,1.0773004761904756,-3.370315269842842e-05,8.067747378626397e-05,1.0768770238095233,1.07563725740994,1.077371953075263,1.0761666148194953,1.0775369334951397,1.946329546863104e-05,-8.50504367081197e-05,1.076659481145523,1.0767559363886836,92.434981913828,90.68646013623702,-0.00010071781898118309,1.077341495119558,1.076906671366061,1.0778694530443769,0.0004348237534967936,0.00023734890532068638,0.0007515912009199501,0.00028152046783902485,0.00022981080151196487,0.00017617475060194288,2.5788841011656185,1.076854804923135,True,False,1.0814599999999999,1.06766,1.07876,1.07896,,False,,,,0.02,running,False,0.0,1038.9800000000002,2024-05-07 19:30:00,0,1,19,5
2024-05-07 21:30:00,1.07501,1.07507,1.07472,1.07506,464,12,0,2024-05-07 21:00:00,2024-05-07 21:00:00,-0.0006359523809518208,-5.07942230278946e-05,1.0760291666666675,-4.965483581574344e-05,0.00016485093419886548,1.0766854761904767,1.075516908115939,1.0769061178068937,1.0752965611828038,1.076647883928264,0.00017171915222743598,1.5164778889025414e-05,1.0765592111319866,1.076595330877824,6.563737033205761,6.575615828617018,3.122343589753004e-05,1.0760235272604157,1.0764875483844314,1.0754311179910565,-0.00046402112401566775,-0.00020148097204592566,0.000972990750195659,-0.00024519091847219343,-0.0002671310629509538,-0.00019628826969397828,1.0767446555038207,-0.4258824195217077,False,True,1.07206,1.07476,1.07476,1.07456,2024-05-08 04:30:00,True,2024-05-08 04:30:00,,2024-05-08 09:36:47,0.02,even,True,10.9,1049.8800000000003,,1,0,19,5
2024-05-08 01:45:00,1.07509,1.07512,1.075,1.07505,67,12,0,2024-05-08 01:00:00,2024-05-08 01:00:00,-4.607142857149249e-05,-0.00035572361757107984,1.0751753571428564,-7.155861569056466e-05,-0.00019488753538523897,1.0752727380952383,1.075571394189721,1.0799168230876768,1.0753462409514298,1.0793797804530136,-9.495878049432306e-05,-4.801445810538025e-05,1.0762802964833966,1.076246394542544,25.000000000002412,39.99692640043962,-0.00017269323171333902,1.0753262544616635,1.0756333800363072,1.075320760233918,-0.00030712557464362966,-0.0003316265791376913,0.0004304098821282324,-7.811833505444454e-05,-3.822497419858628e-05,8.087375300336319e-06,1.0759018135747913,-0.4252602931069551,False,True,1.0720500000000002,1.07475,1.07475,1.0745500000000001,2024-05-08 04:30:00,True,2024-05-08 04:30:00,,2024-05-08 09:33:57,0.02,even,True,10.9,1060.7800000000004,,2,0,19,5
2024-05-08 02:00:00,1.07507,1.07507,1.07491,1.07491,101,12,0,2024-05-08 02:00:00,2024-05-08 02:00:00,-9.738095238187583e-05,-0.0004091045939640381,1.075039166666667,-7.156402438849205e-05,-0.0002182683730017681,1.0751753571428564,1.0754944387141663,1.079830810072035,1.075571394189721,1.0799168230876768,-0.00019488753538523897,-7.155861569056466e-05,1.076193180581242,1.0761410829791405,10.526315789476223,24.207955786906464,-0.00021997550416347884,1.0752622153137152,1.075579796329914,1.075220399036806,-0.0003175810161988313,-0.0003288174665499193,0.00031465430761453225,-0.00010036119711198666,-7.811833505444454e-05,-3.822497419858628e-05,1.0756451823520856,-0.4252043842784734,False,True,1.0719100000000001,1.07461,1.07461,1.07441,2024-05-08 04:30:00,True,2024-05-08 04:30:00,,2024-05-08 09:20:22,0.02,even,True,10.9,1071.6800000000005,,3,0,19,5
2024-05-08 02:15:00,1.0749,1.0749900000000001,1.0748199999999999,1.07485,90,12,0,2024-05-08 02:00:00,2024-05-08 02:00:00,-9.738095238187583e-05,-0.0004091045939640381,1.075039166666667,-7.156402438849205e-05,-0.0002182683730017681,1.0751753571428564,1.0754944387141663,1.079830810072035,1.075571394189721,1.0799168230876768,-0.00019488753538523897,-7.155861569056466e-05,1.076193180581242,1.0761410829791405,5.684666210990472,13.736994000156356,-0.00021997550416347884,1.0751987975731436,1.0755257373425129,1.0751120467836257,-0.00032693976936926106,-0.0003284419271137877,0.00029594481461995534,-0.00010835225318039932,-0.00010036119711198666,-7.811833505444454e-05,1.0755115722833626,-0.42528747871611117,False,True,1.0718500000000002,1.0745500000000001,1.0745500000000001,1.0743500000000001,2024-05-08 04:30:00,True,2024-05-08 04:30:00,,2024-05-08 09:18:56,0.02,even,True,10.9,1082.5800000000006,,4,0,19,5
2024-05-08 02:30:00,1.07485,1.07498,1.07484,1.07491,65,12,0,2024-05-08 02:00:00,2024-05-08 02:00:00,-9.738095238187583e-05,-0.0004091045939640381,1.075039166666667,-7.156402438849205e-05,-0.0002182683730017681,1.0751753571428564,1.0754944387141663,1.079830810072035,1.075571394189721,1.0799168230876768,-0.00019488753538523897,-7.155861569056466e-05,1.076193180581242,1.0761410829791405,5.194805194818903,7.135262398428519,-0.00021997550416347884,1.0751543671772754,1.0754801271689933,1.0750393739250086,-0.00032575999171791103,-0.00032790554003461243,0.00027407419913927665,-7.26728586171177e-05,-0.00010835225318039932,-0.00010036119711198666,1.0754093740938466,-0.42533062624382945,False,True,1.0719100000000001,1.07461,1.07461,1.07441,2024-05-08 04:30:00,True,2024-05-08 04:30:00,,2024-05-08 09:20:22,0.02,even,True,10.9,1093.4800000000007,,5,0,19,5
2024-05-08 04:00:00,1.07473,1.0748199999999999,1.0745,1.07464,406,12,0,2024-05-08 04:00:00,2024-05-08 04:00:00,-5.142857142859114e-05,-0.00048812105440254605,1.0746191666666662,-0.00011965955020476878,-0.00021825180511593907,1.0749877380952384,1.0757508139607115,1.0793596852407625,1.0754442375238122,1.079595141391661,-0.00021825768250880844,-7.434791123216775e-05,1.0759614410705771,1.0758635406335444,20.421696442939496,34.76044852191142,-0.0003102872448560444,1.0749875043845614,1.0752705986997437,1.074808617131063,-0.00028309431518236394,-0.00029211614765971543,0.0002597293462445653,-7.199862401030543e-05,-6.690746474125042e-05,-1.949088407271482e-05,1.0751592517484931,-0.42554201748636733,False,True,1.0716400000000001,1.07434,1.07434,1.07414,2024-05-08 05:00:00,True,2024-05-08 05:00:00,,2024-05-08 09:05:08,0.02,even,True,10.9,1104.3800000000008,,6,0,19,5
2024-05-08 04:15:00,1.07466,1.07471,1.07408,1.07434,364,12,0,2024-05-08 04:00:00,2024-05-08 04:00:00,-5.142857142859114e-05,-0.00048812105440254605,1.0746191666666662,-0.00011965955020476878,-0.00021825180511593907,1.0749877380952384,1.0757508139607115,1.0793596852407625,1.0754442375238122,1.079595141391661,-0.00021825768250880844,-7.434791123216775e-05,1.0759614410705771,1.0758635406335444,13.178754651378052,23.129974926173563,-0.0003102872448560444,1.074887888325398,1.0752016654627257,1.0746873718610248,-0.0003137771373276088,-0.0002964483455932941,0.00030974075175969353,-0.00012124527003809504,-7.199862401030543e-05,-6.690746474125042e-05,1.0751055218759005,-0.42573077815385085,False,True,1.0713400000000002,1.07404,1.07404,1.0738400000000001,2024-05-08 05:30:00,True,2024-05-08 05:30:00,,2024-05-08 05:46:05,0.02,even,True,10.9,1115.2800000000009,,7,0,19,5
2024-05-08 04:30:00,1.07435,1.0743800000000001,1.07407,1.07429,432,12,0,2024-05-08 04:00:00,2024-05-08 04:00:00,-5.142857142859114e-05,-0.00048812105440254605,1.0746191666666662,-0.00011965955020476878,-0.00021825180511593907,1.0749877380952384,1.0757508139607115,1.0793596852407625,1.0754442375238122,1.079595141391661,-0.00021825768250880844,-7.434791123216775e-05,1.0759614410705771,1.0758635406335444,15.705614436499497,16.435355176938998,-0.0003102872448560444,1.074795905506106,1.075134134687709,1.074579274165807,-0.0003382291816029781,-0.0003048045127952309,0.00035404425330839447,-0.00010809769521791246,-0.00012124527003809504,-7.199862401030543e-05,1.0750572339077733,-0.4258986855761595,False,True,1.07129,1.07399,1.07399,1.07379,2024-05-09 10:00:00,True,2024-05-09 10:00:00,,2024-05-09 10:06:28,0.02,even,True,10.9,1126.180000000001,,8,0,19,5
2024-05-08 04:45:00,1.07428,1.07434,1.07395,1.07397,456,12,0,2024-05-08 04:00:00,2024-05-08 04:00:00,-5.142857142859114e-05,-0.00048812105440254605,1.0746191666666662,-0.00011965955020476878,-0.00021825180511593907,1.0749877380952384,1.0757508139607115,1.0793596852407625,1.0754442375238122,1.079595141391661,-0.00021825768250880844,-7.434791123216775e-05,1.0759614410705771,1.0758635406335444,11.897082109523254,13.593817065800252,-0.0003102872448560444,1.0746688431205513,1.0750479024886195,1.0744255899552804,-0.00037905936806814644,-0.000319655483849814,0.0004184781953309087,-0.00015368421052652792,-0.00010809769521791246,-0.00012124527003809504,1.074990535518977,-0.4261393556084163,False,True,1.0709700000000002,1.0736700000000001,1.0736700000000001,1.0734700000000001,2024-05-09 10:45:00,True,2024-05-09 10:45:00,,2024-05-09 13:14:40,0.02,even,True,10.9,1137.080000000001,,9,0,19,5
2024-05-08 05:00:00,1.07395,1.07395,1.07374,1.07392,283,12,0,2024-05-08 05:00:00,2024-05-08 05:00:00,-0.00036857142857216196,-0.0005873925109323164,1.0743027380952384,-0.00019651670006314774,-0.0002951690424088824,1.0746191666666662,1.0761948897897247,1.0794610040909716,1.0757508139607115,1.0793596852407625,-0.00021825180511593907,-0.00011965955020476878,1.0758387674531205,1.075719257382861,9.861271464439275,12.48798933682066,-0.00036570829807129883,1.0745536364866204,1.0749643541561291,1.0742848400412792,-0.0004107176695087311,-0.00033786792098159746,0.0004630269970179842,-0.0001407499140011481,-0.00015368421052652792,-0.00010809769521791246,1.0749099264872535,-0.42634024640469503,False,True,1.07092,1.07362,1.07362,1.07342,2024-05-09 10:45:00,True,2024-05-09 10:45:00,,2024-05-09 13:14:34,0.02,even,True,10.9,1147.9800000000012,,10,0,19,5
2024-05-08 05:15:00,1.07395,1.07418,1.0737700000000001,1.0738,280,12,0,2024-05-08 05:00:00,2024-05-08 05:00:00,-0.00036857142857216196,-0.0005873925109323164,1.0743027380952384,-0.00019651670006314774,-0.0002951690424088824,1.0746191666666662,1.0761948897897247,1.0794610040909716,1.0757508139607115,1.0793596852407625,-0.00021825180511593907,-0.00011965955020476878,1.0758387674531205,1.075719257382861,5.411084843716382,9.056479472559621,-0.00036570829807129883,1.0744376924117556,1.0748781057001195,1.0741547643618858,-0.0004404132883639722,-0.0003583769944580724,0.0005109686878543056,-0.00013007567939338216,-0.0001407499140011481,-0.00015368421052652792,1.0748445720904891,-0.42653504336671744,False,True,1.0708000000000002,1.0735000000000001,1.0735000000000001,1.0733000000000001,2024-05-09 10:45:00,True,2024-05-09 10:45:00,,2024-05-09 13:08:35,0.02,even,True,10.9,1158.8800000000012,,11,0,19,5
2024-05-08 10:45:00,1.07424,1.07431,1.07365,1.0738,691,12,0,2024-05-08 10:00:00,2024-05-08 10:00:00,0.00011428571428684364,-0.0005594841373597337,1.0739973809523804,-0.00011280463319727724,-0.0001679741581828206,1.0740615476190478,1.0749538599576798,1.077347114429695,1.0750750436555592,1.078193800773461,-0.00020936179618885728,-0.0001127998133121281,1.075333721353012,1.0751525510985092,28.893038696960772,37.132482622678346,-0.0005326623660150732,1.074155127408624,1.0742734564020533,1.074211874785002,-0.00011832899342922865,-0.0001479738205211052,0.00020167796103683482,-7.355005159914718e-05,1.264533883627017e-05,-1.6071551426799502e-05,1.0744841400324017,-0.42606039046239763,False,True,1.0708000000000002,1.0735000000000001,1.0735000000000001,1.0733000000000001,2024-05-09 10:45:00,True,2024-05-09 10:45:00,,2024-05-09 13:08:35,0.02,even,True,10.9,1169.7800000000013,,12,0,19,5
2024-05-08 11:00:00,1.07379,1.0741,1.07342,1.07388,824,12,0,2024-05-08 11:00:00,2024-05-08 11:00:00,-6.41666666674201e-05,-0.0005643220994686615,1.0741519047619053,-0.00011527861986275297,-0.00015589945180261475,1.0739973809523804,1.0748457065291477,1.0769979601648734,1.0749538599576798,1.077347114429695,-0.0001679741581828206,-0.00011280463319727724,1.0752696102979793,1.0750875470106285,29.814617552813427,32.56157618672658,-0.0005389943127057908,1.0741128001149896,1.0742443114833826,1.0741625008599935,-0.00013151136839306687,-0.00014468133009549753,0.00020457272537652136,-4.9373925008477926e-05,-7.355005159914718e-05,1.264533883627017e-05,1.0744386740392518,-0.42611367231926467,False,True,1.07088,1.07358,1.07358,1.07338,2024-05-09 10:45:00,True,2024-05-09 10:45:00,,2024-05-09 13:10:23,0.02,even,True,10.9,1180.6800000000014,,13,0,19,5
2024-05-08 11:15:00,1.07387,1.0741,1.07364,1.074,776,12,0,2024-05-08 11:00:00,2024-05-08 11:00:00,-6.41666666674201e-05,-0.0005643220994686615,1.0741519047619053,-0.00011527861986275297,-0.00015589945180261475,1.0739973809523804,1.0748457065291477,1.0769979601648734,1.0749538599576798,1.077347114429695,-0.0001679741581828206,-0.00011280463319727724,1.0752696102979793,1.0750875470106285,28.614826212176297,29.107494153983485,-0.0005389943127057908,1.074095446251145,1.0742262143364654,1.0741344134846922,-0.00013076808532042072,-0.00014189868114048218,0.00020258167069433882,-2.808737530135552e-05,-4.9373925008477926e-05,-7.355005159914718e-05,1.0744078987401295,-0.42613907177074517,False,True,1.0710000000000002,1.0737,1.0737,1.0735000000000001,2024-05-09 10:45:00,True,2024-05-09 10:45:00,,2024-05-09 13:14:50,0.02,even,True,10.9,1191.5800000000015,,14,0,19,5
2024-05-09 10:30:00,1.07368,1.07368,1.07307,1.0731,611,12,0,2024-05-09 10:00:00,2024-05-09 10:00:00,-0.0002610714285724569,-0.0001643661537107377,1.073900119047618,-7.523609072603465e-05,-2.6150703242161653e-05,1.0742149999999993,1.0741057715183329,1.07540731335363,1.0741035715856377,1.0756765000895938,-4.577314020970902e-05,-3.515511922851587e-05,1.0746304851823687,1.074520150279132,12.441045006659287,13.462140835248995,-8.627316115057285e-05,1.0739413883660816,1.0742138937571555,1.0736413347093219,-0.00027250539107392946,-0.0001505516248089553,0.0004409459528112473,-0.00019645682834523726,-0.00010830065359490604,-0.00010154110767124358,1.074236611745617,-0.42695394232697326,False,True,1.0701,1.0728,1.0728,1.0726,2024-05-09 14:45:00,True,2024-05-09 14:45:00,,2024-05-09 14:47:39,0.02,even,True,10.9,1202.4800000000016,,15,0,19,5
2024-05-09 10:45:00,1.07311,1.07344,1.0729,1.0734,650,12,0,2024-05-09 10:00:00,2024-05-09 10:00:00,-0.0002610714285724569,-0.0001643661537107377,1.073900119047618,-7.523609072603465e-05,-2.6150703242161653e-05,1.0742149999999993,1.0741057715183329,1.07540731335363,1.0741035715856377,1.0756765000895938,-4.577314020970902e-05,-3.515511922851587e-05,1.0746304851823687,1.074520150279132,13.49041669386893,13.604854788960495,-8.627316115057285e-05,1.0738580978482228,1.0741536053306995,1.0735264189886484,-0.0002955074824766424,-0.00017954279634249272,0.00047498491200660133,-0.00011491572067345857,-0.00019645682834523726,-0.00010830065359490604,1.0741676486198573,-0.4271148106425604,False,True,1.0704,1.0731,1.0731,1.0729,2024-05-09 11:30:00,True,2024-05-09 11:30:00,,2024-05-09 13:03:31,0.02,even,True,10.9,1213.3800000000017,,16,0,19,5
2024-05-09 11:15:00,1.07311,1.07325,1.07278,1.07281,445,12,0,2024-05-09 11:00:00,2024-05-09 11:00:00,-0.0003148809523811913,-0.0002509376804042951,1.0733880952380954,-9.259352153133185e-05,1.1214304668960335e-05,1.073900119047618,1.074023705954836,1.0749802882365298,1.0741057715183329,1.07540731335363,-2.6150703242161653e-05,-7.523609072603465e-05,1.0745085183964096,1.0743777382568014,13.022551763839752,13.17547091780819,-0.0001192060650013173,1.0735981647315678,1.073981815269804,1.0731813691090466,-0.000383650538236191,-0.0002450923903230048,0.0005966294215287924,-0.00018727554179620576,-0.00015777433780561623,-0.00011491572067345857,1.0739868188281105,-0.42762408061001733,False,True,1.0698100000000001,1.08361,1.07251,1.07231,,False,,,,0.02,running,False,0.0,1213.3800000000017,2024-05-09 14:15:00,0,1,19,5
2024-05-09 11:30:00,1.07276,1.07288,1.0725500000000001,1.07287,721,12,0,2024-05-09 11:00:00,2024-05-09 11:00:00,-0.0003148809523811913,-0.0002509376804042951,1.0733880952380954,-9.259352153133185e-05,1.1214304668960335e-05,1.073900119047618,1.074023705954836,1.0749802882365298,1.0741057715183329,1.07540731335363,-2.6150703242161653e-05,-7.523609072603465e-05,1.0745085183964096,1.0743777382568014,9.9137434736831,11.983246511079578,-0.0001192060650013173,1.0734861393882495,1.0738994585831518,1.0730510491916057,-0.0004133191949022841,-0.00027873775123886065,0.0006472099092517954,-0.0001303199174409464,-0.00018727554179620576,-0.00015777433780561623,1.0739247825690956,-0.4278226841858843,False,True,1.06987,1.08367,1.07257,1.07237,,False,,,,0.02,running,False,0.0,1213.3800000000017,2024-05-09 14:30:00,0,2,19,5
2024-05-09 11:45:00,1.07287,1.07307,1.07254,1.07274,613,12,0,2024-05-09 11:00:00,2024-05-09 11:00:00,-0.0003148809523811913,-0.0002509376804042951,1.0733880952380954,-9.259352153133185e-05,1.1214304668960335e-05,1.073900119047618,1.074023705954836,1.0749802882365298,1.0741057715183329,1.07540731335363,-2.6150703242161653e-05,-7.523609072603465e-05,1.0745085183964096,1.0743777382568014,9.518751966000629,10.818349067841153,-0.0001192060650013173,1.0733713487131342,1.0738135727621776,1.072917450980392,-0.00044222404904337154,-0.0003114350107997628,0.0006969366302854527,-0.0001335982112136147,-0.0001303199174409464,-0.00018727554179620576,1.0738583154312773,-0.4280234134704932,False,True,1.0697400000000001,1.08354,1.07244,1.07224,,False,,,,0.02,running,False,0.0,1213.3800000000017,2024-05-09 14:45:00,0,3,19,5
2024-05-09 12:15:00,1.0727,1.0729,1.07256,1.07268,503,12,0,2024-05-09 12:00:00,2024-05-09 12:00:00,-0.0005120238095226437,-0.0003779269413179964,1.0731046428571425,-0.00010053081620733287,-2.837033811182249e-05,1.0733880952380954,1.0740429845590451,1.0753723948593177,1.074023705954836,1.0749802882365298,1.1214304668960335e-05,-9.259352153133185e-05,1.0744092591450285,1.0742651191962573,8.765966183219701,10.0183107011748,-0.00017095024026465312,1.0731775928656169,1.073653227676764,1.0726809494324043,-0.0004756348111472075,-0.0003685288243694808,0.000756130941019376,-0.00011220158238756106,-0.00012429996560014978,-0.0001335982112136147,1.0737017262027806,-0.42833982733797193,False,True,1.0696800000000002,1.08348,1.07238,1.0721800000000001,,False,,,,0.02,running,False,0.0,1213.3800000000017,2024-05-09 15:15:00,0,4,19,5
2024-05-09 14:30:00,1.07296,1.07298,1.07243,1.07244,1248,12,0,2024-05-09 14:00:00,2024-05-09 14:00:00,-3.5833333332568884e-05,-0.00040788645569977966,1.0728614285714282,-0.00013901495256222278,-9.233447627340659e-05,1.07306880952381,1.0743202068907243,1.075777395184874,1.0742513113939913,1.0758765894096434,-9.23269534469911e-05,-0.00012331020149185972,1.0742360946316014,1.0740737728877123,28.741537236160273,47.941792708815974,-0.0002599190290580433,1.0731266770823786,1.0734100345058275,1.0730628998968006,-0.00028335742344887116,-0.0002884614391306504,0.0005463246897524004,-7.750945992435199e-05,-9.490884072871353e-06,3.853801169539928e-05,1.0738004382279662,-0.42767463843436504,False,True,1.0694400000000002,1.08324,1.07214,1.0719400000000001,,False,,,,0.02,running,False,0.0,1213.3800000000017,2024-05-09 17:30:00,0,5,19,5
2024-05-09 14:45:00,1.07244,1.07315,1.07232,1.07266,1190,12,0,2024-05-09 14:00:00,2024-05-09 14:00:00,-3.5833333332568884e-05,-0.00040788645569977966,1.0728614285714282,-0.00013901495256222278,-9.233447627340659e-05,1.07306880952381,1.0743202068907243,1.075777395184874,1.0742513113939913,1.0758765894096434,-9.23269534469911e-05,-0.00012331020149185972,1.0742360946316014,1.0740737728877123,19.299793238516518,33.30768363492727,-0.0002599190290580433,1.0730548806081666,1.0733544763942848,1.0730340557275542,-0.0002995957861182674,-0.0002906883085281738,0.0005296627857731697,-2.8844169246422524e-05,-7.750945992435199e-05,-9.490884072871353e-06,1.073749100488348,-0.4276809890332396,False,True,1.06966,1.0834599999999999,1.07236,1.07216,,False,,,,0.02,running,False,0.0,1213.3800000000017,2024-05-09 17:45:00,0,6,19,5
2024-05-09 16:00:00,1.07587,1.07587,1.07516,1.07524,1546,12,0,2024-05-09 16:00:00,2024-05-09 16:00:00,0.0009464285714289034,-0.00013792041473048577,1.0747928571428569,-7.170518299274828e-05,0.00010724824323955575,1.073807857142857,1.073314389485529,1.0749777557882956,1.0742094100211947,1.07488923821574,8.039938475545153e-05,-0.00014233627209446354,1.0744666135121506,1.0743825373721598,88.34196891191924,82.42206291748903,-0.0002683775298245539,1.0741218867493485,1.073826293474335,1.0744705091159261,0.00029559327501349486,-4.553776274092816e-05,0.0009441887169945726,0.00030031991743939557,0.0004580667354674439,0.0005739284485717366,2.5757451638838686,1.0731958543479834,True,False,1.0782399999999999,1.07554,1.07554,1.07574,2024-05-09 16:30:00,True,2024-05-09 16:30:00,2024-05-09 22:39:09,,0.02,success,True,109.18,1322.5600000000018,,1,0,19,5
2024-05-09 16:30:00,1.07575,1.07633,1.07565,1.07633,1561,12,0,2024-05-09 16:00:00,2024-05-09 16:00:00,0.0009464285714289034,-0.00013792041473048577,1.0747928571428569,-7.170518299274828e-05,0.00010724824323955575,1.073807857142857,1.073314389485529,1.0749777557882956,1.0742094100211947,1.07488923821574,8.039938475545153e-05,-0.00014233627209446354,1.0744666135121506,1.0743825373721598,88.08290155440459,87.24812895797486,-0.0002683775298245539,1.0746722384418412,1.0741430088085862,1.0752214275885803,0.0005292296332550794,0.00014114619628493336,0.0011888969677674843,0.00040561403508942995,0.00034530443756475293,0.00030031991743939557,2.5768264384950665,1.0736164166820943,True,False,1.07933,1.07663,1.07663,1.07683,2024-05-09 17:30:00,True,2024-05-09 17:30:00,,2024-05-10 15:46:29,0.02,even,True,10.92,1333.4800000000018,,2,0,19,5
2024-05-09 16:45:00,1.07633,1.0767,1.07615,1.07629,1288,12,0,2024-05-09 16:00:00,2024-05-09 16:00:00,0.0009464285714289034,-0.00013792041473048577,1.0747928571428569,-7.170518299274828e-05,0.00010724824323955575,1.073807857142857,1.073314389485529,1.0749777557882956,1.0742094100211947,1.07488923821574,8.039938475545153e-05,-0.00014233627209446354,1.0744666135121506,1.0743825373721598,93.08010189194077,88.82750661798205,-0.0002683775298245539,1.074921124835404,1.0743020451931353,1.0755615342277267,0.000619079642268705,0.00023673288548168773,0.0012964969468919503,0.00034010663914640915,0.00040561403508942995,0.00034530443756475293,2.5773118051060306,1.0738112633494226,True,False,1.0792899999999999,1.07659,1.07659,1.07679,2024-05-09 17:30:00,True,2024-05-09 17:30:00,,2024-05-10 15:52:01,0.02,even,True,10.92,1344.400000000002,,3,0,19,5
2024-05-09 17:00:00,1.0763,1.07706,1.0762,1.07674,1406,12,0,2024-05-09 17:00:00,2024-05-09 17:00:00,0.0009849999999997916,0.00013958750505982387,1.0759752380952374,-7.16948098775457e-05,0.00019078176615451193,1.0747928571428569,1.073237210094574,1.0748948920393242,1.073314389485529,1.0749777557882956,0.00010724824323955575,-7.170518299274828e-05,1.0746629610274956,1.0746327343823872,94.62940485135805,91.9308027659011,-0.00018678452284767835,1.0752009517838035,1.0744826344380882,1.075966570347438,0.0007183173457152581,0.00033304977752840177,0.0014244059580401532,0.0004050361197112107,0.00034010663914640915,0.00040561403508942995,2.5778895183907924,1.0740436223040837,True,False,1.07974,1.07704,1.07704,1.07724,2024-05-09 17:30:00,True,2024-05-09 17:30:00,,2024-05-09 18:52:51,0.02,even,True,10.92,1355.320000000002,,4,0,19,5
2024-05-09 17:15:00,1.07672,1.07753,1.0766,1.07749,1393,12,0,2024-05-09 17:00:00,2024-05-09 17:00:00,0.0009849999999997916,0.00013958750505982387,1.0759752380952374,-7.16948098775457e-05,0.00019078176615451193,1.0747928571428569,1.073237210094574,1.0748948920393242,1.073314389485529,1.0749777557882956,0.00010724824323955575,-7.170518299274828e-05,1.0746629610274956,1.0746327343823872,94.37348674515177,94.02766449615018,-0.00018678452284767835,1.0755531130478337,1.0747054022574891,1.0764452356381156,0.0008477107903446246,0.00043598198009164635,0.0015849684539343913,0.00047866529067763786,0.0004050361197112107,0.00034010663914640915,2.578584943050927,1.0743055282253042,True,False,1.08049,1.07779,1.07779,1.07799,2024-05-09 22:00:00,True,2024-05-09 22:00:00,,2024-05-10 03:22:52,0.02,even,True,10.92,1366.240000000002,,5,0,19,5
2024-05-09 17:30:00,1.07748,1.07796,1.07739,1.07757,1130,12,0,2024-05-09 17:00:00,2024-05-09 17:00:00,0.0009849999999997916,0.00013958750505982387,1.0759752380952374,-7.16948098775457e-05,0.00019078176615451193,1.0747928571428569,1.073237210094574,1.0748948920393242,1.073314389485529,1.0749777557882956,0.00010724824323955575,-7.170518299274828e-05,1.0746629610274956,1.0746327343823872,95.18876573734661,94.7305524446188,-0.00018678452284767835,1.0758634033481669,1.0749175946828602,1.076939360165118,0.0009458086653066911,0.0005379473171346553,0.0017093280356036806,0.0004941245270024819,0.00047866529067763786,0.0004050361197112107,2.579246953013183,1.0746317673170531,True,False,1.0805699999999998,1.0778699999999999,1.0778699999999999,1.0780699999999999,2024-05-09 22:00:00,True,2024-05-09 22:00:00,,2024-05-10 00:00:11,0.02,even,True,10.92,1377.1600000000021,,6,0,19,5
2024-05-09 19:45:00,1.07739,1.07759,1.07729,1.07753,380,12,0,2024-05-09 19:00:00,2024-05-09 19:00:00,0.0007319047619058772,0.0006149735851435079,1.0773228571428575,-6.971223115345014e-05,0.0002265722890027577,1.0767071428571433,1.073062212971067,1.0748077891009526,1.0731604836839634,1.0758517709041595,0.00013986061851670954,-7.170991289755265e-05,1.0749865663102225,1.0750358023812527,76.8108143578968,76.24156989338277,7.762122765652283e-05,1.07707688221389,1.0761762899482916,1.077778630890953,0.0009005922655984655,0.0009158479032362158,0.0019133210220198633,-0.00015248366013032033,-0.00012057791537722906,-9.78396972821649e-05,1.0803616142706798,-0.4248043524887739,True,False,1.08053,1.07783,1.07783,1.07803,2024-05-09 22:00:00,True,2024-05-09 22:00:00,,2024-05-10 00:00:11,0.02,even,True,10.92,1388.0800000000022,,7,0,19,5
2024-05-09 20:00:00,1.07752,1.07789,1.07729,1.07788,703,12,0,2024-05-09 20:00:00,2024-05-09 20:00:00,0.000615714285714164,0.0007678076809476408,1.0777329761904761,3.7565510604705805e-05,0.00024241025751693592,1.0773228571428575,1.0719605331940043,1.0748483432274143,1.073062212971067,1.0748077891009526,0.0002265722890027577,-6.971223115345014e-05,1.0751596910644017,1.0752465381907526,80.7671723978552,78.03510598182024,0.00021565851831474646,1.0772004387963685,1.0763024906928627,1.0778844994840033,0.0008979481035058523,0.0009122679432901431,0.0018872499392776315,0.00010586859305039553,-0.00015248366013032033,-0.00012057791537722906,2.5804322869020284,1.0753367120659785,True,False,1.0808799999999998,1.07818,1.07818,1.07838,2024-05-10 01:15:00,True,2024-05-10 01:15:00,,2024-05-10 02:41:20,0.02,even,True,10.92,1399.0000000000023,,8,0,19,5
2024-05-09 20:15:00,1.07789,1.07795,1.07764,1.07791,619,12,0,2024-05-09 20:00:00,2024-05-09 20:00:00,0.000615714285714164,0.0007678076809476408,1.0777329761904761,3.7565510604705805e-05,0.00024241025751693592,1.0773228571428575,1.0719605331940043,1.0748483432274143,1.073062212971067,1.0748077891009526,0.0002265722890027577,-6.971223115345014e-05,1.0751596910644017,1.0752465381907526,85.15088086516334,80.90962254030511,0.00021565851831474646,1.0773096020584656,1.0764215654563543,1.0779472273821804,0.0008880366021113417,0.0009074216750543829,0.0018289124272739383,6.272789817707292e-05,0.00010586859305039553,-0.00015248366013032033,2.5804162591590005,1.0754781956053605,True,False,1.0809099999999998,1.07821,1.07821,1.0784099999999999,2024-05-10 01:15:00,True,2024-05-10 01:15:00,,2024-05-10 01:43:10,0.02,even,True,10.92,1409.9200000000023,,9,0,19,5
2024-05-09 20:30:00,1.07791,1.07792,1.07769,1.07789,387,12,0,2024-05-09 20:00:00,2024-05-09 20:00:00,0.000615714285714164,0.0007678076809476408,1.0777329761904761,3.7565510604705805e-05,0.00024241025751693592,1.0773228571428575,1.0719605331940043,1.0748483432274143,1.073062212971067,1.0748077891009526,0.0002265722890027577,-6.971223115345014e-05,1.0751596910644017,1.0752465381907526,88.23931623931145,84.71912316744333,0.00021565851831474646,1.077398894049471,1.0765303383855132,1.077917746818025,0.0008685556639578262,0.0008996484728350716,0.0017292453074402147,-2.9480564155415223e-05,6.272789817707292e-05,0.00010586859305039553,1.0802522279830693,-0.4244167343470193,True,False,1.08089,1.07819,1.07819,1.07839,2024-05-10 01:15:00,True,2024-05-10 01:15:00,,2024-05-10 01:43:11,0.02,even,True,10.92,1420.8400000000024,,10,0,19,5
2024-05-09 21:30:00,1.07778,1.07789,1.07769,1.07786,314,12,0,2024-05-09 21:00:00,2024-05-09 21:00:00,0.00041011904761867335,0.0008700681007394184,1.0780728571428568,0.00019058913579465375,0.00024061112152844478,1.0777329761904761,1.0707016129181661,1.075119455448059,1.0719605331940043,1.0748483432274143,0.00024241025751693592,3.7565510604705805e-05,1.075350033576376,1.0754756151354923,71.06229508196746,68.62076502731985,0.00034654043479968085,1.0775611570945804,1.0768462617521815,1.0777329480564153,0.0007148953423989912,0.0008138041512931055,0.0007814019452061311,-1.0687994496771935e-05,-4.579635362778056e-05,-6.239422084641788e-05,1.0787878406824436,-0.42332194456961303,True,False,1.08086,1.07816,1.07816,1.07836,2024-05-10 01:15:00,True,2024-05-10 01:15:00,,2024-05-10 02:42:31,0.02,even,True,10.92,1431.7600000000025,,11,0,19,5
2024-05-09 21:45:00,1.07783,1.07821,1.07782,1.07811,323,12,0,2024-05-09 21:00:00,2024-05-09 21:00:00,0.00041011904761867335,0.0008700681007394184,1.0780728571428568,0.00019058913579465375,0.00024061112152844478,1.0777329761904761,1.0707016129181661,1.075119455448059,1.0719605331940043,1.0748483432274143,0.00024241025751693592,3.7565510604705805e-05,1.075350033576376,1.0754756151354923,83.01131468981042,73.13564770170277,0.00034654043479968085,1.077645594464645,1.0769398719927605,1.0778203336773307,0.0007057224718844957,0.0007921878154113837,0.0007706864904996783,8.738562091537005e-05,-1.0687994496771935e-05,-4.579635362778056e-05,2.5788607604395053,1.076779906915156,True,False,1.0811099999999998,1.06731,1.0784099999999999,1.0786099999999998,,False,,,,0.02,running,False,0.0,1431.7600000000025,2024-05-10 00:45:00,0,1,19,5
2024-05-09 22:00:00,1.0781,1.07822,1.07802,1.07806,290,12,0,2024-05-09 22:00:00,2024-05-09 22:00:00,0.00033988095238068894,0.000968172388478461,1.0780425,0.0002883987941157411,0.00027493343640712424,1.0780728571428568,1.0701912949106815,1.0750122421590442,1.0707016129181661,1.075119455448059,0.00024061112152844478,0.00019058913579465375,1.0755313217327387,1.0756903659246528,87.91837065088076,80.66399347421954,0.0004708668255354369,1.077709349162392,1.0770228444377412,1.0778960853113178,0.000686504724650705,0.000771051197259248,0.0007312348003928102,7.575163398709783e-05,8.738562091537005e-05,-1.0687994496771935e-05,2.578883252291848,1.0769089183307874,True,False,1.08106,1.07836,1.07836,1.07856,2024-05-10 17:00:00,True,2024-05-10 17:00:00,,2024-05-10 17:00:00,0.02,even,True,10.92,1442.6800000000026,,1,0,19,5
2024-05-09 22:15:00,1.07808,1.07815,1.07801,1.07808,247,12,0,2024-05-09 22:00:00,2024-05-09 22:00:00,0.00033988095238068894,0.000968172388478461,1.0780425,0.0002883987941157411,0.00027493343640712424,1.0780728571428568,1.0701912949106815,1.0750122421590442,1.0707016129181661,1.075119455448059,0.00024061112152844478,0.00019058913579465375,1.0755313217327387,1.0756903659246528,89.92274223558054,86.95080919209056,0.0004708668255354369,1.0777663723681778,1.0771011522571678,1.0779625042999663,0.0006652201110100009,0.0007498849800093986,0.0006027915615193776,6.641898864856444e-05,7.575163398709783e-05,8.738562091537005e-05,2.5787762729080175,1.0771487356919152,True,False,1.0810799999999998,1.07838,1.07838,1.0785799999999999,2024-05-10 17:00:00,True,2024-05-10 17:00:00,,2024-05-10 17:00:00,0.02,even,True,10.92,1453.6000000000026,,2,0,19,5
2024-05-10 01:30:00,1.07825,1.07832,1.07819,1.07825,123,13,0,2024-05-10 01:00:00,2024-05-10 01:00:00,-2.035714285630874e-05,0.0009891320348789368,1.0782824999999994,0.0005012782168652587,0.0003356928638702841,1.0781082142857148,1.0699953893086587,1.0754571752408004,1.0692996418132383,1.0745437091151873,0.00040054280001099553,0.0005264256484507739,1.0760121105615714,1.0762423131011363,70.83333333333972,68.02328912531117,0.0007327341122699281,1.0781427741594796,1.0777823648741969,1.0782406742346062,0.00036040928528269234,0.00044334458388994635,0.0002570590074403782,-1.5459236325732206e-05,7.636738905691942e-06,6.809425524556545e-05,1.0785877038946508,-0.4221063554254383,True,False,1.0812499999999998,1.07855,1.07855,1.0787499999999999,2024-05-13 14:45:00,True,2024-05-13 14:45:00,2024-05-14 16:08:38,2024-05-14 03:41:44,0.02,even,True,10.92,1464.5200000000027,,3,0,19,5
2024-05-10 02:00:00,1.07842,1.07847,1.07829,1.07842,104,12,0,2024-05-10 02:00:00,2024-05-10 02:00:00,0.00017428571428457218,0.000982902188188639,1.0782325000000001,0.0004590781652739226,0.0002509876485629827,1.0782824999999994,1.0707090727554482,1.076358211672167,1.0699953893086587,1.0754571752408004,0.0003356928638702841,0.0005012782168652587,1.0761474582672765,1.0763917280530453,75.46296296295822,71.60493827160603,0.0007827677274536704,1.078217607534302,1.0778712730402924,1.078283474372205,0.0003463344940095592,0.0004095568757969911,0.0002212976878317228,2.352597179200444e-05,1.927416580671526e-05,-1.5459236325732206e-05,2.578582226250778,1.077984722493632,True,False,1.0814199999999998,1.07872,1.07872,1.0789199999999999,2024-05-13 15:15:00,True,2024-05-13 15:15:00,2024-05-14 16:09:15,2024-05-13 20:13:32,0.02,even,True,10.92,1475.4400000000028,,4,0,19,5
2024-05-10 02:15:00,1.0784,1.0784,1.07829,1.07837,82,12,0,2024-05-10 02:00:00,2024-05-10 02:00:00,0.00017428571428457218,0.000982902188188639,1.0782325000000001,0.0004590781652739226,0.0002509876485629827,1.0782824999999994,1.0707090727554482,1.076358211672167,1.0699953893086587,1.0754571752408004,0.0003356928638702841,0.0005012782168652587,1.0761474582672765,1.0763917280530453,81.01851851851892,74.9999999999991,0.0007827677274536704,1.0782410525290247,1.0779082157780486,1.0783118507051945,0.00033283675097606213,0.0003942128508328053,0.0002251392161301298,2.837633298957698e-05,2.352597179200444e-05,1.927416580671526e-05,2.57861578864697,1.0780079127634188,True,False,1.08137,1.07867,1.07867,1.07887,2024-05-13 15:00:00,True,2024-05-13 15:00:00,2024-05-14 16:09:14,2024-05-13 20:14:39,0.02,even,True,10.92,1486.3600000000029,,5,0,19,5
2024-05-10 15:45:00,1.07685,1.07712,1.07656,1.07693,925,12,0,2024-05-10 15:00:00,2024-05-10 15:00:00,2.7023809524573394e-05,0.0002721432369487964,1.0775996428571424,-6.506279408284316e-05,8.413547501756784e-06,1.0779361904761913,1.0776059765568466,1.0785108528394423,1.0775285434337765,1.0785018298589617,8.41019112838154e-06,-4.195029680552871e-05,1.0770094539749222,1.0772135302261487,16.071207496089638,25.875572412448154,0.0003856348628815882,1.0775737936075842,1.0777202531669805,1.0773784004127973,-0.00014645955939629474,-3.1708495214379305e-05,0.0003834044861147786,-0.0001625455796341324,-0.00018762985896114692,-3.849329205385388e-05,1.0778959964690522,-0.4231391956434576,False,True,1.07393,1.07663,1.07663,1.07643,2024-05-10 17:30:00,True,2024-05-10 17:30:00,,2024-05-10 17:38:34,0.02,even,True,10.9,1497.260000000003,,6,0,19,5
2024-05-10 17:30:00,1.0762,1.0768,1.0762,1.07657,937,12,0,2024-05-10 17:00:00,2024-05-10 17:00:00,0.0002623809523811804,0.0002376014755893774,1.0773258333333329,-0.0001006715058594804,3.1833682327291495e-05,1.0778620238095236,1.0775780254779517,1.0784617795865534,1.0775358992667827,1.0785214120806335,2.60002841469775e-05,-6.507211271650207e-05,1.0770604066523515,1.0772434199834124,16.638655462182623,42.93979599008105,0.0003175985964487582,1.0773693984861779,1.0775764226037656,1.0772222153422772,-0.00020702411758777295,-9.136256749949043e-05,0.0005898728676357826,-0.00018674922600703248,-0.0002696904024761526,-2.9704162366916975e-05,1.0780185437135856,-0.42357411302903114,False,True,1.0735700000000001,1.08737,1.07627,1.07607,,False,,,,0.02,running,False,0.0,1497.260000000003,2024-05-10 20:30:00,0,1,19,5
2024-05-10 17:45:00,1.0765500000000001,1.07657,1.07596,1.07633,911,12,0,2024-05-10 17:00:00,2024-05-10 17:00:00,0.0002623809523811804,0.0002376014755893774,1.0773258333333329,-0.0001006715058594804,3.1833682327291495e-05,1.0778620238095236,1.0775780254779517,1.0784617795865534,1.0775358992667827,1.0785214120806335,2.60002841469775e-05,-6.507211271650207e-05,1.0770604066523515,1.0772434199834124,9.852988175133575,22.10085600235459,0.0003175985964487582,1.0772094910267658,1.0774840950034867,1.0770278809769527,-0.00027460397672096626,-0.00012801084934378559,0.0006480478377194346,-0.0001943343653245666,-0.00018674922600703248,-0.0002696904024761526,1.077902745557874,-0.42384698360396866,False,True,1.0733300000000001,1.08713,1.07603,1.07583,,False,,,,0.02,running,False,0.0,1497.260000000003,2024-05-10 20:45:00,0,2,19,5
2024-05-10 23:00:00,1.07712,1.07715,1.07701,1.07702,149,11,0,2024-05-10 23:00:00,2024-05-10 23:00:00,-1.5476190475371965e-05,-4.0441303835070386e-05,1.0769755952380962,-0.00011142107832839214,-1.7812142259429465e-05,1.0772340476190478,1.0770306388131634,1.079081553433759,1.0773204667950247,1.079100752393996,-1.781085807647594e-05,-0.0001273080460038428,1.0770933105749028,1.0772084274429332,21.180555555558822,31.759699564832825,7.82395464806107e-05,1.077198419945459,1.077273747985761,1.0771438011695904,-7.532804030208062e-05,-7.242529766214869e-05,0.0003676615290898304,-7.673890608916878e-05,-6.817681458470837e-05,-5.5080839353127686e-05,1.0776401442338617,-0.42335254189468086,False,True,1.0740200000000002,1.08782,1.0767200000000001,1.0765200000000001,,False,,,2024-05-15 20:34:07,0.02,fail,False,-392.42,1104.8400000000029,,0,3,19,5
2024-05-10 23:30:00,1.0771,1.07714,1.07688,1.07691,80,11,0,2024-05-10 23:00:00,2024-05-10 23:00:00,-1.5476190475371965e-05,-4.0441303835070386e-05,1.0769755952380962,-0.00011142107832839214,-1.7812142259429465e-05,1.0772340476190478,1.0770306388131634,1.079081553433759,1.0773204667950247,1.079100752393996,-1.781085807647594e-05,-0.0001273080460038428,1.0770933105749028,1.0772084274429332,13.434829059827992,18.019943019944638,7.82395464806107e-05,1.0771412355822516,1.077234886819068,1.0770347265221865,-9.365123681637222e-05,-7.749833373989113e-05,0.000313609629910593,-6.056759545991497e-05,-4.8507051944035595e-05,-7.673890608916878e-05,1.0774580995225658,-0.42338864647819285,False,True,1.0739100000000001,1.08771,1.07661,1.07641,,False,,,2024-05-15 20:12:40,0.02,fail,False,-392.42,712.4200000000028,,0,4,19,5
2024-05-10 23:45:00,1.07691,1.07704,1.07664,1.07666,447,11,0,2024-05-10 23:00:00,2024-05-10 23:00:00,-1.5476190475371965e-05,-4.0441303835070386e-05,1.0769755952380962,-0.00011142107832839214,-1.7812142259429465e-05,1.0772340476190478,1.0770306388131634,1.079081553433759,1.0773204667950247,1.079100752393996,-1.781085807647594e-05,-0.0001273080460038428,1.0770933105749028,1.0772084274429332,10.268979386619899,14.382750963631663,7.82395464806107e-05,1.0770671993388283,1.0771923026102481,1.0769311455108346,-0.00012510327141979083,-8.701932127587107e-05,0.0003071823562196527,-0.00010358101135188313,-6.056759545991497e-05,-4.8507051944035595e-05,1.0773458416917312,-0.42348355067006205,False,True,1.07366,1.0874599999999999,1.07636,1.07616,,False,,,,0.02,running,False,0.0,712.4200000000028,2024-05-11 02:45:00,0,5,19,5
2024-05-13 11:45:00,1.07786,1.0784,1.07785,1.07831,500,12,0,2024-05-13 11:00:00,2024-05-13 11:00:00,0.0001660714285720566,-6.865669285538445e-06,1.077605833333333,-1.1286492954333938e-05,4.580707847051821e-05,1.0772139285714284,1.0766184396131484,1.077663001041867,1.0766305980009045,1.0778595660580965,3.7564866990188453e-06,-1.1286300317989611e-05,1.0771607183419218,1.0772232211139998,86.49550288598475,82.21652333218783,-6.270958820531436e-05,1.0776021134625793,1.0773702579466578,1.0778057619539045,0.00023185551592153075,0.00013159796310859343,0.0003591573470960522,0.00016327141382954657,9.835569315241877e-05,6.435156518813656e-05,2.5782906243724844,1.077320899535325,True,False,1.08131,1.07861,1.07861,1.07881,2024-05-13 15:00:00,True,2024-05-13 15:00:00,2024-05-14 16:08:38,2024-05-13 22:23:12,0.02,even,True,10.92,723.3400000000028,,1,0,20,5
2024-05-13 12:00:00,1.0783,1.07882,1.0783,1.07849,584,12,0,2024-05-13 12:00:00,2024-05-13 12:00:00,0.00039190476190453793,0.00012434441288178277,1.0778763095238084,2.3205739498222117e-05,8.749875756659363e-05,1.077605833333333,1.0763120498901562,1.0774120974027037,1.0766184396131484,1.077663001041867,4.580707847051821e-05,-1.1286492954333938e-05,1.0772290590940559,1.0773029634248799,90.03187507907334,87.20212333352212,-2.5298787987894933e-05,1.0777387113914132,1.0774532018024607,1.077987774337806,0.0002855095889524595,0.00016238028827736666,0.0004306727295443342,0.00018201238390136432,0.00016327141382954657,9.835569315241877e-05,2.578569182522691,1.077406366152921,True,False,1.0814899999999998,1.07879,1.07879,1.07899,2024-05-13 15:15:00,True,2024-05-13 15:15:00,2024-05-14 16:09:29,2024-05-13 20:10:23,0.02,even,True,10.92,734.2600000000027,,2,0,20,5
2024-05-13 14:30:00,1.07849,1.07883,1.07845,1.0788,361,12,0,2024-05-13 14:00:00,2024-05-13 14:00:00,0.00018059523809621503,0.00023734569848166132,1.0784365476190476,5.930135205264945e-05,0.00013791980181978238,1.0780569047619046,1.0761426348920673,1.0771605679918874,1.0760787880877472,1.0775063343219928,8.750068581843386e-05,5.9300294002420606e-05,1.0773874908408958,1.0774869882428184,83.65800865801164,70.69978093294677,6.359588717476913e-05,1.0782503553797251,1.0779260415840017,1.0785095356037153,0.0003243137957233966,0.00028928069528361025,0.0005445466003697729,4.857585139328435e-05,1.5276917783912936e-05,5.305813553535543e-05,2.5792446735142143,1.0777743976932161,True,False,1.0817999999999999,1.0791,1.0791,1.0793,2024-05-13 15:15:00,True,2024-05-13 15:15:00,2024-05-14 16:12:35,2024-05-13 18:04:07,0.02,even,True,10.92,745.1800000000027,,3,0,20,5
2024-05-13 14:45:00,1.07879,1.07938,1.07871,1.07887,647,12,0,2024-05-13 14:00:00,2024-05-13 14:00:00,0.00018059523809621503,0.00023734569848166132,1.0784365476190476,5.930135205264945e-05,0.00013791980181978238,1.0780569047619046,1.0761426348920673,1.0771605679918874,1.0760787880877472,1.0775063343219928,8.750068581843386e-05,5.9300294002420606e-05,1.0773874908408958,1.0774869882428184,82.27859710910552,78.2559248660969,6.359588717476913e-05,1.078345685321306,1.0779959644296313,1.0786023460612317,0.00034972089167473186,0.0003013687345618346,0.0005683581617030465,9.281045751641237e-05,4.857585139328435e-05,1.5276917783912936e-05,2.5793696295795305,1.0778350625429327,True,False,1.0818699999999999,1.07917,1.07917,1.07937,2024-05-13 15:15:00,True,2024-05-13 15:15:00,2024-05-14 16:12:40,2024-05-13 18:04:06,0.02,even,True,10.92,756.1000000000026,,4,0,20,5
2024-05-13 15:00:00,1.07887,1.07969,1.07882,1.07955,697,12,0,2024-05-13 15:00:00,2024-05-13 15:00:00,0.00037964285714298107,0.00034148616257145825,1.0789764285714287,5.9307520885352225e-05,0.00017001814123185528,1.0784365476190476,1.0762064396527256,1.0771635218809659,1.0761426348920673,1.0771605679918874,0.00013791980181978238,5.930135205264945e-05,1.0775399107866446,1.0776680291833929,87.33905389370047,84.4252198869392,0.00011917394225410695,1.0785309645026435,1.0781110781755845,1.0788141795665642,0.00041988632705902695,0.0003250722530612731,0.0006393311609080962,0.00021183350533249268,9.281045751641237e-05,4.857585139328435e-05,2.57967727663379,1.0779510824993384,True,False,1.08255,1.07985,1.07985,1.08005,2024-05-13 16:30:00,True,2024-05-13 16:30:00,2024-05-15 05:41:39,2024-05-13 17:08:03,0.02,even,True,10.92,767.0200000000026,,5,0,20,5
2024-05-13 15:15:00,1.07957,1.07978,1.07948,1.07961,702,12,0,2024-05-13 15:00:00,2024-05-13 15:00:00,0.00037964285714298107,0.00034148616257145825,1.0789764285714287,5.9307520885352225e-05,0.00017001814123185528,1.0784365476190476,1.0762064396527256,1.0771635218809659,1.0761426348920673,1.0771605679918874,0.00013791980181978238,5.930135205264945e-05,1.0775399107866446,1.0776680291833929,85.42367367643264,85.01377489307954,0.00011917394225410695,1.0786969699637754,1.0782221094218376,1.078990302717578,0.0004748605419377938,0.00035502991083657726,0.0006921945776357873,0.00017612315101378506,0.00021183350533249268,9.281045751641237e-05,2.5799247653973865,1.0780558400377698,True,False,1.0826099999999999,1.07991,1.07991,1.08011,2024-05-13 16:30:00,True,2024-05-13 16:30:00,2024-05-15 06:09:29,2024-05-13 17:08:03,0.02,even,True,10.92,777.9400000000026,,6,0,20,5
2024-05-13 15:30:00,1.0796000000000001,1.07978,1.07948,1.07956,582,12,0,2024-05-13 15:00:00,2024-05-13 15:00:00,0.00037964285714298107,0.00034148616257145825,1.0789764285714287,5.9307520885352225e-05,0.00017001814123185528,1.0784365476190476,1.0762064396527256,1.0771635218809659,1.0761426348920673,1.0771605679918874,0.00013791980181978238,5.930135205264945e-05,1.0775399107866446,1.0776680291833929,91.56907395359015,88.11060050790775,0.00011917394225410695,1.0788297438155023,1.0783212124276274,1.0791527726178187,0.0005085313878749886,0.00038573020624425955,0.0007309297731715829,0.00016246990024071373,0.00017612315101378506,0.00021183350533249268,2.5801395278116006,1.078166017424037,True,False,1.08256,1.07986,1.07986,1.08006,2024-05-13 16:30:00,True,2024-05-13 16:30:00,2024-05-15 05:41:39,2024-05-13 17:08:03,0.02,even,True,10.92,788.8600000000025,,7,0,20,5
2024-05-13 15:45:00,1.07957,1.0799,1.0794,1.07975,653,12,0,2024-05-13 15:00:00,2024-05-13 15:00:00,0.00037964285714298107,0.00034148616257145825,1.0789764285714287,5.9307520885352225e-05,0.00017001814123185528,1.0784365476190476,1.0762064396527256,1.0771635218809659,1.0761426348920673,1.0771605679918874,0.00013791980181978238,5.930135205264945e-05,1.0775399107866446,1.0776680291833929,91.63578167115905,89.54284310039395,0.00011917394225410695,1.0789713216900405,1.0784270485440994,1.0793063226694186,0.0005442731459410766,0.000417438794183623,0.0007664948358005759,0.00015355005159989332,0.00016246990024071373,0.00017612315101378506,2.5803410906977495,1.078271554641088,True,False,1.0827499999999999,1.08005,1.08005,1.08025,2024-05-13 16:30:00,True,2024-05-13 16:30:00,2024-05-15 09:01:38,2024-05-13 17:07:36,0.02,even,True,10.92,799.7800000000025,,8,0,20,5
2024-05-13 16:00:00,1.07976,1.08006,1.07962,1.08004,827,12,0,2024-05-13 16:00:00,2024-05-13 16:00:00,0.000539880952381111,0.0005028305287921864,1.0795933333333336,9.474435302997835e-05,0.0002095001320271133,1.0789764285714287,1.0759300481248824,1.0772469193819645,1.0762064396527256,1.0771635218809659,0.00017001814123185528,5.9307520885352225e-05,1.0777205617036354,1.0778817868487214,94.0309598682224,92.4119384976572,0.00019590525956172285,1.0791357337377265,1.0785465264297218,1.079504045407636,0.0005892073080047133,0.00045179249694784113,0.0007899310096305745,0.00019772273821727637,0.00015355005159989332,0.00016246990024071373,2.580570452270637,1.0784376385446346,True,False,1.0830399999999998,1.0803399999999999,1.0803399999999999,1.0805399999999998,2024-05-14 16:15:00,True,2024-05-14 16:15:00,2024-05-15 10:00:21,,0.02,success,True,109.18,908.9600000000025,,9,0,20,5
2024-05-13 16:15:00,1.08005,1.08035,1.08005,1.08031,817,12,0,2024-05-13 16:00:00,2024-05-13 16:00:00,0.000539880952381111,0.0005028305287921864,1.0795933333333336,9.474435302997835e-05,0.0002095001320271133,1.0789764285714287,1.0759300481248824,1.0772469193819645,1.0762064396527256,1.0771635218809659,0.00017001814123185528,5.9307520885352225e-05,1.0777205617036354,1.0778817868487214,96.9944164158838,94.22038598508841,0.00019590525956172285,1.0793163900857685,1.0786771541015943,1.0797589645682841,0.0006392359841742579,0.0004892811943931245,0.0008131201223126542,0.00025491916064823705,0.00019772273821727637,0.00015355005159989332,2.580856676733406,1.078661252403162,True,False,1.08331,1.08061,1.08061,1.08081,2024-05-14 16:15:00,True,2024-05-14 16:15:00,2024-05-15 11:27:15,,0.02,success,True,109.18,1018.1400000000026,,10,0,20,5
2024-05-13 17:30:00,1.08025,1.08043,1.07995,1.08041,741,12,0,2024-05-13 17:00:00,2024-05-13 17:00:00,0.0006169047619049017,0.0006675172380612437,1.079975357142857,0.00015693414393890361,0.0002084760282371571,1.0795933333333336,1.075501944237939,1.0774773540269758,1.0759300481248824,1.0772469193819645,0.0002095001320271133,9.474435302997835e-05,1.077888267400175,1.0780768439008237,82.33178601497774,82.32568991273097,0.0002902276552616271,1.0798250964055427,1.0791658561619626,1.0805212280701748,0.0006592402435801059,0.0006042714690741204,0.0008920198054479209,0.00013655314757365922,0.00012836257309989385,6.284485724084021e-05,2.5817254548075295,1.0793170013328202,True,False,1.08341,1.08071,1.08071,1.08091,2024-05-14 16:15:00,True,2024-05-14 16:15:00,2024-05-15 15:06:21,,0.02,success,True,109.18,1127.3200000000027,,11,0,20,5
2024-05-13 17:45:00,1.08041,1.08048,1.08018,1.08032,757,12,0,2024-05-13 17:00:00,2024-05-13 17:00:00,0.0006169047619049017,0.0006675172380612437,1.079975357142857,0.00015693414393890361,0.0002084760282371571,1.0795933333333336,1.075501944237939,1.0774773540269758,1.0759300481248824,1.0772469193819645,0.0002095001320271133,9.474435302997835e-05,1.077888267400175,1.0780768439008237,87.7819706162655,84.12085497722119,0.0002902276552616271,1.0799012354200745,1.0792513482981134,1.0805901444788444,0.0006498871219611235,0.0006133945996515211,0.0008905079074953078,6.89164086695726e-05,0.00013655314757365922,0.00012836257309989385,2.581792330153963,1.0793879588037256,True,False,1.0833199999999998,1.08062,1.08062,1.08082,2024-05-14 16:15:00,True,2024-05-14 16:15:00,2024-05-15 11:27:15,,0.02,success,True,109.18,1236.5000000000027,,12,0,20,5
2024-05-14 11:15:00,1.07765,1.0778,1.07746,1.07768,916,12,0,2024-05-14 11:00:00,2024-05-14 11:00:00,5.0119047618757406e-05,-1.2647677423371917e-05,1.0785139285714282,-7.301454240499074e-05,-5.0357624419770636e-05,1.0786147619047617,1.0786347630805673,1.07962205665611,1.0786599538923582,1.079824896468414,-6.242545422841004e-05,-3.004461248462541e-05,1.0784824896281968,1.0785766956612637,26.88149096599966,47.68103570920604,7.311871629464113e-05,1.0783568548748104,1.0785042318175564,1.0782858685930512,-0.00014737694274602475,-6.777915044641119e-05,0.0002859999999567086,-0.00015217750258011975,-0.00017683178534544375,6.233230134933265e-06,1.0786719685929929,-0.42210023140689046,False,True,1.07468,1.08848,1.07738,1.07718,,False,,,2024-05-15 23:17:14,0.02,fail,False,-392.42,844.0800000000027,,0,1,20,5
2024-05-14 11:30:00,1.07769,1.07818,1.0776,1.0781,655,12,0,2024-05-14 11:00:00,2024-05-14 11:00:00,5.0119047618757406e-05,-1.2647677423371917e-05,1.0785139285714282,-7.301454240499074e-05,-5.0357624419770636e-05,1.0786147619047617,1.0786347630805673,1.07962205665611,1.0786599538923582,1.079824896468414,-6.242545422841004e-05,-3.004461248462541e-05,1.0784824896281968,1.0785766956612637,20.187793427227085,30.336226110873714,7.311871629464113e-05,1.078317338740224,1.0784742887199597,1.0782353973168208,-0.00015694997973558777,-8.56133163042465e-05,0.000297936234746913,-5.047127623036829e-05,-0.00015217750258011975,-0.00017683178534544375,1.0786376112337293,-0.4221668166000876,False,True,1.0751000000000002,1.0889,1.0778,1.0776000000000001,,False,,,2024-05-16 01:41:21,0.02,fail,False,-392.42,451.66000000000264,,0,2,20,5
2024-05-14 14:30:00,1.07964,1.07983,1.07961,1.07965,302,12,0,2024-05-14 14:00:00,2024-05-14 14:00:00,0.00029678571428504164,0.00011078780235540542,1.0791660714285713,-9.703629751455565e-05,4.5531490710267865e-05,1.0790321428571426,1.0787073852355278,1.0791456366357521,1.0786138664928713,1.079096474012784,4.553428625805251e-05,-8.282159996160528e-05,1.0786348877023968,1.0787418135110782,92.26441631504844,91.97314246192525,5.613791970664954e-05,1.0792664702824926,1.0789823523259772,1.079625923632611,0.00028411795651539506,0.0001691628745163283,0.0005676595223460545,0.00013844513243888024,0.00014742346061291656,0.0001558892328858974,2.580392263987778,1.0788595832774437,True,False,1.08265,1.07995,1.07995,1.08015,2024-05-14 15:45:00,True,2024-05-14 15:45:00,2024-05-15 06:31:19,2024-05-14 15:48:21,0.02,even,True,10.92,462.58000000000266,,1,0,20,5
2024-05-14 15:30:00,1.07954,1.0808200000000001,1.0766,1.08045,4173,12,0,2024-05-14 15:00:00,2024-05-14 15:00:00,0.00013392857142879855,0.00013010547031799824,1.0795854761904764,-0.00012439840693795562,0.00012111830225126665,1.0791660714285713,1.0786004291274232,1.079037954938751,1.0787073852355278,1.0791456366357521,4.5531490710267865e-05,-9.703629751455565e-05,1.0787384433345002,1.078861668430192,88.87935721466114,85.87034450831528,7.093142982891927e-05,1.0795301232942114,1.0791902282235182,1.0800149673202617,0.000339895070693208,0.00024290201783550724,0.0006682065548749393,0.00013869625043083644,7.459924320585287e-05,0.00012965944272380625,2.580917046169343,1.0791128884711805,True,False,1.0834499999999998,1.0807499999999999,1.0807499999999999,1.0809499999999999,2024-05-14 16:15:00,True,2024-05-14 16:15:00,2024-05-15 15:06:21,,0.02,success,True,109.18,571.7600000000027,,2,0,20,5
2024-05-14 16:00:00,1.08024,1.08213,1.08002,1.0819,2223,12,0,2024-05-14 16:00:00,2024-05-14 16:00:00,0.00041940476190505116,0.0002558039698894454,1.0804415476190468,-0.00014319692707686526,0.00019237759697642728,1.0795854761904764,1.0787483362341546,1.0790979639147604,1.0786004291274232,1.079037954938751,0.00012111830225126665,-0.00012439840693795562,1.0789378986032423,1.0790991349557766,89.99627100692732,87.92159002358453,0.0001079059378410245,1.0799871296958554,1.0794629528665278,1.0804435328517377,0.0005241768293275939,0.0003197080171605339,0.0008985716443216992,0.00036900584795351854,5.955968352244767e-05,0.00013869625043083644,2.581656604571572,1.0792304611319035,True,False,1.0849,1.0822,1.0822,1.0824,2024-05-14 18:00:00,True,2024-05-14 18:00:00,2024-05-15 15:30:05,2024-05-14 18:03:12,0.02,even,True,10.92,582.6800000000027,,3,0,20,5
2024-05-14 16:15:00,1.08191,1.0822,1.08114,1.08149,1678,12,0,2024-05-14 16:00:00,2024-05-14 16:00:00,0.00041940476190505116,0.0002558039698894454,1.0804415476190468,-0.00014319692707686526,0.00019237759697642728,1.0795854761904764,1.0787483362341546,1.0790979639147604,1.0786004291274232,1.079037954938751,0.00012111830225126665,-0.00012439840693795562,1.0789378986032423,1.0790991349557766,88.69267136802125,87.8593614080379,0.0001079059378410245,1.0802183405118777,1.0796131045060442,1.0806952906776752,0.0006052360058335093,0.000376813614895129,0.001001894039630118,0.0002517578259375597,0.00036900584795351854,5.955968352244767e-05,2.582047847631176,1.0793427337241746,True,False,1.08449,1.08179,1.08179,1.08199,2024-05-14 18:00:00,True,2024-05-14 18:00:00,2024-05-15 15:30:02,2024-05-14 18:21:44,0.02,even,True,10.92,593.6000000000026,,4,0,20,5
2024-05-14 17:00:00,1.08183,1.08229,1.08148,1.08172,961,12,0,2024-05-14 17:00:00,2024-05-14 17:00:00,0.0008560714285703597,0.0005130571555216346,1.081311547619047,-0.00014465889937136713,0.00019800849619887442,1.0804415476190468,1.078614167189614,1.0793065287843175,1.0787483362341546,1.0790979639147604,0.00019237759697642728,-0.00014319692707686526,1.0791612599836784,1.0793632041593146,88.98223700728113,88.66290560479804,0.00018893618137714652,1.0807761088854388,1.0800270801151726,1.0813951565187485,0.0007490287702662801,0.0005393617473362481,0.0012242490215019538,0.00020042655658780717,0.00028603371173008263,0.0002134055727553985,2.5830478926977762,1.0797424203397208,True,False,1.08472,1.08202,1.08202,1.08222,2024-05-14 18:00:00,True,2024-05-14 18:00:00,2024-05-15 15:30:05,2024-05-14 18:19:48,0.02,even,True,10.92,604.5200000000026,,5,0,20,5
2024-05-14 17:45:00,1.08161,1.0825,1.08149,1.0824,1103,12,0,2024-05-14 17:00:00,2024-05-14 17:00:00,0.0008560714285703597,0.0005130571555216346,1.081311547619047,-0.00014465889937136713,0.00019800849619887442,1.0804415476190468,1.078614167189614,1.0793065287843175,1.0787483362341546,1.0790979639147604,0.00019237759697642728,-0.00014319692707686526,1.0791612599836784,1.0793632041593146,88.48013662585869,87.18534054571951,0.00018893618137714652,1.0811705693793898,1.0803796589340835,1.0819183488132094,0.0007909104453063254,0.0006428528457099183,0.0011820043711078564,0.00027951496388101127,0.00016385964912157824,7.981768145826074e-05,2.583514054714205,1.0803226429122137,True,False,1.0854,1.0827,1.0827,1.0829,2024-05-15 10:00:00,True,2024-05-15 10:00:00,2024-05-15 15:30:07,2024-05-15 10:11:32,0.02,even,True,10.92,615.4400000000026,,6,0,20,5
2024-05-14 18:00:00,1.08239,1.08243,1.08207,1.0823,919,12,0,2024-05-14 18:00:00,2024-05-14 18:00:00,0.0008700000000001484,0.0007415764652050072,1.081741666666667,-0.0001446471560888647,0.00022142111828920693,1.081311547619047,1.0784580886279032,1.079168337456916,1.078614167189614,1.0793065287843175,0.00019800849619887442,-0.00014465889937136713,1.0793289206298928,1.0795549478265696,94.43865240832946,89.54156861577059,0.0002994642381427187,1.0813443279364068,1.0805219064204479,1.082133625730994,0.0008224215159589043,0.0006787665797597156,0.0011952967553369716,0.00021527691778455704,0.00027951496388101127,0.00016385964912157824,2.5837472763506986,1.080519975111289,True,False,1.0853,1.0826,1.0826,1.0828,2024-05-15 10:00:00,True,2024-05-15 10:00:00,2024-05-15 15:30:05,2024-05-15 10:51:07,0.02,even,True,10.92,626.3600000000025,,7,0,20,5
2024-05-14 18:15:00,1.08232,1.08236,1.08156,1.08175,770,12,0,2024-05-14 18:00:00,2024-05-14 18:00:00,0.0008700000000001484,0.0007415764652050072,1.081741666666667,-0.0001446471560888647,0.00022142111828920693,1.081311547619047,1.0784580886279032,1.079168337456916,1.078614167189614,1.0793065287843175,0.00019800849619887442,-0.00014465889937136713,1.0793289206298928,1.0795549478265696,94.06779661016951,92.32886188145255,0.0002994642381427187,1.0814067390231135,1.0806128763152296,1.0822149673202623,0.0007938627078838412,0.0007017858053845409,0.0011909216318968447,8.134158926842439e-05,0.00021527691778455704,0.00027951496388101127,2.583822711523323,1.0806072231172017,True,False,1.0847499999999999,1.08205,1.08205,1.08225,2024-05-15 05:45:00,True,2024-05-15 05:45:00,2024-05-15 15:30:05,2024-05-15 07:53:23,0.02,even,True,10.92,637.2800000000025,,8,0,20,5
2024-05-14 22:15:00,1.08201,1.08207,1.08195,1.08207,123,12,0,2024-05-14 22:00:00,2024-05-14 22:00:00,7.416666666504312e-05,0.0008314188631162178,1.082007738095238,0.0002025107959422249,0.00034970737824963386,1.0821188095238086,1.0748743700299421,1.078828986663688,1.0760912853979054,1.0791103639517325,0.00028716608756712076,5.297806891151766e-05,1.079916579733467,1.0802032419705219,73.05204924419945,68.67602579383914,0.0006105268505310511,1.0819032665567192,1.0815182794224103,1.0819756897144823,0.00038498713430890064,0.0004567685711132313,0.0002917333257091706,8.298245614124511e-05,5.153078775466113e-06,-4.7141382869764215e-05,2.5823695297041898,1.081581849724775,True,False,1.08507,1.08237,1.08237,1.08257,2024-05-15 06:30:00,True,2024-05-15 06:30:00,2024-05-15 15:30:05,2024-05-15 07:06:30,0.02,even,True,10.92,648.2000000000024,,9,0,20,5
2024-05-14 22:30:00,1.08205,1.08209,1.08199,1.0820400000000001,152,12,0,2024-05-14 22:00:00,2024-05-14 22:00:00,7.416666666504312e-05,0.0008314188631162178,1.082007738095238,0.0002025107959422249,0.00034970737824963386,1.0821188095238086,1.0748743700299421,1.078828986663688,1.0760912853979054,1.0791103639517325,0.00028716608756712076,5.297806891151766e-05,1.079916579733467,1.0802032419705219,77.6336294218531,72.99990410089003,0.0006105268505310511,1.08192430247107,1.0815569253911206,1.0820490161678709,0.00036737707994949353,0.0004388902728804838,0.00028825625173241754,7.332645338853361e-05,8.298245614124511e-05,5.153078775466113e-06,2.5824381621077097,1.081659870228032,True,False,1.08504,1.08234,1.08234,1.08254,2024-05-15 06:15:00,True,2024-05-15 06:15:00,2024-05-15 15:30:05,2024-05-15 07:20:43,0.02,even,True,10.92,659.1200000000024,,10,0,20,5
2024-05-15 16:00:00,1.08605,1.08652,1.08519,1.08642,2313,12,0,2024-05-15 16:00:00,2024-05-15 16:00:00,0.0010554761904750798,0.0007379043345907554,1.0838450000000002,7.306299296889969e-05,0.0003353281622272252,1.0838158333333328,1.0810990001267244,1.0818185696067164,1.081020291392102,1.081877002944223,0.0003092825719734809,7.305723234591505e-05,1.0819393583847325,1.0822790387566765,87.04481792716865,73.19327731092257,0.0005292911226244981,1.084088781706182,1.0833716010779153,1.084476522187823,0.0007171806282666449,0.00030427505624187456,0.0011913132809365558,0.0006110767113869375,0.0006298348813209564,0.0006893808049523997,2.5860847951170873,1.0828682492585586,True,False,1.0894199999999998,1.08672,1.08672,1.0869199999999999,2024-05-15 18:30:00,True,2024-05-15 18:30:00,2024-05-16 03:57:47,2024-05-15 18:41:48,0.02,even,True,10.92,670.0400000000024,,11,0,20,5
2024-05-15 16:15:00,1.08643,1.08643,1.0851,1.08549,1789,12,0,2024-05-15 16:00:00,2024-05-15 16:00:00,0.0010554761904750798,0.0007379043345907554,1.0838450000000002,7.306299296889969e-05,0.0003353281622272252,1.0838158333333328,1.0810990001267244,1.0818185696067164,1.081020291392102,1.081877002944223,0.0003092825719734809,7.305723234591505e-05,1.0819393583847325,1.0822790387566765,81.2324929971976,79.3557422969168,0.0005292911226244981,1.0843043537513848,1.0835285195165882,1.0848622703818376,0.0007758342347965463,0.00039858689195280896,0.0012771951038648421,0.00038574819401460125,0.0006110767113869375,0.0006298348813209564,2.586586483772055,1.08313805699162,True,False,1.08849,1.08579,1.08579,1.08599,2024-05-15 18:15:00,True,2024-05-15 18:15:00,2024-05-15 23:17:14,2024-05-15 18:57:17,0.02,even,True,10.92,680.9600000000023,,12,0,20,5
2024-05-15 18:00:00,1.08569,1.0865,1.08551,1.08648,1052,12,0,2024-05-15 18:00:00,2024-05-15 18:00:00,0.0007767857142852996,0.0008459875270101502,1.0852488095238095,7.30647107621052e-05,0.00039318107247430844,1.0846217857142855,1.0812571479457724,1.081799046360521,1.08117827117914,1.0816329727341605,0.00037462245233802193,7.305393709230587e-05,1.0824212907404374,1.0828198264036513,78.01496942862995,66.76129233055144,0.0006142402771260278,1.08493022410773,1.0841670046801624,1.0858627038183704,0.0007632194275677406,0.0006059263420818154,0.0015200820153330934,0.000300082559339776,0.00022670106639077758,0.00021281045751786465,2.58791481453907,1.0838105930976707,True,False,1.0894799999999998,1.0867799999999999,1.0867799999999999,1.0869799999999998,2024-05-15 18:30:00,True,2024-05-15 18:30:00,,2024-05-15 18:41:44,0.02,even,True,10.92,691.8800000000023,,13,0,20,5
2024-05-15 18:15:00,1.08651,1.08714,1.08625,1.08709,920,12,0,2024-05-15 18:00:00,2024-05-15 18:00:00,0.0007767857142852996,0.0008459875270101502,1.0852488095238095,7.30647107621052e-05,0.00039318107247430844,1.0846217857142855,1.0812571479457724,1.081799046360521,1.08117827117914,1.0816329727341605,0.00037462245233802193,7.305393709230587e-05,1.0824212907404374,1.0828198264036513,88.35723133339108,77.42285310181265,0.0006142402771260278,1.0852624973219254,1.0843835228520022,1.0862160612315104,0.0008789744699231328,0.0006605359676500788,0.001640573375380273,0.0003533574131400208,0.000300082559339776,0.00022670106639077758,2.588430835288274,1.084001287174747,True,False,1.0900899999999998,1.0873899999999999,1.0873899999999999,1.0875899999999998,2024-05-15 20:15:00,True,2024-05-15 20:15:00,,2024-05-15 20:25:35,0.02,even,True,10.92,702.8000000000022,,14,0,20,5
2024-05-15 18:30:00,1.08711,1.08739,1.08663,1.08672,947,12,0,2024-05-15 18:00:00,2024-05-15 18:00:00,0.0007767857142852996,0.0008459875270101502,1.0852488095238095,7.30647107621052e-05,0.00039318107247430844,1.0846217857142855,1.0812571479457724,1.081799046360521,1.08117827117914,1.0816329727341605,0.00037462245233802193,7.305393709230587e-05,1.0824212907404374,1.0828198264036513,92.03895772373517,86.13705282858537,0.0006142402771260278,1.0854867285031675,1.0845565952333354,1.0864330684554517,0.0009301332698321563,0.0007144554280864944,0.001701771136201171,0.00021700722394135674,0.0003533574131400208,0.000300082559339776,2.588730459489323,1.0841356774215802,True,False,1.0897199999999998,1.0870199999999999,1.0870199999999999,1.0872199999999999,2024-05-15 20:15:00,True,2024-05-15 20:15:00,,2024-05-16 11:17:53,0.02,even,True,10.92,713.7200000000022,,15,0,20,5
2024-05-15 19:30:00,1.08654,1.0873,1.0865,1.08707,761,12,0,2024-05-15 19:00:00,2024-05-15 19:00:00,0.0006270238095240632,0.0009762291050723348,1.0861397619047615,8.245924011447601e-05,0.0003931927121031076,1.0852488095238095,1.0812355090135455,1.0822248170866364,1.0812571479457724,1.081799046360521,0.00039318107247430844,7.30647107621052e-05,1.082725723595893,1.083165440291359,80.73038073037927,75.94272694047433,0.0006866380427152893,1.0859722205810327,1.0850551390145313,1.0865487306501544,0.0009170815665013876,0.0008197600234521583,0.0017421968889911423,9.7268661850336e-05,4.407292741626101e-05,-2.3333333332375972e-05,2.5889006964502927,1.0841967648500164,True,False,1.0900699999999999,1.08737,1.08737,1.08757,2024-05-15 20:15:00,True,2024-05-15 20:15:00,,2024-05-15 20:25:39,0.02,even,True,10.92,724.6400000000021,,16,0,20,5
2024-05-15 19:45:00,1.08708,1.08721,1.08679,1.08714,721,12,0,2024-05-15 19:00:00,2024-05-15 19:00:00,0.0006270238095240632,0.0009762291050723348,1.0861397619047615,8.245924011447601e-05,0.0003931927121031076,1.0852488095238095,1.0812355090135455,1.0822248170866364,1.0812571479457724,1.081799046360521,0.00039318107247430844,7.30647107621052e-05,1.082725723595893,1.083165440291359,88.96658896658774,80.76814463911087,0.0006866380427152893,1.0861518789531814,1.0852095731616032,1.0865665049879603,0.0009423057915782795,0.0008442691770773826,0.0017313942358721532,1.777433780580928e-05,9.7268661850336e-05,4.407292741626101e-05,2.5889038872063876,1.0842291227695329,True,False,1.0901399999999999,1.08744,1.08744,1.08764,2024-05-15 20:15:00,True,2024-05-15 20:15:00,,2024-05-15 20:24:27,0.02,even,True,10.92,735.5600000000021,,17,0,20,5
2024-05-15 20:00:00,1.08713,1.08777,1.0871,1.08776,648,12,0,2024-05-15 20:00:00,2024-05-15 20:00:00,0.0008909523809519371,0.0011788349095334105,1.0870227380952378,0.00015648502283725898,0.0003955360036257669,1.0861397619047615,1.0806113051537856,1.0826255812648415,1.0812355090135455,1.0822248170866364,0.0003931927121031076,8.245924011447601e-05,1.0830621285251902,1.0835474050680505,95.49971798365785,88.39889589354159,0.0007850774160789135,1.0863992821911537,1.085398493668151,1.0869658548331604,0.0010007885230025604,0.0008755730462624183,0.0017350022094161875,0.0003993498452001809,1.777433780580928e-05,9.7268661850336e-05,2.5893081078158726,1.0846236018504485,True,False,1.09076,1.08806,1.08806,1.08826,2024-05-15 23:15:00,True,2024-05-15 23:15:00,,2024-05-16 00:00:00,0.02,even,True,10.92,746.4800000000021,,18,0,20,5
2024-05-15 20:15:00,1.08776,1.08781,1.08733,1.0876,554,12,0,2024-05-15 20:00:00,2024-05-15 20:00:00,0.0008909523809519371,0.0011788349095334105,1.0870227380952378,0.00015648502283725898,0.0003955360036257669,1.0861397619047615,1.0806113051537856,1.0826255812648415,1.0812355090135455,1.0822248170866364,0.0003931927121031076,8.245924011447601e-05,1.0830621285251902,1.0835474050680505,96.42012494433361,93.62881063152638,0.0007850774160789135,1.0865840080078992,1.085561568211251,1.0872882662538694,0.001022439796648289,0.0009049463963395924,0.0017061240673956607,0.0003224114207089901,0.0003993498452001809,1.777433780580928e-05,2.5895915337448536,1.0849849987628852,True,False,1.0905999999999998,1.0878999999999999,1.0878999999999999,1.0880999999999998,2024-05-15 23:00:00,True,2024-05-15 23:00:00,,2024-05-16 00:00:00,0.02,even,True,10.92,757.400000000002,,19,0,20,5
2024-05-15 22:00:00,1.08776,1.088,1.0877,1.08796,414,12,0,2024-05-15 22:00:00,2024-05-15 22:00:00,0.0004673809523809691,0.0014639306572554744,1.0878169047619055,0.00037228437477960835,0.00044198970590893845,1.0874901190476187,1.0793483228889948,1.083084091064899,1.079876805225155,1.0827382560838834,0.00042821975526266814,0.0002621461115491144,1.0836719355771955,1.084223195649598,88.43537414965691,84.5492637433074,0.0010158260637227183,1.0873654060014726,1.086455389889405,1.0879446749226012,0.0009100161120676464,0.0009487534859265452,0.0012732992578412322,3.842105263252016e-05,-6.047471619696765e-06,-6.198830409420708e-05,2.589663628920687,1.0862257209245154,True,False,1.09096,1.08826,1.08826,1.08846,2024-05-16 01:15:00,True,2024-05-16 01:15:00,,2024-05-16 05:04:20,0.02,even,True,10.92,768.320000000002,,20,0,20,5
2024-05-15 22:15:00,1.08795,1.08811,1.0879,1.08798,319,12,0,2024-05-15 22:00:00,2024-05-15 22:00:00,0.0004673809523809691,0.0014639306572554744,1.0878169047619055,0.00037228437477960835,0.00044198970590893845,1.0874901190476187,1.0793483228889948,1.083084091064899,1.079876805225155,1.0827382560838834,0.00042821975526266814,0.0002621461115491144,1.0836719355771955,1.084223195649598,94.63382227890914,88.71952022944133,0.0010158260637227183,1.087459958924323,1.0865683239716712,1.0879766322669424,0.0008916349526517653,0.0009373297792715893,0.0013074521023805608,3.195734434124908e-05,3.842105263252016e-05,-6.047471619696765e-06,2.5897416926051564,1.0862115719287286,True,False,1.0909799999999998,1.08828,1.08828,1.08848,2024-05-16 01:15:00,True,2024-05-16 01:15:00,,2024-05-16 05:04:19,0.02,even,True,10.92,779.2400000000019,,21,0,20,5
2024-05-15 22:30:00,1.08798,1.088,1.08781,1.08796,325,12,0,2024-05-15 22:00:00,2024-05-15 22:00:00,0.0004673809523809691,0.0014639306572554744,1.0878169047619055,0.00037228437477960835,0.00044198970590893845,1.0874901190476187,1.0793483228889948,1.083084091064899,1.079876805225155,1.0827382560838834,0.00042821975526266814,0.0002621461115491144,1.0836719355771955,1.084223195649598,95.67102377038837,92.9134067329848,0.0010158260637227183,1.087536888320581,1.0866714110848807,1.088042445820433,0.000865477235700185,0.0009229592705573084,0.0013170516314935667,6.581355349055684e-05,3.195734434124908e-05,3.842105263252016e-05,2.5898204655229495,1.0862644261179166,True,False,1.09096,1.08826,1.08826,1.08846,2024-05-16 01:15:00,True,2024-05-16 01:15:00,,2024-05-16 05:04:20,0.02,even,True,10.92,790.1600000000019,,22,0,20,5
2024-05-15 23:00:00,1.08811,1.08833,1.08808,1.08832,200,11,0,2024-05-15 23:00:00,2024-05-15 23:00:00,0.0003267857142867925,0.0015244938720506696,1.088366904761905,0.0003722610408078748,0.0003841965344784623,1.0878169047619055,1.0797505354830819,1.0839961570661125,1.0793483228889948,1.083084091064899,0.00044198970590893845,0.00037228437477960835,1.0839737461851184,1.0845533399976302,95.55971662860748,95.10473297024066,0.0011175596253883086,1.0877319732946171,1.086892197432168,1.0882856793945652,0.0008397758624492102,0.0008941828850772783,0.001096515237782036,0.00011644306845592922,0.00012679050567632189,6.581355349055684e-05,2.5897659749655713,1.0868053838235594,True,False,1.0913199999999998,1.08862,1.08862,1.08882,2024-05-16 01:15:00,True,2024-05-16 01:15:00,,2024-05-16 03:03:38,0.02,even,True,10.92,801.0800000000019,,23,0,20,5
2024-05-16 00:45:00,1.08832,1.08846,1.08805,1.08828,123,17,0,2024-05-16 00:00:00,2024-05-16 00:00:00,0.0005499999999993843,0.0015553895792659311,1.0883838095238096,0.0003997576699793233,0.00031521596988119834,1.088366904761905,1.0799174672763607,1.084855260279592,1.0797505354830819,1.0839961570661125,0.0003841965344784623,0.0003722610408078748,1.084251569011885,1.0848514727978198,73.87474747474079,68.31178451177915,0.001205125616163833,1.088052081797561,1.0874345296897199,1.0882888235294117,0.0006175521078410906,0.000729928872456987,0.0006673547282804441,3.189542483750252e-05,6.269005847880926e-05,-4.061231510155139e-05,2.58918975241259,1.0873878946462332,True,False,1.0912799999999998,1.0885799999999999,1.0885799999999999,1.0887799999999999,2024-05-16 01:15:00,True,2024-05-16 01:15:00,,2024-05-16 04:10:39,0.02,even,True,10.92,812.0000000000018,,24,0,20,5
2024-05-16 01:00:00,1.08828,1.08887,1.08826,1.08886,320,11,0,2024-05-16 01:00:00,2024-05-16 01:00:00,1.690476190474577e-05,0.0015305671156304879,1.0886226190476196,0.0004804574814162292,0.00026355079372890675,1.0883838095238096,1.0797467864731143,1.085473054046672,1.0799174672763607,1.084855260279592,0.00031521596988119834,0.0003997576699793233,1.0845482419788604,1.0851713549739943,87.29605734766189,75.4407733246378,0.001270213916057164,1.0881763769056285,1.0875401200830739,1.0884205607155135,0.0006362568225546372,0.000711194462476517,0.0006007445380738191,0.00013173718610182128,3.189542483750252e-05,6.269005847880926e-05,2.589231565841913,1.0876095555891139,True,False,1.0918599999999998,1.07806,1.08916,1.0893599999999999,,False,,,,0.02,running,False,0.0,812.0000000000018,2024-05-16 04:00:00,0,1,20,5
2024-05-16 01:15:00,1.08884,1.08888,1.08874,1.08876,96,12,0,2024-05-16 01:00:00,2024-05-16 01:00:00,1.690476190474577e-05,0.0015305671156304879,1.0886226190476196,0.0004804574814162292,0.00026355079372890675,1.0883838095238096,1.0797467864731143,1.085473054046672,1.0799174672763607,1.084855260279592,0.00031521596988119834,0.0003997576699793233,1.0845482419788604,1.0851713549739943,89.4617823947428,83.54419573904848,0.001270213916057164,1.0882661650739933,1.087630481558402,1.0885436704506364,0.0006356835155914009,0.0006960922730994938,0.0005165520303184046,0.0001231097351228616,0.00013173718610182128,3.189542483750252e-05,2.589241015691566,1.0878463252097066,True,False,1.0917599999999998,1.08906,1.08906,1.08926,2024-05-16 04:00:00,True,2024-05-16 04:00:00,,2024-05-16 04:02:37,0.02,even,True,10.92,822.9200000000018,,1,0,20,5
2024-05-16 01:30:00,1.08878,1.08891,1.08877,1.0889,92,12,0,2024-05-16 01:00:00,2024-05-16 01:00:00,1.690476190474577e-05,0.0015305671156304879,1.0886226190476196,0.0004804574814162292,0.00026355079372890675,1.0883838095238096,1.0797467864731143,1.085473054046672,1.0799174672763607,1.084855260279592,0.00031521596988119834,0.0003997576699793233,1.0845482419788604,1.0851713549739943,96.11733795030068,90.9583925642351,0.001270213916057164,1.0883636781395327,1.0877245199614831,1.0886528345373223,0.0006391581780496036,0.0006847054540895157,0.00047240448772905744,0.00010916408668593114,0.0001231097351228616,0.00013173718610182128,2.5892905805957565,1.0880150884788882,True,False,1.0918999999999999,1.0781,1.0892,1.0894,,False,,,,0.02,running,False,0.0,822.9200000000018,2024-05-16 04:30:00,0,1,20,5
2024-05-16 01:45:00,1.08891,1.08893,1.08884,1.08885,86,12,0,2024-05-16 01:00:00,2024-05-16 01:00:00,1.690476190474577e-05,0.0015305671156304879,1.0886226190476196,0.0004804574814162292,0.00026355079372890675,1.0883838095238096,1.0797467864731143,1.085473054046672,1.0799174672763607,1.084855260279592,0.00031521596988119834,0.0003997576699793233,1.0845482419788604,1.0851713549739943,94.14659936402006,93.24190656968783,0.001270213916057164,1.0884384968872969,1.087807888853225,1.0887258169934644,0.0006306080340718889,0.0006738859700859904,0.0004621190323140972,7.298245614206778e-05,0.00010916408668593114,0.0001231097351228616,2.589349677687088,1.0881019562998404,True,False,1.09185,1.0780500000000002,1.08915,1.08935,,False,,,,0.02,running,False,0.0,822.9200000000018,2024-05-16 04:45:00,0,2,20,5
2024-05-16 03:15:00,1.08879,1.08894,1.08864,1.08891,467,12,0,2024-05-16 03:00:00,2024-05-16 03:00:00,5.9642857142216954e-05,0.0014989647960088615,1.0889234523809517,0.00048439877485666,0.0002038222035103042,1.0886822619047618,1.080764115439915,1.0862345515871419,1.0798690269017173,1.0859281545579378,0.00022379466094371694,0.0005425410763451284,1.0851108548431025,1.085768042849989,89.33333333334019,88.66196928636447,0.0013589614589029683,1.0886864014474484,1.088184848657544,1.0889328001375995,0.0005015527899043803,0.0005775506575088566,0.00045682308759703556,3.794289645675519e-05,1.4609563123491043e-05,2.6952184383199906e-05,2.5895495113058553,1.0883160889693435,True,False,1.09191,1.0781100000000001,1.08921,1.08941,,False,,,,0.02,running,False,0.0,822.9200000000018,2024-05-16 06:15:00,0,3,20,5
2024-05-16 03:30:00,1.08891,1.08918,1.08886,1.08907,519,12,0,2024-05-16 03:00:00,2024-05-16 03:00:00,5.9642857142216954e-05,0.0014989647960088615,1.0889234523809517,0.00048439877485666,0.0002038222035103042,1.0886822619047618,1.080764115439915,1.0862345515871419,1.0798690269017173,1.0859281545579378,0.00022379466094371694,0.0005425410763451284,1.0851108548431025,1.085768042849989,91.63900226757546,89.37198901241163,0.0013589614589029683,1.0887454166093793,1.0882504154236519,1.089007516339869,0.0004950011857274283,0.0005610407631525709,0.0004476970702331332,7.471620226939812e-05,3.794289645675519e-05,1.4609563123491043e-05,2.5896119073846835,1.0884031252950541,True,False,1.0920699999999999,1.07827,1.08937,1.08957,,False,,,,0.02,running,False,0.0,822.9200000000018,2024-05-16 06:30:00,0,4,20,5
2024-05-16 03:45:00,1.0890900000000001,1.08944,1.08903,1.08931,471,12,0,2024-05-16 03:00:00,2024-05-16 03:00:00,5.9642857142216954e-05,0.0014989647960088615,1.0889234523809517,0.00048439877485666,0.0002038222035103042,1.0886822619047618,1.080764115439915,1.0862345515871419,1.0798690269017173,1.0859281545579378,0.00022379466094371694,0.0005425410763451284,1.0851108548431025,1.085768042849989,93.28344671202103,91.4185941043122,0.0013589614589029683,1.0888322755925517,1.088328903170048,1.0891063845889237,0.0005033724225036451,0.0005495070950227858,0.00043274203250401447,9.886824905480651e-05,7.471620226939812e-05,3.794289645675519e-05,2.589690586332804,1.0885221828450433,True,False,1.09231,1.07851,1.08961,1.08981,,False,,,,0.02,running,False,0.0,822.9200000000018,2024-05-16 06:45:00,0,5,20,5
2024-05-16 16:00:00,1.08625,1.08652,1.08581,1.08622,1332,12,0,2024-05-16 16:00:00,2024-05-16 16:00:00,-0.0002363095238095969,-7.871891843658219e-05,1.086194642857143,-0.0001754015999446513,-0.00016282798607417578,1.0866205952380954,1.0882443346978008,1.0898370235540549,1.0877005419257255,1.090032711380771,-0.0001646247585646918,-0.00010509276115960207,1.0863371769359151,1.086695651526049,24.61731678486625,31.015429113829267,0.0003838529601377914,1.0866266044146595,1.0869835976194904,1.0864121087031307,-0.0003569932048308466,-0.0003285286223661126,0.0004396995186339464,-0.00010846233230177305,-0.00012565187478474904,-6.64671482621948e-05,1.0870057030532865,-0.41418148564702517,False,True,1.08322,1.08592,1.08592,1.08572,2024-05-16 16:45:00,True,2024-05-16 16:45:00,,2024-05-16 17:03:21,0.02,even,True,10.9,833.8200000000018,,1,0,20,5
2024-05-16 16:30:00,1.08649,1.08663,1.08549,1.08557,1248,12,0,2024-05-16 16:00:00,2024-05-16 16:00:00,-0.0002363095238095969,-7.871891843658219e-05,1.086194642857143,-0.0001754015999446513,-0.00016282798607417578,1.0866205952380954,1.0882443346978008,1.0898370235540549,1.0877005419257255,1.090032711380771,-0.0001646247585646918,-0.00010509276115960207,1.0863371769359151,1.086695651526049,23.472222222220427,25.439814814812717,0.0003838529601377914,1.0864423617406733,1.0868429746394808,1.0861979841761267,-0.0004006128988074398,-0.00034539524117805764,0.00043978669074078977,-0.00018872033023797918,-2.5404196765999032e-05,-0.00010846233230177305,1.0867916962086268,-0.41439572785637346,False,True,1.08257,1.08527,1.08527,1.08507,2024-05-17 11:15:00,True,2024-05-17 11:15:00,,2024-05-17 16:20:34,0.02,even,True,10.9,844.7200000000017,,2,0,20,5
2024-05-16 16:45:00,1.08557,1.08574,1.08539,1.0855299999999999,1072,12,0,2024-05-16 16:00:00,2024-05-16 16:00:00,-0.0002363095238095969,-7.871891843658219e-05,1.086194642857143,-0.0001754015999446513,-0.00016282798607417578,1.0866205952380954,1.0882443346978008,1.0898370235540549,1.0877005419257255,1.090032711380771,-0.0001646247585646918,-0.00010509276115960207,1.0863371769359151,1.086695651526049,17.240786578652788,22.980971412741564,0.0003838529601377914,1.0863019983959543,1.0867457172587787,1.0859961953904362,-0.00044371886282434936,-0.000365059965507316,0.0004906288481995865,-0.00020178878569043768,-0.00018872033023797918,-2.5404196765999032e-05,1.0866585443355057,-0.4146661535546332,False,True,1.08253,1.08523,1.08523,1.08503,2024-05-17 11:15:00,True,2024-05-17 11:15:00,,2024-05-17 16:19:37,0.02,even,True,10.9,855.6200000000017,,3,0,20,5
2024-05-16 17:00:00,1.08556,1.08601,1.08538,1.08598,1024,12,0,2024-05-16 17:00:00,2024-05-16 17:00:00,-0.0004259523809524435,-0.00024221180701244904,1.0863367857142863,-0.0002156229677909414,-0.000183567607498096,1.086194642857143,1.0886518689393996,1.0899404023306467,1.0882443346978008,1.0898370235540549,-0.00016282798607417578,-0.0001754015999446513,1.0863767139077916,1.0867159994039652,13.551336660753188,18.088115153875453,0.00025864000670774333,1.086252460181192,1.0866889974618321,1.085933512211902,-0.00043653728064008135,-0.0003793554285338691,0.0004948905603114013,-6.268317853419525e-05,-0.00020178878569043768,-0.00018872033023797918,1.0866016144683224,-0.4147345900445183,False,True,1.08298,1.08568,1.08568,1.08548,2024-05-17 11:15:00,True,2024-05-17 11:15:00,,2024-05-17 17:01:21,0.02,even,True,10.9,866.5200000000017,,4,0,20,5
2024-05-16 23:00:00,1.08662,1.0866500000000001,1.0864,1.08643,190,11,0,2024-05-16 23:00:00,2024-05-16 23:00:00,-6.535714285726968e-05,-7.477652670617729e-05,1.0869384523809524,-7.888797554783688e-05,-7.435603982454703e-05,1.0870616666666666,1.0860680933043183,1.0884432775165496,1.0868859176007641,1.0886524494958292,-8.348003454501436e-05,-0.00015445712088478806,1.0865700383867363,1.0868099180809812,12.601279989909166,20.26369392931654,1.6095331633990866e-05,1.0867687658407672,1.0868339763069472,1.0865894771241833,-6.521046618002124e-05,-1.5222711615268174e-05,0.0003673817270263594,-9.541795665701791e-05,-8.352597179173138e-05,-7.206398348702514e-05,1.0870854424556688,-0.41390648820730225,False,True,1.0834300000000001,1.08613,1.08613,1.08593,2024-05-17 04:30:00,True,2024-05-17 04:30:00,,2024-05-17 04:44:13,0.02,even,True,10.9,877.4200000000017,,5,0,20,5
2024-05-17 11:00:00,1.08583,1.08588,1.08469,1.08473,940,12,0,2024-05-17 11:00:00,2024-05-17 11:00:00,3.666666666690688e-05,-0.00025763218858276815,1.0854309523809524,-0.00016063752155952285,-4.725930696070255e-05,1.0858913095238096,1.0866911914086903,1.0874751079633111,1.0867740514886284,1.0875264149169135,-4.72581126841809e-05,-0.00013035120578329073,1.0861806038772621,1.0861947039645237,21.217039049922725,47.31632373444102,-0.00024050068272178933,1.0858663054468523,1.0859616005132,1.0859837461300312,-9.529506634775586e-05,-3.67446464917877e-05,0.00038467518767811894,-0.000244661162710047,-2.060887512977949e-05,-2.028207774285029e-05,1.0865030576333967,-0.41453556537333425,False,True,1.08173,1.08443,1.08443,1.08423,2024-05-17 12:30:00,True,2024-05-17 12:30:00,,2024-05-17 14:55:09,0.02,even,True,10.9,888.3200000000016,,6,0,20,5
2024-05-17 11:15:00,1.08473,1.08509,1.0847,1.08487,863,12,0,2024-05-17 11:00:00,2024-05-17 11:00:00,3.666666666690688e-05,-0.00025763218858276815,1.0854309523809524,-0.00016063752155952285,-4.725930696070255e-05,1.0858913095238096,1.0866911914086903,1.0874751079633111,1.0867740514886284,1.0875264149169135,-4.72581126841809e-05,-0.00013035120578329073,1.0861806038772621,1.0861947039645237,12.396839774559416,28.13170960816241,-0.00024050068272178933,1.085713027685798,1.085880741215926,1.0857855073959406,-0.0001677135301278998,-6.293842321901013e-05,0.0004315379473638871,-0.00019823873409063886,-0.000244661162710047,-2.060887512977949e-05,1.086368083624882,-0.4147970688330007,False,True,1.08187,1.08457,1.08457,1.08437,2024-05-17 11:45:00,True,2024-05-17 11:45:00,,2024-05-17 12:03:11,0.02,even,True,10.9,899.2200000000016,,7,0,20,5
2024-05-17 11:30:00,1.08486,1.08488,1.08409,1.08424,953,12,0,2024-05-17 11:00:00,2024-05-17 11:00:00,3.666666666690688e-05,-0.00025763218858276815,1.0854309523809524,-0.00016063752155952285,-4.725930696070255e-05,1.0858913095238096,1.0866911914086903,1.0874751079633111,1.0867740514886284,1.0875264149169135,-4.72581126841809e-05,-0.00013035120578329073,1.0861806038772621,1.0861947039645237,5.415332283923385,13.009737036135162,-0.00024050068272178933,1.0854864080418292,1.085759204829561,1.0854798142414863,-0.0002727967877318438,-0.00010491009612157687,0.0005324919404849792,-0.00030569315445427847,-0.00019823873409063886,-0.000244661162710047,1.086198678361141,-0.4152390498781684,False,True,1.0812400000000002,1.09504,1.0839400000000001,1.0837400000000001,,False,,,,0.02,running,False,0.0,899.2200000000016,2024-05-17 14:30:00,0,1,20,5
2024-05-17 11:45:00,1.08425,1.08455,1.08419,1.08438,511,12,0,2024-05-17 11:00:00,2024-05-17 11:00:00,3.666666666690688e-05,-0.00025763218858276815,1.0854309523809524,-0.00016063752155952285,-4.725930696070255e-05,1.0858913095238096,1.0866911914086903,1.0874751079633111,1.0867740514886284,1.0875264149169135,-4.72581126841809e-05,-0.00013035120578329073,1.0861806038772621,1.0861947039645237,8.391684307660027,8.734618788714261,-0.00024050068272178933,1.0853161914200093,1.0856570415088527,1.0852069281045755,-0.00034085008884332524,-0.00015209809466592655,0.0005992837391541608,-0.0002728861369107882,-0.00030569315445427847,-0.00019823873409063886,1.0860159611524336,-0.41560210494328254,False,True,1.08138,1.08408,1.08408,1.08388,2024-05-17 14:00:00,True,2024-05-17 14:00:00,,2024-05-17 14:23:25,0.02,even,True,10.9,910.1200000000016,,1,0,20,5
2024-05-17 12:15:00,1.08433,1.08433,1.08404,1.08409,454,12,0,2024-05-17 12:00:00,2024-05-17 12:00:00,-0.00046035714285719287,-0.00041154712445590214,1.0850367857142853,-0.00016063632123234853,-2.4004900370691658e-05,1.0854309523809524,1.0865166206771315,1.087097076823092,1.0866911914086903,1.0874751079633111,-4.725930696070255e-05,-0.00016063752155952285,1.0860657262077613,1.086051127647362,7.787141073659467,8.4086268443232,-0.0002747099710686119,1.0849991666379948,1.0854499464239136,1.0846505400756783,-0.00045077978591878676,-0.0002505823337286165,0.0007310455982226509,-0.00029394564843698845,-0.00026244238046024826,-0.0002728861369107882,1.085637451633279,-0.4163363714819224,False,True,1.08109,1.09489,1.08379,1.08359,,False,,,,0.02,running,False,0.0,910.1200000000016,2024-05-17 15:15:00,0,1,20,5
2024-05-17 12:30:00,1.08408,1.08442,1.08408,1.0843,431,12,0,2024-05-17 12:00:00,2024-05-17 12:00:00,-0.00046035714285719287,-0.00041154712445590214,1.0850367857142853,-0.00016063632123234853,-2.4004900370691658e-05,1.0854309523809524,1.0865166206771315,1.087097076823092,1.0866911914086903,1.0874751079633111,-4.725930696070255e-05,-0.00016063752155952285,1.0860657262077613,1.086051127647362,7.352941176475052,8.062379133928209,-0.0002747099710686119,1.0848916025398418,1.0853647652073273,1.0844366391468871,-0.00047316266748542724,-0.0002950984004799787,0.0007685629447310887,-0.0002139009287911442,-0.00029394564843698845,-0.00026244238046024826,1.085474199122274,-0.41660092082849975,False,True,1.0813000000000001,1.084,1.084,1.0838,2024-05-17 14:00:00,True,2024-05-17 14:00:00,,2024-05-17 14:21:41,0.02,even,True,10.9,921.0200000000016,,1,0,20,5
2024-05-17 13:15:00,1.08415,1.08439,1.08415,1.0842,442,12,0,2024-05-17 13:00:00,2024-05-17 13:00:00,-0.0003941666666671395,-0.0005055735708754394,1.0844886904761903,-0.0001902990294561434,-1.9115026116739192e-05,1.0850367857142853,1.0866006759630495,1.0870076384251528,1.0865166206771315,1.087097076823092,-2.4004900370691658e-05,-0.00016063632123234853,1.0859176148395189,1.085868637435573,7.843137254906904,8.374183006540717,-0.0003208826910299774,1.0846358138281882,1.0851345860064265,1.0839485448916408,-0.0004987721782383492,-0.0003910310521051658,0.0008654318767796059,-0.00013381492948050244,-0.00017131750945997837,-0.00018296181630583774,1.0851168779252933,-0.41721978814201166,False,True,1.0812000000000002,1.095,1.0839,1.0837,,False,,,,0.02,running,False,0.0,921.0200000000016,2024-05-17 16:15:00,0,1,20,5
2024-05-17 13:30:00,1.08421,1.08439,1.08412,1.08421,333,12,0,2024-05-17 13:00:00,2024-05-17 13:00:00,-0.0003941666666671395,-0.0005055735708754394,1.0844886904761903,-0.0001902990294561434,-1.9115026116739192e-05,1.0850367857142853,1.0866006759630495,1.0870076384251528,1.0865166206771315,1.087097076823092,-2.4004900370691658e-05,-0.00016063632123234853,1.0859176148395189,1.085868637435573,5.514705882356284,7.475490196082773,-0.0003208826910299774,1.0845703040084669,1.0850660981540985,1.0838827554179562,-0.0004957941456316117,-0.000411983670810455,0.0008923704387824224,-6.578947368462984e-05,-0.00013381492948050244,-0.00017131750945997837,1.0850874555103125,-0.4173219446744001,False,True,1.08121,1.08391,1.08391,1.08371,2024-05-22 14:00:00,True,2024-05-22 14:00:00,,,0.02,running,False,0.0,921.0200000000016,2024-05-17 16:30:00,0,2,20,5
2024-05-17 19:00:00,1.08679,1.0872600000000001,1.08674,1.0872600000000001,558,12,0,2024-05-17 19:00:00,2024-05-17 19:00:00,0.0007236904761898089,2.7741703456651834e-05,1.086689166666667,-2.8443010503972765e-05,9.729110937688511e-05,1.086232857142857,1.083805658191291,1.0863081662901664,1.083836504154061,1.0868049416287764,6.011871530462854e-05,-2.8444625811864035e-05,1.0859361710491227,1.0859217609245237,78.3680485790205,77.71199368949141,-0.00032149935666644545,1.086417977133317,1.0857972142298593,1.0873671826625386,0.0006207629034575834,0.00040810926712945975,0.0013089998726808813,0.00020356381148967095,0.00013689370485092667,0.00016733402132573794,2.5891343324906577,1.0856000328344195,True,False,1.09026,1.08756,1.08756,1.08776,2024-05-20 07:15:00,True,2024-05-20 07:15:00,,2024-05-20 10:09:39,0.02,even,True,10.92,931.9400000000015,,1,0,20,5
2024-05-17 19:15:00,1.08728,1.08737,1.08679,1.08685,435,12,0,2024-05-17 19:00:00,2024-05-17 19:00:00,0.0007236904761898089,2.7741703456651834e-05,1.086689166666667,-2.8443010503972765e-05,9.729110937688511e-05,1.086232857142857,1.083805658191291,1.0863081662901664,1.083836504154061,1.0868049416287764,6.011871530462854e-05,-2.8444625811864035e-05,1.0859361710491227,1.0859217609245237,78.38735774014522,77.84955175477144,-0.00032149935666644545,1.0864844421897297,1.085875198360981,1.0874515376676994,0.0006092438287488289,0.00044833617945333357,0.001326825534881009,8.435500516079664e-05,0.00020356381148967095,0.00013689370485092667,2.5892427521397887,1.0856603231956101,True,False,1.08985,1.08715,1.08715,1.08735,2024-05-17 21:45:00,True,2024-05-17 21:45:00,,2024-05-17 22:55:35,0.02,even,True,10.92,942.8600000000015,,2,0,20,5
2024-05-17 20:15:00,1.08721,1.08737,1.08719,1.08722,351,12,0,2024-05-17 20:00:00,2024-05-17 20:00:00,0.00045630952380992795,0.00013795077682532408,1.08717488095238,-2.8444474490405135e-05,0.00011849761877990599,1.086689166666667,1.083774831618559,1.0861163706029175,1.083805658191291,1.0863081662901664,9.729110937688511e-05,-2.8443010503972765e-05,1.0860241600136955,1.086032020050562,75.78706683512547,73.5275477071072,-0.00022960932996809156,1.0867547550190761,1.086178742098856,1.087414809081528,0.000576012920220137,0.0005237661538409265,0.0013004168562479618,-2.4368765049853636e-05,1.0261437908942739e-05,-4.1252149982407005e-05,1.0891703718374628,-0.4143407536744066,True,False,1.09022,1.08752,1.08752,1.08772,2024-05-20 07:00:00,True,2024-05-20 07:00:00,,2024-05-20 10:10:58,0.02,even,True,10.92,953.7800000000015,,3,0,20,5
2024-05-17 20:30:00,1.08724,1.0872600000000001,1.08704,1.08717,476,12,0,2024-05-17 20:00:00,2024-05-17 20:00:00,0.00045630952380992795,0.00013795077682532408,1.08717488095238,-2.8444474490405135e-05,0.00011849761877990599,1.086689166666667,1.083774831618559,1.0861163706029175,1.083805658191291,1.0863081662901664,9.729110937688511e-05,-2.8443010503972765e-05,1.0860241600136955,1.086032020050562,75.43684614811792,74.98038682327649,-0.00022960932996809156,1.0868186388622951,1.086252168610052,1.0874107464740284,0.0005664702522432119,0.0005323069735213836,0.0012659123192442039,-4.062607499744075e-06,-2.4368765049853636e-05,1.0261437908942739e-05,1.089119728105008,-0.4142982351569513,True,False,1.0901699999999999,1.08747,1.08747,1.08767,2024-05-20 06:45:00,True,2024-05-20 06:45:00,,2024-05-20 10:11:01,0.02,even,True,10.92,964.7000000000014,,4,0,20,5
2024-05-17 21:30:00,1.08723,1.08749,1.08723,1.08743,353,12,0,2024-05-17 21:00:00,2024-05-17 21:00:00,0.0004857142857130903,0.0002674051787390219,1.0874613095238097,3.792391819182617e-05,0.00011850043494383887,1.08717488095238,1.0831747706579544,1.0862450664710825,1.083774831618559,1.0861163706029175,0.00011849761877990599,-2.8444474490405135e-05,1.0861187303353927,1.086148658446517,70.04975124377938,66.69544338936674,-0.00013020642822666887,1.0870597252051,1.0865321009167557,1.0872773202614368,0.0005276242883442972,0.0005368066013065166,0.0010358812673351776,-3.240454078179411e-06,-5.901960784249205e-05,-8.255933952572292e-05,1.0886757599723393,-0.41412111944946584,True,False,1.0904299999999998,1.0877299999999999,1.0877299999999999,1.0879299999999998,2024-05-20 07:15:00,True,2024-05-20 07:15:00,,2024-05-20 09:57:57,0.02,even,True,10.92,975.6200000000014,,5,0,20,5
2024-05-17 21:45:00,1.08743,1.0876,1.08731,1.08749,455,12,0,2024-05-17 21:00:00,2024-05-17 21:00:00,0.0004857142857130903,0.0002674051787390219,1.0874613095238097,3.792391819182617e-05,0.00011850043494383887,1.08717488095238,1.0831747706579544,1.0862450664710825,1.083774831618559,1.0861163706029175,0.00011849761877990599,-2.8444474490405135e-05,1.0861187303353927,1.086148658446517,79.82415508663578,71.10636756959022,-0.00013020642822666887,1.0871259213273923,1.0866030564044034,1.0872854282765738,0.0005228649229889193,0.0005340182656429972,0.0009333348809599029,8.108015137064939e-06,-3.240454078179411e-06,-5.901960784249205e-05,2.58854543036587,1.086025426187278,True,False,1.09049,1.08779,1.08779,1.08799,2024-05-20 07:15:00,True,2024-05-20 07:15:00,,2024-05-20 09:57:34,0.02,even,True,10.92,986.5400000000013,,6,0,20,5
2024-05-17 22:00:00,1.0875,1.0875,1.08725,1.08739,237,12,0,2024-05-17 22:00:00,2024-05-17 22:00:00,0.0002864285714296866,0.0003714130324388165,1.0874944047619048,0.00015816723813369453,0.00011602480098333978,1.0874613095238097,1.0823153533602112,1.0863923284725276,1.0831747706579544,1.0862450664710825,0.00011850043494383887,3.792391819182617e-05,1.0861871993460126,1.0862311657707957,86.70963062158961,78.86117898400158,-2.9882536093571793e-05,1.0871665488154858,1.0866613485225958,1.087319060887513,0.000505200292890029,0.0005282546710924036,0.000804275657564165,3.3632610939138274e-05,8.108015137064939e-06,-3.240454078179411e-06,2.5884048330252245,1.0862332887498014,True,False,1.09039,1.08769,1.08769,1.08789,2024-05-20 07:15:00,True,2024-05-20 07:15:00,,2024-05-20 10:00:05,0.02,even,True,10.92,997.4600000000013,,7,0,20,5
2024-05-17 22:15:00,1.08739,1.08756,1.08735,1.08755,311,12,0,2024-05-17 22:00:00,2024-05-17 22:00:00,0.0002864285714296866,0.0003714130324388165,1.0874944047619048,0.00015816723813369453,0.00011602480098333978,1.0874613095238097,1.0823153533602112,1.0863923284725276,1.0831747706579544,1.0862450664710825,0.00011850043494383887,3.792391819182617e-05,1.0861871993460126,1.0862311657707957,88.30685284381762,84.94687951734767,-2.9882536093571793e-05,1.087225541305411,1.086727174557959,1.0874346818025455,0.0004983667474520725,0.0005222770863643374,0.0007412269108381373,0.0001156209150325882,3.3632610939138274e-05,8.108015137064939e-06,2.588435338132177,1.0864340254729141,True,False,1.09055,1.08785,1.08785,1.08805,2024-05-20 08:15:00,True,2024-05-20 08:15:00,,2024-05-20 09:21:48,0.02,even,True,10.92,1008.3800000000012,,8,0,20,5
2024-05-20 02:15:00,1.08719,1.08728,1.08718,1.08727,144,12,0,2024-05-20 02:00:00,2024-05-20 02:00:00,4.571428571287228e-05,0.00031894072940996665,1.0869977380952378,0.00026183473885702815,0.00010953558772549895,1.0869666666666664,1.0826729329077247,1.0869453672337437,1.0823894329661914,1.0867705179344682,0.00011602833298504018,0.00026183680038513533,1.0863556782581527,1.0864239411723913,77.55845290213779,66.05393883165364,0.00018746199210793534,1.0870365181851913,1.0869113272879103,1.0869157309941515,0.0001251908972810245,0.0001414807799691717,0.0002819296602909387,8.390780873779313e-05,5.9731682146013654e-05,2.889576875553246e-07,2.5872963360355445,1.0865351259527587,True,False,1.0902699999999999,1.08757,1.08757,1.08777,2024-05-20 07:15:00,True,2024-05-20 07:15:00,,2024-05-20 10:09:37,0.02,even,True,10.92,1019.3000000000012,,9,0,21,5
2024-05-20 02:30:00,1.0872600000000001,1.08734,1.08719,1.08731,164,12,0,2024-05-20 02:00:00,2024-05-20 02:00:00,4.571428571287228e-05,0.00031894072940996665,1.0869977380952378,0.00026183473885702815,0.00010953558772549895,1.0869666666666664,1.0826729329077247,1.0869453672337437,1.0823894329661914,1.0867705179344682,0.00011602833298504018,0.00026183680038513533,1.0863556782581527,1.0864239411723913,91.86890034032821,77.38684385868952,0.00018746199210793534,1.0870785923105466,1.086940858599917,1.0870013794289637,0.00013773371062963946,0.00014073136610126525,0.00028402875444535637,8.564843481217999e-05,8.390780873779313e-05,5.9731682146013654e-05,2.587384818247465,1.0866179406104624,True,False,1.09031,1.08761,1.08761,1.08781,2024-05-20 07:15:00,True,2024-05-20 07:15:00,,2024-05-20 10:09:37,0.02,even,True,10.92,1030.2200000000012,,10,0,21,5
2024-05-20 02:45:00,1.08732,1.08735,1.08715,1.08717,153,12,0,2024-05-20 02:00:00,2024-05-20 02:00:00,4.571428571287228e-05,0.00031894072940996665,1.0869977380952378,0.00026183473885702815,0.00010953558772549895,1.0869666666666664,1.0826729329077247,1.0869453672337437,1.0823894329661914,1.0867705179344682,0.00011602833298504018,0.00026183680038513533,1.0863556782581527,1.0864239411723913,92.77667085593642,87.40134136613413,0.00018746199210793534,1.0870926550320008,1.0869578320369602,1.0870767079463364,0.00013482299504063988,0.00013954969188914018,0.00028402875444535637,7.532851737268587e-05,8.564843481217999e-05,8.390780873779313e-05,2.5874601467648377,1.086693269127835,True,False,1.0901699999999999,1.08747,1.08747,1.08767,2024-05-20 06:45:00,True,2024-05-20 06:45:00,,2024-05-20 10:11:01,0.02,even,True,10.92,1041.1400000000012,,11,0,21,5
2024-05-20 03:45:00,1.0874,1.08758,1.08737,1.08745,315,12,0,2024-05-20 03:00:00,2024-05-20 03:00:00,3.107142857139422e-05,0.0003282434133997647,1.0870986904761906,0.00023610233803094763,0.00010952533457272901,1.0869977380952378,1.0830099236376227,1.08706451841203,1.0826729329077247,1.0869453672337437,0.00010953558772549895,0.00026183473885702815,1.0864262796608526,1.0865060258786001,86.93466287513125,81.61023212696915,0.0002156182763663012,1.0872197528911283,1.0870587315232312,1.0873889748882009,0.0001610213678970851,0.0001426664531508228,0.0002999122094076784,7.883384932916293e-05,9.260405916733383e-05,0.00011825593395231593,2.5877938563709013,1.0869840934055004,True,False,1.09045,1.08775,1.08775,1.08795,2024-05-20 07:15:00,True,2024-05-20 07:15:00,,2024-05-20 09:57:48,0.02,even,True,10.92,1052.0600000000013,,12,0,21,5
2024-05-20 04:00:00,1.08744,1.08754,1.08729,1.0875,560,12,0,2024-05-20 04:00:00,2024-05-20 04:00:00,0.00010095238095275683,0.00035768123409907204,1.0872332142857146,0.00023610670333079926,0.00010952017477708103,1.0870986904761906,1.083265650668563,1.0871836080057462,1.0830099236376227,1.08706451841203,0.00010952533457272901,0.00023610233803094763,1.086492326134346,1.0865815438083122,83.02651853052942,82.94002386627825,0.00024403086791285536,1.0872628678309546,1.0870914180770659,1.0874679050567584,0.00017144975388871941,0.00014842311329840214,0.000300444115743885,7.893016855753388e-05,7.883384932916293e-05,9.260405916733383e-05,2.587873504613013,1.0870623055005042,True,False,1.0904999999999998,1.0877999999999999,1.0877999999999999,1.0879999999999999,2024-05-20 07:15:00,True,2024-05-20 07:15:00,,2024-05-20 09:57:34,0.02,even,True,10.92,1062.9800000000014,,13,0,21,5
2024-05-20 06:15:00,1.08743,1.08761,1.08731,1.08759,151,12,0,2024-05-20 06:00:00,2024-05-20 06:00:00,0.00011273809523881795,0.0003547169956228391,1.0875572619047618,0.0002082264432851607,1.4748749830765936e-06,1.0873459523809534,1.0838489784381788,1.0877753219051836,1.083520063739888,1.0873026568594801,0.00010952429481086306,0.00022116837056767205,1.0866227328605464,1.0867285066793555,74.29718875502446,65.99732262383027,0.00028619542215026385,1.0873530335064328,1.0872273042472074,1.087412156862745,0.00012572925922538225,0.0001285112476931935,0.00026358110709779123,2.729618163122005e-05,-3.1785345708801316e-06,5.847953203907963e-07,2.5877679913573273,1.087056322368163,True,False,1.09059,1.08789,1.08789,1.08809,2024-05-20 08:45:00,True,2024-05-20 08:45:00,,2024-05-20 09:20:31,0.02,even,True,10.92,1073.9000000000015,,14,0,21,5
2024-05-20 06:30:00,1.08758,1.08775,1.08753,1.08769,247,12,0,2024-05-20 06:00:00,2024-05-20 06:00:00,0.00011273809523881795,0.0003547169956228391,1.0875572619047618,0.0002082264432851607,1.4748749830765936e-06,1.0873459523809534,1.0838489784381788,1.0877753219051836,1.083520063739888,1.0873026568594801,0.00010952429481086306,0.00022116837056767205,1.0866227328605464,1.0867285066793555,84.99805674311013,74.51742453686224,0.00028619542215026385,1.0874048745054432,1.0872615780066734,1.087467179222566,0.0001432964987697627,0.00013146829790850733,0.00023416660739550472,5.502235982102199e-05,2.729618163122005e-05,-3.1785345708801316e-06,2.58778330414255,1.0871510543025822,True,False,1.09069,1.0768900000000001,1.08799,1.08819,,False,,,,0.02,running,False,0.0,1073.9000000000015,2024-05-20 09:30:00,0,1,21,5
2024-05-20 06:45:00,1.08768,1.08781,1.08766,1.08773,310,12,0,2024-05-20 06:00:00,2024-05-20 06:00:00,0.00011273809523881795,0.0003547169956228391,1.0875572619047618,0.0002082264432851607,1.4748749830765936e-06,1.0873459523809534,1.0838489784381788,1.0877753219051836,1.083520063739888,1.0873026568594801,0.00010952429481086306,0.00022116837056767205,1.0866227328605464,1.0867285066793555,91.73612010768208,83.67712186860555,0.00028619542215026385,1.087454893812298,1.0872962759321052,1.087529267285862,0.00015861788019289058,0.000136898214365384,0.00022816076207936794,6.208806329599525e-05,5.502235982102199e-05,2.729618163122005e-05,2.587837284314669,1.0872212502570548,True,False,1.09073,1.0769300000000002,1.08803,1.08823,,False,,,,0.02,running,False,0.0,1073.9000000000015,2024-05-20 09:45:00,0,2,21,5
2024-05-20 07:00:00,1.08774,1.0881,1.0877,1.08801,208,12,0,2024-05-20 07:00:00,2024-05-20 07:00:00,0.0002113095238083229,0.0003803888983033854,1.0877410714285711,0.0001960958012744923,2.7522718255175786e-05,1.0875572619047618,1.084257936242498,1.0877226497984542,1.0838489784381788,1.0877753219051836,1.4748749830765936e-06,0.0002082264432851607,1.086712879127608,1.0868318261450072,91.17546163218934,89.3032128276605,0.00030503411738088814,1.0875402947642523,1.0873491443815788,1.0876402923976607,0.00019115038267347728,0.00014774864802700267,0.00025180150916846744,0.00011102511179861274,6.208806329599525e-05,5.502235982102199e-05,2.587980224435038,1.0873003603602833,True,False,1.0910099999999998,1.07721,1.0883099999999999,1.0885099999999999,,False,,,,0.02,running,False,0.0,1073.9000000000015,2024-05-20 10:00:00,0,3,21,5
2024-05-20 08:00:00,1.08801,1.08813,1.08794,1.08807,180,12,0,2024-05-20 08:00:00,2024-05-20 08:00:00,0.000183809523809364,0.00042096727797624744,1.0878725,0.00012113354994640856,2.7518544932699675e-05,1.0877410714285711,1.0854310880879614,1.087752590625687,1.084257936242498,1.0877226497984542,2.7522718255175786e-05,0.0001960958012744923,1.086795274022601,1.0869244800534066,85.01529051988862,83.20969711650709,0.00032822074949996003,1.087768651505319,1.0875226782353151,1.0879374269005846,0.00024597327000397406,0.0001972702721389568,0.0003099311751881521,8.465428276571707e-05,9.234262125912274e-05,4.3986928104366996e-05,2.5883558339870887,1.0875190198140805,True,False,1.09107,1.0772700000000002,1.08837,1.08857,,False,,,,0.02,running,False,0.0,1073.9000000000015,2024-05-20 11:00:00,0,4,21,5
2024-05-20 08:15:00,1.08806,1.08812,1.08798,1.08801,123,12,0,2024-05-20 08:00:00,2024-05-20 08:00:00,0.000183809523809364,0.00042096727797624744,1.0878725,0.00012113354994640856,2.7518544932699675e-05,1.0877410714285711,1.0854310880879614,1.087752590625687,1.084257936242498,1.0877226497984542,2.7522718255175786e-05,0.0001960958012744923,1.086795274022601,1.0869244800534066,86.54434250765259,84.30173292559469,0.00032822074949996003,1.0878057820429623,1.0875587761438104,1.0880042965256276,0.00024700589915194193,0.00020721739754155387,0.00031969881662847327,6.686962504298677e-05,8.465428276571707e-05,9.234262125912274e-05,2.5884358899280757,1.0875727031231792,True,False,1.0910099999999998,1.07721,1.0883099999999999,1.0885099999999999,,False,,,,0.02,running,False,0.0,1073.9000000000015,2024-05-20 11:15:00,0,5,21,5
2024-05-20 08:30:00,1.088,1.0882,1.08797,1.08812,218,12,0,2024-05-20 08:00:00,2024-05-20 08:00:00,0.000183809523809364,0.00042096727797624744,1.0878725,0.00012113354994640856,2.7518544932699675e-05,1.0877410714285711,1.0854310880879614,1.087752590625687,1.084257936242498,1.0877226497984542,2.7522718255175786e-05,0.0001960958012744923,1.086795274022601,1.0869244800534066,88.96817306603513,86.8426020311921,0.00032822074949996003,1.087854123267122,1.087600348281306,1.088087657378741,0.0002537749858160243,0.00021652891519644796,0.0003360739006336468,8.336085311344554e-05,6.686962504298677e-05,8.465428276571707e-05,2.5885413571445968,1.0876339576128855,True,False,1.0911199999999999,1.07732,1.08842,1.08862,,False,,,,0.02,running,False,0.0,1073.9000000000015,2024-05-20 11:30:00,0,6,21,5
2024-05-20 14:30:00,1.08626,1.08652,1.08621,1.0863,464,12,0,2024-05-20 14:00:00,2024-05-20 14:00:00,-0.00020821428571538014,0.00011081783913824417,1.086612619047619,-2.7666582287010583e-05,8.287521189498736e-05,1.0870973809523803,1.086368270942257,1.0874858069002307,1.0863026097442106,1.0875554293695078,6.942651046226535e-05,1.834646786789224e-05,1.086852423161171,1.0869360688657566,10.134932533733355,22.8536752032096,0.0002649178182206362,1.0868139311782434,1.0870806873237748,1.0866220227038192,-0.00026675614553139937,-0.00018324209110396158,0.0005532305125529555,-0.00011328173374569595,-0.00010098039215677979,-5.2511179909675576e-05,1.0873688838957658,-0.4141248384881273,False,True,1.0833000000000002,1.086,1.086,1.0858,2024-05-20 15:15:00,True,2024-05-20 15:15:00,2024-05-22 14:10:29,2024-05-20 15:20:08,0.02,even,True,10.9,1084.8000000000015,,1,0,21,5
2024-05-20 14:45:00,1.08629,1.08636,1.08592,1.08594,567,12,0,2024-05-20 14:00:00,2024-05-20 14:00:00,-0.00020821428571538014,0.00011081783913824417,1.086612619047619,-2.7666582287010583e-05,8.287521189498736e-05,1.0870973809523803,1.086368270942257,1.0874858069002307,1.0863026097442106,1.0875554293695078,6.942651046226535e-05,1.834646786789224e-05,1.086852423161171,1.0869360688657566,8.222596019066074,12.80345309342871,0.0002649178182206362,1.0866794802277444,1.0869961919664584,1.0864393120055031,-0.0003167117387139484,-0.00020993602062595898,0.0005801585990221791,-0.00018271069831610198,-0.00011328173374569595,-0.00010098039215677979,1.087222526114183,-0.41434390210317673,False,True,1.08294,1.08564,1.08564,1.08544,2024-05-20 15:30:00,True,2024-05-20 15:30:00,2024-05-22 14:30:44,2024-05-20 15:31:44,0.02,even,True,10.9,1095.7000000000016,,2,0,21,5
2024-05-20 15:00:00,1.08601,1.08625,1.08562,1.08563,738,12,0,2024-05-20 15:00:00,2024-05-20 15:00:00,-0.0004847619047612106,-4.930498020461194e-05,1.0861925,-6.021164676670261e-05,3.6875376803648953e-05,1.086612619047619,1.0863353347572917,1.0880221487197081,1.086368270942257,1.0874858069002307,8.287521189498736e-05,-2.7666582287010583e-05,1.0867774281185147,1.086836383356496,4.946141462838393,7.767890005212599,0.00020207325853558656,1.0865180217311683,1.0868949925615354,1.0862394220846225,-0.0003769708303671404,-0.00024334298257419525,0.0006285167725307072,-0.00019988992088060265,-0.00018271069831610198,-0.00011328173374569595,1.087087919727539,-0.41460907555829385,False,True,1.0826300000000002,1.0853300000000001,1.0853300000000001,1.0851300000000001,2024-05-21 05:15:00,True,2024-05-21 05:15:00,2024-05-22 14:38:31,2024-05-21 05:26:07,0.02,even,True,10.9,1106.6000000000017,,3,0,21,5
2024-05-20 15:15:00,1.08562,1.08617,1.08542,1.08542,869,12,0,2024-05-20 15:00:00,2024-05-20 15:00:00,-0.0004847619047612106,-4.930498020461194e-05,1.0861925,-6.021164676670261e-05,3.6875376803648953e-05,1.086612619047619,1.0863353347572917,1.0880221487197081,1.086368270942257,1.0874858069002307,8.287521189498736e-05,-2.7666582287010583e-05,1.0867774281185147,1.086836383356496,0.5783253708818008,4.58235428426208,0.00020207325853558656,1.0863490953109887,1.0867857338532736,1.086015878912969,-0.0004366385422849284,-0.00028200209451634186,0.0006729722629391357,-0.00022354317165351745,-0.00019988992088060265,-0.00018271069831610198,1.086924391467937,-0.4148926336419989,False,True,1.0824200000000002,1.08512,1.08512,1.08492,2024-05-21 17:00:00,True,2024-05-21 17:00:00,2024-05-22 14:45:31,2024-05-21 17:07:33,0.02,even,True,10.9,1117.5000000000018,,4,0,21,5
2024-05-20 15:30:00,1.08542,1.08597,1.08536,1.08548,1073,12,0,2024-05-20 15:00:00,2024-05-20 15:00:00,-0.0004847619047612106,-4.930498020461194e-05,1.0861925,-6.021164676670261e-05,3.6875376803648953e-05,1.086612619047619,1.0863353347572917,1.0880221487197081,1.086368270942257,1.0874858069002307,8.287521189498736e-05,-2.7666582287010583e-05,1.0867774281185147,1.086836383356496,2.233676975944541,2.5860479365549023,0.00020207325853558656,1.0862153883400674,1.0866890128271052,1.0858370725834203,-0.0004736244870378048,-0.0003203265730206344,0.0006877637675964395,-0.00017880632954869746,-0.00022354317165351745,-0.00019988992088060265,1.0867655536696754,-0.41509140850283477,False,True,1.08248,1.08518,1.08518,1.08498,2024-05-21 17:00:00,True,2024-05-21 17:00:00,2024-05-22 14:45:12,2024-05-21 17:07:40,0.02,even,True,10.9,1128.400000000002,,5,0,21,5
2024-05-20 22:45:00,1.0861,1.08611,1.08585,1.0859,316,12,0,2024-05-20 22:00:00,2024-05-20 22:00:00,0.00014571428571441558,-0.0001758805315343892,1.0862696428571426,-0.00014754193734964213,-0.00011527595637157264,1.0864180952380953,1.0866286331074284,1.0886098291091513,1.0871437218835402,1.0887352015911023,-0.00011527172923934419,-0.0001841505099787273,1.0865925659895916,1.0865897572196297,17.179836926948358,30.19140147773611,-0.00011347033051055887,1.0862545422756749,1.0863436580814343,1.086300811833505,-8.911580575943212e-05,-5.8186960974403746e-05,0.00025242358583036484,-8.853457172408596e-05,-5.337461300292112e-05,-2.3099415205285467e-05,1.086641583674376,-0.4140399600073661,False,True,1.0829000000000002,1.0856000000000001,1.0856000000000001,1.0854000000000001,2024-05-21 05:15:00,True,2024-05-21 05:15:00,2024-05-22 14:30:53,2024-05-21 06:02:32,0.02,even,True,10.9,1139.300000000002,,6,0,21,5
2024-05-20 23:00:00,1.08591,1.08593,1.08574,1.08577,239,11,0,2024-05-20 23:00:00,2024-05-20 23:00:00,-0.00014845238095273494,-0.00021636901721566737,1.0859845238095236,-9.252482074402168e-05,-0.00011706897164939609,1.0862696428571426,1.0860549344788686,1.0884969579870059,1.0866286331074284,1.0886098291091513,-0.00011527595637157264,-0.00014754193734964213,1.086527884312844,1.0865097766420593,7.922365662582682,18.456771920881582,-0.0001340500678515806,1.0861799973101864,1.086301164890217,1.0861656071551424,-0.00012116758003055672,-7.078308478563434e-05,0.0002763301166179171,-0.00013520467836247718,-8.853457172408596e-05,-5.337461300292112e-05,1.0865386528125767,-0.4142074385022918,False,True,1.08277,1.08547,1.08547,1.08527,2024-05-21 05:15:00,True,2024-05-21 05:15:00,2024-05-22 14:38:18,2024-05-21 05:43:02,0.02,even,True,10.9,1150.200000000002,,7,0,21,5
2024-05-20 23:15:00,1.08578,1.08578,1.08571,1.08572,169,11,0,2024-05-20 23:00:00,2024-05-20 23:00:00,-0.00014845238095273494,-0.00021636901721566737,1.0859845238095236,-9.252482074402168e-05,-0.00011706897164939609,1.0862696428571426,1.0860549344788686,1.0884969579870059,1.0866286331074284,1.0886098291091513,-0.00011527595637157264,-0.00014754193734964213,1.086527884312844,1.0865097766420593,2.522404970764453,9.208202520098489,-0.0001340500678515806,1.0861092284932348,1.0862581156390898,1.0860290127278982,-0.0001488871458550367,-8.640389699951482e-05,0.00028785123475501544,-0.00013659442724422988,-0.00013520467836247718,-8.853457172408596e-05,1.0864176118948174,-0.41435958643902104,False,True,1.0827200000000001,1.08542,1.08542,1.08522,2024-05-21 05:15:00,True,2024-05-21 05:15:00,2024-05-22 14:38:22,2024-05-21 05:42:16,0.02,even,True,10.9,1161.1000000000022,,8,0,21,5
2024-05-20 23:30:00,1.08573,1.08579,1.08563,1.08563,177,11,0,2024-05-20 23:00:00,2024-05-20 23:00:00,-0.00014845238095273494,-0.00021636901721566737,1.0859845238095236,-9.252482074402168e-05,-0.00011706897164939609,1.0862696428571426,1.0860549344788686,1.0884969579870059,1.0866286331074284,1.0886098291091513,-0.00011527595637157264,-0.00014754193734964213,1.086527884312844,1.0865097766420593,1.0604166666676964,3.8350624333382677,-0.0001340500678515806,1.0860355010327372,1.0862115885547128,1.0858797557619542,-0.00017608752197562083,-0.00010434062199473604,0.00030875394737000194,-0.00014925696594403348,-0.00013659442724422988,-0.00013520467836247718,1.0862965735909036,-0.41453706206699525,False,True,1.0826300000000002,1.0853300000000001,1.0853300000000001,1.0851300000000001,2024-05-21 05:15:00,True,2024-05-21 05:15:00,2024-05-22 14:38:31,2024-05-21 05:26:07,0.02,even,True,10.9,1172.0000000000023,,9,0,21,5
2024-05-20 23:45:00,1.08563,1.08572,1.08559,1.08559,212,12,0,2024-05-20 23:00:00,2024-05-20 23:00:00,-0.00014845238095273494,-0.00021636901721566737,1.0859845238095236,-9.252482074402168e-05,-0.00011706897164939609,1.0862696428571426,1.0860549344788686,1.0884969579870059,1.0866286331074284,1.0886098291091513,-0.00011527595637157264,-0.00014754193734964213,1.086527884312844,1.0865097766420593,0.26041666666835966,1.2810794347001602,-0.0001340500678515806,1.085966962412316,1.0861655449580674,1.0857624423804606,-0.00019858254575133572,-0.00012318900674605597,0.0003301651102349627,-0.00011731338149356674,-0.00014925696594403348,-0.00013659442724422988,1.0862081652792779,-0.4146832805183567,False,True,1.0825900000000002,1.08529,1.08529,1.08509,2024-05-21 17:00:00,True,2024-05-21 17:00:00,2024-05-22 14:44:04,2024-05-21 17:09:08,0.02,even,True,10.9,1182.9000000000024,,10,0,21,5
2024-05-21 05:15:00,1.08514,1.08538,1.08503,1.08526,443,12,0,2024-05-21 05:00:00,2024-05-21 05:00:00,-0.00011511904761918323,-0.0002506530534054363,1.0857047619047617,-2.101154571144228e-05,-9.764764725653402e-05,1.0857651190476187,1.0853809345573486,1.0876183266378356,1.0853491706765392,1.0875846826951214,-7.906122812969396e-05,5.202263930438887e-06,1.086280242392989,1.0862196239132211,10.846300846301409,25.671710671710894,-0.00022017328809058952,1.0856506271893975,1.085797755771248,1.0856146370829034,-0.00014712858185039757,-9.57468469767777e-05,0.00022190313205330776,-9.48297213623217e-05,-0.0001557550739597069,-8.553147574774655e-05,1.0859142063111753,-0.4146849321453685,False,True,1.08226,1.08496,1.08496,1.08476,2024-05-22 11:30:00,True,2024-05-22 11:30:00,2024-05-22 14:53:21,2024-05-22 11:39:58,0.02,even,True,10.9,1193.8000000000025,,11,0,21,5
2024-05-21 12:15:00,1.08716,1.08741,1.08701,1.08732,703,12,0,2024-05-21 12:00:00,2024-05-21 12:00:00,0.0002945238095235503,5.378127188926385e-06,1.0866595238095234,1.3551852446688498e-06,5.0951526068680866e-05,1.0863079761904761,1.0850183595561127,1.0865838641008643,1.0855290991886655,1.0869893867134706,-6.792531351564732e-06,-5.157384871679667e-05,1.0862704490159811,1.0862422469438417,88.98767242178724,74.47779125975394,-0.00014927931751807725,1.0865014393668926,1.0862162399693784,1.0867302235982115,0.00028519939751414647,0.00017224021603054137,0.00048621600139884337,0.00018117991056088023,0.00018303061575530855,6.530787753655787e-05,2.5873866152001,1.086073831996323,True,False,1.09032,1.0765200000000001,1.08762,1.08782,,False,,,,0.02,running,False,0.0,1193.8000000000025,2024-05-21 15:15:00,0,1,21,5
2024-05-21 12:30:00,1.08733,1.08734,1.08684,1.08702,646,12,0,2024-05-21 12:00:00,2024-05-21 12:00:00,0.0002945238095235503,5.378127188926385e-06,1.0866595238095234,1.3551852446688498e-06,5.0951526068680866e-05,1.0863079761904761,1.0850183595561127,1.0865838641008643,1.0855290991886655,1.0869893867134706,-6.792531351564732e-06,-5.157384871679667e-05,1.0862704490159811,1.0862422469438417,88.5201007777439,83.30073083523918,-0.00014927931751807725,1.0865812179258323,1.0862757777494245,1.0868346336429309,0.00030544017640776744,0.00019888020810598657,0.0004998806524393716,0.00010441004471939408,0.00018117991056088023,0.00018303061575530855,2.587509472523724,1.0861597947621378,True,False,1.09002,1.0762200000000002,1.08732,1.08752,,False,,,,0.02,running,False,0.0,1193.8000000000025,2024-05-21 15:30:00,0,2,21,5
2024-05-21 20:30:00,1.08507,1.08525,1.08497,1.08514,331,12,0,2024-05-21 20:00:00,2024-05-21 20:00:00,-0.0001861904761912836,-0.00020209338006726973,1.0852163095238099,-7.046371065265694e-05,-2.7484023900049023e-05,1.0852801190476182,1.0850344351982144,1.087616779457076,1.0851109864371793,1.087027460298045,4.4436284535881984e-05,-7.0471337103504e-05,1.086011654286041,1.0859436134782134,27.922077922080458,33.405483405485455,-9.044660953633427e-05,1.0853061478717436,1.085562382147722,1.0852020571035437,-0.00025623427597842863,-0.0002320442378546322,0.0004736496595736515,-4.307877536957605e-05,-5.1080151358018355e-05,-0.00013117647058802362,1.085841484143968,-0.41543736993688074,False,True,1.08214,1.08484,1.08484,1.08464,2024-05-22 11:30:00,True,2024-05-22 11:30:00,2024-05-22 14:53:32,2024-05-22 11:33:37,0.02,even,True,10.9,1204.7000000000025,,1,0,21,5
2024-05-22 12:15:00,1.08436,1.08445,1.08406,1.0844,595,12,0,2024-05-22 12:00:00,2024-05-22 12:00:00,-0.0003005952380945587,-9.335261815435203e-05,1.0850009523809532,-5.537069796671925e-05,3.831788887315976e-06,1.0853832142857152,1.0849558898100728,1.0862362265362453,1.0845806840574947,1.0857057218601467,5.92922563065947e-05,-1.278349326376748e-06,1.0856082502558482,1.0855308453573336,9.855691828265279,10.528285135713771,-6.403935418856773e-05,1.0849914105838654,1.0852449726300186,1.0848272514619888,-0.00025356204615323286,-0.00012485754546446087,0.0004340767981362987,-0.00018046783625758067,-0.00020219470244153825,-0.00012170966632241154,1.0854132551394728,-0.4157587522154953,False,True,1.0814000000000001,1.0841,1.0841,1.0839,2024-05-22 14:00:00,True,2024-05-22 14:00:00,2024-05-23 10:24:27,2024-05-22 18:42:15,0.02,even,True,10.9,1215.6000000000026,,2,0,21,5
2024-05-22 12:30:00,1.08441,1.08448,1.08411,1.08428,494,12,0,2024-05-22 12:00:00,2024-05-22 12:00:00,-0.0003005952380945587,-9.335261815435203e-05,1.0850009523809532,-5.537069796671925e-05,3.831788887315976e-06,1.0853832142857152,1.0849558898100728,1.0862362265362453,1.0845806840574947,1.0857057218601467,5.92922563065947e-05,-1.278349326376748e-06,1.0856082502558482,1.0855308453573336,8.712582882983485,9.643140958621652,-6.403935418856773e-05,1.084881962801732,1.0851734931759431,1.0846269693842445,-0.00029153037421103534,-0.00015819211121377577,0.0004790782817175797,-0.00020028207774425155,-0.00018046783625758067,-0.00020219470244153825,1.0852737250645632,-0.41601978629607417,False,True,1.08128,1.08398,1.08398,1.08378,2024-05-22 14:00:00,True,2024-05-22 14:00:00,2024-05-23 10:26:26,2024-05-22 16:33:40,0.02,even,True,10.9,1226.5000000000027,,3,0,21,5
2024-05-22 13:15:00,1.08452,1.08453,1.08388,1.08393,491,12,0,2024-05-22 13:00:00,2024-05-22 13:00:00,-0.0003822619047619824,-0.0002145660943340122,1.084508452380952,-8.674125311602741e-05,3.829221896920654e-06,1.0850009523809532,1.0850132578367908,1.0862404197429751,1.0849558898100728,1.0862362265362453,3.831788887315976e-06,-5.537069796671925e-05,1.085485137336116,1.0853843777287469,10.85598744642897,12.039190633611733,-9.414470221765663e-05,1.0846218809690966,1.0849797678643556,1.0841743102855184,-0.000357886895258952,-0.00024373940287107312,0.0005866083304440632,-0.00018779153766623757,-0.0001002098383227068,-0.0001646577227372159,1.0849662315316178,-0.41661761096058103,False,True,1.0809300000000002,1.08363,1.08363,1.0834300000000001,2024-05-22 14:15:00,True,2024-05-22 14:15:00,2024-05-23 20:56:31,2024-05-22 16:24:22,0.02,even,True,10.9,1237.4000000000028,,4,0,21,5
2024-05-22 13:30:00,1.08394,1.08423,1.08388,1.08397,509,12,0,2024-05-22 13:00:00,2024-05-22 13:00:00,-0.0003822619047619824,-0.0002145660943340122,1.084508452380952,-8.674125311602741e-05,3.829221896920654e-06,1.0850009523809532,1.0850132578367908,1.0862404197429751,1.0849558898100728,1.0862362265362453,3.831788887315976e-06,-5.537069796671925e-05,1.085485137336116,1.0853843777287469,8.972424476412693,11.09377557368223,-9.414470221765663e-05,1.0845215915892354,1.0849049702447737,1.0840259373925007,-0.0003833786555382801,-0.00027166725340451456,0.0006274506620812431,-0.00014837289301761203,-0.00018779153766623757,-0.0001002098383227068,1.0848729957863104,-0.41682112100130886,False,True,1.0809700000000002,1.0836700000000001,1.0836700000000001,1.0834700000000002,2024-05-22 14:15:00,True,2024-05-22 14:15:00,2024-05-23 20:54:09,2024-05-22 16:24:51,0.02,even,True,10.9,1248.300000000003,,5,0,21,5
2024-05-22 13:45:00,1.08397,1.08399,1.08361,1.0836999999999999,547,12,0,2024-05-22 13:00:00,2024-05-22 13:00:00,-0.0003822619047619824,-0.0002145660943340122,1.084508452380952,-8.674125311602741e-05,3.829221896920654e-06,1.0850009523809532,1.0850132578367908,1.0862404197429751,1.0849558898100728,1.0862362265362453,3.831788887315976e-06,-5.537069796671925e-05,1.085485137336116,1.0853843777287469,3.609603440943714,7.812671787928454,-9.414470221765663e-05,1.0843951928831992,1.0848157131896055,1.0838806363949078,-0.00042052030640626903,-0.0003014378640048655,0.0006824531730060453,-0.00014530099759291204,-0.00014837289301761203,-0.00018779153766623757,1.084801948178466,-0.4170406753886504,False,True,1.0807,1.0834,1.0834,1.0832,2024-05-22 14:15:00,True,2024-05-22 14:15:00,2024-05-23 21:23:23,2024-05-22 15:47:03,0.02,even,True,10.9,1259.200000000003,,6,0,21,5
2024-05-22 14:00:00,1.0836999999999999,1.08377,1.08303,1.0831,631,12,0,2024-05-22 14:00:00,2024-05-22 14:00:00,-0.000492500000001117,-0.00035862563109190226,1.083756190476191,-0.0001956563590326139,3.829949977349693e-06,1.084508452380952,1.0852836512585433,1.0862445666529377,1.0850132578367908,1.0862404197429751,3.829221896920654e-06,-8.674125311602741e-05,1.085304160733786,1.0851680275104472,3.7603991128070096,5.447475676721134,-0.00014704088799250578,1.08419593243963,1.0846886233237087,1.0836499449604415,-0.0004926908840787725,-0.0003396884680196469,0.000778452952985873,-0.00023069143446630136,-0.00014530099759291204,-0.00014837289301761203,1.0847008564469725,-0.4174009665260894,False,True,1.0801,1.0828,1.0828,1.0826,2024-05-22 14:45:00,True,2024-05-22 14:45:00,,2024-05-22 15:00:24,0.02,even,True,10.9,1270.100000000003,,7,0,21,5
2024-05-22 14:15:00,1.0831,1.08329,1.08302,1.08308,478,12,0,2024-05-22 14:00:00,2024-05-22 14:00:00,-0.000492500000001117,-0.00035862563109190226,1.083756190476191,-0.0001956563590326139,3.829949977349693e-06,1.084508452380952,1.0852836512585433,1.0862445666529377,1.0850132578367908,1.0862404197429751,3.829221896920654e-06,-8.674125311602741e-05,1.085304160733786,1.0851680275104472,2.938595700326903,3.4361994180258706,-0.00014704088799250578,1.0840242505258408,1.084569466040471,1.0834797316821463,-0.0005452155146301596,-0.0003807938773417495,0.0008585846881227475,-0.00017021327829525035,-0.00023069143446630136,-0.00014530099759291204,1.084638821011112,-0.4176793576468194,False,True,1.0800800000000002,1.08278,1.08278,1.08258,2024-05-22 21:30:00,True,2024-05-22 21:30:00,,2024-05-23 03:20:48,0.02,even,True,10.9,1281.0000000000032,,8,0,21,5
2024-05-22 14:30:00,1.0830899999999999,1.08311,1.08259,1.0826,722,12,0,2024-05-22 14:00:00,2024-05-22 14:00:00,-0.000492500000001117,-0.00035862563109190226,1.083756190476191,-0.0001956563590326139,3.829949977349693e-06,1.084508452380952,1.0852836512585433,1.0862445666529377,1.0850132578367908,1.0862404197429751,3.829221896920654e-06,-8.674125311602741e-05,1.085304160733786,1.0851680275104472,1.6970594587926027,2.798684757308834,-0.00014704088799250578,1.0838051350603268,1.0844235796671027,1.0831973512211908,-0.0006184446067758476,-0.00042832402322856913,0.0009592140880316974,-0.0002823804609555225,-0.00017021327829525035,-0.00023069143446630136,1.0844922902400336,-0.41809758779765205,False,True,1.0796000000000001,1.0823,1.0823,1.0821,2024-05-22 21:30:00,True,2024-05-22 21:30:00,,2024-05-22 21:47:53,0.02,even,True,10.9,1291.9000000000033,,9,0,21,5
2024-05-23 13:15:00,1.08456,1.08465,1.08438,1.08446,547,12,0,2024-05-23 13:00:00,2024-05-23 13:00:00,0.0005532142857138656,0.00010929874590703825,1.0840002380952376,-4.011918513249644e-05,0.00017342587727399604,1.083577976190476,1.081687114946733,1.0821646051655054,1.0817171731850397,1.0837754047260868,6.144905389492406e-05,-3.916492413878179e-05,1.083559633499419,1.083415442184541,92.79778393351613,91.92338471008848,-0.00022910658097476252,1.083898428577761,1.083419752687267,1.0845210147918822,0.00047867589049399584,0.0003336665258335058,0.0008934843777821497,0.00014331957344415613,0.00020324045407638103,0.00024888544891643605,2.585727218701888,1.0833148108818764,True,False,1.0874599999999999,1.08476,1.08476,1.08496,2024-05-23 15:00:00,True,2024-05-23 15:00:00,,2024-05-23 15:44:35,0.02,even,True,10.92,1302.8200000000033,,10,0,21,5
2024-05-23 13:30:00,1.08446,1.08477,1.08446,1.08467,396,12,0,2024-05-23 13:00:00,2024-05-23 13:00:00,0.0005532142857138656,0.00010929874590703825,1.0840002380952376,-4.011918513249644e-05,0.00017342587727399604,1.083577976190476,1.081687114946733,1.0821646051655054,1.0817171731850397,1.0837754047260868,6.144905389492406e-05,-3.916492413878179e-05,1.083559633499419,1.083415442184541,93.99815327792942,93.5674408693787,-0.00022910658097476252,1.0840171318734901,1.0835123635993213,1.084658919848641,0.0005047682741687876,0.0003678868755005622,0.0009398356239298817,0.00013790505675870257,0.00014331957344415613,0.00020324045407638103,2.5859276979409462,1.0833901417563356,True,False,1.08767,1.08497,1.08497,1.08517,2024-05-23 16:00:00,True,2024-05-23 16:00:00,,2024-05-23 16:45:00,0.02,even,True,10.92,1313.7400000000034,,11,0,21,5
2024-05-23 14:45:00,1.08446,1.08518,1.08441,1.08499,534,12,0,2024-05-23 14:00:00,2024-05-23 14:00:00,0.0004222619047615783,0.00022746757910074855,1.0845319047619042,-6.730617136383784e-05,0.0001790543693474376,1.0840002380952376,1.0819648197009815,1.0822851245315588,1.081687114946733,1.0821646051655054,0.00017342587727399604,-4.011918513249644e-05,1.083651915209134,1.0835414068097777,82.72451672566388,81.86831612341189,-0.0001377917489596603,1.084327554587233,1.08384099750278,1.084776938424493,0.0004865570844529987,0.0004419665733226036,0.0010064414207206578,-4.16030271757073e-05,1.609907120792009e-05,2.344685242516853e-05,1.086135634342466,-0.41658175749348003,True,False,1.0879899999999998,1.0852899999999999,1.0852899999999999,1.0854899999999998,2024-05-23 16:15:00,True,2024-05-23 16:15:00,,2024-05-23 16:45:00,0.02,even,True,10.92,1324.6600000000035,,12,0,21,5
2024-05-23 15:00:00,1.08501,1.08536,1.0849199999999999,1.08503,929,12,0,2024-05-23 15:00:00,2024-05-23 15:00:00,0.000531666666666597,0.00036354806676297535,1.0849604761904765,-3.563374307899979e-05,0.00018147765184511782,1.0845319047619042,1.0815521788091764,1.082435523247951,1.0819648197009815,1.0822851245315588,0.0001790543693474376,-6.730617136383784e-05,1.0837517916472543,1.0836740942649956,84.1761836314822,82.2538326116376,-3.752378581513318e-05,1.084435623112274,1.0839290717618335,1.0848166907464742,0.0005065513504405317,0.00045488352874618925,0.001008888497312361,3.975232198127898e-05,-4.16030271757073e-05,1.609907120792009e-05,2.586178690217846,1.0834546912751026,True,False,1.0880299999999998,1.08533,1.08533,1.0855299999999999,2024-05-23 16:15:00,True,2024-05-23 16:15:00,,2024-05-23 16:40:24,0.02,even,True,10.92,1335.5800000000036,,13,0,21,5
2024-05-23 15:15:00,1.08502,1.08532,1.08494,1.08516,787,12,0,2024-05-23 15:00:00,2024-05-23 15:00:00,0.000531666666666597,0.00036354806676297535,1.0849604761904765,-3.563374307899979e-05,0.00018147765184511782,1.0845319047619042,1.0815521788091764,1.082435523247951,1.0819648197009815,1.0822851245315588,0.0001790543693474376,-6.730617136383784e-05,1.0837517916472543,1.0836740942649956,88.11440840425519,85.00503625380043,-3.752378581513318e-05,1.0845470657103857,1.0840202516313273,1.0848555280357761,0.000526814079058413,0.000469269638808634,0.0009977646683175549,3.883728930187402e-05,3.975232198127898e-05,-4.16030271757073e-05,2.586202510338005,1.0835085457335474,True,False,1.0881599999999998,1.0854599999999999,1.0854599999999999,1.0856599999999998,2024-05-23 16:15:00,True,2024-05-23 16:15:00,,2024-05-23 16:38:48,0.02,even,True,10.92,1346.5000000000036,,14,0,21,5
2024-05-23 16:00:00,1.08521,1.08595,1.08508,1.08585,1087,12,0,2024-05-23 16:00:00,2024-05-23 16:00:00,0.000428571428572333,0.0004719852417700565,1.084577142857142,1.1787382571099351e-06,0.00021523228363467249,1.0849604761904765,1.0811586323273739,1.0825480742319535,1.0815521788091764,1.082435523247951,0.00018147765184511782,-3.563374307899979e-05,1.0837252244442057,1.083647366723796,84.99772735912843,83.50172258289736,6.437801970190477e-05,1.0848559692583175,1.0842836829619207,1.0852527898176798,0.0005722862963968289,0.0005020321811307094,0.0009785278057761727,0.00022012383900715804,0.00013149294805669953,4.5644994839832975e-05,2.5865738023554776,1.083931777279882,True,False,1.0888499999999999,1.07505,1.08615,1.08635,,False,,,,0.02,running,False,0.0,1346.5000000000036,2024-05-23 19:00:00,0,1,21,5
2024-05-23 16:15:00,1.08585,1.08602,1.08558,1.08591,917,12,0,2024-05-23 16:00:00,2024-05-23 16:00:00,0.000428571428572333,0.0004719852417700565,1.084577142857142,1.1787382571099351e-06,0.00021523228363467249,1.0849604761904765,1.0811586323273739,1.0825480742319535,1.0815521788091764,1.082435523247951,0.00018147765184511782,-3.563374307899979e-05,1.0837252244442057,1.083647366723796,92.59963801428903,87.10042102996049,6.437801970190477e-05,1.085018127833961,1.0844041508906674,1.0854334021327834,0.0006139769432935704,0.0005244211335632817,0.0009865216672789619,0.00018061231510357878,0.00022012383900715804,0.00013149294805669953,2.58676520638361,1.0841015978819568,True,False,1.0889099999999998,1.07511,1.08621,1.0864099999999999,,False,,,,0.02,running,False,0.0,1346.5000000000036,2024-05-23 19:15:00,0,2,21,5
2024-05-23 16:30:00,1.08593,1.08603,1.0853,1.08581,1291,12,0,2024-05-23 16:00:00,2024-05-23 16:00:00,0.000428571428572333,0.0004719852417700565,1.084577142857142,1.1787382571099351e-06,0.00021523228363467249,1.0849604761904765,1.0811586323273739,1.0825480742319535,1.0815521788091764,1.082435523247951,0.00018147765184511782,-3.563374307899979e-05,1.0837252244442057,1.083647366723796,91.91645836832885,89.83794124724876,6.437801970190477e-05,1.0851399543210438,1.0845082878617291,1.085545252837977,0.0006316664593146726,0.0005458701987135599,0.0008056109482941798,0.00011185070519359464,0.00018061231510357878,0.00022012383900715804,2.586632827618174,1.08445767805778,True,False,1.0888099999999998,1.07501,1.08611,1.0863099999999999,,False,,,,0.02,running,False,0.0,1346.5000000000036,2024-05-23 19:30:00,0,3,21,5
2024-05-23 21:30:00,1.08061,1.0808200000000001,1.08051,1.08057,790,12,0,2024-05-23 21:00:00,2024-05-23 21:00:00,-0.0007173809523808305,-0.0003847784255555098,1.0810429761904758,-6.219896834672289e-05,0.000175055967763994,1.0817863095238096,1.0814338181079053,1.0841451913593845,1.0813779735348277,1.0831336668889238,0.00024450298833898044,-3.706785378639543e-05,1.083119006703816,1.0829389936579727,5.783913711382831,7.745639613131034,-5.040326259098739e-05,1.08154788004472,1.0823581792047785,1.0808861575507394,-0.0008102991600584808,-0.0006455013315255737,0.001605546428272968,-0.00016486412108784876,-0.00021624011007870259,2.309941520350911e-05,1.083053645228908,-0.4212813301274292,False,True,1.0775700000000001,1.09137,1.08027,1.08007,,False,,,,0.02,running,False,0.0,1346.5000000000036,2024-05-24 00:30:00,0,4,21,5
2024-05-23 21:45:00,1.08056,1.08063,1.08042,1.08047,637,12,0,2024-05-23 21:00:00,2024-05-23 21:00:00,-0.0007173809523808305,-0.0003847784255555098,1.0810429761904758,-6.219896834672289e-05,0.000175055967763994,1.0817863095238096,1.0814338181079053,1.0841451913593845,1.0813779735348277,1.0831336668889238,0.00024450298833898044,-3.706785378639543e-05,1.083119006703816,1.0829389936579727,1.6965972299366199,5.426718356317117,-5.040326259098739e-05,1.0813820523455324,1.0822183140784987,1.0807423185414515,-0.0008362617329662481,-0.0006836534118137087,0.001617967655220449,-0.00014383900928782722,-0.00016486412108784876,-0.00021624011007870259,1.082926574875999,-0.421441937793096,False,True,1.0774700000000001,1.09127,1.08017,1.07997,,False,,,,0.02,running,False,0.0,1346.5000000000036,2024-05-24 00:45:00,0,5,21,5
2024-05-24 03:15:00,1.08088,1.08096,1.08076,1.0809,438,12,0,2024-05-24 03:00:00,2024-05-24 03:00:00,8.059523809511582e-05,-0.0005661733953550296,1.0811701190476195,-0.0002958597773591553,-0.00040443518224323605,1.0811669047619046,1.0832757610491621,1.087754092341204,1.082741815778672,1.0883016823660496,-0.00042453011937729847,-0.00021537151377125602,1.0824777533878929,1.0822436092298173,21.117723288136258,38.79652299813446,-0.0004490488186042794,1.0811467621677846,1.0813521333745828,1.0811561300309596,-0.00020537120679819942,-0.00024205709804971996,0.00028769022692586867,-8.257653938748e-05,-8.892328861365151e-05,-6.260749914055452e-05,1.0815445118373095,-0.41923225177539036,False,True,1.0779,1.0917,1.0806,1.0804,,False,,,,0.02,running,False,0.0,1346.5000000000036,2024-05-24 06:15:00,0,6,21,5
2024-05-24 03:30:00,1.08094,1.08097,1.08068,1.08091,426,12,0,2024-05-24 03:00:00,2024-05-24 03:00:00,8.059523809511582e-05,-0.0005661733953550296,1.0811701190476195,-0.0002958597773591553,-0.00040443518224323605,1.0811669047619046,1.0832757610491621,1.087754092341204,1.082741815778672,1.0883016823660496,-0.00042453011937729847,-0.00021537151377125602,1.0824777533878929,1.0822436092298173,24.156194251132693,27.703811463821626,-0.0004490488186042794,1.0811103372188946,1.0813193827542433,1.0810716236670113,-0.0002090455353487286,-0.0002354547855095217,0.00027649171175403285,-8.450636394830013e-05,-8.257653938748e-05,-8.892328861365151e-05,1.0814448874778793,-0.41930164014385674,False,True,1.0779100000000001,1.09171,1.08061,1.08041,,False,,,,0.02,running,False,0.0,1346.5000000000036,2024-05-24 06:30:00,0,7,21,5
2024-05-24 05:15:00,1.08085,1.08085,1.08073,1.08076,279,12,0,2024-05-24 05:00:00,2024-05-24 05:00:00,-2.666666666706341e-05,-0.000541565151931156,1.0809683333333346,-0.00017080570217412684,-0.0003550046664280295,1.0811434523809524,1.081698209601786,1.0867713868938882,1.0826419785923431,1.0871851192086068,-0.0003637941195981376,-0.000259334018715809,1.0822797196662,1.0820358548521174,24.122807017530633,38.9553429027004,-0.00048569833348860946,1.080992857796978,1.0811678088916878,1.0808883006535954,-0.00017495109470977432,-0.00018652439191471203,0.0001898964630234506,-4.15927072578981e-05,-4.441348469197415e-05,-2.0832473339948976e-05,1.081144660878677,-0.41936805957148615,False,True,1.07776,1.0915599999999999,1.08046,1.08026,,False,,,,0.02,running,False,0.0,1346.5000000000036,2024-05-24 08:15:00,0,8,21,5
2024-05-24 05:30:00,1.08074,1.08089,1.08064,1.08071,375,12,0,2024-05-24 05:00:00,2024-05-24 05:00:00,-2.666666666706341e-05,-0.000541565151931156,1.0809683333333346,-0.00017080570217412684,-0.0003550046664280295,1.0811434523809524,1.081698209601786,1.0867713868938882,1.0826419785923431,1.0871851192086068,-0.0003637941195981376,-0.000259334018715809,1.0822797196662,1.0820358548521174,13.44298245613407,26.118421052622292,-0.00048569833348860946,1.0809493412128275,1.081133897121933,1.080829872721018,-0.00018455590910559927,-0.0001861306953528895,0.00020776589390165577,-5.842793257748724e-05,-4.15927072578981e-05,-4.441348469197415e-05,1.081110356677785,-0.4194506112357492,False,True,1.0777100000000002,1.09151,1.08041,1.0802100000000001,,False,,,,0.02,running,False,0.0,1346.5000000000036,2024-05-24 08:30:00,0,9,21,5
2024-05-24 05:45:00,1.08072,1.08091,1.08072,1.0808,295,12,0,2024-05-24 05:00:00,2024-05-24 05:00:00,-2.666666666706341e-05,-0.000541565151931156,1.0809683333333346,-0.00017080570217412684,-0.0003550046664280295,1.0811434523809524,1.081698209601786,1.0867713868938882,1.0826419785923431,1.0871851192086068,-0.0003637941195981376,-0.000259334018715809,1.0822797196662,1.0820358548521174,13.092105263151302,16.885964912272,-0.00048569833348860946,1.0809263656416233,1.08110916400179,1.0808042621259033,-0.00018279836016676931,-0.00018546422831566546,0.00021631612669586778,-2.5610595114633483e-05,-5.842793257748724e-05,-4.15927072578981e-05,1.0810962888969426,-0.41948776464513604,False,True,1.0778,1.0916,1.0805,1.0803,,False,,,,0.02,running,False,0.0,1346.5000000000036,2024-05-24 08:45:00,0,10,21,5
2024-05-24 06:30:00,1.08071,1.08079,1.08057,1.08059,221,12,0,2024-05-24 06:00:00,2024-05-24 06:00:00,-0.00017511904761779995,-0.00053485647891649,1.080762142857143,-8.902801501221265e-05,-0.0003422086718227945,1.0809683333333346,1.0809898235364912,1.0863729078661586,1.081698209601786,1.0867713868938882,-0.0003550046664280295,-0.00017080570217412684,1.0821687700103162,1.081917786463948,8.46930886109629,12.290350051543014,-0.0004955299625741856,1.0808257226531637,1.0810198347573017,1.0806897213622284,-0.00019411210413800006,-0.00018694837075769618,0.0002403726273971419,-4.595459236322874e-05,-3.3123495012388204e-05,-3.546267629928046e-05,1.0810142244092145,-0.41963478168475765,False,True,1.07759,1.0913899999999999,1.08029,1.08009,,False,,,,0.02,running,False,0.0,1346.5000000000036,2024-05-24 09:30:00,0,11,21,5
2024-05-24 06:45:00,1.08059,1.08066,1.08049,1.08056,245,12,0,2024-05-24 06:00:00,2024-05-24 06:00:00,-0.00017511904761779995,-0.00053485647891649,1.080762142857143,-8.902801501221265e-05,-0.0003422086718227945,1.0809683333333346,1.0809898235364912,1.0863729078661586,1.081698209601786,1.0867713868938882,-0.0003550046664280295,-0.00017080570217412684,1.0821687700103162,1.081917786463948,6.731503983045173,9.811962490335242,-0.0004955299625741856,1.0807848422449846,1.0809857729234273,1.0806584348125219,-0.0002009306784427345,-0.00018974483229470385,0.00025197420503243176,-3.128654970652178e-05,-4.595459236322874e-05,-3.3123495012388204e-05,1.0809985999893157,-0.4196817303642719,False,True,1.07756,1.0913599999999999,1.08026,1.08006,,False,,,,0.02,running,False,0.0,1346.5000000000036,2024-05-24 09:45:00,0,12,21,5
2024-05-24 12:15:00,1.08291,1.08296,1.08266,1.08287,405,12,0,2024-05-24 12:00:00,2024-05-24 12:00:00,0.00042178571428652667,-4.715006643829511e-05,1.0823328571428568,7.959642393303893e-06,0.00011153692778822866,1.0818589285714293,1.0803946852547446,1.081309008901834,1.0804081020624743,1.0819435927873782,5.055289276785645e-05,6.093394553206328e-06,1.082064700410411,1.081900668218748,92.49530651123114,90.04622212235279,-0.0003406787034099029,1.0821957690940966,1.081756270230553,1.0827045717234263,0.00043949886354366363,0.0003016431302869875,0.0007489563850251585,0.00014985208118312165,0.00018887512899867787,0.00011585139318870397,2.5837156628432103,1.0816934806036422,True,False,1.08587,1.08317,1.08317,1.08337,2024-05-24 13:15:00,True,2024-05-24 13:15:00,2024-05-27 12:52:04,2024-05-29 11:07:03,0.02,success,True,109.18,1455.6800000000037,,1,0,21,5
2024-05-24 13:15:00,1.0834,1.08392,1.08332,1.08385,461,12,0,2024-05-24 13:00:00,2024-05-24 13:00:00,0.00047392857142747324,9.561449889328166e-05,1.0830546428571433,4.043075328523651e-05,0.0001880322736030698,1.0823328571428568,1.0800904305620174,1.0813222809364684,1.0803946852547446,1.081309008901834,0.00011153692778822866,7.959642393303893e-06,1.0821869778032878,1.082065414761248,92.35308938390028,89.22414520230988,-0.000253420062949266,1.0827267138863017,1.082149550295912,1.0832442449260398,0.0005771635903897288,0.0004253295185476844,0.0008956807466975988,0.00021401100791118566,0.00015636394908891127,7.428276573762105e-05,2.5844534139340816,1.082035075917998,True,False,1.0868499999999999,1.08415,1.08415,1.08435,2024-05-24 15:45:00,True,2024-05-24 15:45:00,2024-05-28 04:20:38,2024-05-24 16:58:47,0.02,even,True,10.92,1466.6000000000038,,2,0,21,5
2024-05-24 13:30:00,1.08385,1.08436,1.08367,1.08415,552,12,0,2024-05-24 13:00:00,2024-05-24 13:00:00,0.00047392857142747324,9.561449889328166e-05,1.0830546428571433,4.043075328523651e-05,0.0001880322736030698,1.0823328571428568,1.0800904305620174,1.0813222809364684,1.0803946852547446,1.081309008901834,0.00011153692778822866,7.959642393303893e-06,1.0821869778032878,1.082065414761248,94.94616962674921,91.60222312740147,-0.000253420062949266,1.0829456809807168,1.082297731755474,1.0835056553147582,0.0006479492252426944,0.00046985345988668646,0.0009721913391947407,0.00026141038871840827,0.00021401100791118566,0.00015636394908891127,2.584818113622671,1.0821931970068452,True,False,1.0871499999999998,1.08445,1.08445,1.08465,2024-05-24 15:45:00,True,2024-05-24 15:45:00,2024-05-28 04:45:05,2024-05-24 16:46:34,0.02,even,True,10.92,1477.5200000000038,,3,0,21,5
2024-05-24 14:45:00,1.08392,1.08423,1.08379,1.08402,576,12,0,2024-05-24 14:00:00,2024-05-24 14:00:00,0.0007217857142864936,0.00031973285273001473,1.0835740476190476,0.00013381598422183589,0.00018803053245234692,1.0830546428571433,1.0793463631643674,1.0815256610080919,1.0800904305620174,1.0813222809364684,0.0001880322736030698,4.043075328523651e-05,1.0823052372998498,1.0822217815803483,78.63945578231248,74.07221544081428,-0.00013878947981340987,1.083435226701353,1.0827767575826197,1.0840240729274164,0.0006584691187332403,0.0005957583777297615,0.0009694758033807923,0.00010495700034462985,0.00010819401444650545,3.0970072239622226e-05,2.5853328652619805,1.0827152805928524,True,False,1.0870199999999999,1.08432,1.08432,1.08452,2024-05-24 15:45:00,True,2024-05-24 15:45:00,2024-05-28 04:45:05,2024-05-24 16:57:31,0.02,even,True,10.92,1488.440000000004,,4,0,21,5
2024-05-24 15:00:00,1.08402,1.0843,1.08388,1.08415,953,12,0,2024-05-24 15:00:00,2024-05-24 15:00:00,0.000519404761904374,0.0004734509034634016,1.0842741666666658,0.00013380875608015862,0.00023941223065979974,1.0835740476190476,1.0794910147326522,1.0814405787062351,1.0793463631643674,1.0815256610080919,0.00018803053245234692,0.00013381598422183589,1.0824829639256661,1.0824488390539204,85.85364242784345,78.56626124546575,-1.634140315804758e-05,1.0835451918242218,1.0828784792431665,1.0841229755761959,0.0006667125810553287,0.0006099492183948749,0.0009534853608426654,9.890264877943089e-05,0.00010495700034462985,0.00010819401444650545,2.5854101808133336,1.0828357703390583,True,False,1.0871499999999998,1.08445,1.08445,1.08465,2024-05-24 15:45:00,True,2024-05-24 15:45:00,2024-05-28 04:45:05,2024-05-24 16:46:34,0.02,even,True,10.92,1499.360000000004,,5,0,21,5
2024-05-24 15:15:00,1.08415,1.08438,1.08407,1.08407,841,12,0,2024-05-24 15:00:00,2024-05-24 15:00:00,0.000519404761904374,0.0004734509034634016,1.0842741666666658,0.00013380875608015862,0.00023941223065979974,1.0835740476190476,1.0794910147326522,1.0814405787062351,1.0793463631643674,1.0815256610080919,0.00018803053245234692,0.00013381598422183589,1.0824829639256661,1.0824488390539204,87.00814268948996,83.83374696654863,-1.634140315804758e-05,1.0836259315435723,1.082966740039969,1.0842134090127278,0.0006591915036033846,0.000619797675436577,0.0009441421150132202,9.04334365319226e-05,9.890264877943089e-05,0.00010495700034462985,2.5854880008679957,1.0829388171574599,True,False,1.08707,1.08437,1.08437,1.08457,2024-05-24 15:45:00,True,2024-05-24 15:45:00,2024-05-28 04:45:05,2024-05-24 16:46:39,0.02,even,True,10.92,1510.280000000004,,6,0,21,5
2024-05-24 15:30:00,1.08404,1.08504,1.08367,1.08484,1411,12,0,2024-05-24 15:00:00,2024-05-24 15:00:00,0.000519404761904374,0.0004734509034634016,1.0842741666666658,0.00013380875608015862,0.00023941223065979974,1.0835740476190476,1.0794910147326522,1.0814405787062351,1.0793463631643674,1.0815256610080919,0.00018803053245234692,0.00013381598422183589,1.0824829639256661,1.0824488390539204,88.83287258144708,87.23155256626016,-1.634140315804758e-05,1.0838127113060998,1.0831055000370082,1.0844104850361191,0.0007072112690915677,0.0006372803941675751,0.0009803565677898695,0.00019707602339136265,9.04334365319226e-05,9.890264877943089e-05,2.5857339664026355,1.0830870036696028,True,False,1.08784,1.08514,1.08514,1.08534,2024-05-24 19:30:00,True,2024-05-24 19:30:00,2024-05-28 07:04:18,2024-05-24 19:44:06,0.02,even,True,10.92,1521.2000000000041,,7,0,21,5
2024-05-24 15:45:00,1.08486,1.08531,1.08466,1.08506,1045,12,0,2024-05-24 15:00:00,2024-05-24 15:00:00,0.000519404761904374,0.0004734509034634016,1.0842741666666658,0.00013380875608015862,0.00023941223065979974,1.0835740476190476,1.0794910147326522,1.0814405787062351,1.0793463631643674,1.0815256610080919,0.00018803053245234692,0.00013381598422183589,1.0824829639256661,1.0824488390539204,89.05026925626593,88.297094842401,-1.634140315804758e-05,1.084004601874392,1.0832502778120447,1.0845874372205033,0.0007543240623473224,0.0006606891278035246,0.0010235651746106883,0.0001769521843841826,0.00019707602339136265,9.04334365319226e-05,2.5859692502062277,1.083205624234779,True,False,1.0880599999999998,1.0853599999999999,1.0853599999999999,1.0855599999999999,2024-05-24 19:30:00,True,2024-05-24 19:30:00,2024-05-28 14:03:49,2024-05-24 19:33:13,0.02,even,True,10.92,1532.1200000000042,,8,0,21,5
2024-05-24 16:00:00,1.08505,1.08521,1.0848200000000001,1.08494,1054,12,0,2024-05-24 16:00:00,2024-05-24 16:00:00,0.0007001190476181307,0.000683590521168842,1.0844330952380952,0.00017805024051228667,0.0002551900892332404,1.0842741666666658,1.0792571530924786,1.0814617658752912,1.0794910147326522,1.0814405787062351,0.00023941223065979974,0.00013380875608015862,1.0825892243175588,1.0825833319296068,89.31083883935226,89.06466022568843,0.00012364498170733035,1.0841485092783316,1.08337544241856,1.084736811145511,0.0007730668597716317,0.000683164674197146,0.0010048701408687615,0.00014937392500757873,0.0001769521843841826,0.00019707602339136265,2.586093385835684,1.083380236455338,True,False,1.08794,1.08524,1.08524,1.08544,2024-05-24 19:30:00,True,2024-05-24 19:30:00,2024-05-28 07:20:04,2024-05-24 19:40:41,0.02,even,True,10.92,1543.0400000000043,,9,0,21,5
2024-05-24 16:15:00,1.08495,1.08524,1.08472,1.08514,993,12,0,2024-05-24 16:00:00,2024-05-24 16:00:00,0.0007001190476181307,0.000683590521168842,1.0844330952380952,0.00017805024051228667,0.0002551900892332404,1.0842741666666658,1.0792571530924786,1.0814617658752912,1.0794910147326522,1.0814405787062351,0.00023941223065979974,0.00013380875608015862,1.0825892243175588,1.0825833319296068,89.94910941475763,89.43673917012528,0.00012364498170733035,1.0843010463124345,1.0835061503875554,1.0848798864809082,0.0007948959248791354,0.0007055109243335439,0.001021616366357754,0.00014307533539725803,0.00014937392500757873,0.0001769521843841826,2.586259068575491,1.0835007043863252,True,False,1.0881399999999999,1.08544,1.08544,1.08564,2024-05-27 13:00:00,True,2024-05-27 13:00:00,2024-05-28 14:04:18,2024-05-27 13:20:49,0.02,even,True,10.92,1553.9600000000044,,10,0,21,5
2024-05-24 18:00:00,1.08455,1.08516,1.0845,1.08515,780,12,0,2024-05-24 18:00:00,2024-05-24 18:00:00,0.0001409523809521307,0.0007540499640448228,1.0848510714285704,0.0003247509298008995,0.000315451217524584,1.0845740476190473,1.0787047385724153,1.0812372582338228,1.0788445267955347,1.0814640504579194,0.0002740285491930502,0.000259063054146341,1.0828657207607357,1.0829246761452194,71.86923305127912,67.18911842409163,0.00034332840038829495,1.0845707946772563,1.0839865554360806,1.0849446267629859,0.0005842392411756769,0.00063942786654753,0.0007504387605563723,0.00012722738218085006,-3.694530443354438e-06,-2.149982799792838e-06,2.5859577190897367,1.0839315344362348,True,False,1.08815,1.08545,1.08545,1.08565,2024-05-27 13:00:00,True,2024-05-27 13:00:00,2024-05-28 14:04:18,2024-05-27 13:20:49,0.02,even,True,10.92,1564.8800000000044,,11,0,21,5
2024-05-24 18:15:00,1.08516,1.0854,1.08502,1.08526,780,12,0,2024-05-24 18:00:00,2024-05-24 18:00:00,0.0001409523809521307,0.0007540499640448228,1.0848510714285704,0.0003247509298008995,0.000315451217524584,1.0845740476190473,1.0787047385724153,1.0812372582338228,1.0788445267955347,1.0814640504579194,0.0002740285491930502,0.000259063054146341,1.0828657207607357,1.0829246761452194,80.39799002712965,71.88136725869693,0.00034332840038829495,1.0846768262653708,1.0840808846630376,1.0850595734434139,0.0005959416023331165,0.0006307306137046473,0.0007426410079432843,0.00011494668042799638,0.00012722738218085006,-3.694530443354438e-06,2.586062138804137,1.0840570080826903,True,False,1.0882599999999998,1.0855599999999999,1.0855599999999999,1.0857599999999998,2024-05-27 13:00:00,True,2024-05-27 13:00:00,2024-05-28 14:04:34,2024-05-27 13:20:09,0.02,even,True,10.92,1575.8000000000045,,12,0,21,5
2024-05-24 18:30:00,1.08526,1.0855299999999999,1.08485,1.08488,701,12,0,2024-05-24 18:00:00,2024-05-24 18:00:00,0.0001409523809521307,0.0007540499640448228,1.0848510714285704,0.0003247509298008995,0.000315451217524584,1.0845740476190473,1.0787047385724153,1.0812372582338228,1.0788445267955347,1.0814640504579194,0.0002740285491930502,0.000259063054146341,1.0828657207607357,1.0829246761452194,82.40172677692118,78.22298328510999,0.00034332840038829495,1.084708083763006,1.0841400783917015,1.0850384485724114,0.0005680053713046362,0.0006181855652246451,0.0007018708333299635,-2.1124871002475842e-05,0.00011494668042799638,0.00012722738218085006,1.085985974197407,-0.4159090770525842,True,False,1.08788,1.08518,1.08518,1.08538,2024-05-24 19:30:00,True,2024-05-24 19:30:00,2024-05-28 07:04:49,2024-05-24 19:42:03,0.02,even,True,10.92,1586.7200000000046,,13,0,21,5
2024-05-24 19:15:00,1.08521,1.08572,1.08515,1.08557,322,12,0,2024-05-24 19:00:00,2024-05-24 19:00:00,0.00027702380952310257,0.0008234787456264936,1.084838452380953,0.0003519791759750146,0.0003365786257059063,1.0848510714285704,1.078910466327883,1.0813287856736753,1.0787047385724153,1.0812372582338228,0.000315451217524584,0.0003247509298008995,1.0829801903890754,1.0830619020536019,80.3960525171741,76.44654078743471,0.0004393584694359347,1.084942384837761,1.0843764814748937,1.0851655865153074,0.000565903362867326,0.0005880657639120184,0.0005750240574795519,9.377364981033587e-05,3.443756449938995e-05,-1.0732714137429156e-06,2.585941868992905,1.08438930403771,True,False,1.0885699999999998,1.08587,1.08587,1.0860699999999999,2024-05-27 13:00:00,True,2024-05-27 13:00:00,2024-05-28 14:09:38,2024-05-27 13:11:29,0.02,even,True,10.92,1597.6400000000046,,14,0,21,5
2024-05-27 14:00:00,1.08618,1.08636,1.08578,1.08606,419,12,0,2024-05-27 14:00:00,2024-05-27 14:00:00,0.0003335714285717106,0.00047704082614830057,1.0859127380952387,3.649829004278797e-05,0.00012900263185798745,1.085845952380952,1.0839683934955018,1.0848506645684863,1.083928784667292,1.0849493267454735,0.00011320361468211622,3.650302026672362e-05,1.0845625642568621,1.0847759795288514,71.4285714285662,62.10317460317115,0.0003888571300502021,1.0856509695559755,1.0853395486059667,1.0859704850361191,0.00031142095000880055,0.00021908306556448897,0.0005463280455443232,9.43997248021855e-05,0.00014157894736799292,7.40763673889866e-05,2.586708027897604,1.0852329421746343,True,False,1.08906,1.08636,1.08636,1.08656,2024-05-28 04:15:00,True,2024-05-28 04:15:00,,2024-05-28 16:59:15,0.02,even,True,10.92,1608.5600000000047,,15,0,22,5
2024-05-27 14:15:00,1.08606,1.08623,1.08596,1.08603,302,12,0,2024-05-27 14:00:00,2024-05-27 14:00:00,0.0003335714285717106,0.00047704082614830057,1.0859127380952387,3.649829004278797e-05,0.00012900263185798745,1.085845952380952,1.0839683934955018,1.0848506645684863,1.083928784667292,1.0849493267454735,0.00011320361468211622,3.650302026672362e-05,1.0845625642568621,1.0847759795288514,74.10714285713863,68.84920634920188,0.0003888571300502021,1.0857092819319794,1.085390693153673,1.0860679635362906,0.00031858877830637233,0.00023898420811286565,0.0005649994100424559,9.74785001714995e-05,9.43997248021855e-05,0.00014157894736799292,2.586830712739848,1.0853052143327333,True,False,1.08903,1.08633,1.08633,1.08653,2024-05-28 04:15:00,True,2024-05-28 04:15:00,,2024-05-28 16:59:16,0.02,even,True,10.92,1619.4800000000048,,16,0,22,5
2024-05-28 04:30:00,1.08672,1.08697,1.08661,1.08697,441,12,0,2024-05-28 04:00:00,2024-05-28 04:00:00,0.0002149999999994101,0.00025804855959332684,1.0864990476190473,0.00010355512658361643,3.6138934582960445e-05,1.08610119047619,1.0837848957739216,1.08668328223442,1.0836725709597066,1.08667546914943,4.546329408195952e-06,0.00010356231779052969,1.0854174767947515,1.0856175432587996,91.4578111946547,87.05775629159085,0.0002501190634523927,1.0863835962687014,1.0861319077726157,1.0866210285517708,0.0002516884960857002,0.00015885940376787354,0.0003451366879204741,0.00015155486756057712,0.00011256621946942325,0.00011819745442087637,2.5870869630804636,1.0861550940230782,True,False,1.0899699999999999,1.08727,1.08727,1.08747,2024-05-28 06:00:00,True,2024-05-28 06:00:00,,2024-05-28 08:34:09,0.02,even,True,10.92,1630.4000000000049,,17,0,22,5
2024-05-28 04:45:00,1.08697,1.08728,1.08697,1.08717,500,12,0,2024-05-28 04:00:00,2024-05-28 04:00:00,0.0002149999999994101,0.00025804855959332684,1.0864990476190473,0.00010355512658361643,3.6138934582960445e-05,1.08610119047619,1.0837848957739216,1.08668328223442,1.0836725709597066,1.08667546914943,4.546329408195952e-06,0.00010356231779052969,1.0854174767947515,1.0856175432587996,91.72417344731711,89.08574850035244,0.0002501190634523927,1.086504581458132,1.0862088034931627,1.0867851977984169,0.0002957779649692682,0.0001862431160081525,0.000406942665923309,0.00016416924664608423,0.00015155486756057712,0.00011256621946942325,2.587334570397413,1.0862358251994204,True,False,1.0901699999999999,1.08747,1.08747,1.08767,2024-05-28 06:45:00,True,2024-05-28 06:45:00,,2024-05-28 08:01:39,0.02,even,True,10.92,1641.320000000005,,18,0,22,5
2024-05-28 05:00:00,1.08716,1.08737,1.08715,1.08732,375,12,0,2024-05-28 05:00:00,2024-05-28 05:00:00,0.00039785714285733853,0.00036377755014482815,1.0869267857142855,0.00010355063684689148,7.599862224211643e-05,1.0864990476190473,1.0838971746868078,1.0863669277112364,1.0837848957739216,1.08668328223442,3.6138934582960445e-05,0.00010355512658361643,1.085553768614445,1.0857705397980957,96.41331565768276,93.1984334332182,0.0002728507607908798,1.0866300304645733,1.0862911143455212,1.0869510354317171,0.00033891611905212393,0.0002167777166169468,0.0004725276006212151,0.0001658376333002476,0.00016416924664608423,0.00015155486756057712,2.5875889476925558,1.0863131231708785,True,False,1.09032,1.08762,1.08762,1.08782,2024-05-28 07:15:00,True,2024-05-28 07:15:00,,2024-05-28 07:56:25,0.02,even,True,10.92,1652.240000000005,,19,0,22,5
2024-05-28 06:00:00,1.08753,1.08753,1.08737,1.08742,392,12,0,2024-05-28 06:00:00,2024-05-28 06:00:00,0.00042773809523821704,0.0004678919744731669,1.0873595238095237,0.00010135043915874498,0.00011343515262443922,1.0869267857142855,1.0840200071471864,1.085950363466611,1.0838971746868078,1.0863669277112364,7.599862224211643e-05,0.00010355063684689148,1.0856967512844808,1.085930496614248,90.2738780142824,88.47078236690542,0.0003118590035273372,1.0869989452761393,1.0865791278076382,1.0874392432060551,0.0004198174685010603,0.00032406400212842503,0.0006279697445066213,0.00010256965944366314,0.00014550051599582225,0.00013174406604710143,2.588287002361139,1.0865914840509712,True,False,1.09042,1.08772,1.08772,1.08792,2024-05-28 14:15:00,True,2024-05-28 14:15:00,,2024-05-28 15:23:06,0.02,even,True,10.92,1663.160000000005,,20,0,22,5
2024-05-28 06:15:00,1.08743,1.08769,1.08732,1.08762,374,12,0,2024-05-28 06:00:00,2024-05-28 06:00:00,0.00042773809523821704,0.0004678919744731669,1.0873595238095237,0.00010135043915874498,0.00011343515262443922,1.0869267857142855,1.0840200071471864,1.085950363466611,1.0838971746868078,1.0863669277112364,7.599862224211643e-05,0.00010355063684689148,1.0856967512844808,1.085930496614248,93.25006849047453,90.28216724369533,0.0003118590035273372,1.0870944921567331,1.086656229451517,1.0875573856209138,0.0004382627052161858,0.0003469037427459772,0.0006621409719103707,0.00011814241485863519,0.00010256965944366314,0.00014550051599582225,2.588451275932993,1.0866634953088348,True,False,1.09062,1.08792,1.08792,1.08812,2024-05-28 14:15:00,True,2024-05-28 14:15:00,,2024-05-28 15:02:07,0.02,even,True,10.92,1674.0800000000052,,21,0,22,5
2024-05-28 06:30:00,1.08762,1.08776,1.08758,1.08772,294,12,0,2024-05-28 06:00:00,2024-05-28 06:00:00,0.00042773809523821704,0.0004678919744731669,1.0873595238095237,0.00010135043915874498,0.00011343515262443922,1.0869267857142855,1.0840200071471864,1.085950363466611,1.0838971746868078,1.0863669277112364,7.599862224211643e-05,0.00010355063684689148,1.0856967512844808,1.085930496614248,94.03438221596114,92.51944290690604,0.0003118590035273372,1.0871907241326204,1.0867350272699232,1.0876650257997929,0.0004556968626971969,0.0003686623667362212,0.0006902096300031753,0.00010764017887909816,0.00011814241485863519,0.00010256965944366314,2.588596808800297,1.0867332427992886,True,False,1.09072,1.08802,1.08802,1.08822,2024-05-28 14:15:00,True,2024-05-28 14:15:00,,2024-05-28 15:01:53,0.02,even,True,10.92,1685.0000000000052,,22,0,22,5
2024-05-28 06:45:00,1.08771,1.0878,1.08771,1.08777,318,12,0,2024-05-28 06:00:00,2024-05-28 06:00:00,0.00042773809523821704,0.0004678919744731669,1.0873595238095237,0.00010135043915874498,0.00011343515262443922,1.0869267857142855,1.0840200071471864,1.085950363466611,1.0838971746868078,1.0863669277112364,7.599862224211643e-05,0.00010355063684689148,1.0856967512844808,1.085930496614248,97.2420020639787,94.84215092347146,0.0003118590035273372,1.0872798434968327,1.0868116919165955,1.0877626900584794,0.00046815158023716386,0.00038856020943640976,0.0007088601178529219,9.766425868651396e-05,0.00010764017887909816,0.00011814241485863519,2.5887196512175805,1.086805728899378,True,False,1.0907699999999998,1.0880699999999999,1.0880699999999999,1.0882699999999998,2024-05-28 14:15:00,True,2024-05-28 14:15:00,,2024-05-28 15:01:49,0.02,even,True,10.92,1695.9200000000053,,23,0,22,5
2024-05-28 07:00:00,1.08777,1.0879,1.08776,1.08788,364,12,0,2024-05-28 07:00:00,2024-05-28 07:00:00,0.0004327380952382498,0.0005549860956268748,1.0875835714285713,0.00011959006698475016,0.00013130535366465563,1.0873595238095237,1.0839733319013642,1.0858312475672007,1.0840200071471864,1.085950363466611,0.00011343515262443922,0.00010135043915874498,1.0858150253951595,1.0860584568851082,98.23406555603981,96.50348327865989,0.0003604844219472447,1.0873721752665508,1.0868908258486996,1.0878523151014796,0.0004813494178512734,0.00040711805111938253,0.0007175448882700391,8.962504300025209e-05,9.766425868651396e-05,0.00010764017887909816,2.5888210007006442,1.086883629502315,True,False,1.0908799999999998,1.08818,1.08818,1.08838,2024-05-28 14:15:00,True,2024-05-28 14:15:00,,2024-05-28 15:01:28,0.02,even,True,10.92,1706.8400000000054,,24,0,22,5
2024-05-28 21:15:00,1.08623,1.08629,1.08576,1.08581,599,12,0,2024-05-28 21:00:00,2024-05-28 21:00:00,-0.0003448809523818319,9.164096769054275e-05,1.0865397619047614,-6.697186367833551e-05,-9.879866602529855e-06,1.0870199999999997,1.08652496837195,1.0889251787479919,1.0870812272496193,1.0882697682064295,5.87459897353886e-05,-0.00010514065305507093,1.0866511539071346,1.08682202494552,4.850396423820679,20.80447223725699,0.0002843786857112486,1.0868055212519017,1.08709012477594,1.0867472273821823,-0.0002846035240382516,-0.00014058081451220932,0.0005188744228446158,-0.00030537323701329555,-0.00018058479532179206,-0.0001064121087028802,1.0874477078530225,-0.4139532530886578,False,True,1.08281,1.08551,1.08551,1.08531,2024-05-29 02:30:00,True,2024-05-29 02:30:00,2024-05-29 17:21:30,2024-05-29 04:20:01,0.02,even,True,10.9,1717.7400000000055,,25,0,22,5
2024-05-28 21:30:00,1.08582,1.08586,1.0855,1.08566,840,12,0,2024-05-28 21:00:00,2024-05-28 21:00:00,-0.0003448809523818319,9.164096769054275e-05,1.0865397619047614,-6.697186367833551e-05,-9.879866602529855e-06,1.0870199999999997,1.08652496837195,1.0889251787479919,1.0870812272496193,1.0882697682064295,5.87459897353886e-05,-0.00010514065305507093,1.0866511539071346,1.08682202494552,4.524847945410296,9.150256455618212,0.0002843786857112486,1.0866292872131476,1.0869841896073518,1.0864384588923284,-0.0003549023942042151,-0.00018344513045061048,0.000585766734018143,-0.00030876848985395,-0.00030537323701329555,-0.00018058479532179206,1.087229243983253,-0.4143523261985962,False,True,1.0826600000000002,1.08536,1.08536,1.0851600000000001,2024-05-29 02:30:00,True,2024-05-29 02:30:00,2024-05-29 17:21:41,2024-05-29 04:12:37,0.02,even,True,10.9,1728.6400000000056,,26,0,22,5
2024-05-28 23:15:00,1.0859,1.08596,1.08588,1.08591,224,11,0,2024-05-28 23:00:00,2024-05-28 23:00:00,-0.0001895238095233065,-0.0001629270599454724,1.086035119047619,-0.00014283134063149635,-0.00015777916825843844,1.0863502380952381,1.0871038194156157,1.0898571438748612,1.0872590015089023,1.08951701073106,-8.985666664979257e-05,-0.00014282802957721062,1.0865464104431846,1.0866666419138882,24.79871175523483,25.12661227111604,0.00013697819407807588,1.086124299259387,1.0865262747649704,1.0855980942552457,-0.00040197550558351836,-0.00036884843738384357,0.0007266640672842603,-6.5565875477791025e-06,-5.2270381836416746e-05,-5.198142414930551e-05,1.0865790907460795,-0.41538290223558816,False,True,1.08291,1.08561,1.08561,1.08541,2024-05-29 02:15:00,True,2024-05-29 02:15:00,2024-05-29 11:07:56,2024-05-29 04:26:35,0.02,even,True,10.9,1739.5400000000056,,27,0,22,5
2024-05-28 23:30:00,1.08592,1.08594,1.08567,1.08568,129,11,0,2024-05-28 23:00:00,2024-05-28 23:00:00,-0.0001895238095233065,-0.0001629270599454724,1.086035119047619,-0.00014283134063149635,-0.00015777916825843844,1.0863502380952381,1.0871038194156157,1.0898571438748612,1.0872590015089023,1.08951701073106,-8.985666664979257e-05,-0.00014282802957721062,1.0865464104431846,1.0866666419138882,19.120923130837035,23.28185360399978,0.00013697819407807588,1.0860559455271734,1.086463587745343,1.0855504437564498,-0.00040764221816957935,-0.00037660719354099074,0.0007535653035285667,-4.765049879584815e-05,-6.5565875477791025e-06,-5.2270381836416746e-05,1.0865677569162133,-0.4154668694033137,False,True,1.08268,1.08538,1.08538,1.08518,2024-05-29 02:30:00,True,2024-05-29 02:30:00,2024-05-29 17:21:41,2024-05-29 04:12:49,0.02,even,True,10.9,1750.4400000000057,,28,0,22,5
2024-05-28 23:45:00,1.08568,1.08568,1.0855299999999999,1.08559,357,11,0,2024-05-28 23:00:00,2024-05-28 23:00:00,-0.0001895238095233065,-0.0001629270599454724,1.086035119047619,-0.00014283134063149635,-0.00015777916825843844,1.0863502380952381,1.0871038194156157,1.0898571438748612,1.0872590015089023,1.08951701073106,-8.985666664979257e-05,-0.00014282802957721062,1.0865464104431846,1.0866666419138882,14.30418929855882,19.407941394876897,0.00013697819407807588,1.085984261599916,1.0863988775419842,1.085486054351564,-0.0004146159420681528,-0.00038420894324642317,0.0007775984396516993,-6.438940488573408e-05,-4.765049879584815e-05,-6.5565875477791025e-06,1.0865358122450939,-0.4155637035419657,False,True,1.0825900000000002,1.08529,1.08529,1.08509,2024-05-29 03:00:00,True,2024-05-29 03:00:00,2024-05-29 17:21:50,2024-05-29 04:07:31,0.02,even,True,10.9,1761.3400000000058,,29,0,22,5
2024-05-29 00:00:00,1.0856,1.0858,1.0852,1.08565,71,15,0,2024-05-29 00:00:00,2024-05-29 00:00:00,-0.0003151190476191612,-0.00026890851378791325,1.0857146428571427,-0.00013569430557346365,-0.00018758434503987373,1.086035119047619,1.0868871143697494,1.0898449063317468,1.0871038194156157,1.0898571438748612,-0.00015777916825843844,-0.00014283134063149635,1.0864950291242694,1.0865933105607772,15.210327566526109,16.21181333197399,5.580085250487805e-05,1.0859328367383905,1.0863434051314667,1.0854727519779845,-0.00041056839307618276,-0.0003894808332123751,0.0007790008558074575,-1.3302373579548998e-05,-6.438940488573408e-05,-4.765049879584815e-05,1.0865244031333245,-0.41557889917735547,False,True,1.0826500000000001,1.08535,1.08535,1.08515,2024-05-29 03:00:00,True,2024-05-29 03:00:00,2024-05-29 17:21:41,2024-05-29 04:12:35,0.02,even,True,10.9,1772.240000000006,,30,0,22,5
2024-05-29 02:00:00,1.08561,1.08563,1.08535,1.08536,182,12,0,2024-05-29 02:00:00,2024-05-29 02:00:00,-0.0001844047619048439,-0.0003614692992006674,1.0853252380952376,-0.00013950411327506908,-0.0001876027443989581,1.0855302380952379,1.0866276249164153,1.0894362957472636,1.0867791506050044,1.089640520135736,-0.00018758489555880422,-0.00013950424101501224,1.086347824655058,1.0863968020586419,27.304964539022308,35.579196217508915,-8.74232579494745e-05,1.0856574349914634,1.0859920376874366,1.0855367939456482,-0.00033460269597318515,-0.00035531396704062564,0.0004928826770628552,-7.487100103231725e-05,-2.1510147918624156e-05,-2.7430340556744426e-05,1.086202185559683,-0.4151285976683867,False,True,1.0823600000000002,1.0850600000000001,1.0850600000000001,1.0848600000000002,2024-05-29 03:15:00,True,2024-05-29 03:15:00,2024-05-29 17:23:00,2024-05-29 03:54:56,0.02,even,True,10.9,1783.140000000006,,31,0,22,5
2024-05-29 02:15:00,1.08536,1.08538,1.08516,1.08516,143,12,0,2024-05-29 02:00:00,2024-05-29 02:00:00,-0.0001844047619048439,-0.0003614692992006674,1.0853252380952376,-0.00013950411327506908,-0.0001876027443989581,1.0855302380952379,1.0866276249164153,1.0894362957472636,1.0867791506050044,1.089640520135736,-0.00018758489555880422,-0.00013950424101501224,1.086347824655058,1.0863968020586419,19.50354609930164,27.89598108748432,-8.74232579494745e-05,1.0855809065312383,1.085930405266145,1.085440120399037,-0.0003494987349066392,-0.00035415092061382835,0.00045472042694603027,-9.667354661124783e-05,-7.487100103231725e-05,-2.1510147918624156e-05,1.086053992975414,-0.4151737521773402,False,True,1.08216,1.08486,1.08486,1.08466,2024-05-29 06:00:00,True,2024-05-29 06:00:00,2024-05-29 17:27:08,2024-05-29 09:08:57,0.02,even,True,10.9,1794.040000000006,,32,0,22,5
2024-05-29 02:30:00,1.08514,1.08528,1.08511,1.08522,168,12,0,2024-05-29 02:00:00,2024-05-29 02:00:00,-0.0001844047619048439,-0.0003614692992006674,1.0853252380952376,-0.00013950411327506908,-0.0001876027443989581,1.0855302380952379,1.0866276249164153,1.0894362957472636,1.0867791506050044,1.089640520135736,-0.00018758489555880422,-0.00013950424101501224,1.086347824655058,1.0863968020586419,9.888318252229855,18.898942963517936,-8.74232579494745e-05,1.0855253824495092,1.085877782653838,1.085348716890266,-0.00035240020432869557,-0.0003538007773568018,0.00037198207844190356,-9.14035087709042e-05,-9.667354661124783e-05,-7.487100103231725e-05,1.0858508926961625,-0.4151534589156305,False,True,1.0822200000000002,1.08492,1.08492,1.0847200000000001,2024-05-29 05:45:00,True,2024-05-29 05:45:00,2024-05-29 17:23:26,2024-05-29 09:09:03,0.02,even,True,10.9,1804.9400000000062,,33,0,22,5
2024-05-29 02:45:00,1.08522,1.08534,1.08504,1.08506,166,12,0,2024-05-29 02:00:00,2024-05-29 02:00:00,-0.0001844047619048439,-0.0003614692992006674,1.0853252380952376,-0.00013950411327506908,-0.0001876027443989581,1.0855302380952379,1.0866276249164153,1.0894362957472636,1.0867791506050044,1.089640520135736,-0.00018758489555880422,-0.00013950424101501224,1.086347824655058,1.0863968020586419,4.923779245128442,11.438547865553312,-8.74232579494745e-05,1.0854537851495847,1.0858172061609612,1.085258114895081,-0.00036342101137654126,-0.0003557248241607497,0.00031375574366364334,-9.060199518495793e-05,-9.14035087709042e-05,-9.667354661124783e-05,1.085681685149027,-0.41516545535886484,False,True,1.08206,1.08476,1.08476,1.08456,2024-05-29 06:00:00,True,2024-05-29 06:00:00,2024-05-29 17:27:23,2024-05-29 06:55:31,0.02,even,True,10.9,1815.8400000000063,,34,0,22,5
2024-05-29 05:30:00,1.08496,1.08498,1.08469,1.08471,249,12,0,2024-05-29 05:00:00,2024-05-29 05:00:00,-7.952380952302995e-05,-0.000502367503233403,1.0848794047619057,-9.301145231987086e-05,-0.00022602774412080041,1.0851503571428571,1.0860147958513897,1.0890401122399067,1.086115741670952,1.0892861339545203,-0.00022602167926370035,-9.300643867953585e-05,1.0860832914474914,1.08606248260144,28.11332265690777,36.42893255491756,-0.00027973188998134575,1.0850781046524227,1.0853585135340436,1.0849183832129343,-0.00028040888162084165,-0.00030653182428652697,0.00033635893528847615,-4.1369109046396346e-05,-6.814585484127278e-06,2.4767801856562244e-05,1.0853724677755738,-0.4155357013497052,False,True,1.0817100000000002,1.08441,1.08441,1.0842100000000001,2024-05-29 11:15:00,True,2024-05-29 11:15:00,2024-05-29 17:31:33,2024-05-29 12:19:55,0.02,even,True,10.9,1826.7400000000064,,35,0,22,5
2024-05-29 05:45:00,1.08471,1.08474,1.08453,1.08456,228,12,0,2024-05-29 05:00:00,2024-05-29 05:00:00,-7.952380952302995e-05,-0.000502367503233403,1.0848794047619057,-9.301145231987086e-05,-0.00022602774412080041,1.0851503571428571,1.0860147958513897,1.0890401122399067,1.086115741670952,1.0892861339545203,-0.00022602167926370035,-9.300643867953585e-05,1.0860832914474914,1.08606248260144,10.937307183017593,26.761506624239995,-0.00027973188998134575,1.0849983962443577,1.0852993643833737,1.0848540626074996,-0.0003009681390160335,-0.0003054190872324283,0.00035619657496253876,-6.432060543470897e-05,-4.1369109046396346e-05,-6.814585484127278e-06,1.085334927983699,-0.4156268027686998,False,True,1.08156,1.08426,1.08426,1.08406,2024-05-29 11:15:00,True,2024-05-29 11:15:00,2024-05-29 17:32:28,2024-05-29 12:12:37,0.02,even,True,10.9,1837.6400000000065,,36,0,22,5
2024-05-29 06:00:00,1.08456,1.08467,1.0845,1.0846,349,12,0,2024-05-29 06:00:00,2024-05-29 06:00:00,-0.00027095238095142804,-0.0005592760292887355,1.0847496428571424,-9.301006968362023e-05,-0.00022603774943143543,1.0848794047619057,1.085913777473491,1.0887940090453487,1.0860147958513897,1.0890401122399067,-0.00022602774412080041,-9.301145231987086e-05,1.0859908210315243,1.0859494839933248,4.568163274624685,14.539597704850017,-0.0003356407178428237,1.0849371045144565,1.085247559614235,1.0847945751633978,-0.00031045509977856156,-0.000306426289741655,0.0003709460877472944,-5.9487444101780085e-05,-6.432060543470897e-05,-4.1369109046396346e-05,1.0852953523818567,-0.41570620205506104,False,True,1.0816000000000001,1.0843,1.0843,1.0841,2024-05-29 11:15:00,True,2024-05-29 11:15:00,2024-05-29 17:32:23,2024-05-29 12:12:44,0.02,even,True,10.9,1848.5400000000066,,37,0,22,5
2024-05-29 07:00:00,1.08464,1.08464,1.08436,1.08436,283,12,0,2024-05-29 07:00:00,2024-05-29 07:00:00,-0.00012976190476332583,-0.000574810910776602,1.0846541666666663,-9.299974028431373e-05,-0.0002260326244293944,1.0847496428571424,1.0858127662949906,1.088547900685669,1.085913777473491,1.0887940090453487,-0.00022603774943143543,-9.301006968362023e-05,1.085907542255297,1.085849525273859,10.914454277278281,13.765978367741454,-0.0003834747564295794,1.0847621353312613,1.0850733641821209,1.0846458066735463,-0.0003112288508595462,-0.0003049965037602123,0.0003687605365928823,-7.796353629108133e-05,-3.707946336573009e-05,-1.5586515306864612e-05,1.0851436333979467,-0.4158520200508542,False,True,1.08136,1.08406,1.08406,1.08386,2024-05-29 11:15:00,True,2024-05-29 11:15:00,2024-05-29 17:55:36,2024-05-29 12:10:06,0.02,even,True,10.9,1859.4400000000066,,38,0,22,5
2024-05-29 07:15:00,1.08436,1.08451,1.08433,1.08451,172,12,0,2024-05-29 07:00:00,2024-05-29 07:00:00,-0.00012976190476332583,-0.000574810910776602,1.0846541666666663,-9.299974028431373e-05,-0.0002260326244293944,1.0847496428571424,1.0858127662949906,1.088547900685669,1.085913777473491,1.0887940090453487,-0.00022603774943143543,-9.301006968362023e-05,1.085907542255297,1.085849525273859,9.040163376443966,11.96127373117906,-0.0003834747564295794,1.084723345280298,1.0850316335019639,1.0845945854833168,-0.00030828822166584224,-0.0003056548473413383,0.000351545634801834,-5.122119022948901e-05,-7.796353629108133e-05,-3.707946336573009e-05,1.0850691720902992,-0.41588000112366563,False,True,1.0815100000000002,1.0842100000000001,1.0842100000000001,1.0840100000000001,2024-05-29 11:15:00,True,2024-05-29 11:15:00,2024-05-29 17:32:54,2024-05-29 12:11:34,0.02,even,True,10.9,1870.3400000000067,,39,0,22,5
2024-05-29 08:30:00,1.08454,1.08461,1.08438,1.08445,372,12,0,2024-05-29 08:00:00,2024-05-29 08:00:00,-9.54761904761181e-05,-0.0005658026582058273,1.0845345238095234,-9.30076852267258e-05,-0.0002146087232609501,1.0846541666666663,1.085711817916032,1.088278091528829,1.0858127662949906,1.088547900685669,-0.0002260326244293944,-9.299974028431373e-05,1.0858102814646327,1.0857335632519503,23.432343234316733,28.086936898814447,-0.000419940336784829,1.0846442515230217,1.0848914529390716,1.0844463157894735,-0.00024720141604994694,-0.0002738572904130061,0.00028277376118494537,-1.6057791538015564e-05,-2.979016167792281e-05,-2.7664258686055376e-05,1.0848280603670732,-0.4159354287881263,False,True,1.08145,1.08415,1.08415,1.08395,2024-05-29 11:15:00,True,2024-05-29 11:15:00,2024-05-29 17:53:14,2024-05-29 12:10:45,0.02,even,True,10.9,1881.2400000000068,,40,0,22,5
2024-05-29 08:45:00,1.08445,1.08457,1.08436,1.0844,339,12,0,2024-05-29 08:00:00,2024-05-29 08:00:00,-9.54761904761181e-05,-0.0005658026582058273,1.0845345238095234,-9.30076852267258e-05,-0.0002146087232609501,1.0846541666666663,1.085711817916032,1.088278091528829,1.0858127662949906,1.088547900685669,-0.0002260326244293944,-9.299974028431373e-05,1.0858102814646327,1.0857335632519503,14.810865701948707,22.94208908069751,-0.000419940336784829,1.0846066743656337,1.084855049017659,1.0844426040591681,-0.00024837465202520725,-0.00026876076273544636,0.00028185398113438596,-3.7117303053335604e-06,-1.6057791538015564e-05,-2.979016167792281e-05,1.0848231069336995,-0.41593789881536325,False,True,1.0814000000000001,1.0841,1.0841,1.0839,2024-05-29 11:15:00,True,2024-05-29 11:15:00,2024-05-29 17:55:00,2024-05-29 12:10:37,0.02,even,True,10.9,1892.140000000007,,41,0,22,5
2024-05-29 18:30:00,1.08128,1.08128,1.08084,1.0811,858,12,0,2024-05-29 18:00:00,2024-05-29 18:00:00,-0.000994999999999635,-0.0007004432113810743,1.0824460714285702,-0.00023201451050679312,-1.6883591166028741e-06,1.0833339285714285,1.0845684333331054,1.0858218560128932,1.084951215080682,1.0858237308547205,-1.6913651218523468e-06,-0.00024078817703552749,1.0847862323698165,1.0845540390005188,6.058415986100861,6.069688451234469,-0.0004621210645042056,1.0823766905937087,1.083265865567279,1.0814446990024082,-0.0008891749735704391,-0.0005800600588402535,0.0014153636752961389,-0.0004310319917442129,-0.0003672617819050483,-0.0004379119367050599,1.0833554399640581,-0.42046604195924164,False,True,1.0781,1.0808,1.0808,1.0806,2024-05-29 22:00:00,True,2024-05-29 22:00:00,,2024-05-30 10:51:40,0.02,even,True,10.9,1903.040000000007,,42,0,22,5
2024-05-29 18:45:00,1.0811,1.0812,1.0808200000000001,1.08104,925,12,0,2024-05-29 18:00:00,2024-05-29 18:00:00,-0.000994999999999635,-0.0007004432113810743,1.0824460714285702,-0.00023201451050679312,-1.6883591166028741e-06,1.0833339285714285,1.0845684333331054,1.0858218560128932,1.084951215080682,1.0858237308547205,-1.6913651218523468e-06,-0.00024078817703552749,1.0847862323698165,1.0845540390005188,5.551633130193578,6.069845732082068,-0.0004621210645042056,1.0821710458869842,1.0831009866363694,1.0810606914344683,-0.0009299407493852385,-0.0006500361969492505,0.0014834400336204714,-0.00038400756793999236,-0.0004310319917442129,-0.0003672617819050483,1.083063335479856,-0.4209419526109195,False,True,1.07804,1.08074,1.08074,1.08054,2024-05-29 22:00:00,True,2024-05-29 22:00:00,,2024-05-30 10:50:59,0.02,even,True,10.9,1913.940000000007,,43,0,22,5
2024-05-29 19:00:00,1.08103,1.08119,1.08074,1.08079,940,12,0,2024-05-29 19:00:00,2024-05-29 19:00:00,-0.0008878571428583282,-0.0009319972207100236,1.081737142857142,-0.00023199936516070654,-1.6893603360672972e-06,1.0824460714285702,1.0843164935806429,1.085820033867668,1.0845684333331054,1.0858218560128932,-1.6883591166028741e-06,-0.00023201451050679312,1.0845735722169252,1.0843089158804773,3.70632173671363,5.105456951002691,-0.0005560962957453692,1.0819585772889866,1.082929802441083,1.0807222187822494,-0.0009712251520963555,-0.0007142739879786716,0.0015441333059944499,-0.0003384726522188686,-0.00038400756793999236,-0.0004310319917442129,1.0828067987453418,-0.421362361180843,False,True,1.07779,1.08049,1.08049,1.08029,2024-05-29 22:30:00,True,2024-05-29 22:30:00,,2024-05-30 10:47:09,0.02,even,True,10.9,1924.8400000000072,,44,0,22,5
2024-05-29 20:15:00,1.08087,1.08144,1.08083,1.08138,546,12,0,2024-05-29 20:00:00,2024-05-29 20:00:00,-0.0007089285714281246,-0.0010190716661542254,1.0812933333333334,-0.0002678734043171259,-3.9653039809904974e-05,1.081737142857142,1.084517935326148,1.0862272721752444,1.0843164935806429,1.085820033867668,-1.6893603360672972e-06,-0.00023199936516070654,1.0843610836868012,1.0840666026100392,16.4416783225789,17.125558805412584,-0.0006486913698271406,1.0815635677779236,1.0823976069831454,1.0806543102855168,-0.0008340392052217371,-0.0008278234455658536,0.0016422365846659147,8.418300653478816e-05,-2.7168902649643556e-05,5.593395252923017e-05,2.582871329674816,1.0784372908962179,False,True,1.0783800000000001,1.08108,1.08108,1.08088,2024-05-29 21:45:00,True,2024-05-29 21:45:00,,2024-05-30 11:37:58,0.02,even,True,10.9,1935.7400000000073,,45,0,22,5
2024-05-29 20:30:00,1.08137,1.08141,1.08099,1.08102,530,12,0,2024-05-29 20:00:00,2024-05-29 20:00:00,-0.0007089285714281246,-0.0010190716661542254,1.0812933333333334,-0.0002678734043171259,-3.9653039809904974e-05,1.081737142857142,1.084517935326148,1.0862272721752444,1.0843164935806429,1.085820033867668,-1.6893603360672972e-06,-0.00023199936516070654,1.0843610836868012,1.0840666026100392,12.883495768853416,15.190323926146236,-0.0006486913698271406,1.0814799419659353,1.0822955620214307,1.0806533986928104,-0.000815620055495403,-0.0008253827675517635,0.0016582246530597847,-9.115927064318186e-07,8.418300653478816e-05,-2.7168902649643556e-05,1.082892001974441,-0.4215852045888202,False,True,1.0780200000000002,1.0807200000000001,1.0807200000000001,1.0805200000000001,2024-05-29 22:15:00,True,2024-05-29 22:15:00,,2024-05-30 10:50:58,0.02,even,True,10.9,1946.6400000000074,,46,0,22,5
2024-05-29 21:45:00,1.08079,1.0808,1.0804,1.08053,530,12,0,2024-05-29 21:00:00,2024-05-29 21:00:00,-0.0004438095238086248,-0.0010774423527293298,1.0807577380952373,-0.00027891092980488234,-0.00012130587522845327,1.0812933333333334,1.084358382340084,1.0869758600477115,1.084517935326148,1.0862272721752444,-3.9653039809904974e-05,-0.0002678734043171259,1.0841139169973302,1.0837836744012361,20.052083333332494,32.57233190111668,-0.0007344415664075785,1.0811706392890679,1.0818727006750781,1.0809570725834203,-0.0007020613860102554,-0.0007480596062884884,0.0011739863713075827,-6.394220846117626e-05,8.508427932540918e-05,0.00010675610595090035,1.0825419541846855,-0.4206278090178448,False,True,1.07753,1.08023,1.08023,1.08003,2024-05-29 22:45:00,True,2024-05-29 22:45:00,,2024-05-29 23:08:18,0.02,even,True,10.9,1957.5400000000075,,47,0,22,5
2024-05-29 22:00:00,1.08053,1.08055,1.08022,1.08032,541,12,0,2024-05-29 22:00:00,2024-05-29 22:00:00,-0.0005355952380960982,-0.0011745272137508866,1.0803664285714287,-0.00027562549139896963,-0.00025577623594092406,1.0807577380952373,1.084031488022917,1.0880026036824435,1.084358382340084,1.0869758600477115,-0.00012130587522845327,-0.00027891092980488234,1.083855599771696,1.0834897804491372,10.243685088190261,21.493561087790667,-0.0008224586958762402,1.0810397717061344,1.0817576858102576,1.0808436463708282,-0.0007179141041231407,-0.0007420305058554189,0.0010641809056810443,-0.00011342621259213814,-6.394220846117626e-05,8.508427932540918e-05,1.0822802905934976,-0.42059299785184123,False,True,1.07732,1.08002,1.08002,1.07982,2024-05-30 03:15:00,True,2024-05-30 03:15:00,,2024-05-30 04:19:51,0.02,even,True,10.9,1968.4400000000076,,48,0,22,5
2024-05-29 22:15:00,1.08033,1.08038,1.08014,1.08026,474,12,0,2024-05-29 22:00:00,2024-05-29 22:00:00,-0.0005355952380960982,-0.0011745272137508866,1.0803664285714287,-0.00027562549139896963,-0.00025577623594092406,1.0807577380952373,1.084031488022917,1.0880026036824435,1.084358382340084,1.0869758600477115,-0.00012130587522845327,-0.00027891092980488234,1.083855599771696,1.0834897804491372,8.265924286897198,12.853897569473318,-0.0008224586958762402,1.0809198068282677,1.0816467461206087,1.0807165497076028,-0.0007269392923410223,-0.0007390122631525396,0.0009983023924056641,-0.00012709666322541224,-0.00011342621259213814,-6.394220846117626e-05,1.0820642579373505,-0.42063115852214494,False,True,1.07726,1.07996,1.07996,1.07976,2024-05-30 03:45:00,True,2024-05-30 03:45:00,,2024-05-30 04:14:19,0.02,even,True,10.9,1979.3400000000076,,49,0,22,5
2024-05-29 22:30:00,1.08026,1.08031,1.08,1.08003,541,12,0,2024-05-29 22:00:00,2024-05-29 22:00:00,-0.0005355952380960982,-0.0011745272137508866,1.0803664285714287,-0.00027562549139896963,-0.00025577623594092406,1.0807577380952373,1.084031488022917,1.0880026036824435,1.084358382340084,1.0869758600477115,-0.00012130587522845327,-0.00027891092980488234,1.083855599771696,1.0834897804491372,5.4757457154689675,7.995118363518809,-0.0008224586958762402,1.0807829134700726,1.0815269871487119,1.0805529239766076,-0.0007440736786392677,-0.0007400245462498853,0.0009502806603049534,-0.00016362573099515387,-0.00012709666322541224,-0.00011342621259213814,1.0818358028680193,-0.420729954914804,False,True,1.0770300000000002,1.07973,1.07973,1.07953,2024-05-30 03:45:00,True,2024-05-30 03:45:00,,2024-05-30 04:03:05,0.02,even,True,10.9,1990.2400000000077,,50,0,22,5
2024-05-29 22:45:00,1.08004,1.08013,1.07994,1.08011,573,12,0,2024-05-29 22:00:00,2024-05-29 22:00:00,-0.0005355952380960982,-0.0011745272137508866,1.0803664285714287,-0.00027562549139896963,-0.00025577623594092406,1.0807577380952373,1.084031488022917,1.0880026036824435,1.084358382340084,1.0869758600477115,-0.00012130587522845327,-0.00027891092980488234,1.083855599771696,1.0834897804491372,6.449345673481034,6.730338558615732,-0.0008224586958762402,1.0806793883208305,1.081422025137696,1.080425294117646,-0.0007426368168654829,-0.0007405470003730048,0.0008737501549926591,-0.00012762985896164203,-0.00016362573099515387,-0.00012709666322541224,1.0816048568268861,-0.42075426859159415,False,True,1.07711,1.07981,1.07981,1.07961,2024-05-30 03:45:00,True,2024-05-30 03:45:00,,2024-05-30 04:07:28,0.02,even,True,10.9,2001.1400000000078,,51,0,22,5
2024-05-29 23:30:00,1.07999,1.08004,1.07994,1.07996,174,11,0,2024-05-29 23:00:00,2024-05-29 23:00:00,-0.00039130952380861395,-0.001259313606216228,1.0801769047619043,-0.0002756247546965973,-0.00039705658994986713,1.0803664285714287,1.0837327678067354,1.0887887905337104,1.084031488022917,1.0880026036824435,-0.00025577623594092406,-0.00027562549139896963,1.083607496560619,1.0832113980132063,4.731272080414887,6.464998921897547,-0.0009098296779442378,1.0804162520960516,1.0811321862915462,1.080007567939457,-0.0007159341954945386,-0.0007324577113746857,0.0005419926198912815,-0.00015160646714740267,-0.0001393704850356503,-0.00012674922600597327,1.0807392579763102,-0.4207241220973963,False,True,1.0769600000000001,1.07966,1.07966,1.07946,2024-05-30 07:45:00,True,2024-05-30 07:45:00,,2024-05-30 10:07:46,0.02,even,True,10.9,2012.040000000008,,52,0,22,5
2024-05-29 23:45:00,1.07997,1.0801,1.07995,1.08001,184,11,0,2024-05-29 23:00:00,2024-05-29 23:00:00,-0.00039130952380861395,-0.001259313606216228,1.0801769047619043,-0.0002756247546965973,-0.00039705658994986713,1.0803664285714287,1.0837327678067354,1.0887887905337104,1.084031488022917,1.0880026036824435,-0.00025577623594092406,-0.00027562549139896963,1.083607496560619,1.0832113980132063,2.9897186147237815,5.092022441164384,-0.0009098296779442378,1.0803537517735822,1.0810490613810613,1.079914767801857,-0.0006953096074790999,-0.0007250280905955685,0.0005431442411397867,-9.280013759993544e-05,-0.00015160646714740267,-0.0001393704850356503,1.0806480125273958,-0.4208184769236818,False,True,1.07701,1.07971,1.07971,1.07951,2024-05-30 03:45:00,True,2024-05-30 03:45:00,,2024-05-30 04:02:41,0.02,even,True,10.9,2022.940000000008,,53,0,22,5
2024-05-30 03:30:00,1.07989,1.07994,1.07948,1.0795,379,12,0,2024-05-30 03:00:00,2024-05-30 03:00:00,-0.00012285714285709126,-0.0011795667511746988,1.0798198809523811,-0.00021840034893784406,-0.0004433081446651727,1.0799761904761904,1.082223065639235,1.0872080866706384,1.082837014948139,1.0878187033995252,-0.0004734801500140881,-0.00027564218512004423,1.082758911594746,1.0822945375524191,24.617376427611834,39.481512307141905,-0.0010988435569755392,1.0799663871085254,1.0803311548830707,1.0798993395252838,-0.00036476777454530485,-0.0004015083449201474,0.00024745908756202073,-0.00010641210870332429,-3.4809081527198416e-05,-6.440316477451802e-05,1.0802334092934927,-0.420434730242925,False,True,1.0765,1.0792,1.0792,1.079,2024-05-30 08:30:00,True,2024-05-30 08:30:00,,2024-05-30 09:03:37,0.02,even,True,10.9,2033.840000000008,,54,0,22,5
2024-05-30 03:45:00,1.0795,1.0796999999999999,1.07949,1.07958,472,12,0,2024-05-30 03:00:00,2024-05-30 03:00:00,-0.00012285714285709126,-0.0011795667511746988,1.0798198809523811,-0.00021840034893784406,-0.0004433081446651727,1.0799761904761904,1.082223065639235,1.0872080866706384,1.082837014948139,1.0878187033995252,-0.0004734801500140881,-0.00027564218512004423,1.082758911594746,1.0822945375524191,18.486151569793545,29.045483269367406,-0.0010988435569755392,1.079906942937983,1.0802755137806213,1.0798063605091157,-0.00036857084263819395,-0.00039492084446375673,0.0002275097067900948,-9.297901616811544e-05,-0.00010641210870332429,-3.4809081527198416e-05,1.0801134986132823,-0.4205007775950509,False,True,1.07658,1.07928,1.07928,1.07908,2024-05-30 08:30:00,True,2024-05-30 08:30:00,,2024-05-30 09:05:33,0.02,even,True,10.9,2044.7400000000082,,55,0,22,5
2024-05-30 13:45:00,1.08178,1.08192,1.08157,1.08169,556,12,0,2024-05-30 13:00:00,2024-05-30 13:00:00,0.00041369047618955435,-0.00024724254050623173,1.0812696428571436,-6.143031744747331e-05,8.899224412556203e-05,1.0807998809523802,1.0794176823789887,1.080546752630555,1.079866899311051,1.0814816694942888,1.9768353682020606e-05,-9.389921770101758e-05,1.0815940975755252,1.0812242650267256,90.97889268167773,84.02353346309793,-0.0007033017594812623,1.0811655156670223,1.0806783581570276,1.0817891675266589,0.00048715750999472895,0.00039135259806248894,0.0009992085201215321,7.407636738787637e-05,0.0001257894736834686,6.334709322497467e-05,2.583138099028823,1.080440236024495,True,False,1.08469,1.08199,1.08199,1.08219,2024-05-30 15:45:00,True,2024-05-30 15:45:00,2024-05-31 12:47:53,2024-05-31 04:59:11,0.02,even,True,10.92,2055.660000000008,,56,0,22,5
2024-05-30 14:30:00,1.08191,1.08211,1.08167,1.08203,600,12,0,2024-05-30 14:00:00,2024-05-30 14:00:00,0.0004697619047633328,-8.344554912587121e-05,1.0816558333333337,-4.83367763015834e-06,0.00012031656627109758,1.0812696428571436,1.0788065205630157,1.0802394553496188,1.0794176823789887,1.080546752630555,8.899224412556203e-05,-6.143031744747331e-05,1.0816054461190399,1.0812679238245875,89.90810083959964,88.5347735368402,-0.0005793305174101841,1.0814186533239905,1.080907411787002,1.0819036394908836,0.0005112415369885603,0.0004411354472183626,0.0010053535033426259,8.444100447113634e-05,5.330237358136536e-05,-2.3271413827741227e-05,2.583260866720396,1.080546412261371,True,False,1.08503,1.08233,1.08233,1.08253,2024-05-30 15:45:00,True,2024-05-30 15:45:00,2024-05-31 13:42:30,2024-05-31 04:46:38,0.02,even,True,10.92,2066.580000000008,,57,0,22,5
2024-05-30 14:45:00,1.08203,1.08207,1.08165,1.08177,575,12,0,2024-05-30 14:00:00,2024-05-30 14:00:00,0.0004697619047633328,-8.344554912587121e-05,1.0816558333333337,-4.83367763015834e-06,0.00012031656627109758,1.0812696428571436,1.0788065205630157,1.0802394553496188,1.0794176823789887,1.080546752630555,8.899224412556203e-05,-6.143031744747331e-05,1.0816054461190399,1.0812679238245875,89.62330597039244,89.22042723802015,-0.0005793305174101841,1.081472706658761,1.080971307210187,1.0819182077743374,0.0005013994485740803,0.0004531882474895062,0.0009611408152207556,1.4568283453808561e-05,8.444100447113634e-05,5.330237358136536e-05,2.5832157478748856,1.0806206676737895,True,False,1.0847699999999998,1.0820699999999999,1.0820699999999999,1.0822699999999998,2024-05-30 15:45:00,True,2024-05-30 15:45:00,2024-05-31 13:01:05,2024-05-31 04:53:55,0.02,even,True,10.92,2077.500000000008,,58,0,22,5
2024-05-30 15:45:00,1.08261,1.08323,1.08255,1.08284,1346,12,0,2024-05-30 15:00:00,2024-05-30 15:00:00,0.00038619047619015134,4.074608810311631e-05,1.0822464285714282,0.00011050211504021215,0.0001768936901317279,1.0816558333333337,1.0778270356975697,1.080374771547195,1.0788065205630157,1.0802394553496188,0.00012031656627109758,-4.83367763015834e-06,1.0816850947565213,1.0813936899186205,78.22199131369439,66.1967936495097,-0.00045531519630752403,1.0818173410661716,1.081274837317744,1.0820847334021328,0.0005425037484274586,0.0004715146310941559,0.0008234870976624197,0.00018378052975576153,0.0001324217406257766,-3.0010319916451422e-05,2.5831964409839774,1.0809730258202885,True,False,1.08584,1.08314,1.08314,1.08334,2024-05-30 17:30:00,True,2024-05-30 17:30:00,2024-05-31 15:30:31,2024-05-30 22:39:59,0.02,even,True,10.92,2088.4200000000083,,59,0,22,5
2024-05-30 16:00:00,1.08287,1.08331,1.08256,1.08272,1495,12,0,2024-05-30 16:00:00,2024-05-30 16:00:00,0.0005905952380944601,0.0002444897857405426,1.0825632142857153,0.00011425613264884626,0.00018944817390522742,1.0822464285714282,1.0779140962260936,1.0803662930458926,1.0778270356975697,1.080374771547195,0.0001768936901317279,0.00011050211504021215,1.0817608950948103,1.081510994725131,86.73933209647744,76.39706385293623,-0.00031535419989791073,1.081956211671376,1.0813818864053186,1.0822399449604403,0.000574325266057274,0.0004920767580867795,0.0007947446130779732,0.00015521155830744426,0.00018378052975576153,0.0001324217406257766,2.5833128501880953,1.081167039732785,True,False,1.0857199999999998,1.0830199999999999,1.0830199999999999,1.0832199999999998,2024-05-30 17:30:00,True,2024-05-30 17:30:00,2024-05-31 15:30:31,2024-05-30 22:40:16,0.02,even,True,10.92,2099.3400000000083,,60,0,22,5
2024-05-30 17:15:00,1.08301,1.08381,1.08299,1.08365,1114,12,0,2024-05-30 17:00:00,2024-05-30 17:00:00,0.00031678571428717106,0.00038153506347149424,1.083108571428572,0.00022164822563932788,0.0002587430047954645,1.0825632142857153,1.0772366200618926,1.0801821433731738,1.0779140962260936,1.0803662930458926,0.00018944817390522742,0.00011425613264884626,1.0819059986370807,1.0817109151471205,79.76164161509173,78.10556729534805,-0.00017597634722402974,1.082601655797138,1.0819184497973915,1.0831151324389399,0.0006832059997465834,0.0005909868373537932,0.0007740267006699221,0.0002284210526313224,0.00014244582043332343,0.00015829033367764644,2.5841600684848443,1.0820701963930355,True,False,1.08665,1.08395,1.08395,1.08415,2024-05-30 18:30:00,True,2024-05-30 18:30:00,2024-05-31 15:38:53,2024-05-30 18:51:19,0.02,even,True,10.92,2110.2600000000084,,61,0,22,5
2024-05-30 17:30:00,1.08364,1.08403,1.08356,1.08403,956,12,0,2024-05-30 17:00:00,2024-05-30 17:00:00,0.00031678571428717106,0.00038153506347149424,1.083108571428572,0.00022164822563932788,0.0002587430047954645,1.0825632142857153,1.0772366200618926,1.0801821433731738,1.0779140962260936,1.0803662930458926,0.00018944817390522742,0.00011425613264884626,1.0819059986370807,1.0817109151471205,86.9731800766309,80.42713135791747,-0.00017597634722402974,1.0828214010591168,1.0820748609235107,1.0833450223598213,0.0007465401356061552,0.0006220974970042657,0.0008458329228340683,0.00022988992088146532,0.0002284210526313224,0.00014244582043332343,2.5844868968056476,1.0822031479139953,True,False,1.08703,1.08433,1.08433,1.08453,2024-05-31 13:00:00,True,2024-05-31 13:00:00,2024-05-31 15:41:08,2024-05-31 18:20:23,0.02,success,True,109.18,2219.4400000000082,,62,0,22,5
2024-05-30 17:45:00,1.08402,1.08436,1.08399,1.08401,1278,12,0,2024-05-30 17:00:00,2024-05-30 17:00:00,0.00031678571428717106,0.00038153506347149424,1.083108571428572,0.00022164822563932788,0.0002587430047954645,1.0825632142857153,1.0772366200618926,1.0801821433731738,1.0779140962260936,1.0803662930458926,0.00018944817390522742,0.00011425613264884626,1.0819059986370807,1.0817109151471205,93.84606596240438,86.86029588470899,-0.00017597634722402974,1.0830042624346372,1.0822182045588062,1.083574410044719,0.00078605787583097,0.0006548895727696066,0.0009069439527060565,0.00022938768489777495,0.00022988992088146532,0.0002284210526313224,2.5847987843808724,1.082350035708566,True,False,1.0870099999999998,1.0843099999999999,1.0843099999999999,1.0845099999999999,2024-05-31 13:00:00,True,2024-05-31 13:00:00,2024-05-31 15:41:07,2024-05-31 18:20:24,0.02,success,True,109.18,2328.620000000008,,63,0,22,5
2024-05-30 19:45:00,1.08396,1.08415,1.08392,1.08392,550,12,0,2024-05-30 19:00:00,2024-05-30 19:00:00,0.00030583333333300544,0.0006761775192292152,1.083772380952381,0.00033433671465860445,0.00028210856203893996,1.083414404761905,1.0771169634976125,1.0804045610594992,1.0768266504809485,1.0800997200501576,0.00028209707682320717,0.00032337567671136857,1.08213515593526,1.082022998580523,73.26565143824581,70.77834179357653,0.00011775297360701858,1.0836589258468778,1.0829886530042767,1.0841401066391472,0.0006702728426011273,0.0007161824719636546,0.0009723385898700308,-6.317853457149525e-05,-2.2063983488029848e-05,2.9205366357532014e-05,1.0854527637354716,-0.41717255045717727,True,False,1.0869199999999999,1.08422,1.08422,1.08442,2024-05-31 13:00:00,True,2024-05-31 13:00:00,2024-05-31 15:39:42,2024-05-31 18:22:04,0.02,success,True,109.18,2437.800000000008,,64,0,22,5
2024-05-30 20:00:00,1.08393,1.08426,1.08393,1.08414,433,12,0,2024-05-30 20:00:00,2024-05-30 20:00:00,0.0003579761904759504,0.0007569648012513142,1.0839288095238093,0.0003704277259694079,0.00034351597762336276,1.083772380952381,1.0772750789247478,1.0799291306489065,1.0771169634976125,1.0804045610594992,0.00028210856203893996,0.00033433671465860445,1.082245791036211,1.0821691586940811,77.83417935702734,73.88606880993251,0.00024559533913587773,1.0837329372550504,1.083073937966923,1.0841852459580328,0.0006589992881274043,0.0007047458351964046,0.0009618250014168215,4.5139318885611956e-05,-6.317853457149525e-05,-2.2063983488029848e-05,2.5854837097099455,1.0828867822061201,True,False,1.08714,1.08444,1.08444,1.08464,2024-05-31 13:00:00,True,2024-05-31 13:00:00,2024-05-31 15:41:13,2024-05-31 13:07:59,0.02,even,True,10.92,2448.720000000008,,65,0,22,5
2024-05-30 20:15:00,1.08413,1.0842,1.08399,1.08409,342,12,0,2024-05-30 20:00:00,2024-05-30 20:00:00,0.0003579761904759504,0.0007569648012513142,1.0839288095238093,0.0003704277259694079,0.00034351597762336276,1.083772380952381,1.0772750789247478,1.0799291306489065,1.0771169634976125,1.0804045610594992,0.00028210856203893996,0.00033433671465860445,1.082245791036211,1.0821691586940811,78.42483884027935,76.50822321185082,0.00024559533913587773,1.0837878699850427,1.083149201821225,1.0842183900928801,0.000638668163817746,0.0006915303009206729,0.0009174026742296847,3.314413484734047e-05,4.5139318885611956e-05,-6.317853457149525e-05,2.58545688370309,1.08297989648267,True,False,1.08709,1.08439,1.08439,1.08459,2024-05-31 13:00:00,True,2024-05-31 13:00:00,2024-05-31 15:41:11,2024-05-31 13:08:07,0.02,even,True,10.92,2459.640000000008,,66,0,22,5
2024-05-30 20:30:00,1.08409,1.08416,1.08393,1.08405,296,12,0,2024-05-30 20:00:00,2024-05-30 20:00:00,0.0003579761904759504,0.0007569648012513142,1.0839288095238093,0.0003704277259694079,0.00034351597762336276,1.083772380952381,1.0772750789247478,1.0799291306489065,1.0771169634976125,1.0804045610594992,0.00028210856203893996,0.00033433671465860445,1.082245791036211,1.0821691586940811,78.26026984878557,78.17309601536408,0.00024559533913587773,1.0838281976796516,1.0832159276122455,1.0842137186102505,0.0006122700674060511,0.0006756782542177486,0.0008931045105046613,-4.671482629614587e-06,3.314413484734047e-05,4.5139318885611956e-05,1.0854194096994318,-0.41699197247893083,True,False,1.0870499999999998,1.08435,1.08435,1.08455,2024-05-31 13:00:00,True,2024-05-31 13:00:00,2024-05-31 15:41:11,2024-05-31 18:20:09,0.02,success,True,109.18,2568.820000000008,,67,0,22,5
2024-05-31 01:45:00,1.08328,1.08332,1.08327,1.08328,103,13,0,2024-05-31 01:00:00,2024-05-31 01:00:00,-0.00014642857142788124,0.0005327249592781413,1.0832141666666673,0.00021679450812675774,0.00011665937047946123,1.0832330952380949,1.079258716500174,1.083484967197596,1.0789093346041163,1.0822916607005382,0.0002410675735721592,0.00022394910624103708,1.0825300999253031,1.0825368632214059,74.0928798535535,67.57561451755781,0.0005049085417975639,1.083259670150034,1.0832511144717514,1.0831496422428621,8.555678282728962e-06,3.0501963440763012e-05,0.0003891580655942731,4.963536291691106e-05,4.255589955248773e-05,4.101135190981431e-05,2.5836750056314144,1.08262427885431,True,False,1.08628,1.08358,1.08358,1.08378,2024-05-31 12:15:00,True,2024-05-31 12:15:00,2024-05-31 15:30:32,2024-06-03 11:06:48,0.02,success,True,109.18,2678.0000000000077,,68,0,22,5
2024-05-31 12:45:00,1.08429,1.08473,1.08427,1.08468,669,12,0,2024-05-31 12:00:00,2024-05-31 12:00:00,0.0005852380952373615,2.4802486005892632e-05,1.0834138095238093,-0.00010183386061419591,4.9848589734413255e-05,1.0825491666666665,1.0819421192128744,1.0839236112367712,1.0829235777829775,1.0842467516380643,-2.8240687739641106e-05,-0.00019205301345842052,1.0825512379628828,1.0825730654467258,95.51844354475895,91.42281451491829,1.888917589806632e-05,1.08344164856462,1.0828757807308613,1.0840848022015814,0.0005658678337587819,0.00028194858419113066,0.000983943257179835,0.00031229102167062983,0.00028634330925414453,0.0003067905056750586,2.585413125598774,1.0827564788043886,True,False,1.08768,1.08498,1.08498,1.08518,2024-05-31 14:15:00,True,2024-05-31 14:15:00,2024-05-31 15:47:08,2024-05-31 14:54:52,0.02,even,True,10.92,2688.920000000008,,69,0,22,5
2024-05-31 13:00:00,1.08469,1.08479,1.08438,1.08464,773,12,0,2024-05-31 13:00:00,2024-05-31 13:00:00,0.0008646428571428277,0.0002706237472784867,1.0840619047619047,-2.8486370029856465e-05,9.164471231374486e-05,1.0834138095238093,1.0812938795946232,1.0836074756468428,1.0819421192128744,1.0839236112367712,4.9848589734413255e-05,-0.00010183386061419591,1.0827027709975356,1.082759220210988,96.24874807968298,94.55105217890679,6.92360901741504e-05,1.0836260103239093,1.0830064636396866,1.0843591881664942,0.0006195466842227049,0.00034946820419744554,0.0010667531735831706,0.0002743859649128044,0.00031229102167062983,0.00028634330925414453,2.5857993049508314,1.082919071382157,True,False,1.08764,1.08494,1.08494,1.08514,2024-05-31 14:15:00,True,2024-05-31 14:15:00,2024-05-31 15:44:51,2024-05-31 14:55:13,0.02,even,True,10.92,2699.840000000008,,70,0,22,5
2024-05-31 13:15:00,1.08463,1.0848200000000001,1.08452,1.08464,711,12,0,2024-05-31 13:00:00,2024-05-31 13:00:00,0.0008646428571428277,0.0002706237472784867,1.0840619047619047,-2.8486370029856465e-05,9.164471231374486e-05,1.0834138095238093,1.0812938795946232,1.0836074756468428,1.0819421192128744,1.0839236112367712,4.9848589734413255e-05,-0.00010183386061419591,1.0827027709975356,1.082759220210988,96.02432604328403,95.93050588924199,6.92360901741504e-05,1.0837820087356156,1.0831274663330432,1.0845917647058818,0.0006545424025723445,0.00041048304387242534,0.0011232950042990542,0.0002325765393875745,0.0002743859649128044,0.00031229102167062983,2.5861082129616855,1.0830753164500782,True,False,1.08764,1.08494,1.08494,1.08514,2024-05-31 14:15:00,True,2024-05-31 14:15:00,2024-05-31 15:44:51,2024-05-31 14:55:13,0.02,even,True,10.92,2710.760000000008,,71,0,22,5
2024-05-31 14:00:00,1.08491,1.08545,1.08486,1.08544,613,12,0,2024-05-31 14:00:00,2024-05-31 14:00:00,0.0006480952380953919,0.0004583366255095367,1.0846934523809513,7.983287218898299e-05,0.00013639855085150623,1.0840619047619047,1.0804530980962912,1.0832535237212586,1.0812938795946232,1.0836074756468428,9.164471231374486e-05,-2.8486370029856465e-05,1.0828638825460817,1.0829544825941089,97.02953755680063,95.93056323020994,0.00014705619724122765,1.0843145806222598,1.0835379861532186,1.0852174234606127,0.0007765944690412141,0.0005711555082124788,0.001299317513164847,0.0002290161678715208,0.00017686618507006813,0.00021977640178927338,2.5869715021033852,1.0834633448178401,True,False,1.0884399999999999,1.08574,1.08574,1.08594,2024-05-31 15:45:00,True,2024-05-31 15:45:00,2024-06-03 18:24:53,2024-05-31 17:41:57,0.02,even,True,10.92,2721.680000000008,,72,0,22,5
2024-05-31 15:30:00,1.0854300000000001,1.08765,1.08486,1.08763,2998,12,0,2024-05-31 15:00:00,2024-05-31 15:00:00,0.0006315476190466018,0.0006101298098295516,1.0860294047619052,0.00010149106517405434,0.00029351519748470177,1.0846934523809513,1.0804119312870029,1.0834164200739846,1.0804530980962912,1.0832535237212586,0.00013639855085150623,7.983287218898299e-05,1.0831920191560118,1.08335412398658,91.11551298440288,89.83759788959314,0.00023967091975889243,1.085243735018674,1.0843299645092028,1.0859801788785686,0.0009137705094712789,0.0007467231987414944,0.0014568794276413463,0.00043808393532884793,-3.888888888892161e-05,2.752665978600355e-05,2.5879469661058847,1.0840133916512527,True,False,1.09063,1.08793,1.08793,1.08813,2024-06-03 18:15:00,True,2024-06-03 18:15:00,2024-06-04 01:00:07,2024-06-04 11:28:36,0.02,success,True,109.18,2830.860000000008,,73,0,22,5
2024-05-31 15:45:00,1.08758,1.08817,1.0873,1.08795,1692,12,0,2024-05-31 15:00:00,2024-05-31 15:00:00,0.0006315476190466018,0.0006101298098295516,1.0860294047619052,0.00010149106517405434,0.00029351519748470177,1.0846934523809513,1.0804119312870029,1.0834164200739846,1.0804530980962912,1.0832535237212586,0.00013639855085150623,7.983287218898299e-05,1.0831920191560118,1.08335412398658,92.41625626628046,90.48303426658106,0.00023967091975889243,1.0856600834773396,1.084598115286299,1.0864160337117301,0.001061968191040652,0.000809772197201326,0.0015792231212481864,0.00043585483316155305,0.00043808393532884793,-3.888888888892161e-05,2.588547984925415,1.084284082498045,True,False,1.0909499999999999,1.08825,1.08825,1.08845,2024-06-03 18:30:00,True,2024-06-03 18:30:00,2024-06-04 03:04:32,2024-06-03 19:28:24,0.02,even,True,10.92,2841.780000000008,,74,0,22,5
2024-05-31 16:00:00,1.08794,1.08802,1.08737,1.08745,1549,12,0,2024-05-31 16:00:00,2024-05-31 16:00:00,0.0013359523809539642,0.0010055638678823087,1.0866421428571433,0.00019345777025332953,0.0003184258578428673,1.0860294047619052,1.0797458184984408,1.0833584998252341,1.0804119312870029,1.0834164200739846,0.00029351519748470177,0.00010149106517405434,1.0834267275975595,1.0836321940676537,91.94252969389622,91.82476631485984,0.0003928495093835757,1.0859354552500564,1.0848093660058322,1.0867428345373238,0.0011260892442241932,0.0008730356066058995,0.0016482541268521616,0.00032680082559366497,0.00043585483316155305,0.00043808393532884793,2.588967977608574,1.0845176914660735,True,False,1.09045,1.08775,1.08775,1.08795,2024-06-03 18:15:00,True,2024-06-03 18:15:00,2024-06-04 01:00:02,2024-06-04 11:30:57,0.02,success,True,109.18,2950.9600000000078,,75,0,22,5
2024-06-03 11:15:00,1.08347,1.08375,1.08327,1.08362,826,12,0,2024-06-03 11:00:00,2024-06-03 11:00:00,-0.0004895238095230514,6.800282710406336e-05,1.0844429761904766,-5.146069193704775e-05,1.659572153643784e-06,1.0847914285714284,1.0841020134542227,1.0857849178133292,1.0839306065604115,1.0851488310304838,6.828951366954402e-05,-1.274254177625423e-06,1.0844853545232507,1.084633151945213,6.083690758169162,11.555029101944099,0.00025873824316372337,1.0845054803925989,1.0848186235962651,1.0842735190918469,-0.00031314320366626625,-0.0001314786713700142,0.000545206382958492,-0.00025052287581806,-0.00028755073959407795,-0.0002080770553825051,1.0850095477088408,-0.4164625095251471,False,True,1.0806200000000001,1.08332,1.08332,1.08312,2024-06-03 13:15:00,True,2024-06-03 13:15:00,,2024-06-03 13:21:35,0.02,even,True,10.9,2961.860000000008,,76,0,23,6
2024-06-03 12:30:00,1.08376,1.08405,1.08336,1.08339,644,12,0,2024-06-03 12:00:00,2024-06-03 12:00:00,-0.00034845238095182474,-5.2101760707135014e-05,1.0840359523809522,-5.541126280901448e-05,1.654987297120713e-06,1.0844429761904766,1.0840458420367445,1.0857867832060129,1.0841020134542227,1.0857849178133292,1.659572153643784e-06,-5.146069193704775e-05,1.0844166219733637,1.084536099789596,11.417322834647644,15.83552055993083,0.0001965702423895517,1.084009789795952,1.0844435564699997,1.0835348262813902,-0.00043376667404770863,-0.0003125975529735237,0.000720531516788429,-0.00014412796697582664,-0.00011459236326150091,-0.00017090127278951428,1.0845075438290546,-0.4174378912662742,False,True,1.0803900000000002,1.09419,1.08309,1.0828900000000001,,False,,,,0.02,running,False,0.0,2961.860000000008,2024-06-03 15:30:00,0,1,23,6
2024-06-03 12:45:00,1.0834,1.08368,1.08315,1.08342,827,12,0,2024-06-03 12:00:00,2024-06-03 12:00:00,-0.00034845238095182474,-5.2101760707135014e-05,1.0840359523809522,-5.541126280901448e-05,1.654987297120713e-06,1.0844429761904766,1.0840458420367445,1.0857867832060129,1.0841020134542227,1.0857849178133292,1.659572153643784e-06,-5.146069193704775e-05,1.0844166219733637,1.084536099789596,11.257474394650146,13.769989277657354,0.0001965702423895517,1.083919052904267,1.0843677374722218,1.083413223254214,-0.0004486845679547713,-0.00033981495596977325,0.0007530987097887353,-0.00012160302717623139,-0.00014412796697582664,-0.00011459236326150091,1.0844299065124288,-0.41760346000400084,False,True,1.0804200000000002,1.08312,1.08312,1.08292,2024-06-03 13:15:00,True,2024-06-03 13:15:00,,2024-06-03 13:16:23,0.02,even,True,10.9,2972.760000000008,,1,0,23,6
2024-06-03 13:00:00,1.08343,1.0835,1.08276,1.08291,829,12,0,2024-06-03 13:00:00,2024-06-03 13:00:00,-0.0004070238095243983,-0.00019162834584296462,1.0837884523809527,-8.003316153116924e-05,1.6578494699403e-06,1.0840359523809522,1.0840036014925365,1.0857885435093562,1.0840458420367445,1.0857867832060129,1.654987297120713e-06,-5.541126280901448e-05,1.0843671624912115,1.0844652118064284,6.597606058520559,9.757467762606106,0.00011893052474304844,1.0837638139959183,1.0842597569187238,1.083195820433437,-0.0004959429228055257,-0.00037104054933692377,0.0008189652007373808,-0.00021740282077686857,-0.00012160302717623139,-0.00014412796697582664,1.0843014234544326,-0.4179097825875584,False,True,1.0799100000000001,1.09371,1.08261,1.08241,,False,,,,0.02,running,False,0.0,2972.760000000008,2024-06-03 16:00:00,0,1,23,6
2024-06-03 18:15:00,1.08814,1.08876,1.08807,1.08865,905,12,0,2024-06-03 18:00:00,2024-06-03 18:00:00,0.0010735714285721176,0.00020238070990985513,1.0867557142857138,-0.00015822235916769034,0.0002017671062606107,1.0853516666666674,1.0844098337952255,1.0856978620013515,1.0849534717663665,1.0855160175123355,0.00016432057540202247,-0.0001896138979188538,1.084849834870215,1.0850258487187276,88.91771143273326,85.32578510567532,-2.616368037967476e-06,1.0866927359570935,1.085694250577687,1.0877480736154113,0.0009984853794064996,0.000592509353861786,0.0017517179186975615,0.00045657034743684655,0.0003964258685942301,0.00022367733058081818,2.590112892805653,1.0853832544251696,True,False,1.0916499999999998,1.0889499999999999,1.0889499999999999,1.0891499999999998,2024-06-03 21:30:00,True,2024-06-03 21:30:00,,2024-06-04 10:21:23,0.02,even,True,10.92,2983.680000000008,,1,0,23,6
2024-06-03 18:30:00,1.08865,1.08894,1.08849,1.0888,718,12,0,2024-06-03 18:00:00,2024-06-03 18:00:00,0.0010735714285721176,0.00020238070990985513,1.0867557142857138,-0.00015822235916769034,0.0002017671062606107,1.0853516666666674,1.0844098337952255,1.0856978620013515,1.0849534717663665,1.0855160175123355,0.00016432057540202247,-0.0001896138979188538,1.084849834870215,1.0850258487187276,97.7847293602931,90.46241243415638,-2.616368037967476e-06,1.0870169304252328,1.0859243060904509,1.0881873409012723,0.0010926243347819664,0.000692532350045822,0.0018870768399881365,0.000439267285861078,0.00045657034743684655,0.0003964258685942301,2.5907348946352564,1.0856397871672883,True,False,1.0917999999999999,1.0891,1.0891,1.0893,2024-06-03 21:45:00,True,2024-06-03 21:45:00,,2024-06-04 10:20:18,0.02,even,True,10.92,2994.600000000008,,2,0,23,6
2024-06-03 18:45:00,1.0888,1.08897,1.0886,1.08889,834,12,0,2024-06-03 18:00:00,2024-06-03 18:00:00,0.0010735714285721176,0.00020238070990985513,1.0867557142857138,-0.00015822235916769034,0.0002017671062606107,1.0853516666666674,1.0844098337952255,1.0856978620013515,1.0849534717663665,1.0855160175123355,0.00016432057540202247,-0.0001896138979188538,1.084849834870215,1.0850258487187276,97.70426245518065,94.80223441606898,-2.616368037967476e-06,1.087305094975197,1.0861439871207879,1.0885782972136215,0.001161107854409149,0.0007862474509184876,0.001984668486175914,0.0003909563123491999,0.000439267285861078,0.00045657034743684655,2.5912575996699587,1.0858989947572841,True,False,1.0918899999999998,1.0891899999999999,1.0891899999999999,1.0893899999999999,2024-06-03 22:00:00,True,2024-06-03 22:00:00,,2024-06-04 10:10:56,0.02,even,True,10.92,3005.520000000008,,3,0,23,6
2024-06-03 20:15:00,1.08829,1.08876,1.08819,1.08874,556,12,0,2024-06-03 20:00:00,2024-06-03 20:00:00,0.0009619047619060517,0.0008276929409811729,1.0884340476190473,0.00011235309663720352,0.00022997060360627601,1.0877176190476199,1.0817476027503687,1.0857404837855342,1.0831771471660077,1.085818548908542,0.00020827285924645943,-4.838537935983441e-05,1.0853168482058801,1.085573462355531,87.29832628137588,86.90405942461986,0.00026155471765866817,1.088052779473842,1.087007371321606,1.0892119814241488,0.0010454081522359715,0.0010145761407946785,0.001907128120155412,2.1431028556229137e-06,1.6752665965569236e-06,8.418988648295489e-05,2.5917866043863587,1.0866373584619389,True,False,1.09174,1.08904,1.08904,1.08924,2024-06-03 21:45:00,True,2024-06-03 21:45:00,,2024-06-04 10:20:21,0.02,even,True,10.92,3016.4400000000082,,4,0,23,6
2024-06-03 20:30:00,1.08873,1.08881,1.08865,1.08876,564,12,0,2024-06-03 20:00:00,2024-06-03 20:00:00,0.0009619047619060517,0.0008276929409811729,1.0884340476190473,0.00011235309663720352,0.00022997060360627601,1.0877176190476199,1.0817476027503687,1.0857404837855342,1.0831771471660077,1.085818548908542,0.00020827285924645943,-4.838537935983441e-05,1.0853168482058801,1.085573462355531,88.61380289047214,87.38308962493177,0.00026155471765866817,1.0881615826317124,1.0871371956681535,1.089183161334709,0.0010243869635588876,0.0010165383053475205,0.0018752597153517297,-2.882008943982939e-05,2.1431028556229137e-06,1.6752665965569236e-06,1.0917147619504337,-0.41334843928101583,True,False,1.0917599999999998,1.08906,1.08906,1.08926,2024-06-03 21:45:00,True,2024-06-03 21:45:00,,2024-06-04 10:20:21,0.02,even,True,10.92,3027.3600000000083,,5,0,23,6
2024-06-03 20:45:00,1.08877,1.0888,1.0885,1.08873,701,12,0,2024-06-03 20:00:00,2024-06-03 20:00:00,0.0009619047619060517,0.0008276929409811729,1.0884340476190473,0.00011235309663720352,0.00022997060360627601,1.0877176190476199,1.0817476027503687,1.0857404837855342,1.0831771471660077,1.085818548908542,0.00020827285924645943,-4.838537935983441e-05,1.0853168482058801,1.085573462355531,90.80570574346238,88.90594497177013,0.00026155471765866817,1.0882490314576028,1.0872551811742164,1.0891238596491233,0.0009938502833863883,0.0010120007009552941,0.0018316306942233968,-5.9301685585655406e-05,-2.882008943982939e-05,2.1431028556229137e-06,1.091596561086325,-0.4133488417880784,True,False,1.0917299999999999,1.08903,1.08903,1.08923,2024-06-03 21:45:00,True,2024-06-03 21:45:00,,2024-06-04 10:20:28,0.02,even,True,10.92,3038.2800000000084,,6,0,23,6
2024-06-03 21:15:00,1.08871,1.08926,1.08871,1.08921,604,12,0,2024-06-03 21:00:00,2024-06-03 21:00:00,0.0007164285714273966,0.0009895905590135978,1.0891739285714286,0.0002904236211657708,0.00025516315630250445,1.0884340476190473,1.0805380665950728,1.085653783620161,1.0817476027503687,1.0857404837855342,0.00022997060360627601,0.00011235309663720352,1.085596406386146,1.0858995853670885,91.96321822912974,90.79849332972874,0.00040716188592965414,1.0884555787359167,1.0874990785101308,1.0889327003783968,0.0009565002257858612,0.0009919735245549441,0.0016931886093074873,-8.348125214951985e-05,-0.00010767801857691772,-5.9301685585655406e-05,1.091218505000962,-0.41335310424416827,True,False,1.09221,1.08951,1.08951,1.08971,2024-06-03 22:15:00,True,2024-06-03 22:15:00,,2024-06-04 10:04:34,0.02,even,True,10.92,3049.2000000000085,,7,0,23,6
2024-06-03 21:30:00,1.08921,1.08955,1.08919,1.08936,630,12,0,2024-06-03 21:00:00,2024-06-03 21:00:00,0.0007164285714273966,0.0009895905590135978,1.0891739285714286,0.0002904236211657708,0.00025516315630250445,1.0884340476190473,1.0805380665950728,1.085653783620161,1.0817476027503687,1.0857404837855342,0.00022997060360627601,0.00011235309663720352,1.085596406386146,1.0858995853670885,91.17047360615062,90.92008261729148,0.00040716188592965414,1.0885947204688526,1.0876369245464175,1.0890695665634667,0.0009577959224351673,0.0009851380041309887,0.0016348700254216685,0.00013686618506980608,-8.348125214951985e-05,-0.00010767801857691772,2.591276641097786,1.0868624920291474,True,False,1.09236,1.08966,1.08966,1.08986,2024-06-03 23:00:00,True,2024-06-03 23:00:00,,2024-06-04 09:42:19,0.02,even,True,10.92,3060.1200000000085,,8,0,23,6
2024-06-03 21:45:00,1.08936,1.0897000000000001,1.08934,1.08965,508,12,0,2024-06-03 21:00:00,2024-06-03 21:00:00,0.0007164285714273966,0.0009895905590135978,1.0891739285714286,0.0002904236211657708,0.00025516315630250445,1.0884340476190473,1.0805380665950728,1.085653783620161,1.0817476027503687,1.0857404837855342,0.00022997060360627601,0.00011235309663720352,1.085596406386146,1.0858995853670885,94.02696586401794,92.38688589976609,0.00040716188592965414,1.0887570711659522,1.0877860412466829,1.089230471276229,0.0009710299192693395,0.0009823163871586589,0.001569737239165371,0.0001609047127624219,0.00013686618506980608,-8.348125214951985e-05,2.5913496165491026,1.0871113260033558,True,False,1.09265,1.08995,1.08995,1.09015,2024-06-04 00:00:00,True,2024-06-04 00:00:00,,2024-06-04 00:06:47,0.02,even,True,10.92,3071.0400000000086,,9,0,23,6
2024-06-03 22:00:00,1.08965,1.0898,1.08954,1.08976,547,12,0,2024-06-03 22:00:00,2024-06-03 22:00:00,0.000739880952381311,0.0011793076638504374,1.0897352380952374,0.0004531142466772763,0.00029762306643709926,1.0891739285714286,1.0798125778680603,1.0854278154957435,1.0805380665950728,1.085653783620161,0.00025516315630250445,0.0002904236211657708,1.0858753479096204,1.0862212185377216,93.96689702837689,93.05477883284847,0.0005615910415138108,1.0889113679096518,1.0879322604135953,1.0893604471964224,0.0009791074960565638,0.00098167460893824,0.001447238980503755,0.00012997592019337034,0.0001609047127624219,0.00013686618506980608,2.5913142198201022,1.0874066745727424,True,False,1.09276,1.09006,1.09006,1.09026,2024-06-04 00:00:00,True,2024-06-04 00:00:00,,2024-06-04 00:03:44,0.02,even,True,10.92,3081.9600000000087,,10,0,23,6
2024-06-03 22:45:00,1.08977,1.08993,1.08976,1.08992,373,12,0,2024-06-03 22:00:00,2024-06-03 22:00:00,0.000739880952381311,0.0011793076638504374,1.0897352380952374,0.0004531142466772763,0.00029762306643709926,1.0891739285714286,1.0798125778680603,1.0854278154957435,1.0805380665950728,1.085653783620161,0.00025516315630250445,0.0002904236211657708,1.0858753479096204,1.0862212185377216,93.59464065346263,93.47436760611248,0.0005615910415138108,1.0892598774181823,1.0883146841925737,1.089648816649467,0.0009451932256085982,0.0009677137428631636,0.0010330404961522472,0.00015917784657792922,0.00011169934640409274,1.749226006242388e-05,2.5910434213192723,1.0882542119796614,True,False,1.09292,1.09022,1.09022,1.09042,2024-06-04 01:15:00,True,2024-06-04 01:15:00,,2024-06-04 08:58:40,0.02,even,True,10.92,3092.8800000000087,,11,0,23,6
2024-06-03 23:00:00,1.08992,1.08993,1.08989,1.0899,74,11,0,2024-06-03 23:00:00,2024-06-03 23:00:00,0.0005613095238088395,0.0013113513989513326,1.0901245238095236,0.0005170295656806057,0.0003228317658542582,1.0897352380952374,1.0799629570552898,1.0854798433764543,1.0798125778680603,1.0854278154957435,0.00029762306643709926,0.0004531142466772763,1.0861653254638386,1.086553121054704,97.45548569077921,94.68557886407673,0.0007115431130013151,1.0893583578153851,1.0884321149931238,1.089798317853457,0.0009262428222613917,0.0009594195587428093,0.0007729057726252898,0.0001495012039900434,0.00015917784657792922,0.00011169934640409274,2.5908417406465007,1.088754895060413,True,False,1.0929,1.0902,1.0902,1.0904,2024-06-04 01:15:00,True,2024-06-04 01:15:00,,2024-06-04 08:58:45,0.02,even,True,10.92,3103.800000000009,,12,0,23,6
2024-06-03 23:15:00,1.08991,1.09006,1.08988,1.08999,151,11,0,2024-06-03 23:00:00,2024-06-03 23:00:00,0.0005613095238088395,0.0013113513989513326,1.0901245238095236,0.0005170295656806057,0.0003228317658542582,1.0897352380952374,1.0799629570552898,1.0854798433764543,1.0798125778680603,1.0854278154957435,0.00029762306643709926,0.0004531142466772763,1.0861653254638386,1.086553121054704,98.120320855614,96.3901490666186,0.0007115431130013151,1.0894555335360951,1.088547513882522,1.0899558685930517,0.0009080196535731222,0.0009491395777088718,0.0007883129666304106,0.0001575507395947806,0.0001495012039900434,0.00015917784657792922,2.591020091098003,1.0888916460881006,True,False,1.09299,1.09029,1.09029,1.09049,2024-06-04 01:15:00,True,2024-06-04 01:15:00,,2024-06-04 08:54:02,0.02,even,True,10.92,3114.720000000009,,13,0,23,6
2024-06-04 01:00:00,1.0901,1.09091,1.0901,1.0909,214,11,0,2024-06-04 01:00:00,2024-06-04 01:00:00,5.023809523851952e-05,0.0014327119892600937,1.0903673809523813,0.0005820575887132166,0.0003620317510071163,1.0901747619047621,1.0806541550970594,1.085844111135787,1.080521312436615,1.0858302486851346,0.00032285038547472485,0.0005170375265287191,1.0866933389334947,1.0871433936607016,88.51784450510515,84.38420742434295,0.0009691718858425814,1.0900391888055954,1.0892643064013638,1.0904831991744073,0.0007748824042315139,0.0008320778862037443,0.0007491733221973543,0.00014474028207800416,1.830753354026271e-05,2.090815273447788e-05,2.5914945831593736,1.089471815189441,True,False,1.0938999999999999,1.0912,1.0912,1.0914,2024-06-04 03:45:00,True,2024-06-04 03:45:00,,2024-06-04 03:59:31,0.02,even,True,10.92,3125.640000000009,,14,0,23,6
2024-06-04 01:15:00,1.0909,1.0909,1.09067,1.09072,176,12,0,2024-06-04 01:00:00,2024-06-04 01:00:00,5.023809523851952e-05,0.0014327119892600937,1.0903673809523813,0.0005820575887132166,0.0003620317510071163,1.0901747619047621,1.0806541550970594,1.085844111135787,1.080521312436615,1.0858302486851346,0.00032285038547472485,0.0005170375265287191,1.0866933389334947,1.0871433936607016,87.69831379426584,85.95665564547322,0.0009691718858425814,1.09014392898935,1.0893721355568182,1.090558383212935,0.0007717934325317533,0.000820020995469346,0.0007680603275084493,7.518403852779798e-05,0.00014474028207800416,1.830753354026271e-05,2.5915952646550715,1.0895215017707987,True,False,1.0937199999999998,1.0910199999999999,1.0910199999999999,1.0912199999999999,2024-06-04 03:15:00,True,2024-06-04 03:15:00,,2024-06-04 04:07:33,0.02,even,True,10.92,3136.560000000009,,15,0,23,6
2024-06-04 01:30:00,1.09074,1.09079,1.09061,1.09064,123,12,0,2024-06-04 01:00:00,2024-06-04 01:00:00,5.023809523851952e-05,0.0014327119892600937,1.0903673809523813,0.0005820575887132166,0.0003620317510071163,1.0901747619047621,1.0806541550970594,1.085844111135787,1.080521312436615,1.0858302486851346,0.00032285038547472485,0.0005170375265287191,1.0866933389334947,1.0871433936607016,88.6765746638326,88.2975776544012,0.0009691718858425814,1.0902202476063731,1.0894660514414982,1.090585046439629,0.0007541961648749318,0.0008068560293504633,0.0007573081715474594,2.6663226693868225e-05,7.518403852779798e-05,0.00014474028207800416,2.591607412471218,1.0895626804080398,True,False,1.09364,1.09094,1.09094,1.09114,2024-06-04 03:15:00,True,2024-06-04 03:15:00,,2024-06-04 04:07:54,0.02,even,True,10.92,3147.480000000009,,16,0,23,6
2024-06-04 02:15:00,1.09073,1.09083,1.09069,1.09076,181,12,0,2024-06-04 02:00:00,2024-06-04 02:00:00,0.00019261904761913584,0.001464832778588887,1.0906177380952378,0.0005692459210096142,0.00047140809681049325,1.0903673809523813,1.0813514064169722,1.085426876933824,1.0806541550970594,1.085844111135787,0.0003620317510071163,0.0005820575887132166,1.0869486073893984,1.0874239221678454,84.11645054664929,82.90194084243895,0.0010683040643918425,1.090416982050106,1.0897237785791498,1.0907443102855177,0.0006932034709561385,0.0007597228058999383,0.0006776483847539416,6.251805985457715e-05,5.157550739642858e-05,4.5170278637707284e-05,2.591659135604935,1.0898294849660999,True,False,1.0937599999999998,1.09106,1.09106,1.09126,2024-06-04 03:45:00,True,2024-06-04 03:45:00,,2024-06-04 04:06:19,0.02,even,True,10.92,3158.400000000009,,17,0,23,6
2024-06-04 03:15:00,1.09121,1.0913599999999999,1.09108,1.09125,433,12,0,2024-06-04 03:00:00,2024-06-04 03:00:00,0.00025035714285648325,0.001450871033468415,1.0908890476190471,0.0005250342370150469,0.0004058502742098137,1.0906177380952378,1.082154641061688,1.086359961614107,1.0813514064169722,1.085426876933824,0.00047140809681049325,0.0005692459210096142,1.0872241811062113,1.0877276083944178,85.28383968050203,81.42918271287873,0.0011448174582071571,1.0906933305625013,1.0900503866044968,1.0910074922600614,0.0006429439580044605,0.0006890786628200934,0.0005482326148878769,0.00011065359477169245,0.00011452012383794674,1.0677674578740692e-05,2.59174760629016,1.0902673782299628,True,False,1.09425,1.0804500000000001,1.09155,1.09175,,False,,,,0.02,running,False,0.0,3158.400000000009,2024-06-04 06:15:00,0,1,23,6
2024-06-04 03:30:00,1.09127,1.09152,1.09123,1.09146,240,12,0,2024-06-04 03:00:00,2024-06-04 03:00:00,0.00025035714285648325,0.001450871033468415,1.0908890476190471,0.0005250342370150469,0.0004058502742098137,1.0906177380952378,1.082154641061688,1.086359961614107,1.0813514064169722,1.085426876933824,0.00047140809681049325,0.0005692459210096142,1.0872241811062113,1.0877276083944178,91.61229351147468,85.55335852274771,0.0011448174582071571,1.090811279706732,1.0901548024115713,1.0911350257997934,0.0006564772951607178,0.0006825583892882183,0.0005557733351168707,0.00012753353973193882,0.00011065359477169245,0.00011452012383794674,2.591885319802201,1.0903847317973856,True,False,1.09446,1.0806600000000002,1.09176,1.09196,,False,,,,0.02,running,False,0.0,3158.400000000009,2024-06-04 06:30:00,0,2,23,6
2024-06-04 03:45:00,1.09147,1.09155,1.09119,1.09122,497,12,0,2024-06-04 03:00:00,2024-06-04 03:00:00,0.00025035714285648325,0.001450871033468415,1.0908890476190471,0.0005250342370150469,0.0004058502742098137,1.0906177380952378,1.082154641061688,1.086359961614107,1.0813514064169722,1.085426876933824,0.00047140809681049325,0.0005692459210096142,1.0872241811062113,1.0877276083944178,88.46771270260884,88.45461529819516,0.0011448174582071571,1.0908741597518503,1.09023370593664,1.0912017337461295,0.0006404538152102734,0.0006741374744726294,0.0005441047693478379,6.670794633611976e-05,0.00012753353973193882,0.00011065359477169245,2.5919362751847492,1.09046719230751,True,False,1.09422,1.0804200000000002,1.09152,1.09172,,False,,,,0.02,running,False,0.0,3158.400000000009,2024-06-04 06:45:00,0,3,23,6
2024-06-04 11:30:00,1.0878,1.08807,1.08733,1.08769,995,12,0,2024-06-04 11:00:00,2024-06-04 11:00:00,-0.0005345238095237903,0.0005480686685011005,1.089042023809523,-4.539507409509415e-05,1.2981890701004501e-06,1.0897039285714292,1.0880664767555535,1.0915402003167178,1.088049262936503,1.0905975952328804,0.00011028800506751291,2.160956801023967e-05,1.0883042108116958,1.0887373467282113,7.566629790999355,10.61810561138304,0.000982731512137065,1.0889645127010321,1.0895953502239515,1.0882418025455798,-0.0006308375229193697,-0.0003734352000002903,0.0010095915015620057,-0.0003102167182664761,-0.00035164086687311524,-0.0001966391468859463,1.0896047510726885,-0.41312114598152894,False,True,1.0846900000000002,1.08739,1.08739,1.08719,2024-06-04 12:15:00,True,2024-06-04 12:15:00,,2024-06-04 12:20:21,0.02,even,True,10.9,3169.3000000000093,,1,0,23,6
2024-06-04 13:00:00,1.0871,1.0871,1.08648,1.0866,960,12,0,2024-06-04 13:00:00,2024-06-04 13:00:00,-0.0008504761904757352,-2.5818198982063834e-05,1.0873722619047617,-0.0002016633991277641,-9.697409546640744e-05,1.0881915476190474,1.0895225874685615,1.0920597186031453,1.0885903632591631,1.0921656581332084,-9.698134967111467e-05,-0.00010598849664723491,1.0881196059236589,1.088443386270758,12.484009918169507,14.747321712637403,0.0006673881680525247,1.0878663822672814,1.088739225292159,1.086970815273478,-0.0008728430248776675,-0.0006875965178465241,0.001405675045434845,-0.00024351909184727738,-0.00018214310285435964,-8.502579979441371e-05,1.0888684765848151,-0.414926846037859,False,True,1.0836000000000001,1.0863,1.0863,1.0861,2024-06-04 15:00:00,True,2024-06-04 15:00:00,,2024-06-04 15:00:07,0.02,even,True,10.9,3180.2000000000094,,2,0,23,6
2024-06-04 13:15:00,1.0866,1.08687,1.08643,1.08646,1018,12,0,2024-06-04 13:00:00,2024-06-04 13:00:00,-0.0008504761904757352,-2.5818198982063834e-05,1.0873722619047617,-0.0002016633991277641,-9.697409546640744e-05,1.0881915476190474,1.0895225874685615,1.0920597186031453,1.0885903632591631,1.0921656581332084,-9.698134967111467e-05,-0.00010598849664723491,1.0881196059236589,1.088443386270758,3.958099554022569,10.852847715459925,0.0006673881680525247,1.0876500157646227,1.0885703937890363,1.0867422394220843,-0.0009203780244135817,-0.0007341528191599357,0.0014580344074671017,-0.00022857585139379744,-0.00024351909184727738,-0.00018214310285435964,1.0887105858721648,-0.41522610702799634,False,True,1.08346,1.08616,1.08616,1.08596,2024-06-05 19:15:00,True,2024-06-05 19:15:00,,2024-06-05 19:23:45,0.02,even,True,10.9,3191.1000000000095,,3,0,23,6
2024-06-04 13:30:00,1.08645,1.08674,1.08637,1.08662,1064,12,0,2024-06-04 13:00:00,2024-06-04 13:00:00,-0.0008504761904757352,-2.5818198982063834e-05,1.0873722619047617,-0.0002016633991277641,-9.697409546640744e-05,1.0881915476190474,1.0895225874685615,1.0920597186031453,1.0885903632591631,1.0921656581332084,-9.698134967111467e-05,-0.00010598849664723491,1.0881196059236589,1.088443386270758,4.094404003639103,6.845504491943717,0.0006673881680525247,1.0874915518008346,1.0884259201750335,1.0865883935328517,-0.0009343683741989128,-0.0007741959301677311,0.0014741502637195397,-0.00015384588923250675,-0.00022857585139379744,-0.00024351909184727738,1.0885784963888732,-0.41540170932316967,False,True,1.08362,1.08632,1.08632,1.08612,2024-06-04 15:00:00,True,2024-06-04 15:00:00,,2024-06-04 15:00:08,0.02,even,True,10.9,3202.0000000000095,,4,0,23,6
2024-06-04 14:45:00,1.08632,1.08635,1.08583,1.08609,829,12,0,2024-06-04 14:00:00,2024-06-04 14:00:00,-0.0008192857142856891,-0.00029255223322199875,1.0866384523809525,-0.0002475370696736425,-0.00013199544655421777,1.0873722619047617,1.0898577202208048,1.0922949384458218,1.0895225874685615,1.0920597186031453,-9.697409546640744e-05,-0.0002016633991277641,1.0879886636060034,1.0882551153690976,12.376512376513134,13.019318050083553,0.00047540008779762004,1.0868732805333692,1.08778580832598,1.0861326074991406,-0.0009125277926107511,-0.0008700200455949392,0.0013463367582777076,-0.00011061919504662399,-9.00997592014896e-05,-2.0708634330901532e-05,1.0879501621228156,-0.4156849471245343,False,True,1.08309,1.08579,1.08579,1.08559,2024-06-05 19:15:00,True,2024-06-05 19:15:00,,2024-06-05 19:18:39,0.02,even,True,10.9,3212.9000000000096,,5,0,23,6
2024-06-04 16:00:00,1.08641,1.08651,1.0861399999999999,1.08638,1073,12,0,2024-06-04 16:00:00,2024-06-04 16:00:00,-0.0003307142857147394,-0.0006332299857141344,1.0861139285714287,-0.0003011612531480165,-0.00033343127367046083,1.0863077380952377,1.0900728308946976,1.0935292362603466,1.0897466985325248,1.0930417909376962,-0.00023500570340970073,-0.00025802302676301283,1.0877825453617573,1.0879605696484045,28.977987421378803,31.663966711132712,9.409651368079438e-05,1.0866563679982648,1.0873760631449767,1.086226250429997,-0.0007196951467118851,-0.0008029511580720025,0.0009737910453591848,-7.994496043606247e-06,-1.6618507051369136e-05,5.5359477123539946e-05,1.087540868341232,-0.4150883674812378,False,True,1.08338,1.08608,1.08608,1.08588,2024-06-05 19:15:00,True,2024-06-05 19:15:00,2024-06-07 15:32:33,2024-06-05 19:23:30,0.02,even,True,10.9,3223.8000000000097,,6,0,23,6
2024-06-05 04:15:00,1.08823,1.08844,1.08814,1.08842,406,12,0,2024-06-05 04:00:00,2024-06-05 04:00:00,0.0001041666666674601,-7.697993776423218e-06,1.0881770238095239,0.00012609216632885156,6.420788651271015e-05,1.088056190476191,1.0857046816357778,1.0882266978923516,1.0855677841473224,1.0881459157014717,6.421370501203115e-05,0.00012609686958726964,1.0879347798820767,1.0880266012776612,73.9678043475435,69.7783697783647,-0.00011655555497045438,1.088148557978285,1.0880400141574047,1.0882454007567928,0.00010854382088032466,6.512628282112249e-05,0.0001861558487522566,6.72067423443945e-05,3.743378052978308e-05,7.017887856908267e-05,2.588496711152608,1.0879940903609773,True,False,1.0914199999999998,1.08872,1.08872,1.0889199999999999,2024-06-06 04:30:00,True,2024-06-06 04:30:00,,2024-06-06 07:39:56,0.02,even,True,10.92,3234.72000000001,,7,0,23,6
2024-06-05 04:45:00,1.08836,1.08854,1.08818,1.08833,478,12,0,2024-06-05 04:00:00,2024-06-05 04:00:00,0.0001041666666674601,-7.697993776423218e-06,1.0881770238095239,0.00012609216632885156,6.420788651271015e-05,1.088056190476191,1.0857046816357778,1.0882266978923516,1.0855677841473224,1.0881459157014717,6.421370501203115e-05,0.00012609686958726964,1.0879347798820767,1.0880266012776612,77.92207792207239,75.360785487362,-0.00011655555497045438,1.0882039971323816,1.0880834414929736,1.0883431372549022,0.00012055563940793768,8.45712621152004e-05,0.0002090310982239969,4.524595803312437e-05,5.2490540076277625e-05,6.72067423443945e-05,2.5886253292375043,1.0880609452722998,True,False,1.09133,1.08863,1.08863,1.08883,2024-06-06 04:30:00,True,2024-06-06 04:30:00,,2024-06-06 07:41:24,0.02,even,True,10.92,3245.64000000001,,8,0,23,6
2024-06-05 05:00:00,1.08834,1.08851,1.08824,1.08846,293,12,0,2024-06-05 05:00:00,2024-06-05 05:00:00,0.00012083333333290369,2.782529062872463e-05,1.0882529761904756,0.0001260929321443371,2.6786947760992426e-05,1.0881770238095239,1.0858415803861574,1.0885375009873435,1.0857046816357778,1.0882266978923516,6.420788651271015e-05,0.00012609216632885156,1.0879557618251685,1.0880452731754482,79.6536796536755,77.25607725607266,-8.767938585061859e-05,1.0882433821889383,1.0881113347157163,1.0883914275885784,0.00013204747322204113,9.406650433656854e-05,0.0002266325955331819,4.829033367625968e-05,4.524595803312437e-05,5.2490540076277625e-05,2.5886973815925485,1.0880854735846086,True,False,1.0914599999999999,1.08876,1.08876,1.08896,2024-06-06 04:30:00,True,2024-06-06 04:30:00,,2024-06-06 05:19:25,0.02,even,True,10.92,3256.56000000001,,9,0,23,6
2024-06-05 05:15:00,1.08845,1.08847,1.08835,1.08841,222,12,0,2024-06-05 05:00:00,2024-06-05 05:00:00,0.00012083333333290369,2.782529062872463e-05,1.0882529761904756,0.0001260929321443371,2.6786947760992426e-05,1.0881770238095239,1.0858415803861574,1.0885375009873435,1.0857046816357778,1.0882266978923516,6.420788651271015e-05,0.00012609216632885156,1.0879557618251685,1.0880452731754482,81.81818181818178,79.79797979797655,-8.767938585061859e-05,1.0882690156983326,1.0881334580701076,1.0884254798761606,0.0001355576282249249,0.00010236472911423982,0.00023764960205763954,3.405228758213141e-05,4.829033367625968e-05,4.524595803312437e-05,2.5887463068389387,1.0881046529133827,True,False,1.09141,1.08871,1.08871,1.08891,2024-06-06 04:30:00,True,2024-06-06 04:30:00,,2024-06-06 07:40:09,0.02,even,True,10.92,3267.48000000001,,10,0,23,6
2024-06-05 05:30:00,1.0884,1.08847,1.08836,1.08841,238,12,0,2024-06-05 05:00:00,2024-06-05 05:00:00,0.00012083333333290369,2.782529062872463e-05,1.0882529761904756,0.0001260929321443371,2.6786947760992426e-05,1.0881770238095239,1.0858415803861574,1.0885375009873435,1.0857046816357778,1.0882266978923516,6.420788651271015e-05,0.00012609216632885156,1.0879557618251685,1.0880452731754482,85.281385281388,82.25108225108175,-8.767938585061859e-05,1.0882907055908968,1.088153942657507,1.0884490333677337,0.00013676293338971135,0.00010924436996933414,0.00024396857726261329,2.355349157312503e-05,3.405228758213141e-05,4.829033367625968e-05,2.5887783909470383,1.088119675788429,True,False,1.09141,1.08871,1.08871,1.08891,2024-06-06 04:30:00,True,2024-06-06 04:30:00,,2024-06-06 07:40:09,0.02,even,True,10.92,3278.40000000001,,11,0,23,6
2024-06-05 11:00:00,1.08708,1.08741,1.08704,1.0872600000000001,697,12,0,2024-06-05 11:00:00,2024-06-05 11:00:00,-0.0002991666666662951,-0.00015600690797801242,1.087419166666667,-5.093417096025139e-05,-1.9305466134910956e-05,1.0874825000000004,1.0877560976008558,1.0886973809680083,1.0876870401181313,1.0887184011952935,-1.93049191971875e-05,-4.17425374678805e-05,1.0878377036256959,1.0878667835555649,24.41670253981295,33.554311952927364,-6.767169825013311e-05,1.0875070748290183,1.087690347431363,1.0873552046783626,-0.00018327260234474174,-0.00014259917835531693,0.00037032643261167704,-5.945304437626753e-05,-0.00011108359133027434,1.0626074991026968e-05,1.0878551453623884,-0.41314473600566326,False,True,1.0842600000000002,1.0869600000000001,1.0869600000000001,1.0867600000000002,2024-06-05 13:30:00,True,2024-06-05 13:30:00,2024-06-07 15:30:14,2024-06-05 15:03:52,0.02,even,True,10.9,3289.30000000001,,12,0,23,6
2024-06-05 11:15:00,1.08725,1.08748,1.08693,1.08724,594,12,0,2024-06-05 11:00:00,2024-06-05 11:00:00,-0.0002991666666662951,-0.00015600690797801242,1.087419166666667,-5.093417096025139e-05,-1.9305466134910956e-05,1.0874825000000004,1.0877560976008558,1.0886973809680083,1.0876870401181313,1.0887184011952935,-1.93049191971875e-05,-4.17425374678805e-05,1.0878377036256959,1.0878667835555649,17.96630140214329,26.231747953864414,-6.767169825013311e-05,1.0874659863937848,1.0876569883623732,1.0872953422772615,-0.00019100196858845564,-0.0001522797364019447,0.00035713349514918466,-5.986240110100738e-05,-5.945304437626753e-05,-0.00011108359133027434,1.087777472495713,-0.4131867879411899,False,True,1.08424,1.08694,1.08694,1.08674,2024-06-05 13:30:00,True,2024-06-05 13:30:00,2024-06-07 15:30:14,2024-06-05 15:02:12,0.02,even,True,10.9,3300.2000000000103,,13,0,23,6
2024-06-05 13:15:00,1.08681,1.08691,1.08657,1.0866,453,12,0,2024-06-05 13:00:00,2024-06-05 13:00:00,-8.952380952420569e-05,-0.00018494275428548868,1.0871286904761905,-8.405673063288406e-05,-4.868270396393676e-05,1.0873296428571428,1.0877930792772454,1.0888765920934826,1.0878621645874667,1.0887195480139455,-2.431568137077988e-05,-6.1600000715503e-05,1.0877376990106247,1.08773898960143,18.03670376018537,33.332172462872975,-0.00010606051174475662,1.0872057469297802,1.0874321968642098,1.0871100963192286,-0.0002264499344295512,-0.00017429084440391036,0.00035279833714241704,-0.00010464740282101204,-9.54833161341817e-05,2.339181287336345e-06,1.087586374074371,-0.41336618143591375,False,True,1.0836000000000001,1.0863,1.0863,1.0861,2024-06-05 19:15:00,True,2024-06-05 19:15:00,2024-06-07 15:31:30,2024-06-05 19:28:04,0.02,even,True,10.9,3311.1000000000104,,14,0,23,6
2024-06-05 13:30:00,1.08661,1.0866500000000001,1.08643,1.08661,572,12,0,2024-06-05 13:00:00,2024-06-05 13:00:00,-8.952380952420569e-05,-0.00018494275428548868,1.0871286904761905,-8.405673063288406e-05,-4.868270396393676e-05,1.0873296428571428,1.0877930792772454,1.0888765920934826,1.0878621645874667,1.0887195480139455,-2.431568137077988e-05,-6.1600000715503e-05,1.0877376990106247,1.08773898960143,10.293446675852893,21.58180320300635,-0.00010606051174475662,1.087114093555968,1.0873712933927868,1.0869807636738904,-0.0002571998368188222,-0.00019087264288689273,0.00038505410878265743,-0.00012933264533820932,-0.00010464740282101204,-9.54833161341817e-05,1.087500586720747,-0.4135390593729662,False,True,1.0836100000000002,1.08631,1.08631,1.0861100000000001,2024-06-05 14:15:00,True,2024-06-05 14:15:00,2024-06-07 15:31:30,2024-06-05 14:18:08,0.02,even,True,10.9,3322.0000000000105,,15,0,23,6
2024-06-05 13:45:00,1.08662,1.08687,1.08661,1.0868,387,12,0,2024-06-05 13:00:00,2024-06-05 13:00:00,-8.952380952420569e-05,-0.00018494275428548868,1.0871286904761905,-8.405673063288406e-05,-4.868270396393676e-05,1.0873296428571428,1.0877930792772454,1.0888765920934826,1.0878621645874667,1.0887195480139455,-2.431568137077988e-05,-6.1600000715503e-05,1.0877376990106247,1.08773898960143,13.407036939546437,13.912395791861556,-0.00010606051174475662,1.0870657714704346,1.0873289753636914,1.0868982868937054,-0.000263203893256847,-0.0002053388929608836,0.00039174268768801335,-8.247678018502569e-05,-0.00012933264533820932,-0.00010464740282101204,1.0874271395220843,-0.4136305657346735,False,True,1.0838,1.0865,1.0865,1.0863,2024-06-05 14:15:00,True,2024-06-05 14:15:00,2024-06-07 15:31:27,2024-06-05 14:42:37,0.02,even,True,10.9,3332.9000000000106,,16,0,23,6
2024-06-05 14:15:00,1.08611,1.08631,1.08609,1.08621,465,12,0,2024-06-05 14:00:00,2024-06-05 14:00:00,-0.00020095238095230172,-0.00025136476451703693,1.0869246428571429,-0.00011413849599658001,-8.63294836775916e-05,1.0871286904761905,1.0877604268493846,1.0890661483734878,1.0877930792772454,1.0888765920934826,-4.868270396393676e-05,-8.405673063288406e-05,1.08767333133252,1.0876590704333156,11.497200117885457,12.658421881900475,-0.0001351213622992127,1.0868096943664058,1.0871624823076915,1.0865629927760572,-0.0003527879412856816,-0.00025316666960083624,0.000465872657876512,-0.00014577915376734474,-0.00018951496388086575,-8.247678018502569e-05,1.0871919208641905,-0.41406593531207614,False,True,1.08321,1.08591,1.08591,1.08571,2024-06-05 19:15:00,True,2024-06-05 19:15:00,2024-06-07 15:36:06,2024-06-05 19:22:52,0.02,even,True,10.9,3343.8000000000106,,17,0,23,6
2024-06-05 14:30:00,1.08621,1.0865,1.08591,1.08634,574,12,0,2024-06-05 14:00:00,2024-06-05 14:00:00,-0.00020095238095230172,-0.00025136476451703693,1.0869246428571429,-0.00011413849599658001,-8.63294836775916e-05,1.0871286904761905,1.0877604268493846,1.0890661483734878,1.0877930792772454,1.0888765920934826,-4.868270396393676e-05,-8.405673063288406e-05,1.08767333133252,1.0876590704333156,11.229000884171692,11.932409863442226,-0.0001351213622992127,1.0867374336946511,1.087101557692307,1.0864436738906085,-0.0003641239976559518,-0.00027535813521185936,0.0004803512603885665,-0.00011931888544869373,-0.00014577915376734474,-0.00018951496388086575,1.087092148092133,-0.414204800310916,False,True,1.0833400000000002,1.0860400000000001,1.0860400000000001,1.0858400000000001,2024-06-05 19:15:00,True,2024-06-05 19:15:00,2024-06-07 15:36:01,2024-06-05 19:23:25,0.02,even,True,10.9,3354.7000000000107,,18,0,23,6
2024-06-05 16:45:00,1.08883,1.0891,1.08816,1.08881,2228,12,0,2024-06-05 16:00:00,2024-06-05 16:00:00,0.00041869047619091937,-0.00014579409222337247,1.0878803571428566,-0.0001324047465133995,4.0321990982013926e-05,1.0873433333333338,1.0877684903085387,1.0884452132043831,1.0877494796024374,1.0885893965178441,-1.4129762853303894e-05,-0.00012162959414267717,1.0877862972431316,1.0878005252147587,93.54240601557638,93.0354538787695,-0.00016327589568865662,1.0879224311157425,1.087610802111567,1.0882563226694177,0.00031162900417558426,5.0842830717637635e-05,0.0007575700187818149,0.0002993498451999699,0.00030669074647438066,0.0003043722050222186,2.5892790421947733,1.0872336031440624,True,False,1.09181,1.08911,1.08911,1.08931,2024-06-06 05:00:00,True,2024-06-06 05:00:00,,2024-06-06 05:03:00,0.02,even,True,10.92,3365.620000000011,,19,0,23,6
2024-06-05 19:00:00,1.08642,1.08642,1.08537,1.0855299999999999,932,12,0,2024-06-05 19:00:00,2024-06-05 19:00:00,-0.0003701190476204097,-0.0002315558678680496,1.0869122619047622,-0.00010147067790278793,4.368998968804543e-05,1.0871952380952372,1.0870141188028857,1.0885330962269244,1.0877667294423095,1.0885327540880463,4.0332115432018246e-05,-0.00015648605167144187,1.087542621713361,1.0874997420984303,11.081924397385231,15.852598068863827,-0.00014739046062567092,1.086796856015401,1.0870827760208555,1.0865836326109397,-0.00028592000545435425,-9.679138525748828e-05,0.0008813389435154127,-0.00043207430340563846,-0.000276195390436218,-0.0002199174406600779,1.0877734401846855,-0.41460617496280605,False,True,1.08253,1.08523,1.08523,1.08503,2024-06-07 15:45:00,True,2024-06-07 15:45:00,2024-06-07 15:46:02,,0.02,success,True,109.0,3474.620000000011,,20,0,23,6
2024-06-05 19:15:00,1.0855299999999999,1.08635,1.0854300000000001,1.08626,663,12,0,2024-06-05 19:00:00,2024-06-05 19:00:00,-0.0003701190476204097,-0.0002315558678680496,1.0869122619047622,-0.00010147067790278793,4.368998968804543e-05,1.0871952380952372,1.0870141188028857,1.0885330962269244,1.0877667294423095,1.0885327540880463,4.0332115432018246e-05,-0.00015648605167144187,1.087542621713361,1.0874997420984303,12.525914491956234,12.994606977330522,-0.00014739046062567092,1.0867142627822626,1.0870218296489402,1.086337306501548,-0.0003075668666776554,-0.0001389464815415217,0.0008948979457775356,-0.0002463261093916813,-0.00043207430340563846,-0.000276195390436218,1.0875454187283478,-0.4148708057252517,False,True,1.0832600000000001,1.09706,1.08596,1.08576,,False,2024-06-07 15:45:00,2024-06-07 15:36:04,,0.02,success,True,109.0,3583.620000000011,,21,0,23,6
2024-06-05 20:15:00,1.08642,1.0865,1.08606,1.0861399999999999,648,12,0,2024-06-05 20:00:00,2024-06-05 20:00:00,-0.000282976190475015,-0.0003058754308549183,1.086762380952381,-0.00010147219085833666,5.016882331069501e-05,1.0869122619047622,1.0869038177877082,1.0885036767631764,1.0870141188028857,1.0885330962269244,4.368998968804543e-05,-0.00010147067790278793,1.087485678377015,1.0874325627305559,26.814732456417065,28.449712725271848,-0.0001790874546715204,1.0865451924440708,1.0868530494384463,1.0859124045407635,-0.0003078569943755216,-0.00023205990406961085,0.0009062003089954802,-6.988648090877625e-05,-9.16546267628604e-05,-0.0001405779153764719,1.0871357749579074,-0.4153109658763803,False,True,1.08314,1.0969399999999998,1.08584,1.08564,,False,2024-06-07 15:45:00,2024-06-07 15:36:11,,0.02,success,True,109.0,3692.620000000011,,22,0,23,6
2024-06-05 20:30:00,1.08613,1.08627,1.0860400000000001,1.0861399999999999,428,12,0,2024-06-05 20:00:00,2024-06-05 20:00:00,-0.000282976190475015,-0.0003058754308549183,1.086762380952381,-0.00010147219085833666,5.016882331069501e-05,1.0869122619047622,1.0869038177877082,1.0885036767631764,1.0870141188028857,1.0885330962269244,4.368998968804543e-05,-0.00010147067790278793,1.087485678377015,1.0874325627305559,27.71215386784243,28.154776823607467,-0.0001790874546715204,1.086482855144983,1.0868002309615243,1.085868183694531,-0.00031737581654134317,-0.00024912308656395736,0.0009089550777441333,-4.422084623256772e-05,-6.988648090877625e-05,-9.16546267628604e-05,1.0870952730494856,-0.41535890566042366,False,True,1.08314,1.0969399999999998,1.08584,1.08564,,False,2024-06-07 15:45:00,2024-06-07 15:36:11,,0.02,success,True,109.0,3801.620000000011,,23,0,23,6
2024-06-06 05:30:00,1.08906,1.08938,1.08899,1.08937,444,12,0,2024-06-06 05:00:00,2024-06-06 05:00:00,0.0006165476190480579,0.00023950146975537656,1.0886401190476191,0.00020278473186726266,2.889684805707149e-05,1.0881378571428575,1.084288846154687,1.0890397452802334,1.0844762590304549,1.0890394714366298,1.9070028727382437e-05,0.00013928359721333545,1.0876585739297637,1.0876794927923306,89.16116272034986,89.06704781918944,-5.699742587639021e-05,1.0886016906923452,1.0880227183886935,1.0892252837977292,0.0005789723036517813,0.0004244501151397785,0.00090992820230853,0.00018682490539956298,0.00015456484348219668,0.00016979360165203516,2.5904536868708457,1.0879968807246128,True,False,1.0923699999999998,1.07857,1.08967,1.08987,,False,,,,0.02,running,False,0.0,3801.620000000011,2024-06-06 08:30:00,0,1,23,6
2024-06-06 05:45:00,1.08938,1.08952,1.08905,1.08912,421,12,0,2024-06-06 05:00:00,2024-06-06 05:00:00,0.0006165476190480579,0.00023950146975537656,1.0886401190476191,0.00020278473186726266,2.889684805707149e-05,1.0881378571428575,1.084288846154687,1.0890397452802334,1.0844762590304549,1.0890394714366298,1.9070028727382437e-05,0.00013928359721333545,1.0876585739297637,1.0876794927923306,89.19460227344241,89.13115697467263,-5.699742587639021e-05,1.0886814305858306,1.0881039985080496,1.0893234571723425,0.0005774320777809372,0.00045504650766801024,0.0009272274082929949,9.817337461326403e-05,0.00018682490539956298,0.00015456484348219668,2.590575214173538,1.0880717001711468,True,False,1.09212,1.08942,1.08942,1.08962,2024-06-07 05:45:00,True,2024-06-07 05:45:00,,2024-06-07 06:52:49,0.02,even,True,10.92,3812.540000000011,,1,0,23,6
2024-06-06 06:00:00,1.08911,1.08926,1.08899,1.08922,559,12,0,2024-06-06 06:00:00,2024-06-06 06:00:00,0.0005022619047616583,0.0003594725546085531,1.0889839285714285,0.00020882809140894648,2.8907848328494863e-05,1.0886401190476191,1.084483064239018,1.089071201124658,1.084288846154687,1.0890397452802334,2.889684805707149e-05,0.00020278473186726266,1.0877451175471984,1.0877851333689443,89.61797636596806,89.32458045325343,2.6296570220598448e-05,1.0887642874187797,1.0881866652852312,1.0894252081183349,0.0005776221335485054,0.0004795616328441093,0.0009403894583396644,0.00010175094599240708,9.817337461326403e-05,0.00018682490539956298,2.5906947338870934,1.0881556823495764,True,False,1.09222,1.08952,1.08952,1.08972,2024-06-07 10:15:00,True,2024-06-07 10:15:00,,2024-06-07 10:19:35,0.02,even,True,10.92,3823.460000000011,,2,0,23,6
2024-06-07 15:45:00,1.08321,1.08392,1.08233,1.0832600000000001,3062,12,0,2024-06-07 15:00:00,2024-06-07 15:00:00,0.00025226190476157484,0.0001509224395606079,1.0872520238095245,-0.000377159728774716,4.188386639897705e-05,1.0891747619047611,1.0884376912179319,1.0894846186076739,1.0884891957942773,1.0894392108246091,4.188693696319464e-05,-1.844667064580415e-05,1.088441996174088,1.0884567944846133,21.143295465598843,40.50612407986595,0.00018239766232370973,1.0875635899917002,1.088358674864071,1.0872640488476097,-0.0007950848723707882,-0.00021324729958253777,0.0016701894104227484,-0.0010298830409347648,-0.001121083591332006,4.7237702098357204e-05,1.0895188045516804,-0.4149907068564609,False,True,1.0802600000000002,1.0829600000000001,1.0829600000000001,1.0827600000000002,2024-06-07 16:15:00,True,2024-06-07 16:15:00,2024-06-07 19:58:24,2024-06-07 16:17:12,0.02,even,True,10.9,3834.360000000011,,3,0,23,6
2024-06-07 16:00:00,1.08324,1.08325,1.08206,1.08259,2491,12,0,2024-06-07 16:00:00,2024-06-07 16:00:00,-0.0019227380952366868,-0.0005255307657550112,1.0851676190476183,-0.00044538269965604575,-0.00010928448215722039,1.0872520238095245,1.0889226524289728,1.091649554391072,1.0884376912179319,1.0894846186076739,4.188386639897705e-05,-0.000377159728774716,1.0880179964209211,1.0879298509258442,8.038385940009837,22.28154158612305,4.081197670796555e-05,1.0867984223006695,1.0879313656148806,1.0861547609219129,-0.001132943314211099,-0.0003971865025082501,0.002064906938989856,-0.0011092879256968668,-0.0010298830409347648,-0.001121083591332006,1.0889423852895492,-0.4166328634457235,False,True,1.07959,1.08229,1.08229,1.08209,2024-06-07 17:00:00,True,2024-06-07 17:00:00,2024-06-10 00:00:02,2024-06-07 17:39:04,0.02,even,True,10.9,3845.260000000011,,4,0,23,6
2024-06-07 16:15:00,1.0826,1.08351,1.0825,1.083,1880,12,0,2024-06-07 16:00:00,2024-06-07 16:00:00,-0.0019227380952366868,-0.0005255307657550112,1.0851676190476183,-0.00044538269965604575,-0.00010928448215722039,1.0872520238095245,1.0889226524289728,1.091649554391072,1.0884376912179319,1.0894846186076739,4.188386639897705e-05,-0.000377159728774716,1.0880179964209211,1.0879298509258442,10.058865313741135,13.080182239783257,4.081197670796555e-05,1.086214049639028,1.0875660792730375,1.0852475266597876,-0.0013520296340094884,-0.0005881551288084978,0.002311878889566219,-0.0009072342621252449,-0.0011092879256968668,-0.0010298830409347648,1.088368563160702,-0.4178735098411268,False,True,1.08,1.0827,1.0827,1.0825,2024-06-07 16:45:00,True,2024-06-07 16:45:00,2024-06-07 22:25:48,2024-06-12 15:34:08,0.02,success,True,109.0,3954.260000000011,,5,0,23,6
2024-06-07 16:30:00,1.08299,1.08299,1.08221,1.08242,2029,12,0,2024-06-07 16:00:00,2024-06-07 16:00:00,-0.0019227380952366868,-0.0005255307657550112,1.0851676190476183,-0.00044538269965604575,-0.00010928448215722039,1.0872520238095245,1.0889226524289728,1.091649554391072,1.0884376912179319,1.0894846186076739,4.188386639897705e-05,-0.000377159728774716,1.0880179964209211,1.0879298509258442,7.568238213398572,8.555163155716501,4.081197670796555e-05,1.085630349694562,1.0871848882157753,1.084333742690059,-0.0015545385212132334,-0.0007814318072894449,0.00256865561465308,-0.0009137839697286321,-0.0009072342621252449,-0.0011092879256968668,1.0878014277698407,-0.4191339423897227,False,True,1.07942,1.08212,1.08212,1.08192,2024-06-07 17:00:00,True,2024-06-07 17:00:00,2024-06-10 00:00:02,2024-06-07 17:19:56,0.02,even,True,10.9,3965.160000000011,,6,0,23,6
2024-06-07 16:45:00,1.0824,1.08253,1.08171,1.0818699999999999,1619,12,0,2024-06-07 16:00:00,2024-06-07 16:00:00,-0.0019227380952366868,-0.0005255307657550112,1.0851676190476183,-0.00044538269965604575,-0.00010928448215722039,1.0872520238095245,1.0889226524289728,1.091649554391072,1.0884376912179319,1.0894846186076739,4.188386639897705e-05,-0.000377159728774716,1.0880179964209211,1.0879298509258442,6.010509761803445,7.879204429647704,4.081197670796555e-05,1.085051834356937,1.0867911927923846,1.0834464843481262,-0.00173935843544748,-0.0009730171329210519,0.00281389113743864,-0.0008872583419328173,-0.0009137839697286321,-0.0009072342621252449,1.0872452373836683,-0.42035226868741593,False,True,1.07887,1.08157,1.08157,1.08137,2024-06-07 17:15:00,True,2024-06-07 17:15:00,2024-06-10 00:00:02,2024-06-07 17:17:00,0.02,even,True,10.9,3976.0600000000113,,7,0,23,6
2024-06-07 17:00:00,1.08188,1.08206,1.08129,1.08133,1705,12,0,2024-06-07 17:00:00,2024-06-07 17:00:00,-0.002084404761906189,-0.0011346704937322816,1.083300476190476,-0.0004940172280664887,-0.00010929260641949104,1.0851676190476183,1.088968028644236,1.0915304512475759,1.0889226524289728,1.091649554391072,-0.00010928448215722039,-0.00044538269965604575,1.087576835361507,1.0873898628517769,2.2739998001806847,5.2842492584608864,-0.0001942845173800839,1.0844792444558697,1.0863866599929488,1.0825743997248012,-0.0019074155370790713,-0.0011598968137526559,0.0030562852179330377,-0.0008720846233249979,-0.0008872583419328173,-0.0009137839697286321,1.0867003847690109,-0.4215515853194085,False,True,1.07833,1.08103,1.08103,1.08083,2024-06-07 18:30:00,True,2024-06-07 18:30:00,2024-06-10 00:00:02,2024-06-07 19:28:58,0.02,even,True,10.9,3986.9600000000114,,8,0,23,6
2024-06-07 17:15:00,1.08134,1.08215,1.08123,1.08174,1407,12,0,2024-06-07 17:00:00,2024-06-07 17:00:00,-0.002084404761906189,-0.0011346704937322816,1.083300476190476,-0.0004940172280664887,-0.00010929260641949104,1.0851676190476183,1.088968028644236,1.0915304512475759,1.0889226524289728,1.091649554391072,-0.00010928448215722039,-0.00044538269965604575,1.087576835361507,1.0873898628517769,2.697427020661864,3.6606455275486507,-0.0001942845173800839,1.0840578222318897,1.086042462956434,1.0818847196422423,-0.0019846407245442954,-0.0013248455959109838,0.0032267450059396234,-0.0006896800825588745,-0.0008720846233249979,-0.0008872583419328173,1.086240825400261,-0.4224713861157763,False,True,1.07874,1.08144,1.08144,1.08124,2024-06-07 18:00:00,True,2024-06-07 18:00:00,2024-06-10 00:00:02,2024-06-12 15:32:07,0.02,success,True,109.0,4095.9600000000114,,9,0,23,6
2024-06-07 18:15:00,1.08117,1.08121,1.0805,1.0806499999999999,1310,12,0,2024-06-07 18:00:00,2024-06-07 18:00:00,-0.0018671428571421789,-0.0016044542440938336,1.0817173809523812,-0.0005084081259976587,-0.00010927612883648825,1.083300476190476,1.0885774795996872,1.0914110122571028,1.088968028644236,1.0915304512475759,-0.00010929260641949104,-0.0004940172280664887,1.0871260717897968,1.0868458738236348,2.9213699049906,4.71412968532104,-0.0004763184627228339,1.0826534825565313,1.084765268378535,1.0799192741658064,-0.0021117858220036645,-0.0017648734955580511,0.0037247460763597403,-0.0004488304093570594,-0.00044074303405650106,-0.0005634709322319686,1.084947681368892,-0.4251091330372794,False,True,1.07765,1.08035,1.08035,1.08015,2024-06-07 20:15:00,True,2024-06-07 20:15:00,2024-06-10 00:00:02,2024-06-07 20:51:48,0.02,even,True,10.9,4106.8600000000115,,10,0,23,6
2024-06-07 18:30:00,1.0806499999999999,1.08085,1.08035,1.08045,993,12,0,2024-06-07 18:00:00,2024-06-07 18:00:00,-0.0018671428571421789,-0.0016044542440938336,1.0817173809523812,-0.0005084081259976587,-0.00010927612883648825,1.083300476190476,1.0885774795996872,1.0914110122571028,1.088968028644236,1.0915304512475759,-0.00010929260641949104,-0.0004940172280664887,1.0871260717897968,1.0868458738236348,2.5021240486994443,3.6308697139459905,-0.0004763184627228339,1.0823144852401418,1.084445618869014,1.0795747334021333,-0.002131133628872073,-0.0018381255222208554,0.0037984052355373526,-0.0003445407636730735,-0.0004488304093570594,-0.00044074303405650106,1.0847025804701087,-0.42555311366584214,False,True,1.07745,1.0912499999999998,1.08015,1.07995,,False,2024-06-10 00:15:00,2024-06-10 00:00:02,,0.02,success,True,109.0,4215.8600000000115,,11,0,23,6
2024-06-07 18:45:00,1.08044,1.08088,1.0804,1.08059,751,12,0,2024-06-07 18:00:00,2024-06-07 18:00:00,-0.0018671428571421789,-0.0016044542440938336,1.0817173809523812,-0.0005084081259976587,-0.00010927612883648825,1.083300476190476,1.0885774795996872,1.0914110122571028,1.088968028644236,1.0915304512475759,-0.00010929260641949104,-0.0004940172280664887,1.0871260717897968,1.0868458738236348,1.702527374669222,2.375340442786408,-0.0004763184627228339,1.0820491798185816,1.084160017471309,1.079411155830754,-0.0021108376527274597,-0.0018926679483221762,0.0038292416568677236,-0.00016357757137930307,-0.0003445407636730735,-0.0004488304093570594,1.0845806320675253,-0.42575832040601735,False,True,1.07759,1.08029,1.08029,1.08009,2024-06-07 20:45:00,True,2024-06-07 20:45:00,2024-06-10 00:00:02,2024-06-07 20:51:38,0.02,even,True,10.9,4226.760000000011,,12,0,23,6
2024-06-07 20:00:00,1.08044,1.08046,1.08009,1.0801,532,12,0,2024-06-07 20:00:00,2024-06-07 20:00:00,-0.0011748809523819403,-0.0021660517016890424,1.0799016666666665,-0.0006464598156217526,-0.00023018371969263547,1.0805424999999993,1.0893055229522564,1.0924824155768758,1.0886040158390984,1.0912922804762737,-0.00010931894157649876,-0.0005459661776110685,1.0862905373311336,1.0858611316043245,5.288000717552753,10.03248787113146,-0.0010508833422653997,1.0811735776299642,1.083001566413264,1.0801600653594772,-0.0018279887832997055,-0.001902411010732718,0.003550338012080661,-0.00012409356725107124,0.00036191606467195214,0.00026811833505258065,1.0849530216757861,-0.42463289095683177,False,True,1.0771000000000002,1.0909,1.0798,1.0796000000000001,,False,2024-06-10 00:15:00,2024-06-10 00:00:02,,0.02,success,True,109.0,4335.760000000011,,13,0,23,6
2024-06-07 20:15:00,1.08012,1.08023,1.08003,1.08013,575,12,0,2024-06-07 20:00:00,2024-06-07 20:00:00,-0.0011748809523819403,-0.0021660517016890424,1.0799016666666665,-0.0006464598156217526,-0.00023018371969263547,1.0805424999999993,1.0893055229522564,1.0924824155768758,1.0886040158390984,1.0912922804762737,-0.00010931894157649876,-0.0005459661776110685,1.0862905373311336,1.0858611316043245,3.6839418849788994,7.133937436961496,-0.0010508833422653997,1.0810130272253544,1.082788857790059,1.0800943034055723,-0.0017758305647046502,-0.0018770949215271046,0.0034079657666548835,-6.576195390484152e-05,-0.00012409356725107124,0.00036191606467195214,1.0846950571905565,-0.4245064503794118,False,True,1.0771300000000001,1.09093,1.07983,1.07963,,False,2024-06-10 00:15:00,2024-06-10 00:00:02,,0.02,success,True,109.0,4444.760000000011,,14,0,23,6
2024-06-07 20:30:00,1.08011,1.08019,1.08003,1.08008,404,12,0,2024-06-07 20:00:00,2024-06-07 20:00:00,-0.0011748809523819403,-0.0021660517016890424,1.0799016666666665,-0.0006464598156217526,-0.00023018371969263547,1.0805424999999993,1.0893055229522564,1.0924824155768758,1.0886040158390984,1.0912922804762737,-0.00010931894157649876,-0.0005459661776110685,1.0862905373311336,1.0858611316043245,2.1609035198327824,3.710948707454797,-0.0010508833422653997,1.0808694845752997,1.082588201657462,1.0800063295493636,-0.0017187170821622022,-0.0018454193536541243,0.003199981145781692,-8.797385620873399e-05,-6.576195390484152e-05,-0.00012409356725107124,1.0843263040961688,-0.4243136449974416,False,True,1.07708,1.0908799999999998,1.07978,1.07958,,False,2024-06-10 00:15:00,2024-06-10 00:00:02,,0.02,success,True,109.0,4553.760000000011,,15,0,23,6
2024-06-07 22:15:00,1.08025,1.08043,1.07995,1.07997,707,12,0,2024-06-07 22:00:00,2024-06-07 22:00:00,-0.00014345238095248014,-0.002260482047871104,1.0800659523809524,-0.0007894288477251676,-0.0006337617751891104,1.079758214285714,1.0891208699010095,1.0954769778079054,1.0892399407755207,1.09402086094968,-0.00041369783771896064,-0.0007121462019112306,1.0855326346467051,1.0849944617899003,21.02339181287076,32.53155657815355,-0.001486176345568842,1.0804607695206683,1.0816321989012507,1.0801568145854832,-0.001171429380582456,-0.0014283707149046932,0.0008028113103497967,-4.005503956072687e-05,5.800825593427206e-05,6.284485724261657e-05,1.0812406098544554,-0.420926980683489,False,True,1.0769700000000002,1.09077,1.0796700000000001,1.0794700000000002,,False,2024-06-10 00:15:00,2024-06-10 00:00:08,,0.02,success,True,109.0,4662.760000000011,,16,0,23,6
2024-06-07 22:30:00,1.07997,1.08024,1.07996,1.08009,660,12,0,2024-06-07 22:00:00,2024-06-07 22:00:00,-0.00014345238095248014,-0.002260482047871104,1.0800659523809524,-0.0007894288477251676,-0.0006337617751891104,1.079758214285714,1.0891208699010095,1.0954769778079054,1.0892399407755207,1.09402086094968,-0.00041369783771896064,-0.0007121462019112306,1.0855326346467051,1.0849944617899003,10.584795321642005,22.636452241720505,-0.001486176345568842,1.08040372805595,1.0815179619456023,1.080157031303749,-0.0011142338896523718,-0.001365543349854229,0.0006819501448241238,2.1671826577751574e-07,-4.005503956072687e-05,5.800825593427206e-05,2.5810776639992614,1.0792363986082365,False,True,1.07709,1.09089,1.07979,1.07959,,False,2024-06-10 00:15:00,2024-06-10 00:00:02,,0.02,success,True,109.0,4771.760000000011,,17,0,23,6
2024-06-07 22:45:00,1.08012,1.08018,1.07996,1.07996,589,12,0,2024-06-07 22:00:00,2024-06-07 22:00:00,-0.00014345238095248014,-0.002260482047871104,1.0800659523809524,-0.0007894288477251676,-0.0006337617751891104,1.079758214285714,1.0891208699010095,1.0954769778079054,1.0892399407755207,1.09402086094968,-0.00041369783771896064,-0.0007121462019112306,1.0855326346467051,1.0849944617899003,4.722222222228088,12.110136452246936,-0.001486176345568842,1.0803354622011885,1.0814025573570392,1.080102057103544,-0.0010670951558506836,-0.00130585371105352,0.0006034185943652665,-5.497420020494914e-05,2.1671826577751574e-07,-4.005503956072687e-05,1.0809166722059371,-0.4207125579988491,False,True,1.0769600000000001,1.09076,1.07966,1.07946,,False,2024-06-10 00:15:00,2024-06-10 00:00:08,,0.02,success,True,109.0,4880.760000000011,,18,0,23,6
2024-06-10 00:00:00,1.07698,1.07761,1.07614,1.07684,242,19,0,2024-06-10 00:00:00,2024-06-10 00:00:00,2.5000000001274003e-06,-0.002199480879083726,1.079111666666666,-0.0006584016629393614,-0.0010583953050867546,1.0800684523809525,1.0865608821201478,1.096847500499444,1.08752721662707,1.0964131084036322,-0.0008486998623093029,-0.0006919558089565986,1.0846678935878036,1.0840116004589717,15.083598010432311,23.555604268063323,-0.001753508232105618,1.079702501698022,1.0807475168017908,1.0794840626074997,-0.0010450151037688649,-0.0010623032834815767,0.0007722255715524632,-0.0005959270725834909,3.304437564644047e-05,-4.110079119445942e-05,1.0805265671290956,-0.4215584419140961,False,True,1.0738400000000001,1.07654,1.07654,1.07634,2024-06-10 07:00:00,True,2024-06-10 07:00:00,2024-06-10 13:09:02,2024-06-10 10:53:26,0.02,even,True,10.9,4891.660000000011,,19,0,24,6
2024-06-10 01:00:00,1.07718,1.07775,1.07659,1.07659,509,12,0,2024-06-10 01:00:00,2024-06-10 01:00:00,-0.0009567857142864788,-0.0024162864244765547,1.0784758333333337,-0.0006361890196462592,-0.0011139706441720394,1.079111666666666,1.0857266517217417,1.0959867061081705,1.0865608821201478,1.096847500499444,-0.0010583953050867546,-0.0006584016629393614,1.0842157714208487,1.083503472422254,20.62084257206023,22.91204730229023,-0.0018860638705798052,1.0784184856048715,1.0797794095500715,1.0776558513931882,-0.0013609239451999322,-0.0011894270730254675,0.0013463353965586474,-0.0004981458548334317,-0.00041869625043000624,-0.00043345029239927335,1.0794734041785423,-0.4241617013921659,False,True,1.07359,1.07629,1.07629,1.07609,2024-06-10 07:00:00,True,2024-06-10 07:00:00,2024-06-10 13:26:40,2024-06-10 10:35:00,0.02,even,True,10.9,4902.56000000001,,20,0,24,6
2024-06-10 01:15:00,1.0765500000000001,1.07697,1.07644,1.07697,228,12,0,2024-06-10 01:00:00,2024-06-10 01:00:00,-0.0009567857142864788,-0.0024162864244765547,1.0784758333333337,-0.0006361890196462592,-0.0011139706441720394,1.079111666666666,1.0857266517217417,1.0959867061081705,1.0865608821201478,1.096847500499444,-0.0010583953050867546,-0.0006584016629393614,1.0842157714208487,1.083503472422254,17.516629711749022,21.212121212119417,-0.0018860638705798052,1.0781956416656606,1.079571305138955,1.0773148675610587,-0.0013756634732944306,-0.0012266743530792601,0.0014319209708267978,-0.00034098383212954886,-0.0004981458548334317,-0.00041869625043000624,1.0792479608716747,-0.42461822574955743,False,True,1.07397,1.07667,1.07667,1.07647,2024-06-10 06:45:00,True,2024-06-10 06:45:00,2024-06-10 13:04:38,2024-06-10 11:06:27,0.02,even,True,10.9,4913.46000000001,,21,0,24,6
2024-06-10 05:15:00,1.07721,1.07734,1.07715,1.07721,196,12,0,2024-06-10 05:00:00,2024-06-10 05:00:00,-0.00029000000000034554,-0.00224701050901821,1.077045119047618,-0.0006383878447665234,-0.0008278599959882978,1.077382023809524,1.0829808287427038,1.0908259944786893,1.0836718758662276,1.0917877053067995,-0.000855870599473471,-0.0006383811419153438,1.0826156057591647,1.0817651066012572,19.55520113414538,34.77432679503708,-0.0021545788878568057,1.077489741209168,1.0781024157104597,1.077512321981423,-0.0006126745012917656,-0.0007381708668729121,0.0009466004084955576,-6.81389748893313e-05,-5.831097351172154e-05,-2.934640522855858e-05,1.0787902325328922,-0.423765588570046,False,True,1.07421,1.07691,1.07691,1.07671,2024-06-10 06:00:00,True,2024-06-10 06:00:00,2024-06-10 12:54:12,2024-06-11 07:11:25,0.02,success,True,109.0,5022.46000000001,,22,0,24,6
2024-06-10 05:30:00,1.0772,1.07721,1.0768,1.07689,202,12,0,2024-06-10 05:00:00,2024-06-10 05:00:00,-0.00029000000000034554,-0.00224701050901821,1.077045119047618,-0.0006383878447665234,-0.0008278599959882978,1.077382023809524,1.0829808287427038,1.0908259944786893,1.0836718758662276,1.0917877053067995,-0.000855870599473471,-0.0006383811419153438,1.0826156057591647,1.0817651066012572,8.704998704993313,21.509572963806537,-0.0021545788878568057,1.0773974733308345,1.0780126071393146,1.077326047471619,-0.0006151338084801061,-0.0007135634551943509,0.0007975207416515298,-0.0001862745098040186,-6.81389748893313e-05,-5.831097351172154e-05,1.0784027004728487,-0.4237506055296105,False,True,1.07389,1.07659,1.07659,1.07639,2024-06-10 07:00:00,True,2024-06-10 07:00:00,2024-06-10 13:06:13,2024-06-10 11:02:06,0.02,even,True,10.9,5033.36000000001,,23,0,24,6
2024-06-10 05:45:00,1.0769,1.07699,1.0766,1.0767,267,12,0,2024-06-10 05:00:00,2024-06-10 05:00:00,-0.00029000000000034554,-0.00224701050901821,1.077045119047618,-0.0006383878447665234,-0.0008278599959882978,1.077382023809524,1.0829808287427038,1.0908259944786893,1.0836718758662276,1.0917877053067995,-0.000855870599473471,-0.0006383811419153438,1.0826156057591647,1.0817651066012572,7.896917896914894,12.052372578684514,-0.0021545788878568057,1.0772901697414754,1.0779153769808467,1.0771343446852417,-0.0006252072393713171,-0.0006958922120297442,0.0006474107403327243,-0.00019170278637736793,-0.0001862745098040186,-6.81389748893313e-05,1.0780083491846908,-0.42373965981420736,False,True,1.0737,1.0764,1.0764,1.0762,2024-06-10 07:00:00,True,2024-06-10 07:00:00,2024-06-10 13:15:44,2024-06-10 10:51:10,0.02,even,True,10.9,5044.260000000009,,24,0,24,6
2024-06-10 06:00:00,1.07669,1.07678,1.07647,1.07648,353,12,0,2024-06-10 06:00:00,2024-06-10 06:00:00,-0.000336904761905954,-0.0022152052828510183,1.0764572619047623,-0.0005164552373156007,-0.0008135473240684046,1.077045119047618,1.0811130057965361,1.0899254586034097,1.0829808287427038,1.0908259944786893,-0.0008278599959882978,-0.0006383878447665234,1.0821565344198638,1.0812638980731566,4.734413507418506,7.112110036442224,-0.0021667041668556484,1.0771655282427868,1.0778090527600432,1.076945913312694,-0.0006435245172564663,-0.0006854186730750886,0.00039174056044615646,-0.00018843137254775932,-0.00019170278637736793,-0.0001862745098040186,1.0774747630692962,-0.4235829364439083,False,True,1.0734800000000002,1.0761800000000001,1.0761800000000001,1.0759800000000002,2024-06-10 07:00:00,True,2024-06-10 07:00:00,2024-06-10 13:29:16,2024-06-10 10:33:37,0.02,even,True,10.9,5055.160000000009,,25,0,24,6
2024-06-10 06:15:00,1.07648,1.07661,1.07648,1.07653,269,12,0,2024-06-10 06:00:00,2024-06-10 06:00:00,-0.000336904761905954,-0.0022152052828510183,1.0764572619047623,-0.0005164552373156007,-0.0008135473240684046,1.077045119047618,1.0811130057965361,1.0899254586034097,1.0829808287427038,1.0908259944786893,-0.0008278599959882978,-0.0006383878447665234,1.0821565344198638,1.0812638980731566,3.653715064757917,5.428348823030425,-0.0021667041668556484,1.0770677546669734,1.077714308111151,1.0768041107671151,-0.0006465534441777443,-0.0006776456272956199,0.00041202750721123946,-0.00014180254557882854,-0.00018843137254775932,-0.00019170278637736793,1.0773603479018503,-0.42375212636762005,False,True,1.07353,1.07623,1.07623,1.07603,2024-06-10 07:00:00,True,2024-06-10 07:00:00,2024-06-10 13:27:09,2024-06-10 10:33:46,0.02,even,True,10.9,5066.060000000009,,26,0,24,6
2024-06-10 06:30:00,1.07652,1.07653,1.07635,1.07642,302,12,0,2024-06-10 06:00:00,2024-06-10 06:00:00,-0.000336904761905954,-0.0022152052828510183,1.0764572619047623,-0.0005164552373156007,-0.0008135473240684046,1.077045119047618,1.0811130057965361,1.0899254586034097,1.0829808287427038,1.0908259944786893,-0.0008278599959882978,-0.0006383878447665234,1.0821565344198638,1.0812638980731566,2.8989980836264926,3.762375551934291,-0.0021667041668556484,1.0769681001028235,1.0776184334362509,1.0766683660130718,-0.0006503333334273442,-0.0006721831685219647,0.0004488570671147194,-0.00013574475404332098,-0.00014180254557882854,-0.00018843137254775932,1.0772743230536768,-0.42393759102753314,False,True,1.07342,1.07612,1.07612,1.07592,2024-06-10 07:00:00,True,2024-06-10 07:00:00,2024-06-10 13:33:26,2024-06-10 10:29:02,0.02,even,True,10.9,5076.960000000008,,27,0,24,6
2024-06-10 06:45:00,1.07641,1.07642,1.07549,1.0755,514,12,0,2024-06-10 06:00:00,2024-06-10 06:00:00,-0.000336904761905954,-0.0022152052828510183,1.0764572619047623,-0.0005164552373156007,-0.0008135473240684046,1.077045119047618,1.0811130057965361,1.0899254586034097,1.0829808287427038,1.0908259944786893,-0.0008278599959882978,-0.0006383878447665234,1.0821565344198638,1.0812638980731566,2.830553527886629,3.1277555587569985,-0.0021667041668556484,1.076742238548543,1.077461512440973,1.0763757103543186,-0.0007192738924299835,-0.0006816013133035685,0.0005714259940701984,-0.00029265565875324917,-0.00013574475404332098,-0.00014180254557882854,1.0771471354463134,-0.42439571473767623,False,True,1.0725,1.0752,1.0752,1.075,2024-06-10 07:15:00,True,2024-06-10 07:15:00,2024-06-11 14:18:31,2024-06-10 07:24:40,0.02,even,True,10.9,5087.860000000008,,28,0,24,6
2024-06-10 07:00:00,1.0755,1.07552,1.07477,1.07479,648,12,0,2024-06-10 07:00:00,2024-06-10 07:00:00,-0.0005878571428556967,-0.0022718533911096905,1.0761086904761905,-0.0004409647380077963,-0.0004213013822568342,1.0764572619047623,1.0799084187583678,1.0834768301755149,1.0811130057965361,1.0899254586034097,-0.0008135473240684046,-0.0005164552373156007,1.0817186934895502,1.0807923862273041,1.8138646050222036,2.5144720721784277,-0.0021877340117064568,1.0764418941564595,1.0772636226305305,1.0759769246646032,-0.0008217284740710262,-0.0007096267454570601,0.0007475397425551783,-0.0003987856897154085,-0.00029265565875324917,-0.00013574475404332098,1.0769861033170527,-0.4250322539878464,False,True,1.07179,1.07449,1.07449,1.07429,2024-06-10 13:00:00,True,2024-06-10 13:00:00,,2024-06-10 14:21:36,0.02,even,True,10.9,5098.7600000000075,,29,0,24,6
2024-06-10 08:15:00,1.07501,1.07515,1.07474,1.07496,364,12,0,2024-06-10 08:00:00,2024-06-10 08:00:00,-0.0003485714285718089,-0.0022693668143227708,1.0756066666666662,-0.00035116301293035523,-0.00044493631266655134,1.0761086904761905,1.0787610587695455,1.0831829360705718,1.0799084187583678,1.0834768301755149,-0.0004213013822568342,-0.0004409647380077963,1.0813039390708696,1.0803521953291197,13.387512212448906,16.171490384947397,-0.0022040605722297196,1.0757034093715527,1.0765892342511716,1.0749548847609214,-0.0008858248796188573,-0.0008215303747720214,0.0010562390827999338,-0.00016201582387420643,-0.00020211214310350556,-0.00018580667354561875,1.0763808075227013,-0.4264710380008585,False,True,1.07196,1.07466,1.07466,1.07446,2024-06-10 13:00:00,True,2024-06-10 13:00:00,2024-06-11 16:50:38,2024-06-10 14:24:11,0.02,even,True,10.9,5109.660000000007,,30,0,24,6
2024-06-10 08:30:00,1.07497,1.07513,1.07474,1.07504,378,12,0,2024-06-10 08:00:00,2024-06-10 08:00:00,-0.0003485714285718089,-0.0022693668143227708,1.0756066666666662,-0.00035116301293035523,-0.00044493631266655134,1.0761086904761905,1.0787610587695455,1.0831829360705718,1.0799084187583678,1.0834768301755149,-0.0004213013822568342,-0.0004409647380077963,1.0813039390708696,1.0803521953291197,9.67970922407116,13.33398463510626,-0.0022040605722297196,1.0756013463913139,1.0764744761584923,1.0748534640522873,-0.0008731297671784599,-0.0008318502532533091,0.0010829322847563708,-0.00010142070863405905,-0.00016201582387420643,-0.00020211214310350556,1.0763154226367084,-0.4266084945321338,False,True,1.07204,1.07474,1.07474,1.07454,2024-06-10 13:00:00,True,2024-06-10 13:00:00,2024-06-11 16:29:19,2024-06-10 14:24:23,0.02,even,True,10.9,5120.560000000007,,31,0,24,6
2024-06-11 13:15:00,1.07476,1.07476,1.07415,1.07425,1163,12,0,2024-06-11 13:00:00,2024-06-11 13:00:00,-0.0004211904761908247,-0.00022890685590071236,1.074795476190477,-0.0001467784369035827,5.199372201078707e-05,1.075428452380952,1.0759350011817421,1.0766780386790888,1.0756027037789473,1.0764540279396078,6.508362573235332e-05,-0.00010176373564278664,1.0765359948850743,1.0761488510812822,21.380021805431642,22.186914898996918,-5.1720561802434624e-05,1.0751483653664462,1.0756988929124576,1.074460701754385,-0.0005505275460113701,-0.00037559970001374305,0.0009673747981190329,-0.0002436532507754663,-0.00015208806329503055,-0.00013895424836585235,1.0757666577318457,-0.4268452542230756,False,True,1.07125,1.07395,1.07395,1.07375,2024-06-11 14:15:00,True,2024-06-11 14:15:00,2024-06-14 10:15:25,2024-06-11 20:02:03,0.02,even,True,10.9,5131.460000000006,,32,0,24,6
2024-06-11 13:30:00,1.07424,1.07451,1.07384,1.07391,1034,12,0,2024-06-11 13:00:00,2024-06-11 13:00:00,-0.0004211904761908247,-0.00022890685590071236,1.074795476190477,-0.0001467784369035827,5.199372201078707e-05,1.075428452380952,1.0759350011817421,1.0766780386790888,1.0756027037789473,1.0764540279396078,6.508362573235332e-05,-0.00010176373564278664,1.0765359948850743,1.0761488510812822,11.821654106449229,19.76869786085358,-5.1720561802434624e-05,1.0749578476177621,1.0755663823263495,1.0742147884416922,-0.0006085347085873494,-0.0004221867017284643,0.0010378061797382827,-0.0002459133126928581,-0.0002436532507754663,-0.00015208806329503055,1.0756158267843388,-0.42718624990095444,False,True,1.07091,1.07361,1.07361,1.07341,2024-06-11 14:15:00,True,2024-06-11 14:15:00,2024-06-14 10:18:29,2024-06-11 16:10:07,0.02,even,True,10.9,5142.360000000006,,33,0,24,6
2024-06-11 13:45:00,1.07391,1.07411,1.07358,1.07403,1061,12,0,2024-06-11 13:00:00,2024-06-11 13:00:00,-0.0004211904761908247,-0.00022890685590071236,1.074795476190477,-0.0001467784369035827,5.199372201078707e-05,1.075428452380952,1.0759350011817421,1.0766780386790888,1.0756027037789473,1.0764540279396078,6.508362573235332e-05,-0.00010176373564278664,1.0765359948850743,1.0761488510812822,8.619958434874428,13.940544782251758,-5.1720561802434624e-05,1.0748151018304142,1.0754525762281013,1.0740560440316473,-0.0006374743976871322,-0.00046524424092019793,0.001083433277457992,-0.00015874441004481987,-0.0002459133126928581,-0.0002436532507754663,1.0755186789562157,-0.427406590892921,False,True,1.0710300000000001,1.07373,1.07373,1.07353,2024-06-11 14:15:00,True,2024-06-11 14:15:00,2024-06-14 10:18:09,2024-06-11 19:13:49,0.02,even,True,10.9,5153.260000000006,,34,0,24,6
2024-06-11 14:00:00,1.07405,1.07408,1.0728,1.07282,1150,12,0,2024-06-11 14:00:00,2024-06-11 14:00:00,-0.0006329761904750875,-0.00040241029402010575,1.0739359523809524,-0.00022085397059522333,1.1078521207621221e-05,1.074795476190477,1.0758515434090947,1.0771714978434808,1.0759350011817421,1.0766780386790888,5.199372201078707e-05,-0.0001467784369035827,1.0762975436021665,1.0758841429947796,5.580977560844958,8.674196700722861,-0.00012185850824596885,1.0745081630872735,1.0752575705815752,1.0737087616099077,-0.0007494074943017459,-0.0005220768915965076,0.0012154405237212933,-0.0003472824217396475,-0.00015874441004481987,-0.0002459133126928581,1.0753496063169314,-0.42793208309711606,False,True,1.0698200000000002,1.0725200000000001,1.0725200000000001,1.0723200000000002,2024-06-11 16:30:00,True,2024-06-11 16:30:00,2024-06-14 11:40:44,2024-06-11 16:38:55,0.02,even,True,10.9,5164.160000000005,,35,0,24,6
2024-06-11 15:15:00,1.07304,1.0732,1.07236,1.07274,1177,12,0,2024-06-11 15:00:00,2024-06-11 15:00:00,-0.0008595238095245872,-0.0006446494538552283,1.073420119047619,-0.00022084182196168648,-5.975011285325477e-05,1.0739359523809524,1.075613708482574,1.0778649216657583,1.0758515434090947,1.0771714978434808,1.1078521207621221e-05,-0.00022085397059522333,1.0760957665955753,1.0756670115551974,15.818936983650815,16.943113654080175,-0.00022641669736782075,1.0736276908354547,1.0745274505849607,1.072768720330238,-0.0008997597495059573,-0.0007543761258597414,0.0014490399120475096,-0.00013899552803509074,-0.00010742690058518356,-0.00023933952528398805,1.0747249242115022,-0.4291874835510261,False,True,1.0697400000000001,1.07244,1.07244,1.07224,2024-06-11 16:30:00,True,2024-06-11 16:30:00,2024-06-14 11:42:11,2024-06-11 16:32:28,0.02,even,True,10.9,5175.060000000005,,36,0,24,6
2024-06-11 16:15:00,1.07282,1.07294,1.07203,1.07221,1372,12,0,2024-06-11 16:00:00,2024-06-11 16:00:00,-0.000515833333333493,-0.0007595395037693908,1.072799166666667,-0.0002921744276827273,-0.00015412557648446527,1.073420119047619,1.076368703019163,1.078607513465143,1.075613708482574,1.0778649216657583,-5.975011285325477e-05,-0.00022084182196168648,1.0758528139119898,1.0754000506307817,15.65548233334752,22.00408704349663,-0.00033304125864813477,1.073237465128038,1.0740891147742653,1.072544441004471,-0.0008516496462271927,-0.0008013244657916873,0.001344244273452151,-0.00022337461300270256,-2.5135878914728238e-05,-8.74097007130814e-06,1.0743591707736315,-0.4292702887646893,False,True,1.0692100000000002,1.08301,1.0719100000000001,1.0717100000000002,,False,2024-06-14 10:15:00,2024-06-14 11:44:31,2024-06-12 16:27:04,0.02,fail,False,-392.42,4782.640000000005,,0,1,24,6
2024-06-11 16:30:00,1.0722,1.0729,1.07203,1.07278,1223,12,0,2024-06-11 16:00:00,2024-06-11 16:00:00,-0.000515833333333493,-0.0007595395037693908,1.072799166666667,-0.0002921744276827273,-0.00015412557648446527,1.073420119047619,1.076368703019163,1.078607513465143,1.075613708482574,1.0778649216657583,-5.975011285325477e-05,-0.00022084182196168648,1.0758528139119898,1.0754000506307817,16.046426760990986,19.096015229882706,-0.00033304125864813477,1.0731670858775706,1.0739921433095048,1.072521124871001,-0.000825057431934173,-0.0008060710590201845,0.001311858478155852,-2.3316133470174805e-05,-0.00022337461300270256,-2.5135878914728238e-05,1.0742921338165112,-0.42924988407450937,False,True,1.0697800000000002,1.07248,1.07248,1.0722800000000001,2024-06-11 18:00:00,True,2024-06-11 18:00:00,2024-06-14 11:42:10,2024-06-11 18:01:10,0.02,even,True,10.9,4793.5400000000045,,1,0,24,6
2024-06-11 17:45:00,1.07236,1.07258,1.07202,1.07218,1221,12,0,2024-06-11 17:00:00,2024-06-11 17:00:00,-0.0006209523809519446,-0.0009135489332465774,1.072412142857143,-0.0003025679995989464,-0.0002618470074821969,1.072799166666667,1.0761877429149505,1.0792467113725024,1.076368703019163,1.078607513465143,-0.00015412557648446527,-0.0002921744276827273,1.0756158581757325,1.0751424465803192,23.665265370467093,26.203482645194615,-0.0004491427935678233,1.0727160316722066,1.0734780228394318,1.0722958238734102,-0.0007619911672251956,-0.0007898512557591627,0.0009301464042713461,-4.154798761546452e-05,8.909528728118232e-07,1.1351909183776598e-06,1.0735515215191764,-0.4289598737723561,False,True,1.06918,1.0829799999999998,1.07188,1.07168,,False,2024-06-14 10:15:00,2024-06-14 11:44:31,2024-06-12 16:26:15,0.02,fail,False,-392.42,4401.120000000004,,0,1,24,6
2024-06-11 18:00:00,1.07216,1.07285,1.07213,1.07231,1210,12,0,2024-06-11 18:00:00,2024-06-11 18:00:00,-0.00038702380952404525,-0.0010141344910765682,1.072567142857143,-0.0003164768602003321,-0.0003423906509342537,1.072412142857143,1.0760359518232663,1.0794792983906196,1.0761877429149505,1.0792467113725024,-0.0002618470074821969,-0.0003025679995989464,1.0754580608740725,1.0749846508538938,23.31406551060014,25.408162864552366,-0.0005621411330695723,1.0726535652610978,1.0733915026291037,1.0722795356037151,-0.0007379373680058698,-0.0007794684782085042,0.000925357048231947,-1.6288269695019508e-05,-4.154798761546452e-05,8.909528728118232e-07,1.0735287676188283,-0.42896969641139804,False,True,1.0693100000000002,1.08311,1.0720100000000001,1.0718100000000002,,False,2024-06-14 09:45:00,2024-06-14 11:44:24,2024-06-12 16:28:31,0.02,fail,False,-392.42,4008.7000000000044,,0,2,24,6
2024-06-12 11:15:00,1.07514,1.07521,1.0748199999999999,1.07514,506,12,0,2024-06-12 11:00:00,2024-06-12 11:00:00,0.00014297619047565213,-1.0859687310738053e-05,1.0743669047619047,1.7765570683168795e-05,3.224250559862878e-05,1.074244285714286,1.0732351024886833,1.074802553575923,1.073171581826448,1.074944076731052,-2.0357343421197037e-05,2.0539659447238953e-05,1.0745300394264807,1.0743151100256627,90.4848439373402,78.49573218739535,-0.00015457512988971005,1.0744504567024196,1.0742328692197116,1.0746719263845885,0.00021758748270794825,0.00011754148347348906,0.0003817359471890644,0.00017283109735055646,0.00020452700378403854,6.790505675913217e-05,2.575187269913294,1.0741565828558832,True,False,1.0781399999999999,1.07544,1.07544,1.07564,2024-06-12 13:45:00,True,2024-06-12 13:45:00,2024-06-12 15:30:01,2024-06-13 18:48:03,0.02,success,True,109.18,4117.880000000005,,1,0,24,6
2024-06-12 11:30:00,1.07515,1.07532,1.0749,1.07493,661,12,0,2024-06-12 11:00:00,2024-06-12 11:00:00,0.00014297619047565213,-1.0859687310738053e-05,1.0743669047619047,1.7765570683168795e-05,3.224250559862878e-05,1.074244285714286,1.0732351024886833,1.074802553575923,1.073171581826448,1.074944076731052,-2.0357343421197037e-05,2.0539659447238953e-05,1.0745300394264807,1.0743151100256627,90.56492684670523,86.84496067652948,-0.00015457512988971005,1.074524232594355,1.07428450853677,1.0747871929824564,0.00023972405758487803,0.00014197799829576685,0.00041101622033225266,0.00011526659786786908,0.00017283109735055646,0.00020452700378403854,2.575342064879905,1.0742323210850078,True,False,1.0779299999999998,1.07523,1.07523,1.0754299999999999,2024-06-12 13:45:00,True,2024-06-12 13:45:00,2024-06-12 15:30:01,2024-06-13 19:01:00,0.02,success,True,109.18,4227.060000000005,,2,0,24,6
2024-06-12 12:15:00,1.07487,1.07532,1.07474,1.07516,674,12,0,2024-06-12 12:00:00,2024-06-12 12:00:00,0.00012261904761867726,4.415823771974914e-05,1.0746813095238097,1.5776383518117772e-05,3.072152520738065e-05,1.0743669047619047,1.073271084855861,1.0748493724887531,1.0732351024886833,1.074802553575923,3.224250559862878e-05,1.7765570683168795e-05,1.0745726175279982,1.0743851012236099,75.77413479052315,75.2005054997765,-0.00011482845636781822,1.074675600174368,1.0744096035099848,1.0749336601307191,0.0002659966643832057,0.0001930482577940786,0.00047116592976982906,7.770209838264819e-05,5.1355349157455876e-05,1.740970072261483e-05,2.5755697341359083,1.07429758612553,True,False,1.0781599999999998,1.0754599999999999,1.0754599999999999,1.0756599999999998,2024-06-12 14:00:00,True,2024-06-12 14:00:00,2024-06-12 15:30:01,2024-06-13 18:48:02,0.02,success,True,109.18,4336.240000000005,,3,0,24,6
2024-06-12 12:30:00,1.07515,1.0752,1.07481,1.07484,789,12,0,2024-06-12 12:00:00,2024-06-12 12:00:00,0.00012261904761867726,4.415823771974914e-05,1.0746813095238097,1.5776383518117772e-05,3.072152520738065e-05,1.0743669047619047,1.073271084855861,1.0748493724887531,1.0732351024886833,1.074802553575923,3.224250559862878e-05,1.7765570683168795e-05,1.0745726175279982,1.0743851012236099,80.32786885245547,75.8955676988421,-0.00011482845636781822,1.0747008924552346,1.0744414847314674,1.0749390712074298,0.0002594077237672021,0.0002063201509887033,0.00048175304881486536,5.411076710704066e-06,7.770209838264819e-05,5.1355349157455876e-05,2.57558943782333,1.0742887045915297,True,False,1.07784,1.07514,1.07514,1.07534,2024-06-12 13:45:00,True,2024-06-12 13:45:00,2024-06-12 15:30:01,2024-06-13 19:02:02,0.02,success,True,109.18,4445.4200000000055,,4,0,24,6
2024-06-12 12:45:00,1.07484,1.07521,1.07472,1.07519,532,12,0,2024-06-12 12:00:00,2024-06-12 12:00:00,0.00012261904761867726,4.415823771974914e-05,1.0746813095238097,1.5776383518117772e-05,3.072152520738065e-05,1.0743669047619047,1.073271084855861,1.0748493724887531,1.0732351024886833,1.074802553575923,3.224250559862878e-05,1.7765570683168795e-05,1.0745726175279982,1.0743851012236099,85.97449908925023,80.6921675774096,-0.00011482845636781822,1.074776139769814,1.0744969303069143,1.075010942552459,0.00027920946289961,0.00022089801337088464,0.0005096410501934182,7.187134502917303e-05,5.411076710704066e-06,7.770209838264819e-05,2.57569895797022,1.074322927134698,True,False,1.07819,1.07549,1.07549,1.07569,2024-06-12 14:00:00,True,2024-06-12 14:00:00,2024-06-12 15:30:04,2024-06-13 18:48:01,0.02,success,True,109.18,4554.600000000006,,5,0,24,6
2024-06-12 13:00:00,1.0752,1.07528,1.07484,1.07513,537,12,0,2024-06-12 13:00:00,2024-06-12 13:00:00,0.0003144047619050294,0.00014777166150103938,1.0751501190476191,1.5769313894247106e-05,6.567673735859152e-05,1.0746813095238097,1.0732881172707218,1.0748851573211544,1.073271084855861,1.0748493724887531,3.072152520738065e-05,1.5776383518117772e-05,1.0746511583326437,1.0744974931257212,85.42805100181901,83.91013964784156,-6.23084327940467e-05,1.0748305798052271,1.074543824358254,1.0750665669074648,0.0002867554469732081,0.00023406950009134935,0.0005244625821181692,5.56243550058344e-05,7.187134502917303e-05,5.411076710704066e-06,2.5757745913933245,1.0743585424216053,True,False,1.0781299999999998,1.0754299999999999,1.0754299999999999,1.0756299999999999,2024-06-12 13:45:00,True,2024-06-12 13:45:00,2024-06-12 15:30:01,2024-06-13 18:48:47,0.02,success,True,109.18,4663.780000000006,,6,0,24,6
2024-06-12 13:15:00,1.07513,1.07531,1.07504,1.0753,486,12,0,2024-06-12 13:00:00,2024-06-12 13:00:00,0.0003144047619050294,0.00014777166150103938,1.0751501190476191,1.5769313894247106e-05,6.567673735859152e-05,1.0746813095238097,1.0732881172707218,1.0748851573211544,1.073271084855861,1.0748493724887531,3.072152520738065e-05,1.5776383518117772e-05,1.0746511583326437,1.0744974931257212,93.80692167576991,88.40315725561304,-6.23084327940467e-05,1.0749027982967305,1.0745998373687535,1.0751780116959064,0.0003029609279769918,0.00024784778566847785,0.0005445190538831864,0.00011144478844160588,5.56243550058344e-05,7.187134502917303e-05,2.5759131124186485,1.0744429109731641,True,False,1.0782999999999998,1.0756,1.0756,1.0757999999999999,2024-06-12 14:15:00,True,2024-06-12 14:15:00,2024-06-12 15:30:04,2024-06-13 18:28:05,0.02,success,True,109.18,4772.960000000006,,7,0,24,6
2024-06-12 13:30:00,1.07531,1.07569,1.07518,1.07564,472,12,0,2024-06-12 13:00:00,2024-06-12 13:00:00,0.0003144047619050294,0.00014777166150103938,1.0751501190476191,1.5769313894247106e-05,6.567673735859152e-05,1.0746813095238097,1.0732881172707218,1.0748851573211544,1.073271084855861,1.0748493724887531,3.072152520738065e-05,1.5776383518117772e-05,1.0746511583326437,1.0744974931257212,95.4172876303959,91.55075343599493,-6.23084327940467e-05,1.0750162139433874,1.0746768864525496,1.07533002751978,0.0003393274908378707,0.00026614372670235643,0.000571667735701029,0.0001520158238734748,0.00011144478844160588,5.56243550058344e-05,2.5761017789629763,1.0745582760765835,True,False,1.0786399999999998,1.07594,1.07594,1.0761399999999999,2024-06-12 15:00:00,True,2024-06-12 15:00:00,2024-06-12 15:30:05,2024-06-13 18:26:52,0.02,success,True,109.18,4882.140000000007,,8,0,24,6
2024-06-12 13:45:00,1.07563,1.07595,1.07563,1.07579,556,12,0,2024-06-12 13:00:00,2024-06-12 13:00:00,0.0003144047619050294,0.00014777166150103938,1.0751501190476191,1.5769313894247106e-05,6.567673735859152e-05,1.0746813095238097,1.0732881172707218,1.0748851573211544,1.073271084855861,1.0748493724887531,3.072152520738065e-05,1.5776383518117772e-05,1.0746511583326437,1.0744974931257212,96.35047938792495,95.19156289803023,-6.23084327940467e-05,1.075135257952097,1.0747593393079162,1.0754927485380112,0.0003759186441807394,0.00028809871019803306,0.0005939775529214478,0.00016272101823133767,0.0001520158238734748,0.00011144478844160588,2.5762946182344555,1.0746908788415672,True,False,1.07879,1.07609,1.07609,1.07629,2024-06-12 15:00:00,True,2024-06-12 15:00:00,2024-06-12 15:30:05,2024-06-12 15:29:56,0.02,even,True,10.92,4893.060000000007,,9,0,24,6
2024-06-12 15:00:00,1.07636,1.07661,1.07614,1.07647,953,12,0,2024-06-12 15:00:00,2024-06-12 15:00:00,0.0005323809523805068,0.0004307651268291579,1.078096428571429,3.9849387001927186e-05,0.0005439608371764621,1.0756824999999997,1.073065698993836,1.0741960787036475,1.0733050239777868,1.0741211145169896,0.00014696752409539717,1.5771637662598168e-05,1.0752652280517727,1.0752804381816106,91.56039667206363,88.93582398070116,9.146340712397344e-05,1.075747422408834,1.075217677692724,1.0761596594427238,0.0005297447161098923,0.0004199085934955224,0.0007391183937905726,0.00012987616099113808,0.00013355005159887412,8.81286549705429e-05,2.577157469274341,1.0751618496111066,True,False,1.07947,1.0656700000000001,1.07677,1.07697,,False,2024-06-12 15:45:00,2024-06-12 15:30:06,,0.02,success,True,109.18,5002.240000000007,,10,0,24,6
2024-06-12 15:15:00,1.07645,1.07674,1.07598,1.07654,922,12,0,2024-06-12 15:00:00,2024-06-12 15:00:00,0.0005323809523805068,0.0004307651268291579,1.078096428571429,3.9849387001927186e-05,0.0005439608371764621,1.0756824999999997,1.073065698993836,1.0741960787036475,1.0733050239777868,1.0741211145169896,0.00014696752409539717,1.5771637662598168e-05,1.0752652280517727,1.0752804381816106,93.11127417090295,90.91380290487864,9.146340712397344e-05,1.0758693574228595,1.075315627493263,1.076284275885792,0.0005537299295965692,0.00044667286071573177,0.000781342434556878,0.00012461644306815955,0.00012987616099113808,0.00013355005159887412,2.577339088172444,1.0752294635991402,True,False,1.07954,1.0657400000000001,1.07684,1.07704,,False,2024-06-12 15:45:00,2024-06-12 15:30:10,,0.02,success,True,109.18,5111.420000000007,,11,0,24,6
2024-06-12 16:00:00,1.08258,1.08278,1.08183,1.08276,2332,12,0,2024-06-12 16:00:00,2024-06-12 16:00:00,0.0024139285714293024,0.0012149082661816468,1.0804447619047628,0.0003954361338789761,0.000583336019528346,1.078096428571429,1.0697209023504877,1.0742696016957483,1.073065698993836,1.0741960787036475,0.0005439608371764621,3.9849387001927186e-05,1.0758023101129486,1.0759452031270818,92.39186690937576,90.85652349559182,0.0003161523789355081,1.078415536973066,1.0767536076605313,1.0796433402132781,0.0016619293125346157,0.0008998945060696207,0.0024342214361137795,0.0010915789473688875,0.0011922807017543668,0.0010752046783628622,2.5829295391520315,1.0763571412745245,True,False,1.0857599999999998,1.08306,1.08306,1.08326,2024-06-12 16:30:00,True,2024-06-12 16:30:00,,2024-06-12 16:37:33,0.02,even,True,10.92,5122.340000000007,,12,0,24,6
2024-06-12 16:15:00,1.08278,1.0835,1.08237,1.08348,1849,12,0,2024-06-12 16:00:00,2024-06-12 16:00:00,0.0024139285714293024,0.0012149082661816468,1.0804447619047628,0.0003954361338789761,0.000583336019528346,1.078096428571429,1.0697209023504877,1.0742696016957483,1.073065698993836,1.0741960787036475,0.0005439608371764621,3.9849387001927186e-05,1.0758023101129486,1.0759452031270818,97.65489295906644,93.47292294123558,0.0003161523789355081,1.0791946851310557,1.0772518589449365,1.0807173374612997,0.0019428261861191842,0.0011084808420795335,0.0028015128056167256,0.0010739972480215965,0.0010915789473688875,0.0011922807017543668,2.584499379748882,1.0769352951737172,True,False,1.08648,1.08378,1.08378,1.08398,2024-06-12 17:30:00,True,2024-06-12 17:30:00,,2024-06-12 20:31:11,0.02,even,True,10.92,5133.2600000000075,,13,0,24,6
2024-06-12 16:30:00,1.08345,1.08366,1.0825,1.08314,2217,12,0,2024-06-12 16:00:00,2024-06-12 16:00:00,0.0024139285714293024,0.0012149082661816468,1.0804447619047628,0.0003954361338789761,0.000583336019528346,1.078096428571429,1.0697209023504877,1.0742696016957483,1.073065698993836,1.0741960787036475,0.0005439608371764621,3.9849387001927186e-05,1.0758023101129486,1.0759452031270818,97.14264784822997,95.72980257222405,0.0003161523789355081,1.0798016566493547,1.077688017541608,1.0816166288269689,0.0021136391077467565,0.0013095124952129781,0.0030539178661788953,0.0008992913656691304,0.0010739972480215965,0.0010915789473688875,2.5857394179463107,1.0774938397076272,True,False,1.0861399999999999,1.08344,1.08344,1.08364,2024-06-12 17:30:00,True,2024-06-12 17:30:00,,2024-06-12 21:00:01,0.02,even,True,10.92,5144.180000000008,,14,0,24,6
2024-06-12 16:45:00,1.0831,1.08365,1.08271,1.08359,1968,12,0,2024-06-12 16:00:00,2024-06-12 16:00:00,0.0024139285714293024,0.0012149082661816468,1.0804447619047628,0.0003954361338789761,0.000583336019528346,1.078096428571429,1.0697209023504877,1.0742696016957483,1.073065698993836,1.0741960787036475,0.0005439608371764621,3.9849387001927186e-05,1.0758023101129486,1.0759452031270818,97.6370329403539,97.47819124921676,0.0003161523789355081,1.0803844787033001,1.0781252014274147,1.082497887856896,0.002259277275885374,0.0014994654513474574,0.003284386903725792,0.000881259029927195,0.0008992913656691304,0.0010739972480215965,2.586931810176926,1.0780639655368662,True,False,1.08659,1.08389,1.08389,1.08409,2024-06-12 17:30:00,True,2024-06-12 17:30:00,,2024-06-12 20:30:13,0.02,even,True,10.92,5155.100000000008,,15,0,24,6
2024-06-12 17:45:00,1.08425,1.08489,1.08419,1.08472,1357,12,0,2024-06-12 17:00:00,2024-06-12 17:00:00,0.0023483333333338408,0.001839256405334444,1.0825670238095237,0.0005250587890214714,0.0006682358950041664,1.0804447619047628,1.0687062542354864,1.0741282508372214,1.0697209023504877,1.0742696016957483,0.000583336019528346,0.0003954361338789761,1.0763776449443712,1.0766471868769152,96.86908520374608,94.41463325412941,0.0006207731842152954,1.0821693761666265,1.07967506520495,1.084949545923632,0.0024943109616764048,0.0020370460187357155,0.003910418008349984,0.0005762745098027988,0.0006159683522533044,0.0007456518747857022,2.5902286102349046,1.0796704816123595,True,False,1.0877199999999998,1.07392,1.0850199999999999,1.0852199999999999,,False,,,2024-06-13 19:31:29,0.02,fail,False,-393.06,4762.040000000007,,0,1,24,6
2024-06-12 18:00:00,1.08473,1.08517,1.08446,1.08461,1309,12,0,2024-06-12 18:00:00,2024-06-12 18:00:00,0.002122261904760947,0.002351046318691097,1.0839216666666667,0.0005250879566887252,0.0007252442743253092,1.0825670238095237,1.0692668838892065,1.0739933417979408,1.0687062542354864,1.0741282508372214,0.0006682358950041664,0.0005250587890214714,1.0768810226898957,1.077249811926762,95.60550344697837,94.97640139200912,0.0009668278111104557,1.0825448567563762,1.0800406159305094,1.0853905263157888,0.002504240825866866,0.0021304849801619457,0.003988349407966503,0.00044098039215678675,0.0005762745098027988,0.0006159683522533044,2.5907747980165436,1.080006254615034,True,False,1.08761,1.0738100000000002,1.08491,1.08511,,False,,,2024-06-13 19:40:13,0.02,fail,False,-393.06,4368.980000000007,,0,2,24,6
2024-06-12 18:15:00,1.08462,1.08506,1.08435,1.08498,1142,12,0,2024-06-12 18:00:00,2024-06-12 18:00:00,0.002122261904760947,0.002351046318691097,1.0839216666666667,0.0005250879566887252,0.0007252442743253092,1.0825670238095237,1.0692668838892065,1.0739933417979408,1.0687062542354864,1.0741282508372214,0.0006682358950041664,0.0005250587890214714,1.0768810226898957,1.077249811926762,96.65708930922823,96.37722598665088,0.0009668278111104557,1.082919494178472,1.0804064962319533,1.0857756174750595,0.0025129979465188246,0.0022069875734333213,0.00405788996894022,0.0003850911592706563,0.00044098039215678675,0.0005762745098027988,2.5912537689331288,1.0802974660169902,True,False,1.08798,1.0741800000000001,1.08528,1.08548,,False,,,2024-06-13 19:22:00,0.02,fail,False,-393.06,3975.920000000007,,0,3,24,6
2024-06-13 13:45:00,1.08005,1.08014,1.07925,1.07936,660,12,0,2024-06-13 13:00:00,2024-06-13 13:00:00,-0.00016547619047635465,0.0001334574165201552,1.0801236904761902,-6.548683529880539e-05,-1.3041974864416796e-05,1.0804857142857138,1.0803052681234733,1.0817382055470872,1.0803294662661032,1.0840849455512716,-0.00018013443877544217,-2.9553965879329744e-05,1.0796617724196973,1.0799875490191821,21.09265489206556,25.980530912094764,0.0004326176951883457,1.0803423482794345,1.0805153777206353,1.0802470863433096,-0.00017302944120078934,-6.600072648731351e-05,0.00044326139770191076,-0.000274358445132572,-0.00014555899552659568,-2.4320605451766397e-06,1.080845489230207,-0.4203513165435879,False,True,1.0763600000000002,1.0790600000000001,1.0790600000000001,1.0788600000000002,2024-06-13 14:45:00,True,2024-06-13 14:45:00,2024-06-13 17:48:57,2024-06-13 15:21:24,0.02,even,True,10.9,3986.820000000007,,1,0,24,6
2024-06-13 14:00:00,1.07936,1.07941,1.07896,1.07932,643,12,0,2024-06-13 14:00:00,2024-06-13 14:00:00,-0.0003620238095236594,-1.658704472196071e-05,1.0794594047619055,-0.00013283960754186897,1.0667707157272865e-05,1.0801236904761902,1.080349763220349,1.0814439601150772,1.0803052681234733,1.0817382055470872,-1.3041974864416796e-05,-6.548683529880539e-05,1.0795713354893943,1.0798493450976476,8.820437342306523,19.45612559573893,0.0003427767472062844,1.0801850639287522,1.0804268312228105,1.0799935190918466,-0.00024176729405822606,-0.00010115404000149603,0.0005024413730571159,-0.00025356725146297165,-0.000274358445132572,-0.00014555899552659568,1.0806718149454737,-0.4206847767617805,False,True,1.0763200000000002,1.07902,1.07902,1.0788200000000001,2024-06-13 14:45:00,True,2024-06-13 14:45:00,2024-06-13 17:52:27,2024-06-13 15:21:21,0.02,even,True,10.9,3997.720000000007,,2,0,24,6
2024-06-13 14:15:00,1.07932,1.07961,1.07894,1.07905,655,12,0,2024-06-13 14:00:00,2024-06-13 14:00:00,-0.0003620238095236594,-1.658704472196071e-05,1.0794594047619055,-0.00013283960754186897,1.0667707157272865e-05,1.0801236904761902,1.080349763220349,1.0814439601150772,1.0803052681234733,1.0817382055470872,-1.3041974864416796e-05,-6.548683529880539e-05,1.0795713354893943,1.0798493450976476,7.680893159980722,12.531328464784265,0.0003427767472062844,1.0800104387089442,1.0803248437248245,1.079679466804266,-0.00031440501588031466,-0.00014380423517725975,0.000574741101157496,-0.0003140522875806351,-0.00025356725146297165,-0.000274358445132572,1.0804553672908286,-0.42109643368229666,False,True,1.0760500000000002,1.07875,1.07875,1.0785500000000001,2024-06-13 14:45:00,True,2024-06-13 14:45:00,2024-06-13 18:23:15,2024-06-13 14:54:35,0.02,even,True,10.9,4008.620000000007,,3,0,24,6
2024-06-13 14:30:00,1.07906,1.07906,1.07843,1.07849,797,12,0,2024-06-13 14:00:00,2024-06-13 14:00:00,-0.0003620238095236594,-1.658704472196071e-05,1.0794594047619055,-0.00013283960754186897,1.0667707157272865e-05,1.0801236904761902,1.080349763220349,1.0814439601150772,1.0803052681234733,1.0817382055470872,-1.3041974864416796e-05,-6.548683529880539e-05,1.0795713354893943,1.0798493450976476,6.825071071023693,7.775467191103641,0.0003427767472062844,1.0797765250614142,1.0801889293748375,1.0793407843137266,-0.00041240431342326467,-0.00019752425082646076,0.0006932296397010796,-0.00033868249053936594,-0.0003140522875806351,-0.00025356725146297165,1.080276644327323,-0.42159507569986987,False,True,1.07549,1.07819,1.07819,1.07799,2024-06-13 17:30:00,True,2024-06-13 17:30:00,2024-06-13 18:48:01,,0.02,success,True,109.0,4117.620000000007,,4,0,24,6
2024-06-13 14:45:00,1.0784799999999999,1.07876,1.07821,1.07826,718,12,0,2024-06-13 14:00:00,2024-06-13 14:00:00,-0.0003620238095236594,-1.658704472196071e-05,1.0794594047619055,-0.00013283960754186897,1.0667707157272865e-05,1.0801236904761902,1.080349763220349,1.0814439601150772,1.0803052681234733,1.0817382055470872,-1.3041974864416796e-05,-6.548683529880539e-05,1.0795713354893943,1.0798493450976476,2.7866540379288836,5.7642060896444285,0.0003427767472062844,1.0795432135135044,1.080046045717442,1.0789908634330925,-0.0005028322039375421,-0.00025858584144867704,0.0008101028741424156,-0.00034992088063412474,-0.00033868249053936594,-0.0003140522875806351,1.0800845023131846,-0.4221027754469997,False,True,1.07526,1.07796,1.07796,1.07776,2024-06-13 17:30:00,True,2024-06-13 17:30:00,2024-06-13 19:00:53,,0.02,success,True,109.0,4226.620000000007,,5,0,24,6
2024-06-13 17:15:00,1.07824,1.07869,1.07712,1.07745,1379,12,0,2024-06-13 17:00:00,2024-06-13 17:00:00,-0.0003572619047615966,-0.0003649697236975946,1.0780571428571435,-0.00029110664938444207,1.9954780936572686e-06,1.0788763095238096,1.0809264194181418,1.0815421033775676,1.0809245904759655,1.0815399155406233,1.9976580321130393e-06,-0.00019524046445984502,1.0793397563442264,1.079502446195397,11.038018119808449,29.71906625098545,2.69136180968018e-05,1.0790047051170688,1.079486516582268,1.0786594564843486,-0.00048181146519921114,-0.00036743469414517936,0.0009881846993502216,-0.0002971998623995109,-0.00016027519780004162,-8.738562091448188e-05,1.0799935058284713,-0.42267459285977416,False,True,1.0744500000000001,1.07715,1.07715,1.07695,2024-06-13 17:45:00,True,2024-06-13 17:45:00,2024-06-13 19:19:25,2024-06-13 18:00:19,0.02,even,True,10.9,4237.520000000007,,6,0,24,6
2024-06-13 17:30:00,1.07745,1.07747,1.07646,1.07671,1684,12,0,2024-06-13 17:00:00,2024-06-13 17:00:00,-0.0003572619047615966,-0.0003649697236975946,1.0780571428571435,-0.00029110664938444207,1.9954780936572686e-06,1.0788763095238096,1.0809264194181418,1.0815421033775676,1.0809245904759655,1.0815399155406233,1.9976580321130393e-06,-0.00019524046445984502,1.0793397563442264,1.079502446195397,6.337336285890501,16.002833839764598,2.69136180968018e-05,1.0786516735605967,1.0792808486872851,1.0782864637082912,-0.0006291751266884749,-0.0004197827806538385,0.0010975996538039753,-0.00037299277605740144,-0.0002971998623995109,-0.00016027519780004162,1.0797682232409265,-0.4231952958243441,False,True,1.0737100000000002,1.07641,1.07641,1.07621,2024-06-13 18:30:00,True,2024-06-13 18:30:00,2024-06-13 19:40:29,2024-06-13 18:35:21,0.02,even,True,10.9,4248.420000000006,,7,0,24,6
2024-06-13 18:30:00,1.07585,1.07659,1.07584,1.07596,1051,12,0,2024-06-13 18:00:00,2024-06-13 18:00:00,-0.000819166666666149,-0.0005922293411124713,1.0770588095238098,-0.00033472744054945395,1.9702527221793413e-06,1.0780571428571435,1.0806560898672097,1.0815445837679738,1.0809264194181418,1.0815421033775676,1.9954780936572686e-06,-0.00029110664938444207,1.0790907398058893,1.0791806504997654,6.369433255222113,8.504626830319616,-9.691497374505283e-05,1.0774970719722943,1.078497976028328,1.076914977640178,-0.0010009040560337024,-0.000695224641481332,0.001448691708646266,-0.00038744066047580183,-0.00045869969040279734,-0.0003139353285173119,1.0788707114468505,-0.4250407561664944,False,True,1.0729600000000001,1.07566,1.07566,1.07546,2024-06-13 19:15:00,True,2024-06-13 19:15:00,2024-06-14 08:58:16,,0.02,success,True,109.0,4357.420000000006,,8,0,24,6
2024-06-13 18:45:00,1.07594,1.07601,1.07527,1.07548,989,12,0,2024-06-13 18:00:00,2024-06-13 18:00:00,-0.000819166666666149,-0.0005922293411124713,1.0770588095238098,-0.00033472744054945395,1.9702527221793413e-06,1.0780571428571435,1.0806560898672097,1.0815445837679738,1.0809264194181418,1.0815421033775676,1.9954780936572686e-06,-0.00029110664938444207,1.0790907398058893,1.0791806504997654,4.728250788351408,6.868588365747283,-9.691497374505283e-05,1.077186753207326,1.078274422248452,1.0764650189198501,-0.0010876690411258938,-0.0007737135214102443,0.0015481628898045643,-0.0004499587203279365,-0.00038744066047580183,-0.00045869969040279734,1.0785550388210863,-0.425625000981386,False,True,1.07248,1.07518,1.07518,1.07498,2024-06-13 19:15:00,True,2024-06-13 19:15:00,2024-06-14 09:32:24,,0.02,success,True,109.0,4466.420000000006,,9,0,24,6
2024-06-13 19:00:00,1.07548,1.0755,1.07459,1.07461,1157,12,0,2024-06-13 19:00:00,2024-06-13 19:00:00,-0.0009983333333336564,-0.0009125019323841244,1.0756203571428573,-0.0004396346268108643,-6.378114558487901e-06,1.0770588095238098,1.0802870948074363,1.0816453958372392,1.0806560898672097,1.0815445837679738,1.9702527221793413e-06,-0.00033472744054945395,1.0787268211087353,1.0787221984597843,3.3348573621380635,4.81084713523719,-0.00026003236547286713,1.0767903296369683,1.0780029835633813,1.0758562745098046,-0.0012126539264130098,-0.0008615016024107974,0.001702192018164348,-0.0006087444100455475,-0.0004499587203279365,-0.00038744066047580183,1.0781542337343264,-0.4264416847147172,False,True,1.0716100000000002,1.07431,1.07431,1.0741100000000001,2024-06-13 19:45:00,True,2024-06-13 19:45:00,2024-06-14 09:38:15,2024-06-13 20:58:01,0.02,even,True,10.9,4477.320000000006,,10,0,24,6
2024-06-13 19:15:00,1.07462,1.07473,1.07403,1.0742,1010,12,0,2024-06-13 19:00:00,2024-06-13 19:00:00,-0.0009983333333336564,-0.0009125019323841244,1.0756203571428573,-0.0004396346268108643,-6.378114558487901e-06,1.0770588095238098,1.0802870948074363,1.0816453958372392,1.0806560898672097,1.0815445837679738,1.9702527221793413e-06,-0.00033472744054945395,1.0787268211087353,1.0787221984597843,2.069797070914468,3.3776350738013083,-0.00026003236547286713,1.076391817385127,1.077721281077205,1.0752098211214312,-0.0013294636920779812,-0.0009550940203442342,0.0018390237446455897,-0.0006464533883734358,-0.0006087444100455475,-0.0004499587203279365,1.0776925031767026,-0.4272728609338403,False,True,1.0712000000000002,1.0739,1.0739,1.0737,2024-06-13 19:45:00,True,2024-06-13 19:45:00,2024-06-14 10:17:10,2024-06-13 20:02:03,0.02,even,True,10.9,4488.220000000006,,11,0,24,6
2024-06-13 19:30:00,1.0742099999999999,1.07429,1.07353,1.07355,845,12,0,2024-06-13 19:00:00,2024-06-13 19:00:00,-0.0009983333333336564,-0.0009125019323841244,1.0756203571428573,-0.0004396346268108643,-6.378114558487901e-06,1.0770588095238098,1.0802870948074363,1.0816453958372392,1.0806560898672097,1.0815445837679738,1.9702527221793413e-06,-0.00033472744054945395,1.0787268211087353,1.0787221984597843,1.051665969100701,2.1521068007177395,-0.00026003236547286713,1.0759546147104921,1.0774122972937084,1.0745265393876848,-0.0014576825832162132,-0.00105561173291863,0.0019661024897086065,-0.0006832817337463215,-0.0006464533883734358,-0.0006087444100455475,1.0771807777487914,-0.42812769897342173,False,True,1.0705500000000001,1.07325,1.07325,1.07305,2024-06-14 09:00:00,True,2024-06-14 09:00:00,2024-06-14 10:46:41,,0.02,success,True,109.0,4597.220000000006,,12,0,24,6
2024-06-13 21:45:00,1.07399,1.074,1.07385,1.07388,373,12,0,2024-06-13 21:00:00,2024-06-13 21:00:00,-0.0008352380952389993,-0.0015173838033222253,1.0740971428571429,-0.0005193707241443237,-0.00022772785272195153,1.0747851190476183,1.0804507064018234,1.0837714137598422,1.0803135469908325,1.0824880906919905,-8.54604475473824e-05,-0.0004729775545522093,1.0781391015113908,1.0779997807763615,19.33109883490391,20.216992666233054,-0.0006838094109020251,1.0743875622858976,1.075670183216633,1.0733405951152393,-0.0012826209307355008,-0.0013587486289022331,0.0022826065510101723,3.3787409700059e-05,5.808393533013323e-05,-5.951152401983961e-07,2.576422113959103,1.0702590762713755,False,True,1.07088,1.07358,1.07358,1.07338,2024-06-14 09:00:00,True,2024-06-14 09:00:00,2024-06-14 10:18:36,,0.02,success,True,109.0,4706.220000000006,,13,0,24,6
2024-06-14 11:00:00,1.07069,1.07111,1.07025,1.07059,1615,12,0,2024-06-14 11:00:00,2024-06-14 11:00:00,-0.0009350000000010183,-0.0012120228957539503,1.0709280952380953,-0.0002844446647771334,-3.138604442857099e-05,1.0722295238095234,1.0734399336732603,1.0747650191354627,1.0732183224062475,1.075482668814037,-8.958063503031526e-05,-0.00016734341842906887,1.0749135599171613,1.0743801934283665,5.989282016741221,9.047716746116057,-0.0011386007846250475,1.0718609308101534,1.0726625104471101,1.0710909253525966,-0.0008015796369567063,-0.000551202824802221,0.001178636500394987,-0.00032266941864533827,-0.0003433298933599449,-0.0003166976264201704,1.07268208462813,-0.4305002339229367,False,True,1.06759,1.07029,1.07029,1.07009,2024-06-14 11:45:00,True,2024-06-14 11:45:00,2024-06-14 12:34:21,2024-06-14 14:30:44,0.02,success,True,109.0,4815.220000000006,,14,0,24,6
2024-06-14 11:15:00,1.07058,1.07084,1.07022,1.07029,1225,12,0,2024-06-14 11:00:00,2024-06-14 11:00:00,-0.0009350000000010183,-0.0012120228957539503,1.0709280952380953,-0.0002844446647771334,-3.138604442857099e-05,1.0722295238095234,1.0734399336732603,1.0747650191354627,1.0732183224062475,1.075482668814037,-8.958063503031526e-05,-0.00016734341842906887,1.0749135599171613,1.0743801934283665,5.755485376948897,7.601984496428616,-0.0011386007846250475,1.0716192491470529,1.0724867689325093,1.0707762917096662,-0.0008675197854564054,-0.0006144662169330579,0.0012722798434559209,-0.00031463364293049523,-0.00032266941864533827,-0.0003433298933599449,1.0724938694983317,-0.4309412860789994,False,True,1.06729,1.06999,1.06999,1.06979,2024-06-14 11:45:00,True,2024-06-14 11:45:00,2024-06-14 12:37:55,2024-06-14 14:19:35,0.02,success,True,109.0,4924.220000000006,,15,0,24,6
2024-06-14 11:30:00,1.07028,1.07043,1.06914,1.06919,1404,12,0,2024-06-14 11:00:00,2024-06-14 11:00:00,-0.0009350000000010183,-0.0012120228957539503,1.0709280952380953,-0.0002844446647771334,-3.138604442857099e-05,1.0722295238095234,1.0734399336732603,1.0747650191354627,1.0732183224062475,1.075482668814037,-8.958063503031526e-05,-0.00016734341842906887,1.0749135599171613,1.0743801934283665,4.358086244822494,5.367617879504205,-0.0011386007846250475,1.0712455185090448,1.0722425638263975,1.0702950808393537,-0.0009970453173526739,-0.0006909820370169812,0.0014427418341703632,-0.00048121087031249843,-0.00031463364293049523,-0.00032266941864533827,1.0722427823154836,-0.43165262063677634,False,True,1.0661900000000002,1.0688900000000001,1.0688900000000001,1.0686900000000001,2024-06-14 12:15:00,True,2024-06-14 12:15:00,,2024-06-14 13:20:11,0.02,even,True,10.9,4935.120000000005,,16,0,24,6
2024-06-14 11:45:00,1.06923,1.06942,1.0688900000000001,1.06913,1380,12,0,2024-06-14 11:00:00,2024-06-14 11:00:00,-0.0009350000000010183,-0.0012120228957539503,1.0709280952380953,-0.0002844446647771334,-3.138604442857099e-05,1.0722295238095234,1.0734399336732603,1.0747650191354627,1.0732183224062475,1.075482668814037,-8.958063503031526e-05,-0.00016734341842906887,1.0749135599171613,1.0743801934283665,2.7320098019557313,4.281860474575708,-0.0011386007846250475,1.070920054123038,1.0720120035429606,1.0698715548675608,-0.0010919494199226332,-0.0007711755135981117,0.0015708815996332561,-0.00042352597179284857,-0.00048121087031249843,-0.00031463364293049523,1.0719922450270658,-0.4322491352919442,False,True,1.06613,1.06883,1.06883,1.06863,2024-06-14 12:15:00,True,2024-06-14 12:15:00,,2024-06-14 13:19:48,0.02,even,True,10.9,4946.020000000005,,17,0,24,6
2024-06-14 12:00:00,1.06913,1.06916,1.06793,1.06809,1404,12,0,2024-06-14 12:00:00,2024-06-14 12:00:00,-0.0013014285714281204,-0.0014926318046233344,1.0698066666666672,-0.00040238386029998476,-0.00011767819930984797,1.0709280952380953,1.0735315521972082,1.0755601319018075,1.0734399336732603,1.0747650191354627,-3.138604442857099e-05,-0.0002844446647771334,1.0745094592773445,1.0739217779540973,3.009765974554664,3.36662067377763,-0.0012094069886247048,1.0704846611810321,1.0717214847620005,1.0693119607843122,-0.001236823580968327,-0.0008643051270721548,0.0017547103274902578,-0.0005595940832485713,-0.00042352597179284857,-0.00048121087031249843,1.071680819726424,-0.4330568981577996,False,True,1.06509,1.06779,1.06779,1.06759,2024-06-14 16:30:00,True,2024-06-14 16:30:00,,2024-06-14 16:40:52,0.02,even,True,10.9,4956.920000000005,,18,0,24,6
2024-06-14 16:15:00,1.06847,1.06866,1.06732,1.0673300000000001,1507,12,0,2024-06-14 16:00:00,2024-06-14 16:00:00,-0.0002626190476189283,-0.0016846204480578386,1.0680652380952382,-0.0005410750459127693,-0.00042785553808620557,1.0687983333333329,1.0734325516534031,1.0768498799107626,1.072947740454837,1.0766454255695554,-0.00034883248954972,-0.00045796353371694193,1.0731276499691287,1.0724092302961985,26.897237545469764,38.0072308132902,-0.001491226372791103,1.0687460320997224,1.0695676685600344,1.0688412727898182,-0.0008216364603119697,-0.0008309173292881193,0.001083664616051161,-0.0002668730650154938,-6.122119023110884e-05,9.012383901030319e-05,1.0703042200214874,-0.43262167444185096,False,True,1.0643300000000002,1.07813,1.0670300000000001,1.0668300000000002,,False,,,,0.02,running,False,0.0,4956.920000000005,2024-06-14 19:15:00,0,1,24,6
2024-06-14 16:30:00,1.06734,1.06789,1.06682,1.06735,1937,12,0,2024-06-14 16:00:00,2024-06-14 16:00:00,-0.0002626190476189283,-0.0016846204480578386,1.0680652380952382,-0.0005410750459127693,-0.00042785553808620557,1.0687983333333329,1.0734325516534031,1.0768498799107626,1.072947740454837,1.0766454255695554,-0.00034883248954972,-0.00045796353371694193,1.0731276499691287,1.0724092302961985,14.615482105817627,27.73935707728153,-0.001491226372791103,1.0685312579305344,1.0694033968148466,1.0685108427932573,-0.0008721388843122568,-0.0008391616402929469,0.0010223502335707296,-0.00033042999656096583,-0.0002668730650154938,-6.122119023110884e-05,1.0698910156085777,-0.4328693300220632,False,True,1.0643500000000001,1.06705,1.06705,1.06685,2024-06-14 17:00:00,True,2024-06-14 17:00:00,,2024-06-14 17:00:06,0.02,even,True,10.9,4967.820000000004,,1,0,24,6
2024-06-14 16:45:00,1.06735,1.06752,1.0667,1.06684,1497,12,0,2024-06-14 16:00:00,2024-06-14 16:00:00,-0.0002626190476189283,-0.0016846204480578386,1.0680652380952382,-0.0005410750459127693,-0.00042785553808620557,1.0687983333333329,1.0734325516534031,1.0768498799107626,1.072947740454837,1.0766454255695554,-0.00034883248954972,-0.00045796353371694193,1.0731276499691287,1.0724092302961985,6.100581930098073,15.871100527128489,-0.001491226372791103,1.0682710644027598,1.0692135155693023,1.068087278981768,-0.0009424511665425683,-0.0008598195455428712,0.001036617576584006,-0.00042356381148933586,-0.00033042999656096583,-0.0002668730650154938,1.0694867127101564,-0.43331215474662055,False,True,1.0638400000000001,1.07764,1.06654,1.06634,,False,,,,0.02,running,False,0.0,4967.820000000004,2024-06-14 19:45:00,0,1,24,6
2024-06-17 12:15:00,1.07122,1.07122,1.07063,1.07105,914,12,0,2024-06-17 12:00:00,2024-06-17 12:00:00,0.0001985714285712703,-0.00010080626238107016,1.0704467857142859,-6.396335302371537e-05,4.75827818433113e-05,1.0701642857142855,1.069395819276616,1.0706290738132151,1.0694643388853073,1.0706613476425368,3.1809385318214584e-05,-6.396979462278432e-05,1.0709862512533932,1.0706483276280763,89.25732455144414,88.1966525348884,-0.00024778099838924987,1.0705837925105903,1.0703757329232355,1.0707691503267966,0.0002080595873548141,7.533905593157182e-05,0.000500490426225223,0.00016845545235577575,0.0002233642930855595,0.00011589611283069345,2.5714448124022007,1.0700934882513926,True,False,1.07405,1.07135,1.07135,1.07155,2024-06-17 16:15:00,True,2024-06-17 16:15:00,2024-06-18 02:57:12,2024-06-17 16:25:00,0.02,even,True,10.92,4978.740000000004,,1,0,25,6
2024-06-17 12:30:00,1.07102,1.07139,1.07093,1.07103,833,12,0,2024-06-17 12:00:00,2024-06-17 12:00:00,0.0001985714285712703,-0.00010080626238107016,1.0704467857142859,-6.396335302371537e-05,4.75827818433113e-05,1.0701642857142855,1.069395819276616,1.0706290738132151,1.0694643388853073,1.0706613476425368,3.1809385318214584e-05,-6.396979462278432e-05,1.0709862512533932,1.0706483276280763,91.31652661064383,89.76376586670739,-0.00024778099838924987,1.0706524398166533,1.070424197151144,1.0709157069143447,0.00022824266550935945,0.00010591977784712935,0.0005226416874012202,0.00014655658754803014,0.00016845545235577575,0.0002233642930855595,2.5716212731923362,1.0702101406363531,True,False,1.0740299999999998,1.07133,1.07133,1.0715299999999999,2024-06-17 16:15:00,True,2024-06-17 16:15:00,2024-06-18 02:48:26,2024-06-17 16:44:22,0.02,even,True,10.92,4989.660000000004,,2,0,25,6
2024-06-17 14:00:00,1.07094,1.0715,1.07086,1.07102,684,12,0,2024-06-17 14:00:00,2024-06-17 14:00:00,0.00022916666666650265,6.89522711223578e-05,1.07084369047619,-0.00010121320415827451,6.323239843159312e-05,1.0706759523809524,1.0696546765951995,1.0706986169735662,1.069822850936223,1.0706799806552298,4.7585002447549155e-05,-0.00010633632236578192,1.0709778535942807,1.0706898645044038,74.88791793313207,66.82771867612192,-0.00014379384902010668,1.0707287679653432,1.0705473291782548,1.0710383969728248,0.0001814387870884282,0.0001602890268473235,0.0005731410530945976,3.528723770340747e-05,8.032335740759677e-06,-5.792225662304418e-05,2.5718121373945024,1.070264656551147,True,False,1.07402,1.07132,1.07132,1.07152,2024-06-17 14:45:00,True,2024-06-17 14:45:00,2024-06-18 02:48:26,2024-06-17 14:46:36,0.02,even,True,10.92,5000.5800000000045,,3,0,25,6
2024-06-17 14:15:00,1.07101,1.07161,1.07099,1.0715,586,12,0,2024-06-17 14:00:00,2024-06-17 14:00:00,0.00022916666666650265,6.89522711223578e-05,1.07084369047619,-0.00010121320415827451,6.323239843159312e-05,1.0706759523809524,1.0696546765951995,1.0706986169735662,1.069822850936223,1.0706799806552298,4.7585002447549155e-05,-0.00010633632236578192,1.0709778535942807,1.0706898645044038,84.4996208014136,75.1033859273877,-0.00014379384902010668,1.070847419047598,1.0706178973872729,1.0711287856897151,0.00022952166032519372,0.00017413555354289757,0.0006126276738297895,9.03887168903772e-05,3.528723770340747e-05,8.032335740759677e-06,2.5719558330493855,1.0703017383300448,True,False,1.0744999999999998,1.0717999999999999,1.0717999999999999,1.0719999999999998,2024-06-17 18:15:00,True,2024-06-17 18:15:00,2024-06-18 16:49:48,2024-06-17 18:40:03,0.02,even,True,10.92,5011.500000000005,,4,0,25,6
2024-06-17 14:30:00,1.0715,1.07171,1.07123,1.07152,817,12,0,2024-06-17 14:00:00,2024-06-17 14:00:00,0.00022916666666650265,6.89522711223578e-05,1.07084369047619,-0.00010121320415827451,6.323239843159312e-05,1.0706759523809524,1.0696546765951995,1.0706986169735662,1.069822850936223,1.0706799806552298,4.7585002447549155e-05,-0.00010633632236578192,1.0709778535942807,1.0706898645044038,87.01326957302551,82.1336027691904,-0.00014379384902010668,1.0709508930402754,1.0706847198030305,1.0711906329549363,0.0002661732372448711,0.00019254309028329228,0.0006484404367983163,6.184726522118211e-05,9.03887168903772e-05,3.528723770340747e-05,2.572066027544614,1.0703152383652585,True,False,1.07452,1.07182,1.07182,1.07202,2024-06-17 18:15:00,True,2024-06-17 18:15:00,2024-06-18 16:49:50,2024-06-17 18:39:31,0.02,even,True,10.92,5022.420000000005,,5,0,25,6
2024-06-17 16:00:00,1.07131,1.0719,1.07131,1.07181,1018,12,0,2024-06-17 16:00:00,2024-06-17 16:00:00,0.00027559523809506103,0.0001711383289759727,1.0713573809523809,1.2976198270656977e-05,7.407990353856522e-05,1.071119285714285,1.0684700350447849,1.07083491652432,1.0691132287279042,1.0707662620733176,6.323815024386078e-05,-5.585883716608726e-05,1.0710342090247555,1.0708035813165275,74.09163288940017,69.00011259087638,-4.1168063557046165e-05,1.0711823451653717,1.0709052875079144,1.0713310423116604,0.0002770576574573358,0.00023500102353252322,0.0005373856468184128,0.00014089439284337146,5.5603715171104184e-05,-1.5823873409370748e-05,2.572056512934865,1.0706055716884555,True,False,1.0748099999999998,1.07211,1.07211,1.0723099999999999,2024-06-17 19:15:00,True,2024-06-17 19:15:00,2024-06-18 16:52:25,2024-06-17 19:20:01,0.02,even,True,10.92,5033.340000000005,,6,0,25,6
2024-06-17 16:15:00,1.07181,1.07202,1.07134,1.07164,965,12,0,2024-06-17 16:00:00,2024-06-17 16:00:00,0.00027559523809506103,0.0001711383289759727,1.0713573809523809,1.2976198270656977e-05,7.407990353856522e-05,1.071119285714285,1.0684700350447849,1.07083491652432,1.0691132287279042,1.0707662620733176,6.323815024386078e-05,-5.585883716608726e-05,1.0710342090247555,1.0708035813165275,82.8529826657907,74.74940829900542,-4.1168063557046165e-05,1.0712527536014684,1.0709597106554762,1.0714030065359477,0.0002930429459921946,0.0002466094080244575,0.0004982562928914848,7.196422428723537e-05,0.00014089439284337146,5.5603715171104184e-05,2.572075652531351,1.0707303605405443,True,False,1.0746399999999998,1.07194,1.07194,1.0721399999999999,2024-06-17 18:15:00,True,2024-06-17 18:15:00,2024-06-18 16:51:25,2024-06-17 18:38:21,0.02,even,True,10.92,5044.260000000005,,7,0,25,6
2024-06-17 16:30:00,1.07165,1.07189,1.07119,1.07129,1350,12,0,2024-06-17 16:00:00,2024-06-17 16:00:00,0.00027559523809506103,0.0001711383289759727,1.0713573809523809,1.2976198270656977e-05,7.407990353856522e-05,1.071119285714285,1.0684700350447849,1.07083491652432,1.0691132287279042,1.0707662620733176,6.323815024386078e-05,-5.585883716608726e-05,1.0710342090247555,1.0708035813165275,78.6146034816217,78.51973967893753,-4.1168063557046165e-05,1.071258483816627,1.0709841765328483,1.0714479807361545,0.0002743072837787519,0.0002521489831753164,0.0004970747764731105,4.497420020688203e-05,7.196422428723537e-05,0.00014089439284337146,2.572119031684393,1.070776929787916,True,False,1.07429,1.07159,1.07159,1.07179,2024-06-17 18:15:00,True,2024-06-17 18:15:00,2024-06-18 16:46:22,2024-06-18 11:34:46,0.02,even,True,10.92,5055.180000000005,,8,0,25,6
2024-06-17 18:00:00,1.07152,1.0722,1.07146,1.07218,775,12,0,2024-06-17 18:00:00,2024-06-17 18:00:00,0.00010607142857121943,0.0002813602808835469,1.071712619047619,0.00018564479552191402,0.00010821544475288185,1.071463452380952,1.0674042113882896,1.0706680727470324,1.0678159101641793,1.0706761168923846,9.004329969700162e-05,0.00010320536755898136,1.071136763569011,1.070965559226309,73.24414715719111,63.42848547817715,6.850693007705247e-05,1.0715022145207462,1.071216840863468,1.0716664017887856,0.00028537365727832054,0.00025878916328865825,0.0004077343907548445,0.00010078087375342548,-2.698658410804633e-05,-1.5493636051466808e-05,2.572216843216305,1.0711159603612666,True,False,1.0751799999999998,1.0724799999999999,1.0724799999999999,1.0726799999999999,2024-06-17 21:15:00,True,2024-06-17 21:15:00,2024-06-18 17:19:36,2024-06-18 05:22:15,0.02,even,True,10.92,5066.100000000005,,9,0,25,6
2024-06-17 18:15:00,1.07216,1.07241,1.07203,1.07212,711,12,0,2024-06-17 18:00:00,2024-06-17 18:00:00,0.00010607142857121943,0.0002813602808835469,1.071712619047619,0.00018564479552191402,0.00010821544475288185,1.071463452380952,1.0674042113882896,1.0706680727470324,1.0678159101641793,1.0706761168923846,9.004329969700162e-05,0.00010320536755898136,1.071136763569011,1.070965559226309,82.27550718338959,71.56613276731252,6.850693007705247e-05,1.0715972584406315,1.071283741540248,1.0717635225318194,0.00031351690038339264,0.0002697347107076051,0.00044476135931233174,9.712074303380724e-05,0.00010078087375342548,-2.698658410804633e-05,2.572363950366891,1.0711630946967476,True,False,1.0751199999999999,1.07242,1.07242,1.07262,2024-06-17 21:15:00,True,2024-06-17 21:15:00,2024-06-18 17:19:13,2024-06-18 05:22:53,0.02,even,True,10.92,5077.020000000005,,10,0,25,6
2024-06-17 18:30:00,1.07213,1.07223,1.07163,1.07195,722,12,0,2024-06-17 18:00:00,2024-06-17 18:00:00,0.00010607142857121943,0.0002813602808835469,1.071712619047619,0.00018564479552191402,0.00010821544475288185,1.071463452380952,1.0674042113882896,1.0706680727470324,1.0678159101641793,1.0706761168923846,9.004329969700162e-05,0.00010320536755898136,1.071136763569011,1.070965559226309,85.44835578733169,80.32267004263747,6.850693007705247e-05,1.0716515263728421,1.0713330940187482,1.0718171241830068,0.00031843235409390047,0.0002794742393848642,0.0004625177474834338,5.3601651187396016e-05,9.712074303380724e-05,0.00010078087375342548,2.5724415231421096,1.0711927252239042,True,False,1.0749499999999999,1.07225,1.07225,1.07245,2024-06-17 19:30:00,True,2024-06-17 19:30:00,2024-06-18 17:18:47,2024-06-17 19:40:23,0.02,even,True,10.92,5087.940000000005,,11,0,25,6
2024-06-17 19:15:00,1.07235,1.07257,1.072,1.07256,530,12,0,2024-06-17 19:00:00,2024-06-17 19:00:00,0.0002491666666668557,0.0003722195779922721,1.0720213095238103,0.0002491267208960724,0.00014687232098883665,1.071712619047619,1.06726836687351,1.0703603260775234,1.0674042113882896,1.0706680727470324,0.00010821544475288185,0.00018564479552191402,1.0712214885000426,1.0710843144882043,91.43664856409491,85.20210524279831,0.0001292494596600964,1.07193952735651,1.0715469224225442,1.072209256965945,0.0003926049339657567,0.0003222779332142823,0.0005411715686694732,0.00011824217406419812,0.00015146542827615406,0.00012242518059779606,2.5729398385836486,1.071478675348241,True,False,1.0755599999999998,1.07286,1.07286,1.07306,2024-06-17 21:30:00,True,2024-06-17 21:30:00,2024-06-18 17:21:49,2024-06-18 04:10:53,0.02,even,True,10.92,5098.860000000005,,12,0,25,6
2024-06-17 20:15:00,1.07246,1.07266,1.0723,1.07232,355,12,0,2024-06-17 20:00:00,2024-06-17 20:00:00,0.00030869047619130896,0.000458067497524306,1.072307499999999,0.0002862165626851075,0.0001526154421907132,1.0720213095238103,1.0673787099617074,1.0704214386611304,1.06726836687351,1.0703603260775234,0.00014687232098883665,0.0002491267208960724,1.071305908596814,1.071199969329148,81.45833333332801,79.71556316589975,0.0001950130672329383,1.0721364385009862,1.071756196250019,1.072422738218094,0.00038024225096711106,0.00035854519784013,0.0004895433246760363,3.097007223828996e-05,5.282421740648857e-05,9.692466460342608e-05,2.573083621706407,1.0717618547297814,True,False,1.0753199999999998,1.07262,1.07262,1.0728199999999999,2024-06-17 21:15:00,True,2024-06-17 21:15:00,2024-06-18 17:19:42,2024-06-18 05:03:23,0.02,even,True,10.92,5109.780000000005,,13,0,25,6
2024-06-17 20:30:00,1.07232,1.07249,1.07226,1.0724,486,12,0,2024-06-17 20:00:00,2024-06-17 20:00:00,0.00030869047619130896,0.000458067497524306,1.072307499999999,0.0002862165626851075,0.0001526154421907132,1.0720213095238103,1.0673787099617074,1.0704214386611304,1.06726836687351,1.0703603260775234,0.00014687232098883665,0.0002491267208960724,1.071305908596814,1.071199969329148,79.74856321838745,79.22174329501443,0.0001950130672329383,1.0721769864239112,1.0718038854166843,1.0724995562435504,0.0003731010072269836,0.00036145635971750076,0.0005041256457815549,7.681802545644878e-05,3.097007223828996e-05,5.282421740648857e-05,2.5731801258653553,1.0718189866217454,True,False,1.0754,1.0727,1.0727,1.0729,2024-06-17 21:15:00,True,2024-06-17 21:15:00,2024-06-18 17:19:45,2024-06-18 04:43:23,0.02,even,True,10.92,5120.700000000005,,14,0,25,6
2024-06-17 20:45:00,1.07241,1.07254,1.07234,1.07253,479,12,0,2024-06-17 20:00:00,2024-06-17 20:00:00,0.00030869047619130896,0.000458067497524306,1.072307499999999,0.0002862165626851075,0.0001526154421907132,1.0720213095238103,1.0673787099617074,1.0704214386611304,1.06726836687351,1.0703603260775234,0.00014687232098883665,0.0002491267208960724,1.071305908596814,1.071199969329148,80.61063218390319,80.6058429118729,0.0001950130672329383,1.072231296204848,1.071857671682115,1.0725760130718964,0.0003736245227328183,0.00036388999232056426,0.000522973230737277,7.645682834600542e-05,7.681802545644878e-05,3.097007223828996e-05,2.573282026933392,1.071869999210401,True,False,1.0755299999999999,1.07283,1.07283,1.07303,2024-06-17 21:15:00,True,2024-06-17 21:15:00,2024-06-18 17:21:34,2024-06-18 04:22:40,0.02,even,True,10.92,5131.620000000005,,15,0,25,6
2024-06-17 21:00:00,1.07254,1.07319,1.07252,1.07305,880,12,0,2024-06-17 21:00:00,2024-06-17 21:00:00,0.0002861904761888301,0.0005149977259040206,1.0728313095238098,0.0002968421451668129,0.00020710396500254612,1.072307499999999,1.0676513169901214,1.0704053337654498,1.0673787099617074,1.0704214386611304,0.0001526154421907132,0.0002862165626851075,1.0714506886873423,1.0713879717828163,86.21310966138243,82.19076835455769,0.0002590099989671548,1.0723572506348713,1.0719459922982546,1.0727039766081872,0.0004112583366167044,0.0003733636611797923,0.0005418385368975885,0.00012796353629074275,7.645682834600542e-05,7.681802545644878e-05,2.573435458632999,1.0719724945833755,True,False,1.07605,1.07335,1.07335,1.07355,2024-06-17 21:45:00,True,2024-06-17 21:45:00,2024-06-18 17:27:32,2024-06-17 22:05:04,0.02,even,True,10.92,5142.540000000005,,16,0,25,6
2024-06-17 21:15:00,1.07304,1.07322,1.07296,1.07308,598,12,0,2024-06-17 21:00:00,2024-06-17 21:00:00,0.0002861904761888301,0.0005149977259040206,1.0728313095238098,0.0002968421451668129,0.00020710396500254612,1.072307499999999,1.0676513169901214,1.0704053337654498,1.0673787099617074,1.0704214386611304,0.0001526154421907132,0.0002862165626851075,1.0714506886873423,1.0713879717828163,90.68803129147689,85.83725771225419,0.0002590099989671548,1.0724684428448912,1.0720299928687542,1.0728341004471968,0.00043844997613695647,0.00038638092417122514,0.0005712486324420555,0.00013012383900967706,0.00012796353629074275,7.645682834600542e-05,2.5736052861009937,1.0720629147934,True,False,1.07608,1.07338,1.07338,1.07358,2024-06-18 01:45:00,True,2024-06-18 01:45:00,2024-06-18 17:27:39,2024-06-18 04:03:19,0.02,even,True,10.92,5153.4600000000055,,17,0,25,6
2024-06-17 21:30:00,1.07307,1.07366,1.0729899999999999,1.07356,628,12,0,2024-06-17 21:00:00,2024-06-17 21:00:00,0.0002861904761888301,0.0005149977259040206,1.0728313095238098,0.0002968421451668129,0.00020710396500254612,1.072307499999999,1.0676513169901214,1.0704053337654498,1.0673787099617074,1.0704214386611304,0.0001526154421907132,0.0002862165626851075,1.0714506886873423,1.0713879717828163,93.1839262011668,90.02835571800871,0.0002590099989671548,1.072636374714908,1.072143326730328,1.0730202992776054,0.0004930479845799418,0.0004077143362529685,0.0006355706098195741,0.00018619883040860152,0.00013012383900967706,0.00012796353629074275,2.573878319600862,1.072162278954349,True,False,1.07656,1.07386,1.07386,1.07406,2024-06-18 17:00:00,True,2024-06-18 17:00:00,,2024-06-18 17:50:50,0.02,even,True,10.92,5164.380000000006,,18,0,25,6
2024-06-17 21:45:00,1.07355,1.07372,1.07348,1.07355,691,12,0,2024-06-17 21:00:00,2024-06-17 21:00:00,0.0002861904761888301,0.0005149977259040206,1.0728313095238098,0.0002968421451668129,0.00020710396500254612,1.072307499999999,1.0676513169901214,1.0704053337654498,1.0673787099617074,1.0704214386611304,0.0001526154421907132,0.0002862165626851075,1.0714506886873423,1.0713879717828163,92.99512495973416,92.28902748412595,0.0002590099989671548,1.072776932451076,1.0722475247503036,1.0731699793601652,0.0005294077007724773,0.00043205300915687025,0.0006599704539340098,0.00014968008255977772,0.00018619883040860152,0.00013012383900967706,2.574060939472976,1.0722790192473544,True,False,1.07655,1.07385,1.07385,1.07405,2024-06-18 17:00:00,True,2024-06-18 17:00:00,,2024-06-18 17:50:50,0.02,even,True,10.92,5175.300000000006,,19,0,25,6
2024-06-17 23:30:00,1.07327,1.07353,1.07322,1.07351,212,12,0,2024-06-17 23:00:00,2024-06-17 23:00:00,0.00022714285714231508,0.0006911314721258499,1.0732796428571425,0.00029683417484000266,0.0002353928829618461,1.073058452380952,1.06828530477797,1.0704571619298864,1.0679682045777805,1.0704759131909993,0.00021723303292592669,0.0002968252665274941,1.0716764299542716,1.0716754193169757,75.09214941959188,70.92351130886176,0.0004087885715630202,1.0731137621300209,1.0726627750927993,1.073462215342278,0.00045098703722157296,0.00045958596382407967,0.000615907731236064,7.573099415170148e-05,2.9700722395942236e-05,2.2813897487816703e-05,2.574293690779447,1.0726307399051092,True,False,1.0765099999999999,1.07381,1.07381,1.07401,2024-06-18 17:00:00,True,2024-06-18 17:00:00,,2024-06-18 17:50:53,0.02,even,True,10.92,5186.220000000006,,20,0,25,6
2024-06-17 23:45:00,1.07351,1.07353,1.07328,1.07336,226,12,0,2024-06-17 23:00:00,2024-06-17 23:00:00,0.00022714285714231508,0.0006911314721258499,1.0732796428571425,0.00029683417484000266,0.0002353928829618461,1.073058452380952,1.06828530477797,1.0704571619298864,1.0679682045777805,1.0704759131909993,0.00021723303292592669,0.0002968252665274941,1.0716764299542716,1.0716754193169757,76.71232876712305,73.48284820131923,0.0004087885715630202,1.0731516448792484,1.0727144213822215,1.0735103749570012,0.0004372234970269062,0.00045511347046464504,0.0005747390712858857,4.8159614723264355e-05,7.573099415170148e-05,2.9700722395942236e-05,2.574286272703237,1.0727344772107652,True,False,1.07636,1.07366,1.07366,1.07386,2024-06-18 02:45:00,True,2024-06-18 02:45:00,,2024-06-18 03:14:58,0.02,even,True,10.92,5197.140000000006,,21,0,25,6
2024-06-18 01:30:00,1.07349,1.07381,1.07349,1.07381,88,12,0,2024-06-18 01:00:00,2024-06-18 01:00:00,5.761904761891756e-05,0.0007006208651019197,1.073487976190476,0.00024834963024195674,0.00023876913054220953,1.0733372619047614,1.069168881674372,1.070921800130052,1.0686002402890993,1.070666054578462,0.0002387642183345046,0.00026836525698612255,1.0718947113335509,1.0719444429098883,81.88608776843994,58.82352941175984,0.0005173324469834523,1.0732993866515315,1.0729665957785728,1.0733443378052958,0.00033279087295867704,0.0003530810469692625,0.0004413226333730385,8.881664946458478e-05,-3.7874097003065543e-06,-2.71757825929253e-05,2.5739401233603494,1.0727485522502422,True,False,1.0768099999999998,1.07411,1.07411,1.0743099999999999,2024-06-18 17:00:00,True,2024-06-18 17:00:00,,2024-06-18 17:05:50,0.02,even,True,10.92,5208.060000000006,,22,0,25,6
2024-06-18 01:45:00,1.07382,1.07394,1.07368,1.0737,136,12,0,2024-06-18 01:00:00,2024-06-18 01:00:00,5.761904761891756e-05,0.0007006208651019197,1.073487976190476,0.00024834963024195674,0.00023876913054220953,1.0733372619047614,1.069168881674372,1.070921800130052,1.0686002402890993,1.070666054578462,0.0002387642183345046,0.00026836525698612255,1.0718947113335509,1.0719444429098883,89.02145763966423,76.46031158794692,0.0005173324469834523,1.0733610194743728,1.073020922017197,1.0734035500515997,0.0003400974571758919,0.0003504843290105884,0.00040978978358045137,5.9212246303896876e-05,8.881664946458478e-05,-3.7874097003065543e-06,2.5739567662594336,1.072850333843766,True,False,1.0767,1.074,1.074,1.0742,2024-06-18 17:00:00,True,2024-06-18 17:00:00,,2024-06-18 17:50:32,0.02,even,True,10.92,5218.980000000006,,23,0,25,6
2024-06-18 02:00:00,1.0737,1.07381,1.07342,1.0737700000000001,141,12,0,2024-06-18 02:00:00,2024-06-18 02:00:00,0.00015071428571467038,0.0007315995176764289,1.0736761904761902,0.00022898127567119443,0.00023875565568381318,1.073487976190476,1.069667497876076,1.0711777318187665,1.069168881674372,1.070921800130052,0.00023876913054220953,0.00024834963024195674,1.0720260202797733,1.0721032874770973,87.106918239005,86.00482121570305,0.0005601858611220476,1.0734239395552385,1.0730764092751823,1.073510185758514,0.00034753028005618525,0.00034989351921970775,0.0004047118317106495,0.00010663570691438196,5.9212246303896876e-05,8.881664946458478e-05,2.5740565467313234,1.0729638247857047,True,False,1.07677,1.07407,1.07407,1.07427,2024-06-18 17:00:00,True,2024-06-18 17:00:00,,2024-06-18 17:50:13,0.02,even,True,10.92,5229.900000000006,,24,0,25,6
2024-06-18 02:30:00,1.07382,1.07393,1.0738,1.07392,103,12,0,2024-06-18 02:00:00,2024-06-18 02:00:00,0.00015071428571467038,0.0007315995176764289,1.0736761904761902,0.00022898127567119443,0.00023875565568381318,1.073487976190476,1.069667497876076,1.0711777318187665,1.069168881674372,1.070921800130052,0.00023876913054220953,0.00024834963024195674,1.0720260202797733,1.0721032874770973,89.93710691824832,86.6876310272645,0.0005601858611220476,1.0735505129359992,1.0731892123415487,1.073706394908841,0.00036130059445049767,0.00035260543374185393,0.0003720067204489609,8.625386996952145e-05,0.00010995528035739888,0.00010663570691438196,2.574208603981447,1.073204185836235,True,False,1.0769199999999999,1.07422,1.07422,1.07442,2024-06-18 17:00:00,True,2024-06-18 17:00:00,,2024-06-18 17:05:28,0.02,even,True,10.92,5240.820000000006,,25,0,25,6
2024-06-18 02:45:00,1.07394,1.07405,1.07384,1.07393,200,12,0,2024-06-18 02:00:00,2024-06-18 02:00:00,0.00015071428571467038,0.0007315995176764289,1.0736761904761902,0.00022898127567119443,0.00023875565568381318,1.073487976190476,1.069667497876076,1.0711777318187665,1.069168881674372,1.070921800130052,0.00023876913054220953,0.00024834963024195674,1.0720260202797733,1.0721032874770973,91.86421544912696,88.2733967639718,0.0005601858611220476,1.0736088955612302,1.073244085501434,1.0737819814241487,0.0003648100597961612,0.0003550463589527154,0.00034401453466215224,7.558651530770177e-05,8.625386996952145e-05,0.00010995528035739888,2.5742464010459427,1.0733175618023547,True,False,1.07693,1.07423,1.07423,1.07443,2024-06-18 17:00:00,True,2024-06-18 17:00:00,,2024-06-18 17:05:19,0.02,even,True,10.92,5251.740000000006,,26,0,25,6
2024-06-18 11:30:00,1.07198,1.07198,1.0714299999999999,1.07193,734,12,0,2024-06-18 11:00:00,2024-06-18 11:00:00,-2.5119047618149537e-05,0.00011872069000906649,1.0722795238095235,-5.096567194452797e-05,-7.1757822313853e-05,1.0723942857142865,1.0722562076524413,1.0745335991654488,1.0719987151657637,1.0742421345389743,-2.725201674381979e-05,-1.7178797103938828e-05,1.072228955824552,1.0722940060746624,23.609790760428314,29.442379896101286,0.00030787332140687167,1.0724286695037994,1.0725400265085998,1.0725685517715855,-0.00011135700480036093,-6.196518541597756e-05,0.00040077009210892194,-9.954592363237147e-05,-0.00010508083935412138,-5.7798417612220376e-05,1.0731095913959325,-0.42797248785276154,False,True,1.0689300000000002,1.07163,1.07163,1.07143,2024-06-18 14:45:00,True,2024-06-18 14:45:00,2024-06-21 10:30:00,2024-06-18 14:58:57,0.02,even,True,10.9,5262.640000000006,,27,0,25,6
2024-06-18 11:45:00,1.0719400000000001,1.0721,1.07156,1.07186,734,12,0,2024-06-18 11:00:00,2024-06-18 11:00:00,-2.5119047618149537e-05,0.00011872069000906649,1.0722795238095235,-5.096567194452797e-05,-7.1757822313853e-05,1.0723942857142865,1.0722562076524413,1.0745335991654488,1.0719987151657637,1.0742421345389743,-2.725201674381979e-05,-1.7178797103938828e-05,1.072228955824552,1.0722940060746624,19.754366759813944,22.901762708176932,0.00030787332140687167,1.0723411818878303,1.0724896541746294,1.0724592397660815,-0.00014847228679903957,-7.926660569258995e-05,0.0004152717986199558,-0.00010931200550401421,-9.954592363237147e-05,-0.00010508083935412138,1.0730198566942184,-0.42810137716205543,False,True,1.0688600000000001,1.07156,1.07156,1.07136,2024-06-18 14:45:00,True,2024-06-18 14:45:00,2024-06-21 10:30:00,2024-06-18 14:58:13,0.02,even,True,10.9,5273.540000000005,,28,0,25,6
2024-06-18 13:00:00,1.07189,1.07196,1.07161,1.07169,587,12,0,2024-06-18 13:00:00,2024-06-18 13:00:00,-0.00012000000000012001,-4.189189823833317e-05,1.0719758333333331,-0.00011476219687960791,-7.175622814798426e-05,1.0721595238095234,1.0729721419579579,1.074379388204183,1.0725146441192246,1.074456458624754,-7.175535790689702e-05,-7.192205114548564e-05,1.0721756210701854,1.0722182867415944,26.929392446639866,29.720853858789507,0.00019209179332169474,1.0721178483413827,1.0723211008078253,1.0719057653938764,-0.00020325246644259387,-0.00014678132253903605,0.00045707402762481977,-0.00015502235982189916,-0.00014758169934747656,-4.1382868934736194e-05,1.0725228153311699,-0.4287112845434171,False,True,1.0686900000000001,1.07139,1.07139,1.07119,2024-06-18 14:45:00,True,2024-06-18 14:45:00,2024-06-21 10:30:00,2024-06-18 14:53:06,0.02,even,True,10.9,5284.440000000005,,29,0,25,6
2024-06-18 13:15:00,1.07167,1.072,1.07162,1.07176,587,12,0,2024-06-18 13:00:00,2024-06-18 13:00:00,-0.00012000000000012001,-4.189189823833317e-05,1.0719758333333331,-0.00011476219687960791,-7.175622814798426e-05,1.0721595238095234,1.0729721419579579,1.074379388204183,1.0725146441192246,1.074456458624754,-7.175535790689702e-05,-7.192205114548564e-05,1.0721756210701854,1.0722182867415944,17.405582922830863,24.630541871926976,0.00019209179332169474,1.0720627947504007,1.0722795377850234,1.0717761575507398,-0.00021674303462271283,-0.00016077366495577142,0.00046926964536668427,-0.00012960784313653662,-0.00015502235982189916,-0.00014758169934747656,1.0724096715719849,-0.42885735647050516,False,True,1.0687600000000002,1.07146,1.07146,1.07126,2024-06-18 14:45:00,True,2024-06-18 14:45:00,2024-06-21 10:30:00,2024-06-18 14:57:31,0.02,even,True,10.9,5295.340000000005,,30,0,25,6
2024-06-18 13:30:00,1.07176,1.07195,1.07155,1.0719400000000001,681,12,0,2024-06-18 13:00:00,2024-06-18 13:00:00,-0.00012000000000012001,-4.189189823833317e-05,1.0719758333333331,-0.00011476219687960791,-7.175622814798426e-05,1.0721595238095234,1.0729721419579579,1.074379388204183,1.0725146441192246,1.074456458624754,-7.175535790689702e-05,-7.192205114548564e-05,1.0721756210701854,1.0722182867415944,18.062397372749356,20.7991242474067,0.00019209179332169474,1.072043903250339,1.0722543868379846,1.0717023047815621,-0.00021048358764552688,-0.00017071564949372252,0.000473617989589308,-7.385276917770689e-05,-0.00012960784313653662,-0.00015502235982189916,1.0723416890675077,-0.4289370795043834,False,True,1.0689400000000002,1.0716400000000001,1.0716400000000001,1.0714400000000002,2024-06-18 14:45:00,True,2024-06-18 14:45:00,2024-06-21 10:30:00,2024-06-18 14:59:06,0.02,even,True,10.9,5306.240000000004,,31,0,25,6
2024-06-18 14:15:00,1.07155,1.07171,1.07129,1.07146,591,12,0,2024-06-18 14:00:00,2024-06-18 14:00:00,-0.00018369047619026801,-0.00010575731859652215,1.0717904761904755,-0.000127670847481271,-7.175311054293314e-05,1.0719758333333331,1.0729834129658327,1.0743022710181787,1.0729721419579579,1.074379388204183,-7.175622814798426e-05,-0.00011476219687960791,1.0721365487430767,1.0721664238022668,16.748576408109162,18.46738365502095,0.00013252197093805137,1.0718542991471103,1.072113345239217,1.0714963811489508,-0.0002590460921068072,-0.00020591093515866178,0.0005279273940572914,-4.4850361196280275e-05,-7.78362573108371e-05,-8.323701410417605e-05,1.072209083130928,-0.4292163208330264,False,True,1.0684600000000002,1.0711600000000001,1.0711600000000001,1.0709600000000001,2024-06-20 19:00:00,True,2024-06-20 19:00:00,2024-06-21 10:30:00,2024-06-20 21:17:46,0.02,even,True,10.9,5317.140000000004,,32,0,25,6
2024-06-18 14:30:00,1.07146,1.07156,1.07097,1.07106,677,12,0,2024-06-18 14:00:00,2024-06-18 14:00:00,-0.00018369047619026801,-0.00010575731859652215,1.0717904761904755,-0.000127670847481271,-7.175311054293314e-05,1.0719758333333331,1.0729834129658327,1.0743022710181787,1.0729721419579579,1.074379388204183,-7.175622814798426e-05,-0.00011476219687960791,1.0721365487430767,1.0721664238022668,13.822798767207354,16.84842810978787,0.00013252197093805137,1.0717320992783241,1.0720353196659418,1.0714031613347097,-0.00030322038761765313,-0.00022537282565046005,0.0005718720719964822,-9.321981424115222e-05,-4.4850361196280275e-05,-7.78362573108371e-05,1.0721751886319049,-0.42936886596248547,False,True,1.06806,1.07076,1.07076,1.07056,2024-06-20 22:45:00,True,2024-06-20 22:45:00,2024-06-21 10:30:00,2024-06-20 22:51:24,0.02,even,True,10.9,5328.040000000004,,33,0,25,6
2024-06-18 17:00:00,1.07477,1.07486,1.07408,1.07467,1773,12,0,2024-06-18 17:00:00,2024-06-18 17:00:00,0.0008492857142863297,0.00024726063553415223,1.0734507142857135,-0.00012767574296174126,0.00012652092165166382,1.0729505952380953,1.0725723098890123,1.0740494066190864,1.072709135899213,1.0739817373310114,5.787457959228929e-05,-0.0001276761642593212,1.0724511546203517,1.0725445618177398,96.37224539235439,94.58341886766709,9.103945581642804e-05,1.073200390451607,1.072696424668362,1.0737050223598217,0.000503965783245075,0.0001438711863300143,0.0010120526995809932,0.0004545992432081203,0.00047367733057934736,0.0003709803921569943,2.575071293504256,1.0723387512153872,True,False,1.07767,1.07497,1.07497,1.07517,2024-06-18 17:30:00,True,2024-06-18 17:30:00,,2024-06-18 17:37:13,0.02,even,True,10.92,5338.960000000004,,34,0,25,6
2024-06-18 23:30:00,1.07394,1.07394,1.07373,1.07382,154,12,0,2024-06-18 23:00:00,2024-06-18 23:00:00,-0.0001740476190477125,0.00038255155480926284,1.0737396428571424,0.00017898154268556428,0.0002670187392362728,1.0738101190476192,1.0696626795857298,1.073517542763236,1.0701521365851587,1.0726176329915427,0.00032458824733038166,9.870792446136662e-05,1.072894647970708,1.0730377959910793,74.14073116568242,67.38810999524439,0.0003021193551104848,1.0737492677634806,1.0736072654798499,1.0737427347781217,0.00014200228363070444,0.00015146205440563798,0.00026391096994608733,4.3866529067404514e-05,6.076023391821117e-05,8.695562435412363e-05,2.574099014587549,1.0733864549686944,True,False,1.0768199999999999,1.07412,1.07412,1.07432,2024-06-19 14:00:00,True,2024-06-19 14:00:00,,2024-06-19 16:29:00,0.02,even,True,10.92,5349.880000000004,,35,0,25,6
2024-06-18 23:45:00,1.07382,1.07393,1.07379,1.07391,153,12,0,2024-06-18 23:00:00,2024-06-18 23:00:00,-0.0001740476190477125,0.00038255155480926284,1.0737396428571424,0.00017898154268556428,0.0002670187392362728,1.0738101190476192,1.0696626795857298,1.073517542763236,1.0701521365851587,1.0726176329915427,0.00032458824733038166,9.870792446136662e-05,1.072894647970708,1.0730377959910793,78.20092141459581,73.78940041761342,0.0003021193551104848,1.0737739957998682,1.0736296902591203,1.0737871413828681,0.00014430554074795765,0.00015003075167410192,0.00022012647892664532,4.4406604746471956e-05,4.3866529067404514e-05,6.076023391821117e-05,2.5740843121294192,1.0734899706363172,True,False,1.0769099999999998,1.0742099999999999,1.0742099999999999,1.0744099999999999,2024-06-19 14:00:00,True,2024-06-19 14:00:00,,2024-06-19 15:40:00,0.02,even,True,10.92,5360.800000000004,,36,0,25,6
2024-06-19 00:00:00,1.07386,1.07396,1.07359,1.07392,67,12,0,2024-06-19 00:00:00,2024-06-19 00:00:00,-7.04761904768425e-05,0.00037837520777794786,1.0738836904761901,0.0002349907825609207,0.00016056780782933142,1.0737396428571424,1.0694989620990298,1.0747109314102337,1.0696626795857298,1.073517542763236,0.0002670187392362728,0.00017898154268556428,1.072964025520985,1.073112372311793,83.5205992509292,78.62075061040248,0.00031737052564397743,1.0737964579845038,1.0736511946843705,1.073861279669762,0.00014526330013331368,0.00014907726136594428,0.00022395460862552517,7.413828689384339e-05,4.4406604746471956e-05,4.3866529067404514e-05,2.5741636183914065,1.0735589409481174,True,False,1.0769199999999999,1.07422,1.07422,1.07442,2024-06-19 14:00:00,True,2024-06-19 14:00:00,,2024-06-19 15:39:59,0.02,even,True,10.92,5371.720000000004,,37,0,25,6
2024-06-19 00:15:00,1.07392,1.07401,1.07383,1.07397,38,16,0,2024-06-19 00:00:00,2024-06-19 00:00:00,-7.04761904768425e-05,0.00037837520777794786,1.0738836904761901,0.0002349907825609207,0.00016056780782933142,1.0737396428571424,1.0694989620990298,1.0747109314102337,1.0696626795857298,1.073517542763236,0.0002670187392362728,0.00017898154268556428,1.072964025520985,1.073112372311793,89.13857677902227,83.62003248151576,0.00031737052564397743,1.0738231567561187,1.0736748098929356,1.073930161678706,0.00014834686318310197,0.0001489311817293758,0.0002277403493554555,6.888200894406005e-05,7.413828689384339e-05,4.4406604746471956e-05,2.574237611150336,1.073622712207076,True,False,1.07697,1.07427,1.07427,1.07447,2024-06-19 14:00:00,True,2024-06-19 14:00:00,,2024-06-19 15:39:49,0.02,even,True,10.92,5382.640000000004,,38,0,25,6
2024-06-19 00:30:00,1.07397,1.07402,1.0739,1.07398,50,18,0,2024-06-19 00:00:00,2024-06-19 00:00:00,-7.04761904768425e-05,0.00037837520777794786,1.0738836904761901,0.0002349907825609207,0.00016056780782933142,1.0737396428571424,1.0694989620990298,1.0747109314102337,1.0696626795857298,1.073517542763236,0.0002670187392362728,0.00017898154268556428,1.072964025520985,1.073112372311793,91.76029962546458,88.13982521847203,0.00031737052564397743,1.0738472864859467,1.073697416567533,1.073956205710354,0.00014986991841370312,0.0001491189290662413,0.00023083038518460452,2.604403164796487e-05,6.888200894406005e-05,7.413828689384339e-05,2.5742678267303534,1.0736445846903548,True,False,1.0769799999999998,1.07428,1.07428,1.0744799999999999,2024-06-19 14:00:00,True,2024-06-19 14:00:00,,2024-06-19 15:39:49,0.02,even,True,10.92,5393.560000000004,,39,0,25,6
2024-06-19 00:45:00,1.074,1.074,1.07395,1.07397,47,20,0,2024-06-19 00:00:00,2024-06-19 00:00:00,-7.04761904768425e-05,0.00037837520777794786,1.0738836904761901,0.0002349907825609207,0.00016056780782933142,1.0737396428571424,1.0694989620990298,1.0747109314102337,1.0696626795857298,1.073517542763236,0.0002670187392362728,0.00017898154268556428,1.072964025520985,1.073112372311793,93.63295880149838,91.51061173532842,0.00031737052564397743,1.0738661654881088,1.073717607932901,1.0739996112831087,0.00014855755520781777,0.00014900665429455658,0.00022907931681221023,4.3405572754728894e-05,2.604403164796487e-05,6.888200894406005e-05,2.5743088683608053,1.0736903542054121,True,False,1.07697,1.07427,1.07427,1.07447,2024-06-19 14:00:00,True,2024-06-19 14:00:00,,2024-06-19 15:39:49,0.02,even,True,10.92,5404.480000000004,,40,0,25,6
2024-06-19 14:00:00,1.07495,1.07526,1.07486,1.07518,1017,12,0,2024-06-19 14:00:00,2024-06-19 14:00:00,0.0004621428571434105,0.00020350923364587103,1.0744947619047625,-0.0001109665453562187,7.69703713028086e-05,1.0740866666666669,1.0737111982313197,1.074025249097222,1.073553771378552,1.0739437983770836,7.582009209606161e-05,-8.936940946996253e-05,1.0735650664191243,1.0737055194161844,85.7863429478877,82.07120915135879,0.00014505001914106886,1.0741547027442113,1.0739113426187032,1.0744481940144484,0.00024336012550807418,8.934893562909567e-05,0.0005273288032382498,0.00021266597867408699,0.0002700206398338345,8.492604059151532e-05,2.57516008789882,1.0737363001300768,True,False,1.07818,1.06438,1.07548,1.07568,,False,,,,0.02,running,False,0.0,5404.480000000004,2024-06-19 17:00:00,0,1,25,6
2024-06-19 14:15:00,1.07518,1.07518,1.07479,1.07489,667,12,0,2024-06-19 14:00:00,2024-06-19 14:00:00,0.0004621428571434105,0.00020350923364587103,1.0744947619047625,-0.0001109665453562187,7.69703713028086e-05,1.0740866666666669,1.0737111982313197,1.074025249097222,1.073553771378552,1.0739437983770836,7.582009209606161e-05,-8.936940946996253e-05,1.0735650664191243,1.0737055194161844,89.96243646221352,86.49285762198139,0.00014505001914106886,1.074267825398948,1.0739838357580584,1.0745821362229104,0.00028398964088949263,0.00012827707668117507,0.0005731788552081541,0.00013394220846207894,0.00021266597867408699,0.0002700206398338345,2.5753559276774416,1.0738083447683795,True,False,1.0778899999999998,1.06409,1.0751899999999999,1.0753899999999998,,False,,,,0.02,running,False,0.0,5404.480000000004,2024-06-19 17:15:00,0,2,25,6
2024-06-19 19:15:00,1.0748,1.07483,1.07467,1.07474,100,12,0,2024-06-19 19:00:00,2024-06-19 19:00:00,6.666666666732546e-05,0.00031804075052455083,1.0747486904761907,0.00013690291854944823,0.00010299809000348484,1.0747783333333332,1.0715400253737983,1.0741610371134902,1.0718560859696706,1.074050406537504,0.0001029999970566318,7.457577104901303e-05,1.0738654729096773,1.074019683747402,77.77777777776777,65.19742883378179,0.00024950562317389597,1.0746111100792317,1.0744605874022273,1.0746528482972133,0.00015052267700443878,0.00015339186888469586,0.00032292568812882665,7.701410388749608e-05,6.73512211908367e-05,8.72652218775194e-05,2.5750887979761874,1.0742168986182394,True,False,1.07774,1.06394,1.07504,1.07524,,False,,,,0.02,running,False,0.0,5404.480000000004,2024-06-19 22:15:00,0,3,25,6
2024-06-19 19:30:00,1.07474,1.07477,1.07465,1.07474,93,12,0,2024-06-19 19:00:00,2024-06-19 19:00:00,6.666666666732546e-05,0.00031804075052455083,1.0747486904761907,0.00013690291854944823,0.00010299809000348484,1.0747783333333332,1.0715400253737983,1.0741610371134902,1.0718560859696706,1.074050406537504,0.0001029999970566318,7.457577104901303e-05,1.0738654729096773,1.074019683747402,73.73737373736736,73.17620650952982,0.00024950562317389597,1.0746309392978115,1.074481284631692,1.0747250464396276,0.00014965466611949196,0.0001526444283316551,0.0003127954604104072,7.219814241432587e-05,7.701410388749608e-05,6.73512211908367e-05,2.5751473203111814,1.0743027725680736,True,False,1.07774,1.06394,1.07504,1.07524,,False,,,,0.02,running,False,0.0,5404.480000000004,2024-06-19 22:30:00,0,4,25,6
2024-06-20 08:30:00,1.0739,1.07399,1.07382,1.07391,324,12,0,2024-06-20 08:00:00,2024-06-20 08:00:00,-9.178571428702931e-05,-5.938349868284121e-06,1.0739549999999998,-2.6563494384244876e-05,-2.7567967419207835e-05,1.0741744047619037,1.074086503068796,1.0750638550886562,1.0740289024051481,1.0750298193659191,-2.0597264133022186e-05,-1.4277666790875883e-05,1.0740762953841079,1.0741521014237725,25.577119896886227,34.98544189271665,7.658735083188038e-05,1.0741092062772306,1.0742135992084825,1.0740109184726523,-0.00010439293125186211,-8.546626242200916e-05,0.00027090096601525127,-7.743378052538219e-06,-3.542827657398995e-05,9.060887513623328e-06,1.074376634776773,-0.42635479783146835,False,True,1.07091,1.07361,1.07361,1.07341,2024-06-20 09:15:00,True,2024-06-20 09:15:00,2024-06-20 18:55:27,2024-06-20 09:25:04,0.02,even,True,10.9,5415.380000000004,,1,0,25,6
2024-06-20 08:45:00,1.07392,1.07393,1.07365,1.07367,347,12,0,2024-06-20 08:00:00,2024-06-20 08:00:00,-9.178571428702931e-05,-5.938349868284121e-06,1.0739549999999998,-2.6563494384244876e-05,-2.7567967419207835e-05,1.0741744047619037,1.074086503068796,1.0750638550886562,1.0740289024051481,1.0750298193659191,-2.0597264133022186e-05,-1.4277666790875883e-05,1.0740762953841079,1.0741521014237725,11.127605447366825,24.067066693286733,7.658735083188038e-05,1.0740416360807337,1.0741733326004468,1.0739421259029929,-0.00013169651971312035,-9.47123138802314e-05,0.0002781144849184873,-6.879256965941494e-05,-7.743378052538219e-06,-3.542827657398995e-05,1.0743175804576328,-0.42643332865164707,False,True,1.07067,1.07337,1.07337,1.07317,2024-06-20 09:45:00,True,2024-06-20 09:45:00,2024-06-20 18:57:17,2024-06-20 10:30:43,0.02,even,True,10.9,5426.280000000003,,2,0,25,6
2024-06-20 09:00:00,1.07366,1.0737700000000001,1.07315,1.07319,739,12,0,2024-06-20 09:00:00,2024-06-20 09:00:00,-0.00021940476190396296,-7.133137719983473e-05,1.0736445238095231,-6.711427702225126e-05,-2.7570530173175248e-05,1.0739549999999998,1.0740656450005888,1.075034258227768,1.074086503068796,1.0750638550886562,-2.7567967419207835e-05,-2.6563494384244876e-05,1.0740204053593267,1.0740767333098706,7.829648126818448,14.844791157023844,4.700360522553736e-05,1.0739106151452362,1.0741004931485618,1.0738083797729618,-0.00018987800332559424,-0.00011374545176930396,0.00033574941060505624,-0.00013374613003103164,-6.879256965941494e-05,-7.743378052538219e-06,1.0742616414772788,-0.4266448819313551,False,True,1.0701900000000002,1.0728900000000001,1.0728900000000001,1.0726900000000001,2024-06-20 11:00:00,True,2024-06-20 11:00:00,2024-06-20 23:27:04,2024-06-20 13:05:12,0.02,even,True,10.9,5437.180000000003,,3,0,25,6
2024-06-20 10:00:00,1.07319,1.07325,1.07302,1.07304,544,12,0,2024-06-20 10:00:00,2024-06-20 10:00:00,-0.00031047619047663844,-0.00016589121394239292,1.0731591666666662,-0.00013114379307611733,-2.7567923924247963e-05,1.0736445238095231,1.0744717467281872,1.0750046167300866,1.0740656450005888,1.075034258227768,-2.7570530173175248e-05,-6.711427702225126e-05,1.07391586307808,1.0739425946450811,6.537015296140371,13.14947545190544,4.424641391951307e-06,1.0735674842036835,1.0738682935192372,1.0733644822841417,-0.00030080931555365176,-0.0002018479312125708,0.00045071535739202946,-0.00015181630546989844,-0.00010347093223161963,-0.00015635362917154616,1.073972948016621,-0.42724398344833747,False,True,1.07004,1.07274,1.07274,1.07254,2024-06-20 11:00:00,True,2024-06-20 11:00:00,2024-06-21 00:00:01,2024-06-20 13:04:37,0.02,even,True,10.9,5448.080000000003,,4,0,25,6
2024-06-20 10:30:00,1.0733,1.07355,1.07283,1.07284,1194,12,0,2024-06-20 10:00:00,2024-06-20 10:00:00,-0.00031047619047663844,-0.00016589121394239292,1.0731591666666662,-0.00013114379307611733,-2.7567923924247963e-05,1.0736445238095231,1.0744717467281872,1.0750046167300866,1.0740656450005888,1.075034258227768,-2.7570530173175248e-05,-6.711427702225126e-05,1.07391586307808,1.0739425946450811,8.36815176438614,9.397293449082932,4.424641391951307e-06,1.0734194413529332,1.0737524601502377,1.0731143550051605,-0.00033301879730451844,-0.00024389245720700923,0.0004814086968360901,-0.00015490196078382645,-9.522531819738944e-05,-0.00015181630546989844,1.0737642567458892,-0.42753554673556815,False,True,1.0698400000000001,1.07254,1.07254,1.07234,2024-06-20 11:15:00,True,2024-06-20 11:15:00,2024-06-21 10:15:00,2024-06-20 12:47:19,0.02,even,True,10.9,5458.980000000002,,5,0,25,6
2024-06-20 10:45:00,1.07283,1.07288,1.07237,1.0724,722,12,0,2024-06-20 10:00:00,2024-06-20 10:00:00,-0.00031047619047663844,-0.00016589121394239292,1.0731591666666662,-0.00013114379307611733,-2.7567923924247963e-05,1.0736445238095231,1.0744717467281872,1.0750046167300866,1.0740656450005888,1.075034258227768,-2.7570530173175248e-05,-6.711427702225126e-05,1.07391586307808,1.0739425946450811,7.707701103932656,9.78752205168036,4.424641391951307e-06,1.0732626042217128,1.0736522779168869,1.0729002648778803,-0.00038967369517406425,-0.00027304870480042025,0.0005407288291954085,-0.00021409012728024202,-0.00015490196078382645,-9.522531819738944e-05,1.073630248797294,-0.42782971904153344,False,True,1.0694000000000001,1.0721,1.0721,1.0719,2024-06-20 11:30:00,True,2024-06-20 11:30:00,2024-06-21 10:15:00,2024-06-20 12:07:27,0.02,even,True,10.9,5469.880000000002,,6,0,25,6
2024-06-20 11:00:00,1.0723799999999999,1.0723799999999999,1.07175,1.07195,991,12,0,2024-06-20 11:00:00,2024-06-20 11:00:00,-0.00048535714285691256,-0.00031716983653140574,1.0725376190476186,-0.00019579297032556748,-9.59458039998487e-05,1.0731591666666662,1.0743260443192566,1.075547406503893,1.0744717467281872,1.0750046167300866,-2.7567923924247963e-05,-0.00013114379307611733,1.0737683880407847,1.0737575870734748,3.3497402242282397,6.475197697515688,-5.98942541927201e-05,1.07306066511068,1.0735261832563767,1.0726272101823195,-0.00046551814569673056,-0.00031154259297968233,0.0006309846802604332,-0.00027305469556071493,-0.00021409012728024202,-0.00015490196078382645,1.073479039500671,-0.42822461913603194,False,True,1.06895,1.07165,1.07165,1.07145,2024-06-20 11:30:00,True,2024-06-20 11:30:00,2024-06-21 10:30:00,2024-06-20 11:33:51,0.02,even,True,10.9,5480.780000000002,,7,0,25,6
2024-06-20 11:15:00,1.0719400000000001,1.0719400000000001,1.07119,1.0714,872,12,0,2024-06-20 11:00:00,2024-06-20 11:00:00,-0.00048535714285691256,-0.00031716983653140574,1.0725376190476186,-0.00019579297032556748,-9.59458039998487e-05,1.0731591666666662,1.0743260443192566,1.075547406503893,1.0744717467281872,1.0750046167300866,-2.7567923924247963e-05,-0.00013114379307611733,1.0737683880407847,1.0737575870734748,5.405468786639841,5.487636704933588,-5.98942541927201e-05,1.0728051781705754,1.0733686882003488,1.0722869487444104,-0.0005635100297733953,-0.0003619360803384249,0.0007666000696084837,-0.00034026143790910623,-0.00027305469556071493,-0.00021409012728024202,1.073321858838382,-0.42874796134956106,False,True,1.0684,1.0711,1.0711,1.0709,2024-06-20 19:00:00,True,2024-06-20 19:00:00,2024-06-21 10:30:00,2024-06-20 21:17:18,0.02,even,True,10.9,5491.680000000001,,8,0,25,6
2024-06-20 18:15:00,1.07123,1.0718,1.07122,1.0715,1157,12,0,2024-06-20 18:00:00,2024-06-20 18:00:00,8.27380952390655e-05,-0.000532479667958663,1.0716317857142856,-0.0002524744578329091,-0.00013239530169202224,1.07208261904762,1.0733372692928969,1.0749709509451781,1.0740162345836757,1.0751132902162377,-0.00013240784774361039,-0.0002950528984939741,1.0730696186052076,1.0729277548267055,24.407637451111935,48.91096669478039,-0.0004498934475238074,1.072133737719668,1.0723493123874082,1.0720856656346742,-0.00021557466774013712,-0.00016804751612554554,0.0005001723037049,-0.00010736154110779772,-0.0001720536635705372,-4.298933608581912e-05,1.072760898244676,-0.42858956697532746,False,True,1.0685,1.0712,1.0712,1.071,2024-06-20 19:00:00,True,2024-06-20 19:00:00,2024-06-21 10:30:00,2024-06-20 21:18:00,0.02,even,True,10.9,5502.580000000001,,9,0,25,6
2024-06-20 18:30:00,1.07151,1.07188,1.07146,1.07153,817,12,0,2024-06-20 18:00:00,2024-06-20 18:00:00,8.27380952390655e-05,-0.000532479667958663,1.0716317857142856,-0.0002524744578329091,-0.00013239530169202224,1.07208261904762,1.0733372692928969,1.0749709509451781,1.0740162345836757,1.0751132902162377,-0.00013240784774361039,-0.0002950528984939741,1.0730696186052076,1.0729277548267055,15.696649029979866,29.53569511540273,-0.0004498934475238074,1.0720408549935652,1.0722886225809336,1.0719921465428284,-0.0002477675873684415,-0.00018399153037412474,0.0004947447153769882,-9.351909184585061e-05,-0.00010736154110779772,-0.0001720536635705372,1.0726600519085874,-0.42867575882293063,False,True,1.0685300000000002,1.0712300000000001,1.0712300000000001,1.0710300000000001,2024-06-20 19:00:00,True,2024-06-20 19:00:00,2024-06-21 10:30:00,2024-06-20 21:18:53,0.02,even,True,10.9,5513.4800000000005,,10,0,25,6
2024-06-20 18:45:00,1.07154,1.07158,1.07064,1.07066,997,12,0,2024-06-20 18:00:00,2024-06-20 18:00:00,8.27380952390655e-05,-0.000532479667958663,1.0716317857142856,-0.0002524744578329091,-0.00013239530169202224,1.07208261904762,1.0733372692928969,1.0749709509451781,1.0740162345836757,1.0751132902162377,-0.00013240784774361039,-0.0002950528984939741,1.0730696186052076,1.0729277548267055,14.214274551823664,18.106187010971826,-0.0004498934475238074,1.0718284157637858,1.0721679838712348,1.0717644478844173,-0.00033956810744895094,-0.00021510684578908998,0.0005936758375244043,-0.00022769865841110182,-9.351909184585061e-05,-0.00010736154110779772,1.0725659102650753,-0.42903701449624077,False,True,1.06766,1.07036,1.07036,1.07016,2024-06-21 00:00:00,True,2024-06-21 00:00:00,2024-06-21 10:30:00,2024-06-21 00:55:57,0.02,even,True,10.9,5524.38,,11,0,25,6
2024-06-20 19:00:00,1.07066,1.07087,1.07044,1.07085,908,12,0,2024-06-20 19:00:00,2024-06-20 19:00:00,-0.00045083333333439946,-0.0006617596695752681,1.0711711904761905,-0.00020199926550148732,-0.00013239687940911447,1.0716317857142856,1.0726909363602304,1.0748286625211567,1.0733372692928969,1.0749709509451781,-0.00013239530169202224,-0.0002524744578329091,1.0729135141790653,1.0727455344405692,12.871811640736837,14.260911740846794,-0.0004922666919340995,1.071677890261665,1.0720703554363284,1.0715869762641892,-0.00039246517466340336,-0.00025057851156395266,0.0006526670923172197,-0.00017747162022807572,-0.00022769865841110182,-9.351909184585061e-05,1.0724680768388175,-0.4292941243104391,False,True,1.0678500000000002,1.0705500000000001,1.0705500000000001,1.0703500000000001,2024-06-20 23:30:00,True,2024-06-20 23:30:00,2024-06-21 10:30:00,2024-06-21 02:20:03,0.02,even,True,10.9,5535.28,,12,0,25,6
2024-06-20 19:15:00,1.07086,1.07094,1.07069,1.0707200000000001,673,12,0,2024-06-20 19:00:00,2024-06-20 19:00:00,-0.00045083333333439946,-0.0006617596695752681,1.0711711904761905,-0.00020199926550148732,-0.00013239687940911447,1.0716317857142856,1.0726909363602304,1.0748286625211567,1.0733372692928969,1.0749709509451781,-0.00013239530169202224,-0.0002524744578329091,1.0729135141790653,1.0727455344405692,9.30090179531761,12.128995995959377,-0.0004922666919340995,1.0715305225291012,1.0719703291077116,1.0713050533195745,-0.0004398065786104244,-0.00028842412497324704,0.0007096062288767558,-0.0002819229446147098,-0.00017747162022807572,-0.00022769865841110182,1.072263021728558,-0.42965291508940906,False,True,1.0677200000000002,1.0704200000000001,1.0704200000000001,1.0702200000000002,2024-06-20 23:30:00,True,2024-06-20 23:30:00,2024-06-21 10:30:00,2024-06-21 02:14:33,0.02,even,True,10.9,5546.179999999999,,13,0,25,6
2024-06-20 20:15:00,1.07074,1.07085,1.07035,1.07061,805,12,0,2024-06-20 20:00:00,2024-06-20 20:00:00,-0.0004605952380951628,-0.000735909802308532,1.0708841666666664,-0.00015284346307312114,-0.00013241048758915228,1.0711711904761905,1.0721616114436439,1.0746865438052913,1.0726909363602304,1.0748286625211567,-0.00013239687940911447,-0.00020199926550148732,1.0727668358449323,1.0725770916853237,14.460784313725839,14.618736383443185,-0.000540995314008986,1.0711112279103872,1.0716265334584647,1.0705528207774342,-0.0005153055480775492,-0.0004142053289329729,0.0008050573478921028,-0.00018697282421609174,-0.00015417612659218705,-0.00017930168558599746,1.0716396481970885,-0.4305340066422201,False,True,1.0676100000000002,1.07031,1.07031,1.0701100000000001,2024-06-21 01:15:00,True,2024-06-21 01:15:00,2024-06-21 10:30:00,2024-06-21 02:05:57,0.02,even,True,10.9,5557.079999999999,,14,0,25,6
2024-06-20 20:30:00,1.07062,1.07076,1.07033,1.07066,862,12,0,2024-06-20 20:00:00,2024-06-20 20:00:00,-0.0004605952380951628,-0.000735909802308532,1.0708841666666664,-0.00015284346307312114,-0.00013241048758915228,1.0711711904761905,1.0721616114436439,1.0746865438052913,1.0726909363602304,1.0748286625211567,-0.00013239687940911447,-0.00020199926550148732,1.0727668358449323,1.0725770916853237,14.58333333333177,14.910130718953944,-0.000540995314008986,1.071041808231866,1.0715549383874674,1.0704178809769531,-0.0005131301556013934,-0.00043399029426665703,0.0008047045006679826,-0.0001349398004810709,-0.00018697282421609174,-0.00015417612659218705,1.071504232052855,-0.4306684700989487,False,True,1.06766,1.07036,1.07036,1.07016,2024-06-21 00:00:00,True,2024-06-21 00:00:00,2024-06-21 10:30:00,2024-06-21 00:55:57,0.02,even,True,10.9,5567.979999999999,,15,0,25,6
2024-06-20 20:45:00,1.07065,1.0707,1.07041,1.07064,576,12,0,2024-06-20 20:00:00,2024-06-20 20:00:00,-0.0004605952380951628,-0.000735909802308532,1.0708841666666664,-0.00015284346307312114,-0.00013241048758915228,1.0711711904761905,1.0721616114436439,1.0746865438052913,1.0726909363602304,1.0748286625211567,-0.00013239687940911447,-0.00020199926550148732,1.0727668358449323,1.0725770916853237,13.480392156862052,14.17483660130656,-0.000540995314008986,1.0709799915808096,1.071487165173581,1.0703242105263162,-0.0005071735927713039,-0.0004486269539675864,0.0008072449029851679,-9.367045063690682e-05,-0.0001349398004810709,-0.00018697282421609174,1.0714139911453462,-0.43076557009271377,False,True,1.0676400000000001,1.07034,1.07034,1.07014,2024-06-21 00:00:00,True,2024-06-21 00:00:00,2024-06-21 10:30:00,2024-06-21 00:36:00,0.02,even,True,10.9,5578.879999999998,,16,0,25,6
2024-06-20 22:30:00,1.07055,1.07063,1.07033,1.07036,676,12,0,2024-06-20 22:00:00,2024-06-20 22:00:00,-2.345238095280422e-05,-0.0007391916143593136,1.0705796428571424,-0.00010617261634182061,-0.00013239677408038395,1.0708607142857136,1.07163727482375,1.074401860860882,1.071766282371732,1.0745442680340824,-0.0001324153484304929,-0.00010906310929383143,1.0725083131587807,1.072287906402458,18.850574712640164,31.804573903520463,-0.0006172936582878284,1.0708637070905405,1.07123055520695,1.0707231647746829,-0.0003668481164096349,-0.00037658902700749177,0.0008089351025039134,-7.749914000587665e-05,1.9398004816206793e-05,8.423804609503094e-05,1.0718152271630632,-0.43036889761369745,False,True,1.06736,1.07006,1.07006,1.06986,2024-06-21 10:30:00,True,2024-06-21 10:30:00,2024-06-21 10:35:01,,0.02,success,True,109.0,5687.879999999998,,17,0,25,6
2024-06-20 22:45:00,1.07037,1.07079,1.07031,1.07045,780,12,0,2024-06-20 22:00:00,2024-06-20 22:00:00,-2.345238095280422e-05,-0.0007391916143593136,1.0705796428571424,-0.00010617261634182061,-0.00013239677408038395,1.0708607142857136,1.07163727482375,1.074401860860882,1.071766282371732,1.0745442680340824,-0.0001324153484304929,-0.00010906310929383143,1.0725083131587807,1.072287906402458,13.103448275856444,21.007115489869804,-0.0006172936582878284,1.0708000598458418,1.0711727363027315,1.0707014413484686,-0.00037267645688965345,-0.0003758065129839241,0.0007686947812558312,-2.172342621431511e-05,-7.749914000587665e-05,1.9398004816206793e-05,1.0717391793031639,-0.43033629660622674,False,True,1.06745,1.07015,1.07015,1.06995,2024-06-21 10:30:00,True,2024-06-21 10:30:00,2024-06-21 10:30:40,,0.02,success,True,109.0,5796.879999999998,,18,0,25,6
2024-06-20 23:00:00,1.07044,1.07054,1.07034,1.07038,384,12,0,2024-06-20 23:00:00,2024-06-20 23:00:00,-0.00028107142857125567,-0.000756227788653252,1.070304880952381,-0.00010617066824780294,-0.00014433964643152124,1.0705796428571424,1.07152353128707,1.074374271135043,1.07163727482375,1.074401860860882,-0.00013239677408038395,-0.00010617261634182061,1.0723542284388594,1.0721144738902615,8.304798649624468,13.41960721270703,-0.0006450804843609132,1.0707354352541738,1.0711140150951217,1.07068561747506,-0.0003785798409479124,-0.00037636117857672185,0.0007449105092091127,-1.582387340848257e-05,-2.172342621431511e-05,-7.749914000587665e-05,1.0716912466624924,-0.4303200117123722,False,True,1.0673800000000002,1.0700800000000001,1.0700800000000001,1.0698800000000002,2024-06-21 10:30:00,True,2024-06-21 10:30:00,2024-06-21 10:35:01,,0.02,success,True,109.0,5905.879999999998,,19,0,25,6
2024-06-20 23:15:00,1.07037,1.0704,1.07012,1.0702099999999999,258,12,0,2024-06-20 23:00:00,2024-06-20 23:00:00,-0.00028107142857125567,-0.000756227788653252,1.070304880952381,-0.00010617066824780294,-0.00014433964643152124,1.0705796428571424,1.07152353128707,1.074374271135043,1.07163727482375,1.074401860860882,-0.00013239677408038395,-0.00010617261634182061,1.0723542284388594,1.0721144738902615,8.11083313238313,9.839693352621351,-0.0006450804843609132,1.070654599061224,1.0710470510140015,1.070576174750602,-0.0003924519527775949,-0.0003795793334168965,0.0007077016791914772,-0.00010944272445811976,-1.582387340848257e-05,-2.172342621431511e-05,1.0715315720175105,-0.43037922251630656,False,True,1.06721,1.0810099999999998,1.06991,1.06971,,False,2024-06-21 10:45:00,2024-06-21 10:37:32,,0.02,success,True,109.0,6014.879999999998,,20,0,25,6
2024-06-20 23:30:00,1.0702,1.07033,1.07015,1.07031,325,12,0,2024-06-20 23:00:00,2024-06-20 23:00:00,-0.00028107142857125567,-0.000756227788653252,1.070304880952381,-0.00010617066824780294,-0.00014433964643152124,1.0705796428571424,1.07152353128707,1.074374271135043,1.07163727482375,1.074401860860882,-0.00013239677408038395,-0.00010617261634182061,1.0723542284388594,1.0721144738902615,7.931235431239774,8.115622404415795,-0.0006450804843609132,1.0706015838210357,1.070992454642594,1.0705097970416242,-0.000390870821558309,-0.000381837631045179,0.0006193041794875197,-6.637770897777173e-05,-0.00010944272445811976,-1.582387340848257e-05,1.0713458576839323,-0.43032626360068393,False,True,1.0673100000000002,1.0700100000000001,1.0700100000000001,1.0698100000000001,2024-06-21 10:30:00,True,2024-06-21 10:30:00,2024-06-21 10:35:02,,0.02,success,True,109.0,6123.879999999998,,21,0,25,6
2024-06-20 23:45:00,1.07032,1.07033,1.0701,1.07012,323,12,0,2024-06-20 23:00:00,2024-06-20 23:00:00,-0.00028107142857125567,-0.000756227788653252,1.070304880952381,-0.00010617066824780294,-0.00014433964643152124,1.0705796428571424,1.07152353128707,1.074374271135043,1.07163727482375,1.074401860860882,-0.00013239677408038395,-0.00010617261634182061,1.0723542284388594,1.0721144738902615,6.244855967077341,7.4289748435667535,-0.0006450804843609132,1.0705274940024148,1.0709278283727721,1.0704043274853794,-0.0004003343703573581,-0.0003855369789076148,0.00048135641687253167,-0.00010546955624479715,-6.637770897777173e-05,-0.00010944272445811976,1.0710541586481572,-0.43024550367739844,False,True,1.06712,1.0809199999999999,1.06982,1.06962,,False,2024-06-21 10:45:00,2024-06-21 10:37:44,,0.02,success,True,109.0,6232.879999999998,,22,0,25,6
2024-06-21 01:00:00,1.07036,1.07039,1.07006,1.07006,181,12,0,2024-06-21 01:00:00,2024-06-21 01:00:00,-1.773809523797354e-05,-0.000761620727681489,1.0702916666666678,-0.00010616489504099626,-0.00021542691169712272,1.070287142857143,1.0712960156239004,1.074593577449055,1.0714097565629745,1.0744881448332795,-0.00017590234358868175,-0.00010617455829549184,1.0720923476764628,1.0718290507007173,18.260718846925112,19.742990938391486,-0.0006909356971353073,1.0703597768247257,1.0707073186391725,1.0700801616787072,-0.00034754181444673904,-0.0003691973006991593,0.0003604511063445068,-8.890608875078421e-05,-4.3237014103914007e-05,-5.029583763316303e-05,1.0705667706722723,-0.4304064473148579,False,True,1.0670600000000001,1.08086,1.06976,1.06956,,False,2024-06-21 10:45:00,2024-06-21 10:38:00,,0.02,success,True,109.0,6341.879999999998,,23,0,25,6
2024-06-21 01:15:00,1.07007,1.07017,1.07007,1.07016,146,12,0,2024-06-21 01:00:00,2024-06-21 01:00:00,-1.773809523797354e-05,-0.000761620727681489,1.0702916666666678,-0.00010616489504099626,-0.00021542691169712272,1.070287142857143,1.0712960156239004,1.074593577449055,1.0714097565629745,1.0744881448332795,-0.00017590234358868175,-0.00010617455829549184,1.0720923476764628,1.0718290507007173,18.551724137931313,19.507145897949368,-0.0006909356971353073,1.070329041928614,1.0706667765177522,1.0700174269005847,-0.00033773458913821663,-0.0003629047583869708,0.0003659289549421358,-6.273477812257511e-05,-8.890608875078421e-05,-4.3237014103914007e-05,1.0705114309897565,-0.43047657718858723,False,True,1.06716,1.08096,1.06986,1.06966,,False,2024-06-21 10:45:00,2024-06-21 10:37:37,,0.02,success,True,109.0,6450.879999999998,,24,0,25,6
2024-06-24 09:00:00,1.06981,1.07013,1.06967,1.06999,779,12,0,2024-06-24 09:00:00,2024-06-24 09:00:00,0.0002435714285715651,-2.1089500382709403e-05,1.0697488095238104,4.92988103738412e-05,7.613847838448885e-05,1.0693610714285722,1.0677976818208028,1.0694434505661201,1.0678823193348665,1.0697008067573595,1.1176320912657304e-05,3.21853784129558e-05,1.0696979599749292,1.0695291425290414,91.02351523860266,88.75414347815786,-0.0001863133561384753,1.0695012000436728,1.0693009884801803,1.069703921568627,0.0002002115634924806,0.00010915605825416344,0.00036860683670413073,0.00011251805985512675,8.106639146854278e-05,6.324045407612999e-05,2.5702015407981778,1.0692063023390765,True,False,1.0729899999999999,1.07029,1.07029,1.07049,2024-06-24 10:15:00,True,2024-06-24 10:15:00,2024-06-24 13:55:36,2024-06-24 10:26:31,0.02,even,True,10.92,6461.799999999998,,25,0,26,6
2024-06-24 10:00:00,1.07025,1.0708,1.07018,1.07073,1051,12,0,2024-06-24 10:00:00,2024-06-24 10:00:00,0.00038773809523817704,9.13358750678217e-05,1.0703067857142863,4.431154843462362e-05,0.00011899169734218839,1.0697488095238104,1.0678872933341845,1.069528089727802,1.0677976818208028,1.0694434505661201,7.613847838448885e-05,4.92988103738412e-05,1.0697948657829985,1.0696628111267181,86.92361905422315,86.1800381578309,-0.00013078350989721593,1.0699720538440323,1.069606777243514,1.0703452975576195,0.0003652766005182162,0.0002325277351183316,0.0005705532403418363,0.0001738940488471563,0.0001291950464401559,0.00017021671826644713,2.571115544432081,1.069575050683158,True,False,1.0737299999999999,1.07103,1.07103,1.07123,2024-06-24 10:45:00,True,2024-06-24 10:45:00,2024-06-24 16:02:33,2024-06-24 11:02:30,0.02,even,True,10.92,6472.719999999998,,26,0,26,6
2024-06-24 10:30:00,1.07032,1.0714299999999999,1.07029,1.07134,1138,12,0,2024-06-24 10:00:00,2024-06-24 10:00:00,0.00038773809523817704,9.13358750678217e-05,1.0703067857142863,4.431154843462362e-05,0.00011899169734218839,1.0697488095238104,1.0678872933341845,1.069528089727802,1.0677976818208028,1.0694434505661201,7.613847838448885e-05,4.92988103738412e-05,1.0697948657829985,1.0696628111267181,88.745253451181,85.84998544335497,-0.00013078350989721593,1.0702317071901057,1.0697861396120663,1.0706679910560717,0.0004455675780394852,0.00029687024615678037,0.0006683748948488416,0.0002511386308909902,7.155486756116325e-05,0.0001738940488471563,2.5715702971641177,1.0697656849480257,True,False,1.0743399999999999,1.07164,1.07164,1.07184,2024-06-24 12:30:00,True,2024-06-24 12:30:00,2024-06-24 17:02:22,2024-06-25 14:21:24,0.02,success,True,109.18,6581.899999999999,,27,0,26,6
2024-06-24 10:45:00,1.07135,1.07142,1.07109,1.0712,952,12,0,2024-06-24 10:00:00,2024-06-24 10:00:00,0.00038773809523817704,9.13358750678217e-05,1.0703067857142863,4.431154843462362e-05,0.00011899169734218839,1.0697488095238104,1.0678872933341845,1.069528089727802,1.0677976818208028,1.0694434505661201,7.613847838448885e-05,4.92988103738412e-05,1.0697948657829985,1.0696628111267181,86.65611346373665,85.7608169131928,-0.00013078350989721593,1.070380675314705,1.0698908700111724,1.0708583969728238,0.0004898053035324867,0.00033545725763192165,0.0007259988522011079,0.00019040591675212326,0.0002511386308909902,7.155486756116325e-05,2.5718384954232953,1.0698782985223523,True,False,1.0741999999999998,1.0715,1.0715,1.0716999999999999,2024-06-24 11:45:00,True,2024-06-24 11:45:00,2024-06-24 16:53:15,2024-06-24 11:48:11,0.02,even,True,10.92,6592.819999999999,,28,0,26,6
2024-06-24 11:00:00,1.0712,1.0714,1.07079,1.0713,1213,12,0,2024-06-24 11:00:00,2024-06-24 11:00:00,0.0005579761904759284,0.0002712512982172566,1.0708084523809527,6.220756900669969e-05,0.00014280987354376264,1.0703067857142863,1.0677830513400135,1.0694471715716134,1.0678872933341845,1.069528089727802,0.00011899169734218839,4.431154843462362e-05,1.0698919712163537,1.0697937862365807,93.27987531553082,89.56041407681614,-5.037654827432143e-05,1.0705221098816735,1.069995250010345,1.071047199862401,0.000526859871328611,0.00037373778037125955,0.0007810917573480853,0.0001888028895771221,0.00019040591675212326,0.0002511386308909902,2.572101673734821,1.069992725989981,True,False,1.0742999999999998,1.0715999999999999,1.0715999999999999,1.0717999999999999,2024-06-24 12:30:00,True,2024-06-24 12:30:00,2024-06-24 17:01:29,2024-06-25 14:22:38,0.02,success,True,109.18,6701.999999999999,,29,0,26,6
2024-06-24 11:15:00,1.0713,1.07163,1.0713,1.07136,911,12,0,2024-06-24 11:00:00,2024-06-24 11:00:00,0.0005579761904759284,0.0002712512982172566,1.0708084523809527,6.220756900669969e-05,0.00014280987354376264,1.0703067857142863,1.0677830513400135,1.0694471715716134,1.0678872933341845,1.069528089727802,0.00011899169734218839,4.431154843462362e-05,1.0698919712163537,1.0697937862365807,90.57780764635702,90.17126547520816,-5.037654827432143e-05,1.0706510160537237,1.0700963426021712,1.071205572755418,0.0005546734515524676,0.0004099249146075012,0.0008236680156856921,0.0001583728930170114,0.0001888028895771221,0.00019040591675212326,2.5723175245765937,1.0700936209342422,True,False,1.07436,1.07166,1.07166,1.07186,2024-06-24 12:30:00,True,2024-06-24 12:30:00,2024-06-24 17:02:22,2024-06-25 14:21:06,0.02,success,True,109.18,6811.179999999999,,30,0,26,6
2024-06-24 11:30:00,1.07137,1.07173,1.07106,1.07173,934,12,0,2024-06-24 11:00:00,2024-06-24 11:00:00,0.0005579761904759284,0.0002712512982172566,1.0708084523809527,6.220756900669969e-05,0.00014280987354376264,1.0703067857142863,1.0677830513400135,1.0694471715716134,1.0678872933341845,1.069528089727802,0.00011899169734218839,4.431154843462362e-05,1.0698919712163537,1.0697937862365807,93.98521505376392,92.61429933855061,-5.037654827432143e-05,1.0708170135839201,1.0702173542612696,1.0714110113519095,0.000599659322650492,0.0004478717962160994,0.0008911307424073136,0.00020543859649158058,0.0001583728930170114,0.0001888028895771221,2.5726140378541595,1.0702079848496597,True,False,1.07473,1.07203,1.07203,1.07223,2024-06-24 12:30:00,True,2024-06-24 12:30:00,,2024-06-24 13:01:01,0.02,even,True,10.92,6822.099999999999,,31,0,26,6
2024-06-24 12:30:00,1.0724,1.07283,1.07229,1.0727,1047,12,0,2024-06-24 12:00:00,2024-06-24 12:00:00,0.0005016666666664005,0.00040005081796934405,1.0714632142857141,0.0001411404484288146,0.00020167381682846002,1.0708084523809527,1.0672655500170896,1.0696045158080656,1.0677830513400135,1.0694471715716134,0.00014280987354376264,6.220756900669969e-05,1.0700408762991698,1.0699862833376543,94.33653074514092,91.551110653234,3.970892497441167e-05,1.0714618597346792,1.0707126364136537,1.072147254901961,0.0007492233210255606,0.0005825307074189371,0.0010701358169546414,0.00026921224630283014,0.00023790161678638455,0.00014636394908773553,2.5735919382548498,1.0707025715490723,True,False,1.0756999999999999,1.073,1.073,1.0732,2024-06-24 15:00:00,True,2024-06-24 15:00:00,,2024-06-24 15:09:10,0.02,even,True,10.92,6833.0199999999995,,32,0,26,6
2024-06-24 13:30:00,1.07207,1.07271,1.07195,1.07269,827,12,0,2024-06-24 13:00:00,2024-06-24 13:00:00,0.0006547619047614361,0.0005792196015519391,1.0721575000000008,0.0002235371003069857,0.00021474743303943113,1.0714632142857141,1.066894911367731,1.0696255923035363,1.0672655500170896,1.0696045158080656,0.00020167381682846002,0.0001411404484288146,1.0702285616992233,1.070223380670642,80.62656641604042,79.47608747897233,0.00014761106028991715,1.071874567010099,1.071130948005674,1.0725215239078083,0.0007436190044249891,0.0006746736432627395,0.001088916433920293,0.00013668730650140404,3.917784657803125e-05,7.820777433642512e-05,2.5739915610936004,1.071051486722016,True,False,1.0756899999999998,1.0729899999999999,1.0729899999999999,1.0731899999999999,2024-06-24 15:00:00,True,2024-06-24 15:00:00,,2024-06-24 15:09:11,0.02,even,True,10.92,6843.94,,33,0,26,6
2024-06-24 13:45:00,1.0727,1.07301,1.07243,1.07295,836,12,0,2024-06-24 13:00:00,2024-06-24 13:00:00,0.0006547619047614361,0.0005792196015519391,1.0721575000000008,0.0002235371003069857,0.00021474743303943113,1.0714632142857141,1.066894911367731,1.0696255923035363,1.0672655500170896,1.0696045158080656,0.00020167381682846002,0.0001411404484288146,1.0702285616992233,1.070223380670642,87.98651039363251,81.16467639687565,0.00014761106028991715,1.0720400182393146,1.0712656925978463,1.0726952665978666,0.0007743256414682875,0.0006946040429038491,0.001105304332176511,0.00017374269005832055,0.00013668730650140404,3.917784657803125e-05,2.5741874274463052,1.0712031057494282,True,False,1.07595,1.07325,1.07325,1.07345,2024-06-24 15:00:00,True,2024-06-24 15:00:00,,2024-06-24 15:00:09,0.02,even,True,10.92,6854.86,,34,0,26,6
2024-06-24 14:00:00,1.07294,1.07335,1.07287,1.07297,1028,12,0,2024-06-24 14:00:00,2024-06-24 14:00:00,0.0006942857142866465,0.0007721209926323525,1.0728292857142843,0.00023060034969307449,0.0002525882703094811,1.0721575000000008,1.0671070680423598,1.0694691615167982,1.066894911367731,1.0696255923035363,0.00021474743303943113,0.0002235371003069857,1.0704402673960476,1.0704863102169908,92.56240325077378,87.05849335348226,0.0002725130467584042,1.0721830923563431,1.0713919375905985,1.0728457653938765,0.0007911547657446505,0.0007139141874720094,0.0011073537525987946,0.00015049879600992355,0.00017374269005832055,0.00013668730650140404,2.574340692959885,1.0713508378278682,True,False,1.0759699999999999,1.07327,1.07327,1.07347,2024-06-24 15:00:00,True,2024-06-24 15:00:00,,2024-06-24 15:00:09,0.02,even,True,10.92,6865.78,,35,0,26,6
2024-06-24 14:45:00,1.07283,1.07352,1.0727,1.07351,928,12,0,2024-06-24 14:00:00,2024-06-24 14:00:00,0.0006942857142866465,0.0007721209926323525,1.0728292857142843,0.00023060034969307449,0.0002525882703094811,1.0721575000000008,1.0671070680423598,1.0694691615167982,1.066894911367731,1.0696255923035363,0.00021474743303943113,0.0002235371003069857,1.0704402673960476,1.0704863102169908,84.59771371048934,83.71590599722643,0.0002725130467584042,1.0725347910451946,1.071734293799375,1.0731002511179917,0.0008004972458195425,0.0007478216995059216,0.0010688896107927488,0.00013066391468963268,6.866529067828253e-05,5.51565187472125e-05,2.574543252092562,1.0716572501434214,True,False,1.0765099999999999,1.07381,1.07381,1.07401,2024-06-24 17:00:00,True,2024-06-24 17:00:00,,2024-06-24 17:14:27,0.02,even,True,10.92,6876.7,,36,0,26,6
2024-06-24 15:00:00,1.07352,1.07352,1.07276,1.07284,1315,12,0,2024-06-24 15:00:00,2024-06-24 15:00:00,0.0006717857142835015,0.0009486424236846425,1.0732400000000009,0.0002802388365867079,0.0002959932473810416,1.0728292857142843,1.0669967081802931,1.069092410928722,1.0671070680423598,1.0694691615167982,0.0002525882703094811,0.00023060034969307449,1.070630572725335,1.0707186053996316,82.20827657598646,82.19709622843753,0.0004077389221436519,1.0725817462690108,1.0718161979623844,1.0731472067423458,0.0007655483066264512,0.0007513670209300275,0.0010228250095008795,4.6955624354083625e-05,0.00013066391468963268,6.866529067828253e-05,2.5745280205051717,1.0717663929795196,True,False,1.07584,1.07314,1.07314,1.07334,2024-06-24 16:00:00,True,2024-06-24 16:00:00,,2024-06-24 17:45:44,0.02,even,True,10.92,6887.62,,37,0,26,6
2024-06-24 16:00:00,1.0734,1.07386,1.0734,1.07368,1074,12,0,2024-06-24 16:00:00,2024-06-24 16:00:00,0.00041071428571659574,0.0010339253285187588,1.0737459523809523,0.0002981313987243429,0.0003085049992985912,1.0732400000000009,1.0671445969058597,1.0693436156444103,1.0669967081802931,1.069092410928722,0.0002959932473810416,0.0002802388365867079,1.0708615035172486,1.0709979169676611,79.29061635877754,72.28154459058642,0.0005329762034186733,1.0728908177978569,1.072177259016629,1.073343061575507,0.0007135587812279187,0.0007226630598581682,0.0008860300973404499,0.00013844169246612914,8.174062607380073e-05,-3.52528379763406e-05,2.5745392022069167,1.0721469209440975,True,False,1.0766799999999999,1.07398,1.07398,1.07418,2024-06-24 17:00:00,True,2024-06-24 17:00:00,,2024-06-24 17:00:13,0.02,even,True,10.92,6898.54,,38,0,26,6
2024-06-24 16:15:00,1.07368,1.07403,1.07352,1.07373,1296,12,0,2024-06-24 16:00:00,2024-06-24 16:00:00,0.00041071428571659574,0.0010339253285187588,1.0737459523809523,0.0002981313987243429,0.0003085049992985912,1.0732400000000009,1.0671445969058597,1.0693436156444103,1.0669967081802931,1.069092410928722,0.0002959932473810416,0.0002802388365867079,1.0708615035172486,1.0709979169676611,89.5690427101112,80.4233264832091,0.0005329762034186733,1.0730199227520327,1.072292276867249,1.073421327829378,0.0007276458847838008,0.0007236596248432948,0.0008776384981260661,7.82662538709733e-05,0.00013844169246612914,8.174062607380073e-05,2.5746061398018485,1.0722365158569078,True,False,1.07673,1.07403,1.07403,1.07423,2024-06-25 08:30:00,True,2024-06-25 08:30:00,,2024-06-25 09:00:26,0.02,even,True,10.92,6909.46,,39,0,26,6
2024-06-24 16:30:00,1.07373,1.07403,1.0735,1.07369,1126,12,0,2024-06-24 16:00:00,2024-06-24 16:00:00,0.00041071428571659574,0.0010339253285187588,1.0737459523809523,0.0002981313987243429,0.0003085049992985912,1.0732400000000009,1.0671445969058597,1.0693436156444103,1.0669967081802931,1.069092410928722,0.0002959932473810416,0.0002802388365867079,1.0708615035172486,1.0709979169676611,86.92312605793389,85.26092837560755,0.0005329762034186733,1.0731230115594124,1.0723958119141193,1.073495669074647,0.0007271996452931084,0.0007243676289332576,0.0008124218937182879,7.434124526906061e-05,7.82662538709733e-05,0.00013844169246612914,2.574592438631167,1.0723988995181275,True,False,1.07669,1.07399,1.07399,1.07419,2024-06-24 17:00:00,True,2024-06-24 17:00:00,,2024-06-24 17:00:13,0.02,even,True,10.92,6920.38,,40,0,26,6
2024-06-24 16:45:00,1.07369,1.07429,1.07362,1.0742099999999999,1085,12,0,2024-06-24 16:00:00,2024-06-24 16:00:00,0.00041071428571659574,0.0010339253285187588,1.0737459523809523,0.0002981313987243429,0.0003085049992985912,1.0732400000000009,1.0671445969058597,1.0693436156444103,1.0669967081802931,1.069092410928722,0.0002959932473810416,0.0002802388365867079,1.0708615035172486,1.0709979169676611,88.84474940812878,88.44563939205796,0.0005329762034186733,1.073290240550272,1.072530196216777,1.0736976814585486,0.0007600443334949691,0.0007315029698456,0.0008462775352837678,0.00020201238390149534,7.434124526906061e-05,7.82662538709733e-05,2.574840156131182,1.0725552067859154,True,False,1.0772099999999998,1.06341,1.0745099999999999,1.0747099999999998,,False,,,,0.02,running,False,0.0,6920.38,2024-06-24 19:45:00,0,1,26,6
2024-06-25 13:45:00,1.07232,1.07252,1.07217,1.07226,686,12,0,2024-06-25 13:00:00,2024-06-25 13:00:00,-0.0003777380952378895,7.708700363706633e-05,1.0725695238095228,-8.398239854271884e-05,5.500030271758115e-05,1.0729004761904757,1.073094626669804,1.0737633870514798,1.072388696263898,1.0737043506092852,5.4999272881982676e-05,-2.6594323712636642e-05,1.072584575809986,1.072765798861522,25.701032157984724,30.650387852371377,0.0003295235376684193,1.0726825717074828,1.072950050173992,1.0725291640866867,-0.0002674784665090968,-0.00020753462673986568,0.0006234318995624438,-6.02511179914611e-05,-5.6267629859885204e-05,3.642242862134104e-05,1.073370797151096,-0.42831246897772246,False,True,1.06926,1.07196,1.07196,1.07176,2024-06-25 14:30:00,True,2024-06-25 14:30:00,2024-06-25 17:08:33,2024-06-27 15:43:08,0.02,success,True,109.0,7029.38,,1,0,26,6
2024-06-25 14:00:00,1.07226,1.07237,1.07195,1.07205,843,12,0,2024-06-25 14:00:00,2024-06-25 14:00:00,-0.00033095238095293134,-2.7611726712617468e-05,1.071884642857142,-0.0001379786661451826,2.8012420271463378e-05,1.0725695238095228,1.0730584726860797,1.074081238266873,1.073094626669804,1.0737633870514798,5.500030271758115e-05,-8.398239854271884e-05,1.0724746031770838,1.0726149349526002,13.68270147924794,24.086599323415626,0.00025809648479221194,1.0725852529832547,1.0728833797907331,1.0724583969728254,-0.0002981268074784271,-0.000225653062887578,0.0006354657085361603,-7.076711386133638e-05,-6.02511179914611e-05,-5.6267629859885204e-05,1.0733162756793493,-0.42839948173369846,False,True,1.06905,1.07175,1.07175,1.07155,2024-06-25 14:30:00,True,2024-06-25 14:30:00,2024-06-25 17:09:41,2024-06-27 15:39:50,0.02,success,True,109.0,7138.38,,2,0,26,6
2024-06-25 14:15:00,1.07206,1.07206,1.07136,1.07141,698,12,0,2024-06-25 14:00:00,2024-06-25 14:00:00,-0.00033095238095293134,-2.7611726712617468e-05,1.071884642857142,-0.0001379786661451826,2.8012420271463378e-05,1.0725695238095228,1.0730584726860797,1.074081238266873,1.073094626669804,1.0737633870514798,5.500030271758115e-05,-8.398239854271884e-05,1.0724746031770838,1.0726149349526002,7.607483526224146,15.66373905448561,0.00025809648479221194,1.0724044448319847,1.0727742405469751,1.0722532576539383,-0.0003697957149904063,-0.0002544815933081437,0.0006736843969733603,-0.00020513931888710424,-7.076711386133638e-05,-6.02511179914611e-05,1.0731627315898524,-0.4286562162819758,False,True,1.06841,1.07111,1.07111,1.07091,2024-06-25 15:00:00,True,2024-06-25 15:00:00,2024-06-26 13:13:59,2024-06-25 15:01:05,0.02,even,True,10.9,7149.28,,3,0,26,6
2024-06-25 14:30:00,1.07142,1.07145,1.07085,1.07107,841,12,0,2024-06-25 14:00:00,2024-06-25 14:00:00,-0.00033095238095293134,-2.7611726712617468e-05,1.071884642857142,-0.0001379786661451826,2.8012420271463378e-05,1.0725695238095228,1.0730584726860797,1.074081238266873,1.073094626669804,1.0737633870514798,5.500030271758115e-05,-8.398239854271884e-05,1.0724746031770838,1.0726149349526002,5.614072204452687,8.968085736641598,0.00025809648479221194,1.0721991456270639,1.0726480005064585,1.071974361885105,-0.0004488548793946112,-0.00029335625052543724,0.000711229686335841,-0.00027889576883333156,-0.00020513931888710424,-7.076711386133638e-05,1.0729345219616584,-0.42898579819144844,False,True,1.06807,1.07077,1.07077,1.07057,2024-06-25 16:00:00,True,2024-06-25 16:00:00,2024-06-26 14:23:25,2024-06-25 16:02:05,0.02,even,True,10.9,7160.179999999999,,4,0,26,6
2024-06-25 14:45:00,1.07108,1.07134,1.07085,1.07088,919,12,0,2024-06-25 14:00:00,2024-06-25 14:00:00,-0.00033095238095293134,-2.7611726712617468e-05,1.071884642857142,-0.0001379786661451826,2.8012420271463378e-05,1.0725695238095228,1.0730584726860797,1.074081238266873,1.073094626669804,1.0737633870514798,5.500030271758115e-05,-8.398239854271884e-05,1.0724746031770838,1.0726149349526002,3.87750189146078,5.699685874045879,0.00025809648479221194,1.071996200145977,1.07251703750598,1.0716598314413488,-0.0005208373600029681,-0.00033885247242094346,0.0007507167686453981,-0.000314530443756178,-0.00027889576883333156,-0.00020513931888710424,1.07267329907902,-0.4293536361963224,False,True,1.0678800000000002,1.07058,1.07058,1.07038,2024-06-25 16:30:00,True,2024-06-25 16:30:00,2024-06-26 15:49:44,2024-06-25 16:36:29,0.02,even,True,10.9,7171.079999999999,,5,0,26,6
2024-06-25 15:45:00,1.07073,1.07096,1.07015,1.07044,958,12,0,2024-06-25 15:00:00,2024-06-25 15:00:00,-0.0006848809523807287,-0.00025264759641818735,1.0712405952380941,-0.0001723751816903008,-4.13205564165813e-05,1.071884642857142,1.0729080007403191,1.074702177824607,1.0730584726860797,1.074081238266873,2.8012420271463378e-05,-0.0001379786661451826,1.0723433384559815,1.0724409401563921,5.917724810040301,8.055359302537193,0.0001559476685501321,1.0714199063876353,1.072074735136682,1.070755761953904,-0.0006548287490466542,-0.0004938303256604266,0.0008638821293395648,-0.00024848641210883926,-0.00022108015135891002,-0.00025066391468908655,1.0719220028285126,-0.4304104789207044,False,True,1.0674400000000002,1.07014,1.07014,1.0699400000000001,2024-06-25 17:15:00,True,2024-06-25 17:15:00,2024-06-26 16:13:15,2024-06-25 18:00:32,0.02,even,True,10.9,7181.979999999999,,6,0,26,6
2024-06-25 16:45:00,1.07045,1.07056,1.06995,1.0702099999999999,996,12,0,2024-06-25 16:00:00,2024-06-25 16:00:00,-0.000644047619047905,-0.00045087862741399753,1.0707538095238098,-0.00019689777147647832,-0.0001308211920438512,1.0712405952380941,1.0731003954958214,1.0753247392964556,1.0729080007403191,1.074702177824607,-4.13205564165813e-05,-0.0001723751816903008,1.072205703716886,1.0722624649438808,9.85153965379291,13.958864068534867,3.4582409357306165e-05,1.0709436794727556,1.0716485767427923,1.0702430409356727,-0.0007048972700367528,-0.000605186168988496,0.0010418385991725972,-0.00014976608187078355,-0.0001299105607164286,-0.0001582077743378374,1.0716495230445557,-0.43116344117321037,False,True,1.06721,1.06991,1.06991,1.06971,2024-06-25 17:15:00,True,2024-06-25 17:15:00,2024-06-26 16:17:39,2024-06-25 17:43:44,0.02,even,True,10.9,7192.879999999998,,7,0,26,6
2024-06-25 17:00:00,1.07019,1.07027,1.069,1.06943,1773,12,0,2024-06-25 17:00:00,2024-06-25 17:00:00,-0.00048678571428428796,-0.0006023499913765384,1.0702894047619043,-0.00025089530785829745,-0.0002047141070820095,1.0707538095238098,1.0730124713098177,1.0756448763944855,1.0731003954958214,1.0753247392964556,-0.0001308211920438512,-0.00019689777147647832,1.0720634002512806,1.0720814677483703,11.906901996078384,12.811432498899256,-9.280407078946275e-05,1.0707108057077164,1.0714842377248077,1.069987389060888,-0.0007734320170913467,-0.0006388353386090662,0.0011369613010385905,-0.0002556518747847125,-0.00014976608187078355,-0.0001299105607164286,1.07152228681729,-0.43154750869551406,False,True,1.0664300000000002,1.0691300000000001,1.0691300000000001,1.0689300000000002,2024-06-26 10:15:00,True,2024-06-26 10:15:00,,2024-06-26 10:46:40,0.02,even,True,10.9,7203.779999999998,,8,0,26,6
2024-06-25 17:15:00,1.06946,1.06966,1.06919,1.06935,1219,12,0,2024-06-25 17:00:00,2024-06-25 17:00:00,-0.00048678571428428796,-0.0006023499913765384,1.0702894047619043,-0.00025089530785829745,-0.0002047141070820095,1.0707538095238098,1.0730124713098177,1.0756448763944855,1.0731003954958214,1.0753247392964556,-0.0001308211920438512,-0.00019689777147647832,1.0720634002512806,1.0720814677483703,10.673985207514226,10.810808952461848,-9.280407078946275e-05,1.0705014509834523,1.0713261460414887,1.0697352184382516,-0.0008246950580363954,-0.0006760072824945321,0.0012008875884359476,-0.0002521706226363829,-0.0002556518747847125,-0.00014976608187078355,1.0713564166826401,-0.43188597980613697,False,True,1.0663500000000001,1.06905,1.06905,1.06885,2024-06-26 10:30:00,True,2024-06-26 10:30:00,,2024-06-26 10:44:43,0.02,even,True,10.9,7214.679999999998,,9,0,26,6
2024-06-26 10:15:00,1.0688900000000001,1.06906,1.06846,1.06876,1008,12,0,2024-06-26 10:00:00,2024-06-26 10:00:00,-0.0004970238095227675,-0.000386147047765073,1.069834285714285,-0.00010601310966102584,6.839712396387975e-07,1.0703028571428579,1.070152809350621,1.0717227188297547,1.0700074980105616,1.0716507919018683,6.76028729982212e-06,-4.36670436656363e-05,1.0711478912973562,1.0710173606838396,5.551547218213339,6.405233333094756,-0.00027136099413747905,1.0698727266064378,1.0703866820225445,1.0694155314757474,-0.0005139554161066595,-0.00030094539720402927,0.0007785492919916544,-0.00029431716546257647,-0.000282817337461605,-0.00018998624011112852,1.070466573019936,-0.43163551006844125,False,True,1.06576,1.06846,1.06846,1.06826,2024-06-26 13:30:00,True,2024-06-26 13:30:00,,2024-06-26 13:33:52,0.02,even,True,10.9,7225.579999999997,,10,0,26,6
2024-06-26 13:00:00,1.06884,1.06884,1.06834,1.06836,610,12,0,2024-06-26 13:00:00,2024-06-26 13:00:00,-0.00034547619047642364,-0.0006113150893722885,1.068767261904762,-0.00022185592899689416,-0.00016102712996488177,1.0691735714285713,1.0712925905405115,1.0729272901795648,1.071146839393684,1.072554420835819,-9.692488534389928e-05,-0.00019418874508514176,1.0707338834161735,1.070539744476178,14.79780685853809,31.5239546982835,-0.0004076492252649171,1.0692347570114293,1.069705320473127,1.0689506845545238,-0.000470563461697715,-0.000423245025919467,0.000810322569554153,-0.0001188028895771076,-5.9755761952828834e-05,-3.6762985896832134e-05,1.070044620023422,-0.43214325091437433,False,True,1.06536,1.06806,1.06806,1.06786,2024-06-26 16:00:00,True,2024-06-26 16:00:00,,2024-06-26 16:05:38,0.02,even,True,10.9,7236.479999999997,,11,0,26,6
2024-06-26 13:15:00,1.06837,1.06846,1.06814,1.06822,707,12,0,2024-06-26 13:00:00,2024-06-26 13:00:00,-0.00034547619047642364,-0.0006113150893722885,1.068767261904762,-0.00022185592899689416,-0.00016102712996488177,1.0691735714285713,1.0712925905405115,1.0729272901795648,1.071146839393684,1.072554420835819,-9.692488534389928e-05,-0.00019418874508514176,1.0707338834161735,1.070539744476178,8.696625045646213,18.917904423197943,-0.0004076492252649171,1.0690786405481325,1.069595296734377,1.0688176229790156,-0.000516656186244413,-0.0004419272579844562,0.000834096717051263,-0.00013306157550818654,-0.0001188028895771076,-5.9755761952828834e-05,1.0699436535470348,-0.4323084075890036,False,True,1.06522,1.06792,1.06792,1.06772,2024-06-26 16:00:00,True,2024-06-26 16:00:00,,2024-06-26 16:05:08,0.02,even,True,10.9,7247.3799999999965,,12,0,26,6
2024-06-26 13:30:00,1.06822,1.06873,1.06819,1.0683799999999999,830,12,0,2024-06-26 13:00:00,2024-06-26 13:00:00,-0.00034547619047642364,-0.0006113150893722885,1.068767261904762,-0.00022185592899689416,-0.00016102712996488177,1.0691735714285713,1.0712925905405115,1.0729272901795648,1.071146839393684,1.072554420835819,-9.692488534389928e-05,-0.00019418874508514176,1.0707338834161735,1.070539744476178,6.414450291557885,9.969627398580743,-0.0004076492252649171,1.0689711573868812,1.0695052747540528,1.0687313003095973,-0.0005341173671715715,-0.0004603652798218793,0.0008222311111010952,-8.632266941832611e-05,-0.00013306157550818654,-0.0001188028895771076,1.0698413123095838,-0.4323787116903892,False,True,1.06538,1.06808,1.06808,1.06788,2024-06-26 16:00:00,True,2024-06-26 16:00:00,,2024-06-26 16:05:39,0.02,even,True,10.9,7258.279999999996,,13,0,26,6
2024-06-26 14:15:00,1.06836,1.06837,1.06802,1.06803,970,12,0,2024-06-26 14:00:00,2024-06-26 14:00:00,-0.00040630952380937835,-0.0006989449010768034,1.0688346428571431,-0.0002218530792000081,-0.00019989076452806237,1.068767261904762,1.0710547041748162,1.0730017632827216,1.0712925905405115,1.0729272901795648,-0.00016102712996488177,-0.00022185592899689416,1.0706446006151302,1.0704445649180838,9.726000394241778,11.668966423543488,-0.00046590836042729436,1.0686873966690662,1.0692492078459623,1.0684400171998627,-0.000561811176896132,-0.000503371212007704,0.0007387715028317112,-0.0001471001031985164,-8.893016855870961e-05,-5.52528379773598e-05,1.0694373587286856,-0.4325573243289602,False,True,1.0650300000000001,1.06773,1.06773,1.06753,2024-06-26 16:15:00,True,2024-06-26 16:15:00,,2024-06-26 16:55:08,0.02,even,True,10.9,7269.179999999996,,14,0,26,6
2024-06-26 15:30:00,1.06856,1.06863,1.06795,1.06832,1263,12,0,2024-06-26 15:00:00,2024-06-26 15:00:00,6.73809523812352e-05,-0.0006389372424753237,1.0684234523809528,-0.0002281544557314512,-0.00020513521988769625,1.0688346428571431,1.0708845306445827,1.072804736266778,1.0710547041748162,1.0730017632827216,-0.00019989076452806237,-0.0002218530792000081,1.0704507554141542,1.0702201997246372,29.85074626865241,40.43547996198165,-0.0005005141368369002,1.0686442307313895,1.0690520220537165,1.0682647678018573,-0.0004077913223270446,-0.0004560984103920202,0.0005371523682623506,-5.5820433436659656e-05,-2.999312005491639e-05,-5.924664602785512e-05,1.0689899234990115,-0.43246038789529684,False,True,1.06532,1.06802,1.06802,1.06782,2024-06-26 16:00:00,True,2024-06-26 16:00:00,,2024-06-26 16:05:38,0.02,even,True,10.9,7280.079999999995,,15,0,26,6
2024-06-26 15:45:00,1.06831,1.06834,1.06762,1.06764,1345,12,0,2024-06-26 15:00:00,2024-06-26 15:00:00,6.73809523812352e-05,-0.0006389372424753237,1.0684234523809528,-0.0002281544557314512,-0.00020513521988769625,1.0688346428571431,1.0708845306445827,1.072804736266778,1.0710547041748162,1.0730017632827216,-0.00019989076452806237,-0.0002218530792000081,1.0704507554141542,1.0702201997246372,18.572155723030864,31.784969541726344,-0.0005005141368369002,1.0684897336957913,1.0689474278275153,1.068139590643275,-0.00045769413172402906,-0.00045641755465842203,0.0005781946039727846,-0.0001251771585824013,-5.5820433436659656e-05,-2.999312005491639e-05,1.068920153358638,-0.4326409720720883,False,True,1.06464,1.06734,1.06734,1.06714,2024-06-26 16:30:00,True,2024-06-26 16:30:00,,2024-06-26 16:40:12,0.02,even,True,10.9,7290.979999999995,,16,0,26,6
2024-06-26 16:00:00,1.06764,1.06816,1.0673,1.06743,1603,12,0,2024-06-26 16:00:00,2024-06-26 16:00:00,-0.0004111904761903151,-0.0007716742379488828,1.0680461904761913,-0.0002874224847928364,-0.00022151370841441635,1.0684234523809528,1.071118007459982,1.072696025778463,1.0708845306445827,1.072804736266778,-0.00020513521988769625,-0.0002281544557314512,1.0702558679680798,1.0699969837466663,9.514757092176621,19.31255302795331,-0.0005547461570592967,1.0683266977425925,1.0688350257662178,1.0679626590987266,-0.0005083280236253263,-0.0004667996484518029,0.0006307146740510398,-0.00017693154454834215,-0.0001251771585824013,-5.5820433436659656e-05,1.0688141239086955,-0.43288880571124233,False,True,1.0644300000000002,1.07823,1.0671300000000001,1.0669300000000002,,False,,,,0.02,running,False,0.0,7290.979999999995,2024-06-26 19:00:00,0,1,26,6
2024-06-26 16:15:00,1.06742,1.06744,1.06687,1.06696,1362,12,0,2024-06-26 16:00:00,2024-06-26 16:00:00,-0.0004111904761903151,-0.0007716742379488828,1.0680461904761913,-0.0002874224847928364,-0.00022151370841441635,1.0684234523809528,1.071118007459982,1.072696025778463,1.0708845306445827,1.072804736266778,-0.00020513521988769625,-0.0002281544557314512,1.0702558679680798,1.0699969837466663,3.564847845758191,10.55058688698857,-0.0005547461570592967,1.0681164365514244,1.0686961349687203,1.0677337461300305,-0.0005796984172958819,-0.0004893794022206188,0.0007256392584450901,-0.00022891296869609334,-0.00017693154454834215,-0.0001251771585824013,1.0687133591289313,-0.43324586686887034,False,True,1.06396,1.0777599999999998,1.06666,1.06646,,False,,,,0.02,running,False,0.0,7290.979999999995,2024-06-26 19:15:00,0,2,26,6
2024-06-27 12:30:00,1.06956,1.06967,1.06935,1.06953,889,12,0,2024-06-27 12:00:00,2024-06-27 12:00:00,-0.00023583333333410117,8.867521329380956e-05,1.0692379761904767,3.855117214224094e-05,0.00010362119508550895,1.0690754761904755,1.0674065198604432,1.0684974548483444,1.0673651884859845,1.0690240857771225,5.749838135840762e-05,3.856039378099199e-05,1.0691083021778478,1.0689788048194167,72.07207207207108,57.237237237236116,-4.83259397025172e-05,1.0690854630074957,1.0690050746946398,1.0689309047127624,8.038831285595016e-05,8.067661556638257e-05,0.0003181781472654438,8.217406260846438e-05,0.0001025834193315589,-5.2524939800902004e-05,2.569360445211571,1.068501364213954,True,False,1.07253,1.06983,1.06983,1.07003,2024-06-27 14:00:00,True,2024-06-27 14:00:00,2024-06-27 16:36:09,2024-06-27 14:19:02,0.02,even,True,10.92,7301.899999999995,,1,0,26,6
2024-06-27 12:45:00,1.06954,1.07004,1.06953,1.06965,674,12,0,2024-06-27 12:00:00,2024-06-27 12:00:00,-0.00023583333333410117,8.867521329380956e-05,1.0692379761904767,3.855117214224094e-05,0.00010362119508550895,1.0690754761904755,1.0674065198604432,1.0684974548483444,1.0673651884859845,1.0690240857771225,5.749838135840762e-05,3.856039378099199e-05,1.0691083021778478,1.0689788048194167,83.23886993789803,70.98953322254147,-4.83259397025172e-05,1.0691723148524963,1.0690528469394813,1.0690333264533882,0.00011946791301498116,8.84348750561023e-05,0.00033259184204859716,0.00010242174062580212,8.217406260846438e-05,0.0001025834193315589,2.5694823254401538,1.0685843274666227,True,False,1.0726499999999999,1.06995,1.06995,1.07015,2024-06-27 14:00:00,True,2024-06-27 14:00:00,,2024-06-27 14:13:57,0.02,even,True,10.92,7312.819999999995,,2,0,26,6
2024-06-27 13:30:00,1.0695000000000001,1.07002,1.06946,1.06992,819,12,0,2024-06-27 13:00:00,2024-06-27 13:00:00,0.0001625000000011756,0.00016296780264357658,1.069575119047619,3.855891674137319e-05,0.0001309888789572007,1.0692379761904767,1.0674475885164518,1.068288453566769,1.0674065198604432,1.0684974548483444,0.00010362119508550895,3.855117214224094e-05,1.0691851859083092,1.0690845004338634,74.43365695792512,72.57791772354629,-6.067191233298444e-06,1.0693244383562461,1.069152064900137,1.069316518747849,0.0001723734561092094,0.00011336011380166865,0.0003670567622733947,0.00016681458548317707,9.939456484286957e-05,1.6983144134785633e-05,2.569812045376918,1.06882099211878,True,False,1.0729199999999999,1.07022,1.07022,1.07042,2024-06-27 15:45:00,True,2024-06-27 15:45:00,,2024-06-27 18:26:11,0.02,even,True,10.92,7323.739999999995,,3,0,26,6
2024-06-27 13:45:00,1.06991,1.07038,1.06976,1.0703,781,12,0,2024-06-27 13:00:00,2024-06-27 13:00:00,0.0001625000000011756,0.00016296780264357658,1.069575119047619,3.855891674137319e-05,0.0001309888789572007,1.0692379761904767,1.0674475885164518,1.068288453566769,1.0674065198604432,1.0684974548483444,0.00010362119508550895,3.855117214224094e-05,1.0691851859083092,1.0690845004338634,88.3710895361337,77.6231571377165,-6.067191233298444e-06,1.0694745247629776,1.0692370971297565,1.0695610354317169,0.00023742763322109894,0.00013817361768555473,0.00042477758893798664,0.00024451668386782366,0.00016681458548317707,9.939456484286957e-05,2.570134485176783,1.0689875856866506,True,False,1.0733,1.0706,1.0706,1.0708,2024-06-27 15:45:00,True,2024-06-27 15:45:00,,2024-06-27 18:10:22,0.02,even,True,10.92,7334.659999999995,,4,0,26,6
2024-06-27 14:00:00,1.07031,1.07035,1.06989,1.06997,767,12,0,2024-06-27 14:00:00,2024-06-27 14:00:00,0.0003371428571423696,0.0002825289063264069,1.0694846428571434,3.855261739257175e-05,0.00013098801097127593,1.069575119047619,1.0674887872363092,1.068428266959445,1.0674475885164518,1.068288453566769,0.0001309888789572007,3.855891674137319e-05,1.0691867868174505,1.0690945403991543,91.2526968716262,84.68581445522835,5.165202827864263e-05,1.0695507517225196,1.069291386231256,1.069700316477468,0.00025936549126348574,0.00016241199240114095,0.00044716439937004935,0.00013928104575122724,0.00024451668386782366,0.00016681458548317707,2.570303988416618,1.0690966445383185,True,False,1.07297,1.07027,1.07027,1.07047,2024-06-27 15:45:00,True,2024-06-27 15:45:00,,2024-06-27 18:26:05,0.02,even,True,10.92,7345.579999999995,,5,0,26,6
2024-06-27 15:30:00,1.07009,1.07198,1.0695999999999999,1.07165,2641,12,0,2024-06-27 15:00:00,2024-06-27 15:00:00,-9.047619047564126e-05,0.00023710130130893958,1.0703222619047619,3.855264676024344e-05,0.00025607310684403443,1.0694846428571434,1.0675300448193694,1.0680586520915578,1.0674887872363092,1.068428266959445,0.00013098801097127593,3.855261739257175e-05,1.0693605425066475,1.069317377167222,78.11254962217177,68.64837661650485,8.874188288470203e-05,1.0700007350388838,1.0696208284526616,1.070438627450981,0.00037990658622222284,0.00025145654113173686,0.0006872149106337869,0.00033916752666041106,9.396972824182726e-05,6.48744410043367e-05,2.5713663675803367,1.0695108873216252,True,False,1.0746499999999999,1.07195,1.07195,1.07215,2024-06-27 16:45:00,True,2024-06-27 16:45:00,,2024-06-27 16:52:27,0.02,even,True,10.92,7356.499999999995,,6,0,26,6
2024-06-27 15:45:00,1.07165,1.07215,1.0711,1.07188,1971,12,0,2024-06-27 15:00:00,2024-06-27 15:00:00,-9.047619047564126e-05,0.00023710130130893958,1.0703222619047619,3.855264676024344e-05,0.00025607310684403443,1.0694846428571434,1.0675300448193694,1.0680586520915578,1.0674887872363092,1.068428266959445,0.00013098801097127593,3.855261739257175e-05,1.0693605425066475,1.069317377167222,87.78853313476985,76.36613954074858,8.874188288470203e-05,1.0702898527252094,1.0697881744932052,1.0707472411420709,0.000501678232004199,0.0003015008793062293,0.0008368287360012675,0.00030861369108992065,0.00033916752666041106,9.396972824182726e-05,2.571876959935673,1.0696175223484692,True,False,1.0748799999999998,1.06108,1.07218,1.0723799999999999,,False,,,,0.02,running,False,0.0,7356.499999999995,2024-06-27 18:45:00,0,1,26,6
2024-06-27 16:00:00,1.07189,1.07229,1.07169,1.07204,1695,12,0,2024-06-27 16:00:00,2024-06-27 16:00:00,0.0008376190476184764,0.0004965068755855562,1.071063214285714,3.9405098957411906e-05,0.00027656574777110593,1.0703222619047619,1.0675621683205354,1.0681601668600433,1.0675300448193694,1.0680586520915578,0.00025607310684403443,3.855264676024344e-05,1.0695295397642832,1.0695303869938442,91.14563355069883,85.6822387692135,0.00017029488142487287,1.0705591061521003,1.0699549763825975,1.071063629170966,0.0006041297695027481,0.0003620266573455331,0.0009670999603958141,0.00031638802889522033,0.00030861369108992065,0.00033916752666041106,2.5723692141175007,1.0697580442244317,True,False,1.07504,1.0612400000000002,1.07234,1.07254,,False,,,,0.02,running,False,0.0,7356.499999999995,2024-06-27 19:00:00,0,2,26,6
2024-06-27 16:15:00,1.07205,1.07246,1.07164,1.0719400000000001,1196,12,0,2024-06-27 16:00:00,2024-06-27 16:00:00,0.0008376190476184764,0.0004965068755855562,1.071063214285714,3.9405098957411906e-05,0.00027656574777110593,1.0703222619047619,1.0675621683205354,1.0681601668600433,1.0675300448193694,1.0680586520915578,0.00025607310684403443,3.855264676024344e-05,1.0695295397642832,1.0695303869938442,89.63144928289512,89.52187198945461,0.00017029488142487287,1.0707715513594693,1.0701020151690717,1.071313866529068,0.0006695361903976682,0.0004235285639559601,0.00106331039685706,0.0002502373581019235,0.00031638802889522033,0.00030861369108992065,2.5727493355648248,1.069878397493311,True,False,1.07494,1.0611400000000002,1.07224,1.07244,,False,,,,0.02,running,False,0.0,7356.499999999995,2024-06-27 19:15:00,0,3,26,6
2024-06-28 07:00:00,1.06915,1.06916,1.06882,1.06884,196,12,0,2024-06-28 07:00:00,2024-06-28 07:00:00,-0.0002542857142857624,-0.00017607313100853617,1.0689658333333338,-0.0001383542717522556,-0.00013523736189976923,1.0693269047619047,1.0702562861082288,1.0726048223417064,1.0692062984197257,1.0727497776597679,-0.00013523454286411293,-5.1776530602598887e-05,1.0697603281221655,1.069757473365505,24.56814021402681,27.969597873333836,8.445462014843352e-05,1.0693171096560392,1.069658007188516,1.068845276917784,-0.00034089753247679155,-0.0003004546444344644,0.0007328774340884035,-5.012039903773413e-05,-2.8152734778075228e-05,-6.497764017776575e-05,1.0698346614538035,-0.4321441076182353,False,True,1.0658400000000001,1.07964,1.06854,1.06834,,False,,,,0.02,running,False,0.0,7356.499999999995,2024-06-28 10:00:00,0,4,26,6
2024-06-28 07:15:00,1.06883,1.06884,1.0685,1.06852,265,12,0,2024-06-28 07:00:00,2024-06-28 07:00:00,-0.0002542857142857624,-0.00017607313100853617,1.0689658333333338,-0.0001383542717522556,-0.00013523736189976923,1.0693269047619047,1.0702562861082288,1.0726048223417064,1.0692062984197257,1.0727497776597679,-0.00013523454286411293,-5.1776530602598887e-05,1.0697603281221655,1.069757473365505,16.03198501120215,23.183609125037503,8.445462014843352e-05,1.0691944774012638,1.0695737103597371,1.0687525077399376,-0.00037923295847330785,-0.0003162103072422331,0.0007702969124927086,-9.276917784650784e-05,-5.012039903773413e-05,-2.8152734778075228e-05,1.0697924085718027,-0.43228739309192754,False,True,1.06552,1.0793199999999998,1.06822,1.06802,,False,,,,0.02,running,False,0.0,7356.499999999995,2024-06-28 10:15:00,0,5,26,6
2024-06-28 07:30:00,1.06851,1.06871,1.06851,1.06865,324,12,0,2024-06-28 07:00:00,2024-06-28 07:00:00,-0.0002542857142857624,-0.00017607313100853617,1.0689658333333338,-0.0001383542717522556,-0.00013523736189976923,1.0693269047619047,1.0702562861082288,1.0726048223417064,1.0692062984197257,1.0727497776597679,-0.00013523454286411293,-5.1776530602598887e-05,1.0697603281221655,1.069757473365505,11.726370328832678,17.442165184687223,8.445462014843352e-05,1.0691107116472232,1.069505287370127,1.068743278293773,-0.0003945757229038005,-0.0003318833903745466,0.0007884102147542925,-9.22944616466026e-06,-9.276917784650784e-05,-5.012039903773413e-05,1.0698076320836911,-0.4323210754961453,False,True,1.0656500000000002,1.07945,1.0683500000000001,1.0681500000000002,,False,,,,0.02,running,False,0.0,7356.499999999995,2024-06-28 10:30:00,0,6,26,6
2024-06-28 07:45:00,1.06865,1.06866,1.06852,1.0686,253,12,0,2024-06-28 07:00:00,2024-06-28 07:00:00,-0.0002542857142857624,-0.00017607313100853617,1.0689658333333338,-0.0001383542717522556,-0.00013523736189976923,1.0693269047619047,1.0702562861082288,1.0726048223417064,1.0692062984197257,1.0727497776597679,-0.00013523454286411293,-5.1776530602598887e-05,1.0697603281221655,1.069757473365505,9.320987654314896,12.359780998116586,8.445462014843352e-05,1.0690321406245735,1.069438229046414,1.0687514551083583,-0.0004060884218404226,-0.0003467243966677218,0.0008002108055977235,8.176814585425518e-06,-9.22944616466026e-06,-9.276917784650784e-05,2.569831739695915,1.0676711705208015,False,True,1.0656,1.0794,1.0683,1.0681,,False,,,,0.02,running,False,0.0,7356.499999999995,2024-06-28 10:45:00,0,7,26,6
2024-06-28 18:15:00,1.07146,1.07157,1.0709,1.0714,1264,12,0,2024-06-28 18:00:00,2024-06-28 18:00:00,0.0005022619047616583,0.0002615388244702199,1.070846666666667,6.64597225758709e-05,7.461701545299095e-05,1.0707045238095239,1.0682105139427553,1.0710254861742208,1.068139527231225,1.0709456160362651,7.462564718219476e-05,6.646238596770562e-05,1.0700548053908578,1.0701163338499116,79.8975167520714,64.56229464314237,7.078774847181903e-05,1.070655121672676,1.0703445618975773,1.0707735534915719,0.000310559775098751,0.0001790950175247747,0.0005786700269274583,0.0002510251117990858,0.0002430994152040622,0.00031953560371555945,2.571554758027924,1.0699923489552199,True,False,1.0743999999999998,1.0716999999999999,1.0716999999999999,1.0718999999999999,2024-06-28 19:30:00,True,2024-06-28 19:30:00,2024-07-01 00:00:02,2024-06-28 19:38:01,0.02,even,True,10.92,7367.4199999999955,,1,0,26,6
2024-06-28 18:30:00,1.0714,1.0717,1.07125,1.07131,1114,12,0,2024-06-28 18:00:00,2024-06-28 18:00:00,0.0005022619047616583,0.0002615388244702199,1.070846666666667,6.64597225758709e-05,7.461701545299095e-05,1.0707045238095239,1.0682105139427553,1.0710254861742208,1.068139527231225,1.0709456160362651,7.462564718219476e-05,6.646238596770562e-05,1.0700548053908578,1.0701163338499116,74.72492820541841,73.08451026216743,7.078774847181903e-05,1.070755872184572,1.07041607583109,1.0709859614723083,0.0003397963534819137,0.00021123528471620254,0.000573071548817801,0.00021240798073640654,0.0002510251117990858,0.0002430994152040622,2.5717596080632124,1.0702123148814042,True,False,1.0743099999999999,1.07161,1.07161,1.07181,2024-06-28 19:30:00,True,2024-06-28 19:30:00,2024-07-01 00:00:02,2024-06-28 19:39:02,0.02,even,True,10.92,7378.339999999996,,2,0,26,6
2024-06-28 19:15:00,1.07159,1.07207,1.07146,1.07191,747,12,0,2024-06-28 19:00:00,2024-06-28 19:00:00,0.0001421428571430905,0.00030735318856289773,1.0710732142857142,6.646124689156759e-05,0.00017832968232474883,1.070846666666667,1.068281519367833,1.0698325349694253,1.0682105139427553,1.0710254861742208,7.461701545299095e-05,6.64597225758709e-05,1.070149979236609,1.0702294271419188,78.53107344632757,73.33333333333348,0.00011810083649003478,1.071074212962069,1.0706474604918348,1.0714334743722052,0.00042675247023415963,0.0002970076127055403,0.0006812549694483182,0.00017710354317057586,0.00016042999656185053,0.0001099793601644361,2.5723531685809604,1.07051378016345,True,False,1.0749099999999998,1.0722099999999999,1.0722099999999999,1.0724099999999999,2024-07-01 00:15:00,True,2024-07-01 00:15:00,2024-07-01 03:43:25,2024-07-01 18:09:23,0.02,success,True,109.18,7487.519999999996,,3,0,26,6
2024-06-28 19:30:00,1.0719,1.07209,1.07128,1.07154,943,12,0,2024-06-28 19:00:00,2024-06-28 19:00:00,0.0001421428571430905,0.00030735318856289773,1.0710732142857142,6.646124689156759e-05,0.00017832968232474883,1.070846666666667,1.068281519367833,1.0698325349694253,1.0682105139427553,1.0710254861742208,7.461701545299095e-05,6.64597225758709e-05,1.070149979236609,1.0702294271419188,83.95480225988729,78.07909604519803,0.00011810083649003478,1.071145872506366,1.0707135745294767,1.071560340557276,0.0004322979768893731,0.00032406568554230685,0.0007083965462447314,0.0001268661850708508,0.00017710354317057586,0.00016042999656185053,2.5725166758947067,1.0706040052198456,True,False,1.0745399999999998,1.07184,1.07184,1.0720399999999999,2024-06-28 20:15:00,True,2024-06-28 20:15:00,2024-07-01 03:23:28,2024-06-28 20:29:04,0.02,even,True,10.92,7498.439999999996,,4,0,26,6
2024-06-28 19:45:00,1.07153,1.07168,1.07135,1.07153,862,12,0,2024-06-28 19:00:00,2024-06-28 19:00:00,0.0001421428571430905,0.00030735318856289773,1.0710732142857142,6.646124689156759e-05,0.00017832968232474883,1.070846666666667,1.068281519367833,1.0698325349694253,1.0682105139427553,1.0710254861742208,7.461701545299095e-05,6.64597225758709e-05,1.070149979236609,1.0702294271419188,83.38983050847617,81.95856873823037,0.00011810083649003478,1.071204969043848,1.0707740504902563,1.0716734468524263,0.0004309185535917859,0.0003454362591522027,0.0007308412960861736,0.00011310629515026704,0.0001268661850708508,0.00017710354317057586,2.572660082602143,1.07068681110271,True,False,1.07453,1.07183,1.07183,1.07203,2024-06-28 20:15:00,True,2024-06-28 20:15:00,2024-07-01 03:23:24,2024-06-28 20:29:04,0.02,even,True,10.92,7509.359999999996,,5,0,26,6
2024-06-28 20:00:00,1.07152,1.07218,1.07141,1.07212,765,12,0,2024-06-28 20:00:00,2024-06-28 20:00:00,0.00022654761904727927,0.00038366057142824594,1.071301547619047,6.64710366910076e-05,0.00021392110652008943,1.0710732142857142,1.0683523856595347,1.0696451621010814,1.068281519367833,1.0698325349694253,0.00017832968232474883,6.646124689156759e-05,1.0702286902536018,1.0703206729705654,85.43055397565928,84.25839558134093,0.000171212783477677,1.0713457430371023,1.070873750453941,1.0718646611627107,0.0004719925831613292,0.000370747523954028,0.000787045742041106,0.0001912143102844599,0.00011310629515026704,0.0001268661850708508,2.5729271729144663,1.0708021494109552,True,False,1.0751199999999999,1.07242,1.07242,1.07262,2024-07-01 00:15:00,True,2024-07-01 00:15:00,2024-07-01 04:23:43,2024-07-01 18:04:43,0.02,success,True,109.18,7618.539999999996,,6,0,26,6
2024-06-28 20:15:00,1.07212,1.07241,1.07177,1.07178,572,12,0,2024-06-28 20:00:00,2024-06-28 20:00:00,0.00022654761904727927,0.00038366057142824594,1.071301547619047,6.64710366910076e-05,0.00021392110652008943,1.0710732142857142,1.0683523856595347,1.0696451621010814,1.068281519367833,1.0698325349694253,0.00017832968232474883,6.646124689156759e-05,1.0702286902536018,1.0703206729705654,85.78115326812349,84.867179250753,0.000171212783477677,1.071412551800625,1.0709408800499454,1.0719823495012042,0.0004716717506796364,0.0003909323692991497,0.0008162328099660827,0.00011768833849346017,0.0001912143102844599,0.00011310629515026704,2.5730842637946587,1.07088043520775,True,False,1.0747799999999998,1.07208,1.07208,1.07228,2024-07-01 00:15:00,True,2024-07-01 00:15:00,2024-07-01 03:37:52,2024-07-01 18:10:16,0.02,success,True,109.18,7727.719999999997,,7,0,26,6
2024-07-01 00:15:00,1.07419,1.07431,1.07352,1.07365,103,13,0,2024-07-01 00:00:00,2024-07-01 00:00:00,-5.0833333333777375e-05,0.0003327503051140379,1.0719690476190478,0.00016592361537971572,0.0002671605991970683,1.0712669047619043,1.067794307600172,1.0702130457047996,1.0683005056222714,1.0710094059588515,0.00012261171941514013,9.423394044155516e-05,1.0706027437289005,1.0707526460025754,72.24641350210935,54.227204284090284,0.00028504354076953464,1.0719114671093914,1.07147237749592,1.0718981871345028,0.0004390896134713884,0.00022289803193119078,0.0007897678984361715,0.00041824217406238873,0.000561231510149085,6.3295493624160315e-06,2.572964373797392,1.0708320004716139,True,False,1.0766499999999999,1.07395,1.07395,1.07415,2024-07-01 03:30:00,True,2024-07-01 03:30:00,2024-07-01 09:05:13,2024-07-01 15:41:35,0.02,success,True,109.18,7836.899999999997,,8,0,27,7
2024-07-01 00:30:00,1.07366,1.07395,1.07351,1.07372,314,19,0,2024-07-01 00:00:00,2024-07-01 00:00:00,-5.0833333333777375e-05,0.0003327503051140379,1.0719690476190478,0.00016592361537971572,0.0002671605991970683,1.0712669047619043,1.067794307600172,1.0702130457047996,1.0683005056222714,1.0710094059588515,0.00012261171941514013,9.423394044155516e-05,1.0706027437289005,1.0707526460025754,83.88185654008515,71.00113269703728,0.00028504354076953464,1.0721897029387157,1.0716388680517779,1.0723506983144142,0.0005508348869378565,0.00028848540293252393,0.0009006604984124338,0.0004525111799114079,0.00041824217406238873,0.000561231510149085,2.573566589987271,1.0711348066415574,True,False,1.07672,1.07402,1.07402,1.07422,2024-07-01 03:45:00,True,2024-07-01 03:45:00,2024-07-01 09:08:14,2024-07-01 15:31:10,0.02,success,True,109.18,7946.079999999997,,9,0,27,7
2024-07-01 00:45:00,1.07379,1.07392,1.07353,1.0737700000000001,206,16,0,2024-07-01 00:00:00,2024-07-01 00:00:00,-5.0833333333777375e-05,0.0003327503051140379,1.0719690476190478,0.00016592361537971572,0.0002671605991970683,1.0712669047619043,1.067794307600172,1.0702130457047996,1.0683005056222714,1.0710094059588515,0.00012261171941514013,9.423394044155516e-05,1.0706027437289005,1.0707526460025754,80.33755274261785,78.8219409282708,0.00028504354076953464,1.0724328255635287,1.0717967296775721,1.072756687306501,0.0006360958859565891,0.000358007499537337,0.0009931059024096147,0.0004059889920868809,0.0004525111799114079,0.00041824217406238873,2.574097380274754,1.0714159943382482,True,False,1.07677,1.07407,1.07407,1.07427,2024-07-01 03:45:00,True,2024-07-01 03:45:00,2024-07-01 09:12:31,2024-07-01 15:30:47,0.02,success,True,109.18,8055.2599999999975,,10,0,27,7
2024-07-01 01:45:00,1.07349,1.07366,1.07343,1.07361,265,13,0,2024-07-01 01:00:00,2024-07-01 01:00:00,0.0007021428571434285,0.0006039763789920105,1.0726648809523809,0.00023998212251254215,0.0002671812928482185,1.0719690476190478,1.067423579841547,1.0704986514792376,1.067794307600172,1.0702130457047996,0.0002671605991970683,0.00016592361537971572,1.07079676026252,1.0709812343223695,77.72151898734137,77.60900140646987,0.0003488301084140298,1.0729879058532834,1.0722664845021397,1.0738120295837636,0.0007214213511437251,0.0005651841854364313,0.00118910428477423,0.00021818369453119324,0.00024652562779414744,0.0003037392500868652,2.575417320368209,1.0722067387993184,True,False,1.0766099999999998,1.07391,1.07391,1.07411,2024-07-01 03:30:00,True,2024-07-01 03:30:00,2024-07-01 09:04:58,2024-07-01 15:41:46,0.02,success,True,109.18,8164.439999999998,,11,0,27,7
2024-07-01 02:00:00,1.07367,1.07385,1.07362,1.07385,333,12,0,2024-07-01 02:00:00,2024-07-01 02:00:00,0.0006958333333331179,0.0007587999268834356,1.0730905952380947,0.00023998593881434342,0.0002671736809592822,1.0726648809523809,1.0676797060369496,1.0707847643169413,1.067423579841547,1.0704986514792376,0.0002671812928482185,0.00023998212251254215,1.070966646697196,1.07117713557658,78.29248586048982,77.4336415596848,0.000430824072107911,1.073120535722009,1.0723837819464257,1.0740357344341251,0.0007367537755833542,0.000599498103465816,0.0012354490412000174,0.00022370485036149468,0.00021818369453119324,0.00024652562779414744,2.575703590639745,1.072367878228505,True,False,1.0768499999999999,1.07415,1.07415,1.07435,2024-07-01 03:45:00,True,2024-07-01 03:45:00,2024-07-01 09:12:51,2024-07-01 03:55:38,0.02,even,True,10.92,8175.359999999998,,12,0,27,7
2024-07-01 02:15:00,1.07383,1.07389,1.07357,1.07358,175,12,0,2024-07-01 02:00:00,2024-07-01 02:00:00,0.0006958333333331179,0.0007587999268834356,1.0730905952380947,0.00023998593881434342,0.0002671736809592822,1.0726648809523809,1.0676797060369496,1.0707847643169413,1.067423579841547,1.0704986514792376,0.0002671812928482185,0.00023998212251254215,1.070966646697196,1.07117713557658,78.83270491067452,78.2822365861686,0.000430824072107911,1.0731912225340077,1.0724723906911349,1.0741465772273835,0.0007188318428728024,0.0006233648513472133,0.0012677995372832253,0.00011084279325834778,0.00022370485036149468,0.00021818369453119324,2.5758581066027157,1.0724350478520512,True,False,1.0765799999999999,1.07388,1.07388,1.07408,2024-07-01 03:30:00,True,2024-07-01 03:30:00,2024-07-01 09:04:20,2024-07-01 17:34:37,0.02,success,True,109.18,8284.539999999997,,13,0,27,7
2024-07-01 03:30:00,1.07419,1.07491,1.07418,1.07488,727,12,0,2024-07-01 03:00:00,2024-07-01 03:00:00,0.00042571428571380743,0.0008271026284654148,1.0737990476190482,0.0002399769498691808,0.0002671845048620793,1.0730905952380947,1.0679362675533692,1.071071034865124,1.0676797060369496,1.0707847643169413,0.0002671736809592822,0.00023998593881434342,1.0711946049747965,1.0714429647304535,80.69325015581296,74.83806754350907,0.0005100797833794118,1.0736710599993118,1.0729522388710941,1.0743651840385278,0.0007188211282176393,0.000657792578315296,0.0013965305820987245,0.0001358754729963163,6.673202614360108e-05,-4.2397660817261595e-05,2.576250500324361,1.0724798677526945,True,False,1.07788,1.07518,1.07518,1.07538,2024-07-01 04:30:00,True,2024-07-01 04:30:00,2024-07-03 16:12:37,2024-07-01 04:41:33,0.02,even,True,10.92,8295.459999999997,,14,0,27,7
2024-07-01 03:45:00,1.07487,1.07488,1.07415,1.0745,797,12,0,2024-07-01 03:00:00,2024-07-01 03:00:00,0.00042571428571380743,0.0008271026284654148,1.0737990476190482,0.0002399769498691808,0.0002671845048620793,1.0730905952380947,1.0679362675533692,1.071071034865124,1.0676797060369496,1.0707847643169413,0.0002671736809592822,0.00023998593881434342,1.0711946049747965,1.0714429647304535,82.53424657533849,78.19721215163783,0.0005100797833794118,1.073798589230187,1.0730668878436056,1.0743685070519444,0.000731701386581296,0.0006725743399684961,0.0014133302280090454,3.3230134166561953e-06,0.0001358754729963163,6.673202614360108e-05,2.5762765028597565,1.072460511244132,True,False,1.0775,1.0748,1.0748,1.075,2024-07-01 04:30:00,True,2024-07-01 04:30:00,2024-07-01 09:28:40,2024-07-01 04:45:06,0.02,even,True,10.92,8306.379999999997,,15,0,27,7
2024-07-01 04:00:00,1.0745,1.07488,1.07422,1.07484,858,12,0,2024-07-01 04:00:00,2024-07-01 04:00:00,0.000708452380953517,0.0009727908510785976,1.0743945238095238,0.00023668017628698776,0.00029868839410303907,1.0737990476190482,1.0682170188869609,1.0712926646959977,1.0679362675533692,1.071071034865124,0.0002671845048620793,0.0002399769498691808,1.0714246304602937,1.0717083275520174,90.34090909090878,84.52280194068676,0.000602621996919249,1.0739588062716967,1.07319822948482,1.0743980426556585,0.0007605767868767987,0.0006901748293501566,0.0014224304318329922,2.9535603714103686e-05,3.3230134166561953e-06,0.0001358754729963163,2.576318323738633,1.072477761572684,True,False,1.07784,1.07514,1.07514,1.07534,2024-07-01 04:30:00,True,2024-07-01 04:30:00,2024-07-03 16:11:58,2024-07-01 04:41:34,0.02,even,True,10.92,8317.299999999997,,16,0,27,7
2024-07-01 04:15:00,1.07484,1.07568,1.07475,1.07562,786,12,0,2024-07-01 04:00:00,2024-07-01 04:00:00,0.000708452380953517,0.0009727908510785976,1.0743945238095238,0.00023668017628698776,0.00029868839410303907,1.0737990476190482,1.0682170188869609,1.0712926646959977,1.0679362675533692,1.071071034865124,0.0002671845048620793,0.0002399769498691808,1.0714246304602937,1.0717083275520174,90.11857707509866,87.66457758044866,0.000602621996919249,1.0742143745375896,1.0733776198933518,1.0745127622979014,0.0008367546442378249,0.0007194907923276903,0.0014637480430064573,0.00011471964224285536,2.9535603714103686e-05,3.3230134166561953e-06,2.57648882215596,1.0725367024398427,True,False,1.07862,1.07592,1.07592,1.07612,2024-07-01 09:15:00,True,2024-07-01 09:15:00,2024-07-03 16:44:00,2024-07-01 10:24:26,0.02,even,True,10.92,8328.219999999998,,17,0,27,7
2024-07-01 06:15:00,1.0754299999999999,1.07559,1.07527,1.07537,177,12,0,2024-07-01 06:00:00,2024-07-01 06:00:00,0.0005817857142855765,0.0012003136852942742,1.075212619047619,0.0003330489520487236,0.00029719393359099516,1.0749763095238094,1.0679067409351464,1.0719430985691347,1.0682020672618742,1.071624642099313,0.0002971938327407506,0.00026477687054151386,1.0719105454912665,1.0722623124400277,75.62092838497408,69.00495592630564,0.0007982820846210688,1.0748955391132224,1.074164020132981,1.0754329858961127,0.0007315189802414857,0.0007428416005702859,0.0007480581528706736,8.756105951168713e-05,0.00011834537323696104,0.0001701272789822461,2.5764428644024884,1.0744231073897372,True,False,1.0783699999999998,1.07567,1.07567,1.0758699999999999,2024-07-01 08:45:00,True,2024-07-01 08:45:00,2024-07-03 16:18:09,2024-07-01 08:55:07,0.02,even,True,10.92,8339.139999999998,,18,0,27,7
2024-07-01 08:15:00,1.07561,1.0757,1.07535,1.07567,437,12,0,2024-07-01 08:00:00,2024-07-01 08:00:00,7.11904761909743e-05,0.0012417770237032055,1.075501785714286,0.0004456817090071248,0.00033349971238696925,1.07528380952381,1.0679052332469674,1.0721656580586736,1.0677418963761918,1.0718202473428136,0.0003317298659814246,0.00040342155283587154,1.072353286949173,1.0727529332492396,75.60947295100961,65.00663391733848,0.0009557851303605498,1.075336494192355,1.0747644714967484,1.0755588544891646,0.0005720226956067442,0.0006355613369614481,0.0007171936047856068,2.94736842112453e-05,6.229102167254474e-05,-1.3969728243079516e-05,2.5765270658556254,1.074590643122704,True,False,1.0786699999999998,1.0759699999999999,1.0759699999999999,1.0761699999999998,2024-07-01 09:15:00,True,2024-07-01 09:15:00,2024-07-03 16:45:15,2024-07-01 10:24:22,0.02,even,True,10.92,8350.059999999998,,19,0,27,7
2024-07-01 08:30:00,1.07567,1.07606,1.07564,1.07606,469,12,0,2024-07-01 08:00:00,2024-07-01 08:00:00,7.11904761909743e-05,0.0012417770237032055,1.075501785714286,0.0004456817090071248,0.00033349971238696925,1.07528380952381,1.0679052332469674,1.0721656580586736,1.0677418963761918,1.0718202473428136,0.0003317298659814246,0.00040342155283587154,1.072353286949173,1.0727529332492396,90.6779661016917,76.30085390707744,0.0009557851303605498,1.0754478027781467,1.0748604365710632,1.0756743102855177,0.0005873662070834396,0.0006259223109858465,0.000700634950179102,0.00011545579635319214,2.94736842112453e-05,6.229102167254474e-05,2.57662016746826,1.0747284531027759,True,False,1.07906,1.07636,1.07636,1.07656,2024-07-01 09:15:00,True,2024-07-01 09:15:00,2024-07-03 16:51:01,2024-07-01 09:44:40,0.02,even,True,10.92,8360.979999999998,,20,0,27,7
2024-07-01 18:00:00,1.07295,1.0729899999999999,1.0719,1.07225,1456,12,0,2024-07-01 18:00:00,2024-07-01 18:00:00,-0.0006765476190473407,0.0002603090351243065,1.0735047619047609,-9.450340670246556e-05,-8.696188655877272e-05,1.0742694047619057,1.0734134380682783,1.0781252169753133,1.0733379720651766,1.0773483437431424,3.102657063617747e-05,-3.420463673413447e-05,1.073537044497548,1.0738714186400167,4.819425864034387,9.40301544401524,0.0007499801469081247,1.0741132713486856,1.074633265254714,1.0739315583075333,-0.0005199939060283043,-0.0002802116791099523,0.0008970048309480844,-0.00043088063295582124,-0.0002962848297214382,-0.00021792225662164988,1.0751425148293132,-0.42727939821424665,False,True,1.06925,1.07195,1.07195,1.07175,2024-07-02 10:30:00,True,2024-07-02 10:30:00,,2024-07-02 10:35:37,0.02,even,True,10.9,8371.879999999997,,21,0,27,7
2024-07-01 18:15:00,1.07225,1.07251,1.07217,1.07219,1076,12,0,2024-07-01 18:00:00,2024-07-01 18:00:00,-0.0006765476190473407,0.0002603090351243065,1.0735047619047609,-9.450340670246556e-05,-8.696188655877272e-05,1.0742694047619057,1.0734134380682783,1.0781252169753133,1.0733379720651766,1.0773483437431424,3.102657063617747e-05,-3.420463673413447e-05,1.073537044497548,1.0738714186400167,5.65945113545379,5.912675238120362,0.0007499801469081247,1.0738173834488878,1.0744522826432537,1.07353044375645,-0.0006348991943658788,-0.0003511491821611376,0.0009904993690440591,-0.00040111455108338134,-0.00043088063295582124,-0.0002962848297214382,1.0748676179046595,-0.42780673039175965,False,True,1.06919,1.07189,1.07189,1.07169,2024-07-02 10:30:00,True,2024-07-02 10:30:00,,2024-07-02 10:35:13,0.02,even,True,10.9,8382.779999999997,,22,0,27,7
2024-07-02 10:30:00,1.07154,1.07196,1.0712,1.0713,1048,12,0,2024-07-02 10:00:00,2024-07-02 10:00:00,-0.0002522619047617969,-0.00028776949990549916,1.0724302380952382,-7.716948144490081e-05,-6.431922027112924e-05,1.0728440476190475,1.072364861047587,1.0744716129544447,1.0719024726005335,1.0744629760324536,-4.9650602755316004e-05,3.298782325858337e-05,1.0732530036885075,1.073285256672159,9.077154491605597,10.627359711438274,-0.00017778446314779359,1.072454231037157,1.0728331885594682,1.0722357103543168,-0.0003789575223112074,-0.0002172636120947951,0.0005485283341816888,-0.00026416580667354417,-0.00022905744754098123,-0.00013153078775296478,1.072976223605462,-0.4285048028968286,False,True,1.0683,1.0820999999999998,1.071,1.0708,,False,,,2024-07-05 06:02:34,0.02,fail,False,-392.42,7990.359999999997,,0,1,27,7
2024-07-02 11:45:00,1.07183,1.07223,1.0717,1.07202,804,12,0,2024-07-02 11:00:00,2024-07-02 11:00:00,-0.00041380952380931646,-0.00040385993941693954,1.0721857142857139,-8.904124809352289e-05,-6.232912460469102e-05,1.0724302380952382,1.0724594380557781,1.0743855457020277,1.072364861047587,1.0744716129544447,-6.431922027112924e-05,-7.716948144490081e-05,1.0731734550634424,1.0731840361383862,26.638772663880136,26.731752673178757,-0.00022299955840162278,1.072103854483562,1.0725123573291022,1.0717040282077737,-0.0004085028455402817,-0.00035217688803654724,0.0006597873395251868,-2.2198142416662847e-05,-7.931200550337358e-05,-0.00017757137942853163,1.0725947411161327,-0.4291866847005854,False,True,1.06902,1.07172,1.07172,1.07152,2024-07-02 12:30:00,True,2024-07-02 12:30:00,,2024-07-02 13:28:33,0.02,even,True,10.9,8001.259999999997,,1,0,27,7
2024-07-02 12:15:00,1.07174,1.07196,1.07122,1.07148,847,12,0,2024-07-02 12:00:00,2024-07-02 12:00:00,-0.00024452380952433295,-0.00044525925711824677,1.0716890476190477,-8.752123151066474e-05,-6.23262914318798e-05,1.0721857142857139,1.0723535596641844,1.0743186078291964,1.0724594380557781,1.0743855457020277,-6.232912460469102e-05,-8.904124809352289e-05,1.0730351676399945,1.0730117132473154,26.0808926080916,27.847512784753764,-0.0002674514981449476,1.0719631147485857,1.072384284404237,1.071515156518748,-0.00042116965565131004,-0.0003745348775205077,0.0006782575715733581,-0.00011416924664597872,-7.470244237972601e-05,-2.2198142416662847e-05,1.072430804240372,-0.42940049120287616,False,True,1.06848,1.08228,1.07118,1.07098,,False,,,2024-07-05 06:23:08,0.02,fail,False,-392.42,7608.8399999999965,,0,1,27,7
2024-07-02 12:30:00,1.07147,1.07171,1.07131,1.07138,788,12,0,2024-07-02 12:00:00,2024-07-02 12:00:00,-0.00024452380952433295,-0.00044525925711824677,1.0716890476190477,-8.752123151066474e-05,-6.23262914318798e-05,1.0721857142857139,1.0723535596641844,1.0743186078291964,1.0724594380557781,1.0743855457020277,-6.232912460469102e-05,-8.904124809352289e-05,1.0730351676399945,1.0730117132473154,17.339133319819783,24.747633003400313,-0.0002674514981449476,1.071873404787265,1.0723098929668862,1.0713949501203994,-0.00043648817962127495,-0.0003869255379406612,0.0007004700803003756,-0.00012020639834853242,-0.00011416924664597872,-7.470244237972601e-05,1.072340584728805,-0.42955068448800615,False,True,1.06838,1.08218,1.07108,1.07088,,False,,,2024-07-05 06:22:26,0.02,fail,False,-392.42,7216.419999999996,,0,2,27,7
2024-07-02 12:45:00,1.07136,1.07144,1.07099,1.07103,773,12,0,2024-07-02 12:00:00,2024-07-02 12:00:00,-0.00024452380952433295,-0.00044525925711824677,1.0716890476190477,-8.752123151066474e-05,-6.23262914318798e-05,1.0721857142857139,1.0723535596641844,1.0743186078291964,1.0724594380557781,1.0743855457020277,-6.232912460469102e-05,-8.904124809352289e-05,1.0730351676399945,1.0730117132473154,9.117494192567177,17.512506706826198,-0.0002674514981449476,1.0717436502046087,1.0722150860804502,1.0712228379772955,-0.00047143587584153046,-0.0004038276055208351,0.0007420635642553508,-0.00017211214310397516,-0.00012020639834853242,-0.00011416924664597872,1.0722246237890403,-0.42977894783444937,False,True,1.06803,1.0818299999999998,1.07073,1.07053,,False,,,2024-07-05 06:02:07,0.02,fail,False,-392.42,6823.999999999996,,0,3,27,7
2024-07-02 13:00:00,1.07101,1.07116,1.07093,1.07099,659,12,0,2024-07-02 13:00:00,2024-07-02 13:00:00,-0.0004966666666661457,-0.0005728869518963897,1.0715516666666665,-0.00013520708049347794,-6.232585830742138e-05,1.0716890476190477,1.072869960544151,1.0742516071631176,1.0723535596641844,1.0743186078291964,-6.23262914318798e-05,-8.752123151066474e-05,1.0729464471470915,1.07290357618753,5.211653460521641,10.556093657636213,-0.00032853858889523603,1.0716277040192843,1.0721243389633799,1.0711029480564167,-0.0004966349440955753,-0.00042238907323578317,0.0007697657652783638,-0.00011988992087874628,-0.00017211214310397516,-0.00012020639834853242,1.0721421318395425,-0.42993623572670914,False,True,1.0679900000000002,1.08179,1.0706900000000001,1.0704900000000002,,False,,,2024-07-05 06:01:55,0.02,fail,False,-392.42,6431.579999999996,,0,4,27,7
2024-07-02 16:45:00,1.07424,1.07446,1.07382,1.07411,1949,12,0,2024-07-02 16:00:00,2024-07-02 16:00:00,0.0004227380952372961,-0.00033296095744761445,1.0729035714285704,-0.00019301192482045723,3.540829990738478e-05,1.0721263095238096,1.0729774787950783,1.0740421186991873,1.073573274697414,1.0740892381457838,-4.986019585069466e-05,-0.00022946188284388342,1.0729965815001317,1.0729764448943155,90.66757280701704,90.42845531546197,-0.0003872356335313905,1.0730773049581055,1.072662979732812,1.0737365841073274,0.00041432522529349924,0.0001339653314168928,0.0008941918139083416,0.0002811730306162552,0.00036951152390773956,0.00027975920192480075,2.574943743056104,1.072529425158551,True,False,1.0771099999999998,1.0744099999999999,1.0744099999999999,1.0746099999999998,2024-07-03 01:15:00,True,2024-07-03 01:15:00,2024-07-03 15:35:10,2024-07-03 04:23:54,0.02,even,True,10.92,6442.499999999996,,1,0,27,7
2024-07-02 18:15:00,1.0738,1.0739,1.07347,1.07368,843,12,0,2024-07-02 18:00:00,2024-07-02 18:00:00,0.0006655952380965058,7.19389492567224e-05,1.0738040476190471,-6.557544101939563e-05,5.948430084402224e-05,1.073569166666667,1.0716275087577052,1.0737838640250625,1.0716977708341577,1.0737202201106668,5.947179506575677e-05,-6.557815836075887e-05,1.0731092248091683,1.0731176629585488,71.73516306909822,64.73703986830238,-0.0002501289518781282,1.0733376354624529,1.0729484898354227,1.0738848022015821,0.0003891456270301852,0.0003027368652408835,0.0010133401864118748,2.2284141727224593e-05,6.671826625259669e-05,0.00020995528035894218,2.575252811453238,1.0725167929499262,True,False,1.0766799999999999,1.07398,1.07398,1.07418,2024-07-02 22:15:00,True,2024-07-02 22:15:00,2024-07-03 15:30:12,2024-07-03 00:00:00,0.02,even,True,10.92,6453.419999999996,,2,0,27,7
2024-07-02 21:15:00,1.07415,1.07415,1.07403,1.07404,220,12,0,2024-07-02 21:00:00,2024-07-02 21:00:00,2.2857142858212498e-05,0.00015042551459276687,1.0739242857142854,9.55359683347858e-05,0.0001052734419445865,1.0738478571428574,1.070221366578143,1.073487399839698,1.0710433500898457,1.0735165238380069,9.31549755520061e-05,-1.3348393907433007e-05,1.0732179894555673,1.0732497744138665,75.75972009278716,68.38745531065585,-6.762711516242225e-05,1.0736229649007765,1.0733318356198078,1.0737564740282084,0.0002911292809686383,0.0002599265654258879,0.00046704496579232866,0.00016306157550838307,0.00019212246301969493,6.0110079119546356e-05,2.574386984732028,1.0731259633243888,True,False,1.07704,1.07434,1.07434,1.07454,2024-07-02 22:30:00,True,2024-07-02 22:30:00,2024-07-03 15:35:07,2024-07-03 00:00:00,0.02,even,True,10.92,6464.3399999999965,,3,0,27,7
2024-07-02 21:30:00,1.07403,1.07408,1.07385,1.07398,349,12,0,2024-07-02 21:00:00,2024-07-02 21:00:00,2.2857142858212498e-05,0.00015042551459276687,1.0739242857142854,9.55359683347858e-05,0.0001052734419445865,1.0738478571428574,1.070221366578143,1.073487399839698,1.0710433500898457,1.0735165238380069,9.31549755520061e-05,-1.3348393907433007e-05,1.0732179894555673,1.0732497744138665,81.40326305224879,75.59232717244065,-6.762711516242225e-05,1.07367789337758,1.0733798477961183,1.073800502235982,0.00029804558146162563,0.00026755036863303547,0.0004551831134160053,4.402820777360539e-05,0.00016306157550838307,0.00019212246301969493,2.5744149994390937,1.0731860050328703,True,False,1.0769799999999998,1.07428,1.07428,1.0744799999999999,2024-07-02 22:30:00,True,2024-07-02 22:30:00,2024-07-03 15:34:14,2024-07-03 00:00:00,0.02,even,True,10.92,6475.259999999997,,4,0,27,7
2024-07-02 21:45:00,1.07399,1.07422,1.07392,1.07415,267,12,0,2024-07-02 21:00:00,2024-07-02 21:00:00,2.2857142858212498e-05,0.00015042551459276687,1.0739242857142854,9.55359683347858e-05,0.0001052734419445865,1.0738478571428574,1.070221366578143,1.073487399839698,1.0710433500898457,1.0735165238380069,9.31549755520061e-05,-1.3348393907433007e-05,1.0732179894555673,1.0732497744138665,84.04442880816572,80.40247065106725,-6.762711516242225e-05,1.0737505251656445,1.073436896107517,1.0738718300653596,0.0003136290581275958,0.00027676610653194756,0.0004549542102302677,7.132782937757653e-05,4.402820777360539e-05,0.00016306157550838307,2.5744860182491704,1.0732576418815487,True,False,1.0771499999999998,1.07445,1.07445,1.0746499999999999,2024-07-03 01:15:00,True,2024-07-03 01:15:00,2024-07-03 15:35:14,2024-07-03 04:15:08,0.02,even,True,10.92,6486.179999999997,,5,0,27,7
2024-07-02 22:00:00,1.07415,1.07447,1.07409,1.07444,283,12,0,2024-07-02 22:00:00,2024-07-02 22:00:00,7.642857142808879e-05,0.00022617571531391434,1.0740815476190484,0.00019423384475797574,0.00014078013330749527,1.0739242857142854,1.0696976009329173,1.073260172423333,1.070221366578143,1.073487399839698,0.0001052734419445865,9.55359683347858e-05,1.0733039256197243,1.0733537924607572,91.75744207102184,85.73504464381215,-8.866549067154935e-06,1.0738565982170838,1.0735112000995526,1.0739419676642585,0.00034539811753120375,0.0002904925087317988,0.00047827920723510393,7.01375988989561e-05,7.132782937757653e-05,4.402820777360539e-05,2.574587644594026,1.0732962907344912,True,False,1.07744,1.07474,1.07474,1.07494,2024-07-03 03:15:00,True,2024-07-03 03:15:00,2024-07-03 15:37:42,2024-07-03 03:50:21,0.02,even,True,10.92,6497.099999999997,,6,0,27,7
2024-07-02 22:15:00,1.07445,1.07456,1.07423,1.07454,261,12,0,2024-07-02 22:00:00,2024-07-02 22:00:00,7.642857142808879e-05,0.00022617571531391434,1.0740815476190484,0.00019423384475797574,0.00014078013330749527,1.0739242857142854,1.0696976009329173,1.073260172423333,1.070221366578143,1.073487399839698,0.0001052734419445865,9.55359683347858e-05,1.0733039256197243,1.0733537924607572,96.97980915779722,90.92722667899494,-8.866549067154935e-06,1.073961736952917,1.0735874074995857,1.074151035431716,0.000374329453331379,0.00030725989765171483,0.0005041246539702627,0.00020906776745754918,7.01375988989561e-05,7.132782937757653e-05,2.5748316037145758,1.0734704671488562,True,False,1.07754,1.07484,1.07484,1.07504,2024-07-03 03:15:00,True,2024-07-03 03:15:00,2024-07-03 15:42:42,2024-07-03 03:32:17,0.02,even,True,10.92,6508.019999999997,,7,0,27,7
2024-07-02 22:30:00,1.07453,1.07458,1.07442,1.07449,413,12,0,2024-07-02 22:00:00,2024-07-02 22:00:00,7.642857142808879e-05,0.00022617571531391434,1.0740815476190484,0.00019423384475797574,0.00014078013330749527,1.0739242857142854,1.0696976009329173,1.073260172423333,1.070221366578143,1.073487399839698,0.0001052734419445865,9.55359683347858e-05,1.0733039256197243,1.0733537924607572,96.99364328659045,95.24363150513652,-8.866549067154935e-06,1.0740430081909298,1.0736542662033202,1.0743041658066734,0.00038874198760963097,0.0003235563156432981,0.000529440900139959,0.00015313037495734427,0.00020906776745754918,7.01375988989561e-05,2.5750189110218624,1.0735894205914844,True,False,1.0774899999999998,1.07479,1.07479,1.07499,2024-07-03 03:15:00,True,2024-07-03 03:15:00,2024-07-03 15:37:42,2024-07-03 03:50:13,0.02,even,True,10.92,6518.939999999997,,8,0,27,7
2024-07-02 22:45:00,1.07449,1.07457,1.07442,1.07455,363,12,0,2024-07-02 22:00:00,2024-07-02 22:00:00,7.642857142808879e-05,0.00022617571531391434,1.0740815476190484,0.00019423384475797574,0.00014078013330749527,1.0739242857142854,1.0696976009329173,1.073260172423333,1.070221366578143,1.073487399839698,0.0001052734419445865,9.55359683347858e-05,1.0733039256197243,1.0733537924607572,97.04100400302423,97.00481881580397,-8.866549067154935e-06,1.0741210069307867,1.073720616854926,1.0744476229790165,0.0004003900758606793,0.00033892306768677435,0.000546005799793169,0.00014345717234309774,0.00015313037495734427,0.00020906776745754918,2.575184730808737,1.0737105151492958,True,False,1.0775499999999998,1.0748499999999999,1.0748499999999999,1.0750499999999998,2024-07-03 03:15:00,True,2024-07-03 03:15:00,2024-07-03 15:42:42,2024-07-03 03:32:17,0.02,even,True,10.92,6529.859999999997,,9,0,27,7
2024-07-03 01:00:00,1.07446,1.07487,1.07444,1.07479,113,12,0,2024-07-03 01:00:00,2024-07-03 01:00:00,0.0001669047619059505,0.00038236906980793073,1.074641666666667,0.0002467320455297741,9.766613290787749e-05,1.0743483333333337,1.070156648814478,1.0739880357137437,1.0698924933086837,1.0735310665007072,0.0001435554375006422,0.00024674460731235695,1.0735356947379897,1.0736261192236822,81.17573483425322,75.76016088857169,0.00017022924284988385,1.0744252134427812,1.0741107219937087,1.0746229583763316,0.00031449144907247373,0.00033643977296082144,0.0005290721438623599,2.5827313379744865e-05,-2.8737530099354203e-05,-1.3426212591038933e-05,2.5753372057705457,1.0739087109821175,True,False,1.0777899999999998,1.0750899999999999,1.0750899999999999,1.0752899999999999,2024-07-03 10:30:00,True,2024-07-03 10:30:00,2024-07-03 16:11:26,,0.02,success,True,109.18,6639.039999999997,,10,0,27,7
2024-07-03 01:15:00,1.07475,1.07475,1.07466,1.07467,89,12,0,2024-07-03 01:00:00,2024-07-03 01:00:00,0.0001669047619059505,0.00038236906980793073,1.074641666666667,0.0002467320455297741,9.766613290787749e-05,1.0743483333333337,1.070156648814478,1.0739880357137437,1.0698924933086837,1.0735310665007072,0.0001435554375006422,0.00024674460731235695,1.0735356947379897,1.0736261192236822,82.8955597248178,79.06280711157221,0.00017022924284988385,1.0744628729131227,1.0741521499941746,1.0746257447540433,0.0003107229189480698,0.0003312964021582711,0.0005128541053863931,2.7863777116721167e-06,2.5827313379744865e-05,-2.8737530099354203e-05,2.575318097796315,1.0739333917117717,True,False,1.07767,1.07497,1.07497,1.07517,2024-07-03 10:30:00,True,2024-07-03 10:30:00,2024-07-03 15:42:57,,0.02,success,True,109.18,6748.2199999999975,,11,0,27,7
2024-07-03 01:30:00,1.0747,1.07473,1.07466,1.07469,94,12,0,2024-07-03 01:00:00,2024-07-03 01:00:00,0.0001669047619059505,0.00038236906980793073,1.074641666666667,0.0002467320455297741,9.766613290787749e-05,1.0743483333333337,1.070156648814478,1.0739880357137437,1.0698924933086837,1.0735310665007072,0.0001435554375006422,0.00024674460731235695,1.0735356947379897,1.0736261192236822,85.25641025640515,83.10923493849208,0.00017022924284988385,1.0744978155418732,1.0741919907353468,1.074652198142415,0.0003058248065264113,0.00032620208303189916,0.00048162502711718297,2.6453388371816544e-05,2.7863777116721167e-06,2.5827313379744865e-05,2.575302391929023,1.074002004355807,True,False,1.0776899999999998,1.07499,1.07499,1.0751899999999999,2024-07-03 10:30:00,True,2024-07-03 10:30:00,2024-07-03 15:42:57,,0.02,success,True,109.18,6857.399999999998,,12,0,27,7
2024-07-03 01:45:00,1.07469,1.07484,1.07468,1.07483,184,12,0,2024-07-03 01:00:00,2024-07-03 01:00:00,0.0001669047619059505,0.00038236906980793073,1.074641666666667,0.0002467320455297741,9.766613290787749e-05,1.0743483333333337,1.070156648814478,1.0739880357137437,1.0698924933086837,1.0735310665007072,0.0001435554375006422,0.00024674460731235695,1.0735356947379897,1.0736261192236822,86.5384615384578,84.89681050656027,0.00017022924284988385,1.0745489208431234,1.0742392506808767,1.074687186102512,0.0003096701622467002,0.00032289569887485937,0.0004469757637869908,3.4987960096932724e-05,2.6453388371816544e-05,2.7863777116721167e-06,2.5752906033836247,1.0740837688213996,True,False,1.0778299999999998,1.07513,1.07513,1.07533,2024-07-03 10:30:00,True,2024-07-03 10:30:00,2024-07-03 16:11:58,,0.02,success,True,109.18,6966.579999999998,,13,0,27,7
2024-07-03 02:30:00,1.07464,1.07485,1.07462,1.07485,149,12,0,2024-07-03 02:00:00,2024-07-03 02:00:00,0.0002933333333332566,0.00043032507720708324,1.0747700000000002,0.0002467428645359826,6.5005785243508e-05,1.074641666666667,1.0704206764296822,1.0742658102732066,1.070156648814478,1.0739880357137437,9.766613290787749e-05,0.0002467320455297741,1.0736127466903775,1.0737144296857877,84.93589743590445,84.93589743589972,0.00022224840972132374,1.0746184313346367,1.0743381136965249,1.074702968696251,0.00028031763811187105,0.0003036841915374719,0.0003193571669482392,4.5146198830448014e-05,-1.1076711385227256e-05,-1.8286893706198626e-05,2.5751341008716313,1.074271836520871,True,False,1.07785,1.07515,1.07515,1.07535,2024-07-03 10:30:00,True,2024-07-03 10:30:00,2024-07-03 16:12:00,,0.02,success,True,109.18,7075.759999999998,,14,0,27,7
2024-07-03 02:45:00,1.07484,1.07486,1.07466,1.07473,104,12,0,2024-07-03 02:00:00,2024-07-03 02:00:00,0.0002933333333332566,0.00043032507720708324,1.0747700000000002,0.0002467428645359826,6.5005785243508e-05,1.074641666666667,1.0704206764296822,1.0742658102732066,1.070156648814478,1.0739880357137437,9.766613290787749e-05,0.0002467320455297741,1.0736127466903775,1.0737144296857877,87.82051282051755,85.68376068376556,0.00022224840972132374,1.0746355957446925,1.074367142311597,1.074728462332302,0.0002684534330954502,0.00029663803984906757,0.00027166339481361247,2.5493636050866186e-05,4.5146198830448014e-05,-1.1076711385227256e-05,2.5750952079153,1.0743617167493036,True,False,1.0777299999999999,1.07503,1.07503,1.07523,2024-07-03 10:30:00,True,2024-07-03 10:30:00,2024-07-03 15:42:57,,0.02,success,True,109.18,7184.939999999999,,15,0,27,7
2024-07-03 03:00:00,1.07474,1.07538,1.07473,1.07505,389,12,0,2024-07-03 03:00:00,2024-07-03 03:00:00,0.0001283333333332859,0.0004417434260952646,1.074767857142857,0.0002467374842392989,6.420879564673988e-05,1.0747700000000002,1.0706848330264596,1.0743390092698486,1.0704206764296822,1.0742658102732066,6.5005785243508e-05,0.0002467428645359826,1.073684827549063,1.0737956753109246,87.77502067824908,86.84381031155705,0.0002661474129961119,1.0746993502455089,1.0744177243625899,1.0748063226694184,0.00028162588291902324,0.0002936356084630587,0.00025539185594333855,7.786033711654206e-05,2.5493636050866186e-05,4.5146198830448014e-05,2.575151101674942,1.074461543663895,True,False,1.07805,1.07535,1.07535,1.07555,2024-07-03 10:45:00,True,2024-07-03 10:45:00,2024-07-03 16:17:22,2024-07-03 13:00:55,0.02,even,True,10.92,7195.859999999999,,16,0,27,7
2024-07-03 11:00:00,1.07589,1.07613,1.07549,1.07613,904,12,0,2024-07-03 11:00:00,2024-07-03 11:00:00,0.0005654761904760885,0.0003366301701339669,1.075209880952381,3.657410264008791e-05,0.00010697054894455217,1.074752857142857,1.0731025253011663,1.0745728090827702,1.0730137465597345,1.074531074226821,9.836834416393821e-05,3.988886987794181e-05,1.0741069683369335,1.0742495621232004,93.8461106903407,88.15094556422873,0.0002630878286063136,1.0750024657094068,1.0746491613816593,1.0752499105607156,0.00035330432774749454,0.00010453336968097509,0.0006830439225127681,0.00032866873065073854,0.0002984038527689137,0.00028501547987591636,2.5761720198561076,1.0743278012653235,True,False,1.07913,1.07643,1.07643,1.07663,2024-07-03 15:45:00,True,2024-07-03 15:45:00,2024-07-03 16:56:54,,0.02,success,True,109.18,7305.039999999999,,17,0,27,7
2024-07-03 11:15:00,1.07613,1.07626,1.07578,1.07593,820,12,0,2024-07-03 11:00:00,2024-07-03 11:00:00,0.0005654761904760885,0.0003366301701339669,1.075209880952381,3.657410264008791e-05,0.00010697054894455217,1.074752857142857,1.0731025253011663,1.0745728090827702,1.0730137465597345,1.074531074226821,9.836834416393821e-05,3.988886987794181e-05,1.0741069683369335,1.0742495621232004,92.9193899782145,91.39128103951718,0.0002630878286063136,1.075145163292575,1.0747440383163513,1.075502786377709,0.0004011249762236879,0.00016385169098951768,0.0007438756617084422,0.0002528758169932921,0.00032866873065073854,0.0002984038527689137,2.5765070185210153,1.0744985542344025,True,False,1.07893,1.07623,1.07623,1.07643,2024-07-03 15:30:00,True,2024-07-03 15:30:00,2024-07-03 16:49:44,,0.02,success,True,109.18,7414.219999999999,,18,0,27,7
2024-07-03 11:30:00,1.07596,1.07626,1.07586,1.07621,583,12,0,2024-07-03 11:00:00,2024-07-03 11:00:00,0.0005654761904760885,0.0003366301701339669,1.075209880952381,3.657410264008791e-05,0.00010697054894455217,1.074752857142857,1.0731025253011663,1.0745728090827702,1.0730137465597345,1.074531074226821,9.836834416393821e-05,3.988886987794181e-05,1.0741069683369335,1.0742495621232004,95.30864197531064,94.02471421462197,0.0002630878286063136,1.0753089843244865,1.0748526280706958,1.075786332989337,0.00045635625379070177,0.00022235260354975451,0.0008171603270367494,0.0002835466116279939,0.0002528758169932921,0.00032866873065073854,2.5768894994308367,1.0746831665478374,True,False,1.07921,1.07651,1.07651,1.07671,2024-07-03 15:45:00,True,2024-07-03 15:45:00,2024-07-03 17:00:00,,0.02,success,True,109.18,7523.4,,19,0,27,7
2024-07-03 12:30:00,1.07584,1.07617,1.07575,1.076,668,12,0,2024-07-03 12:00:00,2024-07-03 12:00:00,0.0004570238095238377,0.0004242414635760028,1.0754165476190478,3.657713199745526e-05,0.00010697620995453367,1.075209880952381,1.0731417236941094,1.0746876450107565,1.0731025253011663,1.0745728090827702,0.00010697054894455217,3.657410264008791e-05,1.0741936155410023,1.0743455971533444,83.08457711443033,82.71297831828792,0.00029531855560025144,1.0755664234268691,1.0751106545037277,1.076309329205367,0.0004557689231414752,0.00035809647437095714,0.0009246020766171812,9.166838665475296e-05,0.00012986584107110843,0.00012573787409819737,2.5775575420088,1.0750611164019337,True,False,1.079,1.0763,1.0763,1.0765,2024-07-03 15:45:00,True,2024-07-03 15:45:00,2024-07-03 16:50:32,,0.02,success,True,109.18,7632.58,,20,0,27,7
2024-07-03 15:30:00,1.07652,1.0777700000000001,1.07648,1.07756,1570,12,0,2024-07-03 15:00:00,2024-07-03 15:00:00,0.00014738095238064908,0.0004811851237165321,1.0764421428571427,3.6574856997975175e-05,0.000185813157656026,1.0758291666666666,1.0732595804032576,1.0747851130858912,1.0732202092008103,1.0749176161835097,0.00010697715969840293,3.658007759596658e-05,1.0745809623520362,1.0747867597161436,71.53802943489386,58.29338208509213,0.0003799893358958263,1.0760843258837687,1.0756705002185671,1.07616647746818,0.0004138256652015393,0.00033615584153491156,0.0006394594071754217,0.0003460853113175233,0.00012836601307131268,-7.094943240359974e-05,2.5770297476678667,1.0753032072684932,True,False,1.08056,1.07786,1.07786,1.07806,2024-07-03 16:30:00,True,2024-07-03 16:30:00,2024-07-03 17:00:37,2024-07-03 21:20:58,0.02,success,True,109.18,7741.76,,21,0,27,7
2024-07-03 15:45:00,1.07755,1.07758,1.07713,1.0774,1181,12,0,2024-07-03 15:00:00,2024-07-03 15:00:00,0.00014738095238064908,0.0004811851237165321,1.0764421428571427,3.6574856997975175e-05,0.000185813157656026,1.0758291666666666,1.0732595804032576,1.0747851130858912,1.0732202092008103,1.0749176161835097,0.00010697715969840293,3.658007759596658e-05,1.0745809623520362,1.0747867597161436,90.09100101111933,72.66715009889847,0.0003799893358958263,1.076286737286266,1.075798611313488,1.0764421843825251,0.00048812597277780867,0.000366549867783491,0.0006064082783841316,0.0002757069143450863,0.0003460853113175233,0.00012836601307131268,2.5772608355583437,1.0756235332067066,True,False,1.0803999999999998,1.0776999999999999,1.0776999999999999,1.0778999999999999,2024-07-03 16:15:00,True,2024-07-03 16:15:00,2024-07-03 17:00:02,,0.02,success,True,109.18,7850.9400000000005,,22,0,27,7
2024-07-03 16:00:00,1.07739,1.07801,1.07714,1.0779,992,12,0,2024-07-03 16:00:00,2024-07-03 16:00:00,0.0006129761904760667,0.0006614192662386387,1.077291904761904,9.464105927350417e-05,0.0002674190846290054,1.0764421428571427,1.0728051527072273,1.0748815862338421,1.0732595804032576,1.0747851130858912,0.000185813157656026,3.6574856997975175e-05,1.0748563841357759,1.0751118189388522,91.20622354169977,84.27841799590435,0.0004362753219643888,1.0765349315499173,1.075954269734711,1.0768143240454071,0.0005806618152062182,0.00040937225726803643,0.00067419705336083,0.0003721396628819651,0.0002757069143450863,0.0003460853113175233,2.5777244900674443,1.07590415802337,True,False,1.0809,1.0782,1.0782,1.0784,2024-07-03 16:45:00,True,2024-07-03 16:45:00,2024-07-03 17:08:46,2024-07-03 20:35:37,0.02,success,True,109.18,7960.120000000001,,23,0,27,7
2024-07-03 16:15:00,1.07789,1.07843,1.0778699999999999,1.07825,1010,12,0,2024-07-03 16:00:00,2024-07-03 16:00:00,0.0006129761904760667,0.0006614192662386387,1.077291904761904,9.464105927350417e-05,0.0002674190846290054,1.0764421428571427,1.0728051527072273,1.0748815862338421,1.0732595804032576,1.0747851130858912,0.000185813157656026,3.6574856997975175e-05,1.0748563841357759,1.0751118189388522,92.06754998442132,91.12159151241349,0.0004362753219643888,1.0767987882345453,1.0761243238284361,1.0771846233230131,0.0006744644061091876,0.00046239068703626666,0.0007818893784255288,0.0003702992776060121,0.0003721396628819651,0.0002757069143450863,2.578240173983888,1.0761290726621386,True,False,1.0812499999999998,1.07855,1.07855,1.0787499999999999,2024-07-03 17:00:00,True,2024-07-03 17:00:00,2024-07-03 17:12:41,2024-07-03 20:26:30,0.02,success,True,109.18,8069.300000000001,,24,0,27,7
2024-07-03 16:30:00,1.07825,1.07864,1.07824,1.07863,846,12,0,2024-07-03 16:00:00,2024-07-03 16:00:00,0.0006129761904760667,0.0006614192662386387,1.077291904761904,9.464105927350417e-05,0.0002674190846290054,1.0764421428571427,1.0728051527072273,1.0748815862338421,1.0732595804032576,1.0747851130858912,0.000185813157656026,3.6574856997975175e-05,1.0748563841357759,1.0751118189388522,96.74566225277663,93.33981192629926,0.0004362753219643888,1.0770805131215384,1.0763099294707743,1.0775783384932915,0.0007705836507641006,0.0005240292797818334,0.0009130684531268905,0.0003937151702784192,0.0003702992776060121,0.0003721396628819651,2.578810980905013,1.0763456960815703,True,False,1.0816299999999999,1.07893,1.07893,1.07913,2024-07-03 17:15:00,True,2024-07-03 17:15:00,2024-07-03 17:16:42,2024-07-03 20:07:31,0.02,success,True,109.18,8178.480000000001,,25,0,27,7
2024-07-03 16:45:00,1.07863,1.07918,1.07862,1.07885,1180,12,0,2024-07-03 16:00:00,2024-07-03 16:00:00,0.0006129761904760667,0.0006614192662386387,1.077291904761904,9.464105927350417e-05,0.0002674190846290054,1.0764421428571427,1.0728051527072273,1.0748815862338421,1.0732595804032576,1.0747851130858912,0.000185813157656026,3.6574856997975175e-05,1.0748563841357759,1.0751118189388522,95.11256532606141,94.64192585441981,0.0004362753219643888,1.077352741872071,1.0764980828433095,1.077984633642931,0.000854659028761473,0.0005901552295777613,0.001039809598001668,0.00040629514963952396,0.0003937151702784192,0.0003702992776060121,2.5793883766002335,1.076580890685629,True,False,1.08185,1.07915,1.07915,1.07935,2024-07-03 17:15:00,True,2024-07-03 17:15:00,2024-07-05 06:02:16,2024-07-03 19:47:42,0.02,even,True,10.92,8189.4000000000015,,26,0,27,7
2024-07-03 17:00:00,1.07927,1.0814300000000001,1.07908,1.08134,3190,12,0,2024-07-03 17:00:00,2024-07-03 17:00:00,0.0008497619047613814,0.0009308053581984499,1.0785157142857138,0.0002806477146365787,0.00041463553911429363,1.077291904761904,1.0715368167442243,1.0749581600039768,1.0728051527072273,1.0748815862338421,0.0002674190846290054,9.464105927350417e-05,1.0752217787076612,1.075544473423744,96.46441717791323,96.10754825225045,0.0005351813292112011,1.0779661661994446,1.0768567433734346,1.0788241795665636,0.0011094228260100092,0.000694008748864211,0.0014289156728435233,0.0008395459236325564,0.00040629514963952396,0.0003937151702784192,2.5807532157249025,1.0768951434082248,True,False,1.0843399999999999,1.08164,1.08164,1.08184,2024-07-05 06:15:00,True,2024-07-05 06:15:00,,2024-07-05 10:04:01,0.02,even,True,10.92,8200.320000000002,,27,0,27,7
2024-07-04 18:00:00,1.08076,1.08132,1.08064,1.08123,813,12,0,2024-07-04 18:00:00,2024-07-04 18:00:00,0.00027154761904735203,0.0005345877776621322,1.0804639285714288,0.00013117649738489647,0.0001233736927088629,1.0801739285714287,1.077592556803859,1.079320372533208,1.0777600898341646,1.0792040035475134,0.00010857697389872536,8.976496956143972e-05,1.0787143180102545,1.0790946384513609,94.70596737250848,91.86179814206838,0.0005138449235357839,1.080283173201272,1.079957294169303,1.0804375782593738,0.00032587903196912293,0.00021574260484683624,0.000409610791018302,0.00023301341589343494,0.00012645682834455663,0.00010287925696572664,2.5809905528272488,1.079884603691499,True,False,1.0842299999999998,1.0815299999999999,1.0815299999999999,1.0817299999999999,2024-07-05 06:15:00,True,2024-07-05 06:15:00,,2024-07-05 15:30:01,0.02,even,True,10.92,8211.240000000002,,28,0,27,7
2024-07-04 19:00:00,1.08101,1.0813,1.08093,1.08129,282,12,0,2024-07-04 19:00:00,2024-07-04 19:00:00,0.0002900000000001235,0.0005985837307562747,1.0808103571428578,0.0001283410567565325,0.00012358699786507631,1.0804639285714288,1.0777596817677204,1.079450410228259,1.077592556803859,1.079320372533208,0.0001233736927088629,0.00013117649738489647,1.078872103945077,1.079259867375252,92.49563699825241,91.44851657940391,0.000530792684979882,1.0807121788046576,1.0802756461674654,1.0811042139662896,0.0004365326371922329,0.0003309734808663197,0.000604621093567398,0.00015642586859376806,0.00011029927760564107,0.00019798761610001492,2.5819204524426054,1.0802879754899737,True,False,1.08429,1.08159,1.08159,1.08179,2024-07-05 06:15:00,True,2024-07-05 06:15:00,,2024-07-05 10:04:26,0.02,even,True,10.92,8222.160000000002,,29,0,27,7
2024-07-04 19:15:00,1.08129,1.08131,1.08123,1.08128,152,12,0,2024-07-04 19:00:00,2024-07-04 19:00:00,0.0002900000000001235,0.0005985837307562747,1.0808103571428578,0.0001283410567565325,0.00012358699786507631,1.0804639285714288,1.0777596817677204,1.079450410228259,1.077592556803859,1.079320372533208,0.0001233736927088629,0.00013117649738489647,1.078872103945077,1.079259867375252,93.36823734729434,91.62303664921306,0.000530792684979882,1.0807995359116334,1.0803500427476531,1.0812233436532512,0.0004494931639802413,0.000354677417489104,0.0006272022534933053,0.00011912968696159432,0.00015642586859376806,0.00011029927760564107,2.5820700666954672,1.0803766206110352,True,False,1.08428,1.08158,1.08158,1.08178,2024-07-05 06:15:00,True,2024-07-05 06:15:00,,2024-07-05 15:30:01,0.02,even,True,10.92,8233.080000000002,,30,0,27,7
2024-07-04 19:30:00,1.08127,1.08129,1.0811,1.08111,178,12,0,2024-07-04 19:00:00,2024-07-04 19:00:00,0.0002900000000001235,0.0005985837307562747,1.0808103571428578,0.0001283410567565325,0.00012358699786507631,1.0804639285714288,1.0777596817677204,1.079450410228259,1.077592556803859,1.079320372533208,0.0001233736927088629,0.00013117649738489647,1.078872103945077,1.079259867375252,94.75537100559579,93.53974845038086,0.000530792684979882,1.080847299617536,1.0804063358774565,1.0813081492948056,0.0004409637400795141,0.00037193468200718606,0.0006285480624323811,8.480564155433079e-05,0.00011912968696159432,0.00015642586859376806,2.5821566891790892,1.0804596094105219,True,False,1.08411,1.08141,1.08141,1.08161,2024-07-05 03:45:00,True,2024-07-05 03:45:00,2024-07-05 15:32:28,2024-07-05 03:56:04,0.02,even,True,10.92,8244.000000000002,,31,0,27,7
2024-07-04 22:45:00,1.0812,1.08125,1.08119,1.08122,76,12,0,2024-07-04 22:00:00,2024-07-04 22:00:00,0.00018309523809589834,0.0006480119013707597,1.0812834523809525,0.00014631868417979617,0.0001400128048100655,1.0811954761904756,1.0780018120679153,1.0796569785309296,1.0780364584153186,1.0795058312425405,0.00014000920723973554,0.00012833151449271463,1.0792856796722665,1.0796789776867004,72.87888263498769,66.84038635258368,0.0005883574729725208,1.0811269855123424,1.0808763877501948,1.081158837289302,0.00025059776214764184,0.00029756251073869956,0.0003662617462848539,9.466804266056172e-06,2.0096319229612192e-05,-2.810113519013946e-05,2.581653290646787,1.0806643839318173,True,False,1.08422,1.08152,1.08152,1.08172,2024-07-05 06:00:00,True,2024-07-05 06:00:00,,2024-07-05 15:30:01,0.02,even,True,10.92,8254.920000000002,,32,0,27,7
2024-07-04 23:00:00,1.08125,1.0812599999999999,1.08117,1.08121,83,12,0,2024-07-04 23:00:00,2024-07-04 23:00:00,8.797619047684613e-05,0.0006375134631193546,1.0811888095238094,0.00016475400839913943,0.00014285871191643167,1.0812834523809525,1.0780020649222617,1.0797883504184485,1.0780018120679153,1.0796569785309296,0.0001400128048100655,0.00014631868417979617,1.0793930551772817,1.0797806594717645,81.25738308666286,73.6009774627724,0.0005981886710018876,1.081139756971982,1.080901099768699,1.0811772308221534,0.00023865720328308804,0.00028578144924757727,0.0003107903904433067,1.839353285149059e-05,9.466804266056172e-06,2.0096319229612192e-05,2.581596797849252,1.080757663795055,True,False,1.08421,1.08151,1.08151,1.08171,2024-07-05 06:00:00,True,2024-07-05 06:00:00,,2024-07-05 15:30:01,0.02,even,True,10.92,8265.840000000002,,33,0,27,7
2024-07-04 23:15:00,1.08122,1.08131,1.08121,1.0812599999999999,76,12,0,2024-07-04 23:00:00,2024-07-04 23:00:00,8.797619047684613e-05,0.0006375134631193546,1.0811888095238094,0.00016475400839913943,0.00014285871191643167,1.0812834523809525,1.0780020649222617,1.0797883504184485,1.0780018120679153,1.0796569785309296,0.0001400128048100655,0.00014631868417979617,1.0793930551772817,1.0797806594717645,83.83190883190666,79.32272485118575,0.0005981886710018876,1.0811582558993695,1.0809276849710177,1.0811851599587199,0.00023057092835188087,0.000274739345068438,0.00024016175130981267,7.929136566442452e-06,1.839353285149059e-05,9.466804266056172e-06,2.581509378322988,1.0808609415944517,True,False,1.0842599999999998,1.0815599999999999,1.0815599999999999,1.0817599999999998,2024-07-05 06:15:00,True,2024-07-05 06:15:00,,2024-07-05 15:30:01,0.02,even,True,10.92,8276.760000000002,,34,0,27,7
2024-07-05 07:45:00,1.08205,1.08221,1.08201,1.08212,152,12,0,2024-07-05 07:00:00,2024-07-05 07:00:00,0.0002871428571433743,0.0005141987792587344,1.0819445238095242,0.0001313533600883171,8.082873593809214e-05,1.0817455952380948,1.0794211899564852,1.0811521075041075,1.07927942264373,1.0810647484124372,8.082039415152812e-05,0.00013134301316130524,1.0802892262514463,1.0806547202474945,70.40498442368005,68.3281412253416,0.0005086449719397012,1.0819247894578656,1.0816684215068453,1.0821277261781903,0.00025636795102035315,0.00023748754544906654,0.000419357842574444,3.293429652551083e-05,1.1510147918114555e-05,9.339525284701722e-06,2.5826938592656656,1.0815615930907148,True,False,1.0851199999999999,1.08242,1.08242,1.08262,2024-07-05 11:00:00,True,2024-07-05 11:00:00,,2024-07-05 11:12:53,0.02,even,True,10.92,8287.680000000002,,35,0,27,7
2024-07-05 11:45:00,1.08292,1.08299,1.08268,1.08273,373,12,0,2024-07-05 11:00:00,2024-07-05 11:00:00,0.0002649999999995156,0.0005499125203021205,1.082515595238095,8.314869469373666e-05,0.00011556645807402641,1.0823357142857137,1.0803388134579994,1.0812191946435572,1.0802489613674235,1.081308197004453,0.00010230489485671393,8.315093990719187e-05,1.080783349758532,1.0811513018592747,82.86061870003867,78.87730274591924,0.0005167767920698804,1.0824804106490822,1.0821971828833814,1.0826795321637421,0.00028322776570077757,0.0002469076248872142,0.00032041743627021665,6.970760233904194e-05,0.00011691434468508177,6.546611627111787e-05,2.583112095702707,1.0822469686247773,True,False,1.0857299999999999,1.08303,1.08303,1.08323,2024-07-05 21:45:00,True,2024-07-05 21:45:00,,,0.02,running,False,0.0,8287.680000000002,2024-07-05 14:45:00,0,1,27,7
2024-07-05 12:00:00,1.08273,1.08288,1.08257,1.08285,582,12,0,2024-07-05 12:00:00,2024-07-05 12:00:00,0.00017988095238119506,0.0005714708699016136,1.082582619047619,8.315311851896182e-05,0.00012658499888238485,1.082515595238095,1.0804285717522792,1.0811902007395189,1.0803388134579994,1.0812191946435572,0.00011556645807402641,8.314869469373666e-05,1.0808992626773366,1.0812655977105328,89.50295446646771,83.40748464836645,0.000527715607636227,1.0825372705492233,1.0822455397068345,1.0827634502923975,0.0002917308423888709,0.00025587226838754557,0.00032739476701113847,8.391812865538029e-05,6.970760233904194e-05,0.00011691434468508177,2.5832054332278624,1.0823214673569326,True,False,1.08585,1.08315,1.08315,1.08335,2024-07-05 22:00:00,True,2024-07-05 22:00:00,,,0.02,running,False,0.0,8287.680000000002,2024-07-05 15:00:00,0,2,27,7
2024-07-05 13:00:00,1.08259,1.08283,1.08234,1.08282,530,12,0,2024-07-05 13:00:00,2024-07-05 13:00:00,6.702380952416931e-05,0.0005555983493805705,1.0825551190476195,8.315549038953619e-05,0.0001325139992302425,1.082582619047619,1.080518371001172,1.0812506251841936,1.0804285717522792,1.0811902007395189,0.00012658499888238485,8.315311851896182e-05,1.0809960844400892,1.0813563498936902,76.52582159624109,76.27543035993624,0.0005332921559850957,1.0826079828476305,1.082359818997748,1.0828338390092873,0.00024816384988257667,0.00025645850265920776,0.00034729910279205744,2.4922600618593194e-05,-9.772961815368575e-06,1.2855177157655717e-05,2.583302692798057,1.082364985220518,True,False,1.0858199999999998,1.0831199999999999,1.0831199999999999,1.0833199999999998,2024-07-05 22:00:00,True,2024-07-05 22:00:00,,,0.02,running,False,0.0,8287.680000000002,2024-07-05 16:00:00,0,3,27,7
2024-07-05 22:00:00,1.08363,1.08389,1.0836,1.0838,569,12,0,2024-07-05 22:00:00,2024-07-05 22:00:00,0.00041035714285753144,0.00040481611058096334,1.0833772619047621,3.4922299000701282e-06,9.755117719334122e-05,1.0829788095238098,1.0798901342126854,1.083322772058038,1.080883635324522,1.0829221836785268,0.00012807426487343676,-9.999503577014425e-05,1.0818229248557811,1.0821466636203896,96.95172486200745,96.33199079392666,0.00037933900895193194,1.0830844970757594,1.0828077973624077,1.0833203818369448,0.0002766997133516469,0.000158890306254644,0.0005486796273497836,0.0001675610595115451,9.067423460540347e-05,5.014103887135413e-05,2.584061099333867,1.0825796643400225,True,False,1.0868,1.0730000000000002,1.0841,1.0843,,False,,,,0.02,running,False,0.0,8287.680000000002,2024-07-06 01:00:00,0,4,27,7
