time,open,high,low,close,tick_volume,spread,real_volume,support_trendline_15,resistance_trendline_15,support_gradient_15,resistance_gradient_15,fixed_resistance_gradient_15,fixed_support_gradient_15,fixed_support_trendline_15,fixed_resistance_trendline_15,hourly_time,time2,prev_hour_lsma_slope,prev_hour_macd_line,hour_lsma,fixed_support_gradient,fixed_resistance_gradient,prev_hour_lsma,fixed_support_trendline,fixed_resistance_trendline,prev_fixed_support_trendline,prev_fixed_resistance_trendline,prev_fixed_resistance_gradient,prev_fixed_support_gradient,ema_50,ema_24,stoch_k,stoch_d,prev_hour_macd_signal,prev_psar,prev_psar_direction,prev_nadaraya_watson,prev_nadaraya_watson_trend,ema_short,ema_long,lsma,macd_line,macd_signal,lsma_stddev,lsma_slope,prev_lsma_slope_1,prev_lsma_slope_2,lsma_upper_band,lsma_lower_band,ticket,is_buy2,is_sell2,type,tp,sl,be,be_condition,time_updated,sl_updated,time_to_trail,time_tp_hit,time_sl_hit,lot_size,success,profit,account_balance,position_close_time,win_streak,losing_streak,Week,Month
2024-07-02 10:30:00,1.07154,1.07196,1.0712,1.0713,1048,12,0,1.0709846851918565,1.0720299762576098,0.0001356741628923419,0.0001399129566257006,-0.00035869235476044235,-0.0005116115616474138,1.0722888842772909,1.073087622359814,2024-07-02 10:00:00,2024-07-02 10:00:00,-0.0002522619047617969,-0.0003464855720736182,1.0724302380952382,-4.429382276491191e-05,-0.0001924482136386272,1.0728440476190475,1.072229109988198,1.0780497325274165,1.0717416879432193,1.0782571441797464,-0.00019245525605332618,1.862578621143838e-05,1.072056659629082,1.0736099916344324,9.077154491605626,10.627359711438288,-0.0002942258109528863,1.0719,1.0,1.0732985056888649,bearish,1.0724542310373961,1.0728332123176247,1.0722357103543168,-0.00037898128022861854,-0.00021729854968468226,0.0005485283341213933,-0.00026416580667354417,-0.00022905744754098123,-0.00013153078775296478,1.072784238688438,1.0716871820201954,,False,True,fail,1.0663,1.0802999999999998,1.0705,1.0703,,False,,,2024-07-03 17:00:02,0.01,False,-164.22,535.78,,0,1,27,7
2024-07-02 12:45:00,1.07136,1.07144,1.07099,1.07103,773,12,0,1.070886059569973,1.07144,5.1025622237051035e-05,0.00017231414353492707,-0.00023323668048061644,-0.00011979029669591823,1.0713395228868658,1.0721828396962663,2024-07-02 12:00:00,2024-07-02 12:00:00,-0.00024452380952433295,-0.0004916914555401775,1.0716890476190477,-4.66433643374532e-05,-0.00019243712165752937,1.0721857142857139,1.072146582633292,1.0776349691938953,1.0721816749683912,1.077842244835554,-0.0001924503598580866,-4.430460735220084e-05,1.0713640732921201,1.0732865689193836,9.117494192567206,17.512506706826212,-0.0003596148989295785,,-1.0,1.0733236712671517,bullish,1.0717436502046618,1.0722150979654435,1.0712228379772955,-0.0004714477607816736,-0.00040384508325736976,0.0007420635642144855,-0.00017211214310397516,-0.00012020639834853242,-0.00011416924664597872,1.07196490154151,1.0704807744130809,,False,True,fail,1.06603,1.0800299999999998,1.07023,1.07003,,False,,,2024-07-03 17:00:01,0.01,False,-164.22,371.55999999999995,,0,2,27,7
2024-07-02 13:00:00,1.07101,1.07116,1.07093,1.07099,659,12,0,1.0708566895267853,1.0717533117959916,9.025158504094264e-05,6.222152856902965e-05,-0.00024323889549580268,-0.00010237223915835535,1.0712124789460151,1.0719421175369743,2024-07-02 13:00:00,2024-07-02 13:00:00,-0.0004966666666661457,-0.0006141742643681614,1.0715516666666665,-4.7129829836989105e-05,-0.00019245048400405134,1.0716890476190477,1.0720985959287896,1.0774275324452394,1.072146582633292,1.0776349691938953,-0.00019243712165752937,-4.66433643374532e-05,1.0715613577640402,1.073156443405833,5.21165346052167,10.556093657636227,-0.0004105267720172951,,-1.0,1.0733510216391307,bullish,1.0716277040193292,1.072124349968003,1.0711029480564167,-0.000496645948673935,-0.00042240525634068283,0.0007697657652395185,-0.00011988992087874628,-0.00017211214310397516,-0.00012020639834853242,1.0718727138216562,1.0703331822911772,,False,True,fail,1.0659900000000002,1.07999,1.0701900000000002,1.0699900000000002,,False,,,2024-07-03 17:00:01,0.01,False,-164.22,207.33999999999995,,0,3,27,7
2024-07-02 22:00:00,1.07415,1.07447,1.07409,1.07444,283,12,0,1.07409,1.0745383331715528,0.00010572490207965246,2.0163645481809987e-05,9.595955088365982e-05,5.519057711757657e-05,1.0738057211326728,1.0741574007653367,2024-07-02 22:00:00,2024-07-02 22:00:00,7.642857142808879e-05,0.00021184800022289174,1.0740815476190484,-6.557227205264082e-05,2.3024424084313912e-05,1.0739242857142854,1.0719085239653143,1.0741912419329984,1.0719788311911367,1.0741664529643535,2.3026885922147165e-05,-6.557172671430447e-05,1.0743584108803417,1.0734731865912814,91.75744207102186,85.73504464381215,-3.741628906426584e-05,1.0716479140641586,1.0,1.0740091196201436,bullish,1.0738565982170842,1.0735112007887129,1.0739419676642585,0.00034539742837136345,0.0002904914952615663,0.00047827920715816347,7.01375988989561e-05,7.132782937757653e-05,4.402820777360539e-05,1.0744202468714168,1.0734636884571003,,True,False,even,1.07944,1.07524,1.07524,1.07544,2024-07-03 10:30:00,True,2024-07-03 10:30:00,2024-07-03 17:00:00,2024-07-03 13:10:23,0.01,True,14.6,221.93999999999994,,1,0,27,7
2024-07-02 22:15:00,1.07445,1.07456,1.07423,1.07454,261,12,0,1.07423,1.074568333398818,7.158881067409635e-05,1.0856952962062956e-05,0.00017652272866574444,0.00013931759060963433,1.0737918713581922,1.0740936309017854,2024-07-02 22:00:00,2024-07-02 22:00:00,7.642857142808879e-05,0.00021184800022289174,1.0740815476190484,-6.557227205264082e-05,2.3024424084313912e-05,1.0739242857142854,1.0719085239653143,1.0741912419329984,1.0719788311911367,1.0741664529643535,2.3026885922147165e-05,-6.557172671430447e-05,1.0743584108803417,1.0734731865912814,96.97980915779726,90.92722667899496,-3.741628906426584e-05,1.0716479140641586,1.0,1.0740091196201436,bullish,1.0739617369529175,1.073587408137697,1.074151035431716,0.00037432881522048156,0.00030725895925334937,0.0005041246538967373,0.00020906776745754918,7.01375988989561e-05,7.132782937757653e-05,1.074655160085613,1.0736469107778193,,True,False,even,1.07954,1.07534,1.07534,1.07554,2024-07-03 10:45:00,True,2024-07-03 10:45:00,2024-07-03 17:00:00,2024-07-03 13:01:03,0.01,True,14.6,236.53999999999994,,2,0,27,7
2024-07-02 22:30:00,1.07453,1.07458,1.07442,1.07449,413,12,0,1.0743850027720887,1.0745692606843429,3.257366570639399e-05,2.5044541265809055e-05,8.686708932144547e-05,0.00014930938391013285,1.073931520325382,1.0743833732470491,2024-07-02 22:00:00,2024-07-02 22:00:00,7.642857142808879e-05,0.00021184800022289174,1.0740815476190484,-6.557227205264082e-05,2.3024424084313912e-05,1.0739242857142854,1.0719085239653143,1.0741912419329984,1.0719788311911367,1.0741664529643535,2.3026885922147165e-05,-6.557172671430447e-05,1.0743584108803417,1.0734731865912814,96.9936432865905,95.24363150513653,-3.741628906426584e-05,1.0716479140641586,1.0,1.0740091196201436,bullish,1.0740430081909302,1.073654266794164,1.0743041658066734,0.00038874139676625674,0.00032355544675593086,0.0005294409000695888,0.00015313037495734427,0.00020906776745754918,7.01375988989561e-05,1.074833606706743,1.0737747249066039,,True,False,even,1.0794899999999998,1.0752899999999999,1.0752899999999999,1.0754899999999998,2024-07-03 10:45:00,True,2024-07-03 10:45:00,2024-07-03 17:00:00,2024-07-03 13:01:12,0.01,True,14.6,251.13999999999993,,3,0,27,7
2024-07-02 22:45:00,1.07449,1.07457,1.07442,1.07455,363,12,0,1.07442,1.0746000003921181,1.5742839993874756e-05,2.3263746833506046e-05,2.0163645481809987e-05,0.00010572490207965246,1.0740981650791828,1.0745398910446096,2024-07-02 22:00:00,2024-07-02 22:00:00,7.642857142808879e-05,0.00021184800022289174,1.0740815476190484,-6.557227205264082e-05,2.3024424084313912e-05,1.0739242857142854,1.0719085239653143,1.0741912419329984,1.0719788311911367,1.0741664529643535,2.3026885922147165e-05,-6.557172671430447e-05,1.0743584108803417,1.0734731865912814,97.04100400302427,97.00481881580401,-3.741628906426584e-05,1.0716479140641586,1.0,1.0740091196201436,bullish,1.0741210069307872,1.0737206174020038,1.0744476229790165,0.00040038952878340694,0.0003389222631614261,0.000546005799724823,0.00014345717234309774,0.00015313037495734427,0.00020906776745754918,1.0749936287787414,1.0739016171792917,,True,False,even,1.0795499999999998,1.0753499999999998,1.0753499999999998,1.0755499999999998,2024-07-03 10:45:00,True,2024-07-03 10:45:00,2024-07-03 17:00:00,2024-07-03 13:01:03,0.01,True,14.6,265.73999999999995,,4,0,27,7
2024-07-03 01:00:00,1.07446,1.07487,1.07444,1.07479,113,12,0,1.07444,1.07487,7.777794064769835e-05,-1.2633628316409365e-05,0.0001553224747415928,4.188517191113675e-05,1.0743082446288192,1.0743812981490193,2024-07-03 01:00:00,2024-07-03 01:00:00,0.0001669047619059505,0.00037230384939501704,1.074641666666667,6.75125858466683e-05,5.795340012275871e-05,1.0743483333333337,1.070140195032405,1.0737322624280117,1.0708365719308743,1.0740526291892951,3.408933534673069e-05,7.314095813258326e-06,1.0746992004029756,1.073719090000392,81.17573483425325,75.76016088857169,0.00015015679457252684,1.0720463331054368,1.0,1.0743720741724325,bullish,1.0744252134427812,1.0741107222673838,1.0746229583763316,0.00031449117539739113,0.00033643937049765345,0.0005290721437884613,2.5827313379744865e-05,-2.8737530099354203e-05,-1.3426212591038933e-05,1.07515203052012,1.074093886232543,,True,False,even,1.0797899999999998,1.0755899999999998,1.0755899999999998,1.0757899999999998,2024-07-03 11:00:00,True,2024-07-03 11:00:00,2024-07-03 17:00:00,2024-07-03 11:04:09,0.01,True,14.6,280.34,,5,0,27,7
2024-07-03 01:45:00,1.07469,1.07484,1.07468,1.07483,184,12,0,1.0746511163972159,1.07484,-9.651767361407794e-06,-2.310265625190673e-07,-1.2633628316409365e-05,7.777794064769835e-05,1.0744460304740764,1.0748690200690663,2024-07-03 01:00:00,2024-07-03 01:00:00,0.0001669047619059505,0.00037230384939501704,1.074641666666667,6.75125858466683e-05,5.795340012275871e-05,1.0743483333333337,1.070140195032405,1.0737322624280117,1.0708365719308743,1.0740526291892951,3.408933534673069e-05,7.314095813258326e-06,1.0746992004029756,1.073719090000392,86.53846153845784,84.89681050656027,0.00015015679457252684,1.0720463331054368,1.0,1.0743720741724325,bullish,1.0745489208431234,1.0742392508981287,1.074687186102512,0.000309669944994706,0.00032289537938658304,0.00044697576369742985,3.4987960096932724e-05,2.6453388371816544e-05,2.7863777116721167e-06,1.0751341618662094,1.0742402103388147,,True,False,even,1.0798299999999998,1.0756299999999999,1.0756299999999999,1.0758299999999998,2024-07-03 11:00:00,True,2024-07-03 11:00:00,2024-07-03 17:00:00,2024-07-03 11:03:20,0.01,True,14.6,294.94,,6,0,27,7
2024-07-03 02:30:00,1.07464,1.07485,1.07462,1.07485,149,12,0,1.074563350889369,1.074876648593093,7.753669869956923e-05,0.0002340889941814576,-2.310265625190673e-07,-9.651767361407794e-06,1.0746503677145354,1.0748399820762313,2024-07-03 02:00:00,2024-07-03 02:00:00,0.0002933333333332566,0.000421377671553147,1.0747700000000002,0.00012395198256530252,5.7957926288394065e-05,1.074641666666667,1.0696129383604844,1.0737944852268366,1.070140195032405,1.0737322624280117,5.795340012275871e-05,6.75125858466683e-05,1.0747197334676586,1.0737999628003605,84.93589743590447,84.93589743589973,0.0002044009699686509,1.0722025531191106,1.0,1.0745071840024014,bullish,1.0746184313346367,1.0743381138689865,1.074702968696251,0.0002803174656502705,0.0003036839379173922,0.00031935716682046644,4.5146198830448014e-05,-1.1076711385227256e-05,-1.8286893706198626e-05,1.0750223258630716,1.0743836115294305,,True,False,even,1.07985,1.07565,1.07565,1.07585,2024-07-03 11:00:00,True,2024-07-03 11:00:00,2024-07-03 17:00:00,2024-07-03 11:03:20,0.01,True,14.6,309.54,,7,0,27,7
2024-07-03 02:45:00,1.07484,1.07486,1.07466,1.07473,104,12,0,1.07466,1.0754149950413636,4.6748510168000476e-05,-3.254149414282854e-05,5.973235818769336e-06,2.722204887031499e-05,1.074574348424739,1.074830462701434,2024-07-03 02:00:00,2024-07-03 02:00:00,0.0002933333333332566,0.000421377671553147,1.0747700000000002,0.00012395198256530252,5.7957926288394065e-05,1.074641666666667,1.0696129383604844,1.0737944852268366,1.070140195032405,1.0737322624280117,5.795340012275871e-05,6.75125858466683e-05,1.0747197334676586,1.0737999628003605,87.82051282051759,85.68376068376556,0.0002044009699686509,1.0722025531191106,1.0,1.0745071840024014,bullish,1.0746355957446925,1.0743671424712837,1.074728462332302,0.0002684532734087419,0.0002966378050156622,0.00027166339466257574,2.5493636050866186e-05,4.5146198830448014e-05,-1.1076711385227256e-05,1.0750001257269646,1.0744567989376392,,True,False,even,1.0797299999999999,1.0755299999999999,1.0755299999999999,1.0757299999999999,2024-07-03 11:00:00,True,2024-07-03 11:00:00,2024-07-03 17:00:00,2024-07-03 11:04:48,0.01,True,14.6,324.14000000000004,,8,0,27,7
2024-07-03 03:00:00,1.07474,1.07538,1.07473,1.07505,389,12,0,1.07473,1.0754917145602942,-1.528269287774605e-05,-0.00016897379195530065,0.00022656856085917046,5.513527312406678e-05,1.0745565355593663,1.0746669266894084,2024-07-03 03:00:00,2024-07-03 03:00:00,0.0001283333333332859,0.0004337897542414648,1.074767857142857,0.0001689859477048799,7.908386189256864e-05,1.0747700000000002,1.0693155116668784,1.073586118920781,1.0696129383604844,1.0737944852268366,5.7957926288394065e-05,0.00012395198256530252,1.0747265778225528,1.0738743657763317,87.7750206782491,86.84381031155705,0.0002502787268232137,1.0724159488695817,1.0,1.0746491539764198,bullish,1.0746993502455089,1.074417724510448,1.0748063226694184,0.0002816257350608531,0.0002936353910247004,0.0002553918557817024,7.786033711654206e-05,2.5493636050866186e-05,4.5146198830448014e-05,1.0750617145252002,1.0745509308136367,,True,False,even,1.08005,1.07585,1.07585,1.07605,2024-07-03 11:15:00,True,2024-07-03 11:15:00,2024-07-03 17:00:01,2024-07-03 11:25:38,0.01,True,14.6,338.74000000000007,,9,0,27,7
2024-07-03 11:00:00,1.07589,1.07613,1.07549,1.07613,904,12,0,1.07549,1.076228858320891,5.9108278666326746e-05,1.893647493932321e-05,9.723453379198925e-05,0.0001299769910701903,1.075080967432818,1.0758976756649006,2024-07-03 11:00:00,2024-07-03 11:00:00,0.0005654761904760885,0.00033352951512832796,1.075209880952381,0.00012546809115885997,8.171172237451661e-05,1.074752857142857,1.0708054522108301,1.0742652347871324,1.0706711347529416,1.07420262618659,7.695808392526338e-05,0.00012546273690804393,1.0756344896475876,1.074289947555183,93.84611069034072,88.15094556422876,0.0002568939050751828,1.07356,1.0,1.0760004892104518,bullish,1.0750024657094068,1.074649161394257,1.0752499105607156,0.0003533043151497939,0.00010453335115526823,0.0006830439224527148,0.00032866873065073854,0.0002984038527689137,0.00028501547987591636,1.0759329544831684,1.0745668666382628,,True,False,success,1.08113,1.07693,1.07693,1.07713,2024-07-03 15:45:00,True,2024-07-03 15:45:00,2024-07-03 17:10:57,,0.01,True,91.28,430.0200000000001,,10,0,27,7
2024-07-03 11:15:00,1.07613,1.07626,1.07578,1.07593,820,12,0,1.07578,1.0764067002825866,-5.8643607025060406e-05,-5.4211205268947354e-05,9.603181396164254e-05,7.283182739796124e-05,1.0753390833909897,1.076014226504679,2024-07-03 11:00:00,2024-07-03 11:00:00,0.0005654761904760885,0.00033352951512832796,1.075209880952381,0.00012546809115885997,8.171172237451661e-05,1.074752857142857,1.0708054522108301,1.0742652347871324,1.0706711347529416,1.07420262618659,7.695808392526338e-05,0.00012546273690804393,1.0756344896475876,1.074289947555183,92.91938997821451,91.3912810395172,0.0002568939050751828,1.07356,1.0,1.0760004892104518,bullish,1.075145163292575,1.0747440383280158,1.075502786377709,0.00040112496455924074,0.00016385167383606275,0.000743875661653011,0.0002528758169932921,0.00032866873065073854,0.0002984038527689137,1.0762466620393618,1.074758910716056,,True,False,success,1.08093,1.07673,1.07673,1.07693,2024-07-03 15:45:00,True,2024-07-03 15:45:00,2024-07-03 17:08:46,,0.01,True,91.28,521.3000000000001,,11,0,27,7
2024-07-03 11:30:00,1.07596,1.07626,1.07586,1.07621,583,12,0,1.0757700026966974,1.0764554135008757,-9.29635003943006e-05,-0.00015367678887061374,6.469265724272515e-05,8.438382076296585e-05,1.075416665004456,1.0761151130322397,2024-07-03 11:00:00,2024-07-03 11:00:00,0.0005654761904760885,0.00033352951512832796,1.075209880952381,0.00012546809115885997,8.171172237451661e-05,1.074752857142857,1.0708054522108301,1.0742652347871324,1.0706711347529416,1.07420262618659,7.695808392526338e-05,0.00012546273690804393,1.0756344896475876,1.074289947555183,95.30864197531066,94.02471421462197,0.0002568939050751828,1.07356,1.0,1.0760004892104518,bullish,1.0753089843244865,1.074852628081496,1.075786332989337,0.0004563562429904522,0.00022235258766694065,0.000817160326985987,0.0002835466116279939,0.0002528758169932921,0.00032866873065073854,1.0766034933163229,1.074969172662351,,True,False,success,1.08121,1.07701,1.07701,1.07721,2024-07-03 15:45:00,True,2024-07-03 15:45:00,2024-07-03 17:12:40,,0.01,True,91.28,612.58,,12,0,27,7
2024-07-03 12:30:00,1.07584,1.07617,1.07575,1.076,668,12,0,1.0755599710411636,1.07617,-0.0001720195512236508,-4.050123854574371e-05,-4.0487983551857946e-05,-2.3247089148207943e-05,1.0755581745896192,1.0762868079831467,2024-07-03 12:00:00,2024-07-03 12:00:00,0.0004570238095238377,0.00042148528179786204,1.0754165476190478,0.00012544918134438094,8.169466474768648e-05,1.075209880952381,1.070939772356243,1.074353046779759,1.0708054522108301,1.0742652347871324,8.171172237451661e-05,0.00012546809115885997,1.0755114965491959,1.0743827517507685,83.08457711443036,82.71297831828794,0.00028981218041971863,1.07361,1.0,1.0761883794171245,bullish,1.0755664234268691,1.0751106545116662,1.076309329205367,0.0004557689152029365,0.0003580964626966385,0.0009246020765715256,9.166838665475296e-05,0.00012986584107110843,0.00012573787409819737,1.0772339312819386,1.0753847271287953,,True,False,success,1.081,1.0768,1.0768,1.077,2024-07-03 15:45:00,True,2024-07-03 15:45:00,2024-07-03 17:08:46,,0.01,True,91.28,703.86,,13,0,27,7
2024-07-03 15:45:00,1.07755,1.07758,1.07713,1.0774,1181,12,0,1.0766503418271078,1.0776533600393932,0.00045469437931729855,0.00036020870463111555,0.0007475345449209036,0.0006705525672919174,1.074822798404172,1.0762198385697244,2024-07-03 15:00:00,2024-07-03 15:00:00,0.00014738095238064908,0.00047924929776743674,1.0764421428571427,7.277944485848828e-05,0.0001280953827541176,1.0758291666666666,1.0722883147840243,1.0746096157150826,1.0722103198975892,1.0745170897392342,8.273187148918319e-05,7.27708061994025e-05,1.0768322776499701,1.0748156915553024,90.09100101111937,72.66715009889849,0.0003761208650509045,1.07391890752,1.0,1.0767559931272481,bullish,1.076286737286266,1.0757986113164066,1.0764421843825251,0.0004881259698592544,0.0003665498634911188,0.0006064082783107955,0.0002757069143450863,0.0003460853113175233,0.00012836601307131268,1.077048592660836,1.0758357761042143,,True,False,even,1.0823999999999998,1.0781999999999998,1.0781999999999998,1.0783999999999998,2024-07-03 16:45:00,True,2024-07-03 16:45:00,2024-07-05 09:38:18,2024-07-03 20:35:38,0.01,True,14.6,718.46,,14,0,27,7
2024-07-03 16:15:00,1.07789,1.07843,1.0778699999999999,1.07825,1010,12,0,1.0777329000712985,1.078419447184974,0.0004163860184084355,0.0009292483383242379,0.000200729859898996,0.0003114474634616221,1.0765052590937911,1.0777862990864329,2024-07-03 16:00:00,2024-07-03 16:00:00,0.0006129761904760667,0.0006596985159612601,1.077291904761904,7.278254738693674e-05,0.00019910491516457365,1.0764421428571427,1.072366410158538,1.0742655208445082,1.0722883147840243,1.0746096157150826,0.0001280953827541176,7.277944485848828e-05,1.0781774258833234,1.0751384362308782,92.06754998442136,91.1215915124135,0.00043283639523297566,1.0740137512192,1.0,1.076942814799633,bullish,1.0767987882345453,1.0761243238309384,1.0771846233230131,0.0006744644036069669,0.0004623906833563036,0.0007818893783680663,0.0003702992776060121,0.0003721396628819651,0.0002757069143450863,1.077966512701381,1.0764027339446451,,True,False,even,1.0832499999999998,1.0790499999999998,1.0790499999999998,1.0792499999999998,2024-07-03 17:15:00,True,2024-07-03 17:15:00,2024-07-05 15:30:21,2024-07-03 20:07:07,0.01,True,14.6,733.0600000000001,,15,0,27,7
2024-07-03 16:30:00,1.07825,1.07864,1.07824,1.07863,846,12,0,1.077987207792477,1.078753445314494,0.0005066102238562438,0.0012390410920952782,0.00036020870463111555,0.00045469437931729855,1.0766873971072457,1.0776827424599402,2024-07-03 16:00:00,2024-07-03 16:00:00,0.0006129761904760667,0.0006596985159612601,1.077291904761904,7.278254738693674e-05,0.00019910491516457365,1.0764421428571427,1.072366410158538,1.0742655208445082,1.0722883147840243,1.0746096157150826,0.0001280953827541176,7.277944485848828e-05,1.0781774258833234,1.0751384362308782,96.74566225277665,93.33981192629926,0.00043283639523297566,1.0740137512192,1.0,1.076942814799633,bullish,1.0770805131215384,1.0763099294730911,1.0775783384932915,0.0007705836484472872,0.0005240292763745004,0.0009130684530774743,0.0003937151702784192,0.0003702992776060121,0.0003721396628819651,1.078491406946369,1.0766652700402142,,True,False,even,1.0836299999999999,1.07943,1.07943,1.0796299999999999,2024-07-03 17:15:00,True,2024-07-03 17:15:00,2024-07-05 15:30:37,2024-07-03 19:31:01,0.01,True,14.6,747.6600000000001,,16,0,27,7
2024-07-03 16:45:00,1.07863,1.07918,1.07862,1.07885,1180,12,0,1.07862,1.081064700650693,0.0004325773648437642,0.0003378499403230275,0.0003525879982963416,0.00046101543431453546,1.077177688786417,1.078067934369863,2024-07-03 16:00:00,2024-07-03 16:00:00,0.0006129761904760667,0.0006596985159612601,1.077291904761904,7.278254738693674e-05,0.00019910491516457365,1.0764421428571427,1.072366410158538,1.0742655208445082,1.0722883147840243,1.0746096157150826,0.0001280953827541176,7.277944485848828e-05,1.0781774258833234,1.0751384362308782,95.11256532606144,94.64192585441981,0.00043283639523297566,1.0740137512192,1.0,1.076942814799633,bullish,1.077352741872071,1.0764980828454547,1.077984633642931,0.0008546590266163001,0.0005901552264228604,0.0010398095979581089,0.00040629514963952396,0.0003937151702784192,0.0003702992776060121,1.079024443240889,1.076944824044973,,True,False,even,1.08385,1.07965,1.07965,1.07985,2024-07-03 17:15:00,True,2024-07-03 17:15:00,2024-07-05 15:30:42,2024-07-03 18:52:21,0.01,True,14.6,762.2600000000001,,17,0,27,7
2024-07-03 17:00:00,1.07927,1.0814300000000001,1.07908,1.08134,3190,12,0,1.07908,1.081858887501596,0.00032441413892344954,-0.00022157124296874308,0.0009292483383242379,0.0004163860184084355,1.077767993574797,1.07849781679065,2024-07-03 17:00:00,2024-07-03 17:00:00,0.0008497619047613814,0.0009292757898740067,1.0785157142857138,5.272379099366852e-05,0.0002924390431319525,1.077291904761904,1.07276564397454,1.07440359448932,1.072366410158538,1.0742655208445082,0.00019910491516457365,7.278254738693674e-05,1.0797391419611078,1.075568961332408,96.46441717791326,96.10754825225045,0.000532124274161182,1.074239126146048,1.0,1.0771266532941965,bullish,1.0779661661994446,1.076856743375421,1.0788241795665636,0.0011094228240235982,0.000694008745943008,0.0014289156728116176,0.0008395459236325564,0.00040629514963952396,0.0003937151702784192,1.0802530952393752,1.077395263893752,,True,False,even,1.0863399999999999,1.0821399999999999,1.0821399999999999,1.0823399999999999,2024-07-05 06:30:00,True,2024-07-05 06:30:00,,2024-07-05 06:45:57,0.01,True,14.6,776.8600000000001,,18,0,27,7
2024-07-04 19:00:00,1.08101,1.0813,1.08093,1.08129,282,12,0,1.08093,1.0813400055200857,-5.923382390356188e-06,-2.312254984294066e-05,-2.6422358526151466e-06,-2.489647872612325e-07,1.0809307863083033,1.0813097767058935,2024-07-04 19:00:00,2024-07-04 19:00:00,0.0002900000000001235,0.0005985121778280256,1.0808103571428578,7.742932163729324e-05,7.485518336968402e-05,1.0804639285714288,1.0773515283212576,1.0795363058658995,1.077641827806762,1.0799745327485197,5.388092457539363e-05,5.2514957542103604e-05,1.0810511041393789,1.0792626691628449,92.49563699825244,91.44851657940389,0.0005306495866524234,1.0779788,1.0,1.0804869211607677,bullish,1.0807121788046576,1.0802756461674659,1.0811042139662896,0.0004365326371917888,0.0003309734808654496,0.0006046210934885199,0.00015642586859376806,0.00011029927760564107,0.00019798761610001492,1.081708835059778,1.0804995928728012,,True,False,even,1.08629,1.08209,1.08209,1.08229,2024-07-05 06:30:00,True,2024-07-05 06:30:00,,2024-07-05 06:46:19,0.01,True,14.6,791.4600000000002,,19,0,27,7
2024-07-04 19:15:00,1.08129,1.08131,1.08123,1.08128,152,12,0,1.0811433155308907,1.081308791406022,-0.00011253961942857457,-2.7372708724040306e-05,2.6421804791835282e-06,-1.5473599066599715e-06,1.0809332144750208,1.0813002232609858,2024-07-04 19:00:00,2024-07-04 19:00:00,0.0002900000000001235,0.0005985121778280256,1.0808103571428578,7.742932163729324e-05,7.485518336968402e-05,1.0804639285714288,1.0773515283212576,1.0795363058658995,1.077641827806762,1.0799745327485197,5.388092457539363e-05,5.2514957542103604e-05,1.0810511041393789,1.0792626691628449,93.36823734729438,91.62303664921306,0.0005306495866524234,1.0779788,1.0,1.0804869211607677,bullish,1.0807995359116334,1.0803500427476536,1.0812233436532512,0.0004494931639797972,0.0003546774174883191,0.0006272022534172671,0.00011912968696159432,0.00015642586859376806,0.00011029927760564107,1.0818505459066685,1.080596141399834,,True,False,even,1.08628,1.08208,1.08208,1.08228,2024-07-05 06:30:00,True,2024-07-05 06:30:00,,2024-07-05 06:46:21,0.01,True,14.6,806.0600000000002,,20,0,27,7
2024-07-04 19:30:00,1.08127,1.08129,1.0811,1.08111,178,12,0,1.0808683351797115,1.08129,2.929529475977099e-05,-3.736776407115938e-05,-4.62378745788199e-06,8.362486028858136e-05,1.0808466601586706,1.0813096100782977,2024-07-04 19:00:00,2024-07-04 19:00:00,0.0002900000000001235,0.0005985121778280256,1.0808103571428578,7.742932163729324e-05,7.485518336968402e-05,1.0804639285714288,1.0773515283212576,1.0795363058658995,1.077641827806762,1.0799745327485197,5.388092457539363e-05,5.2514957542103604e-05,1.0810511041393789,1.0792626691628449,94.7553710055958,93.53974845038086,0.0005306495866524234,1.0779788,1.0,1.0804869211607677,bullish,1.080847299617536,1.080406335877457,1.0813081492948056,0.00044096374007907,0.0003719346820064693,0.0006285480623565057,8.480564155433079e-05,0.00011912968696159432,0.00015642586859376806,1.081936697357162,1.080679601232449,,True,False,even,1.08611,1.08191,1.08191,1.08211,2024-07-05 06:30:00,True,2024-07-05 06:30:00,,2024-07-05 07:03:18,0.01,True,14.6,820.6600000000002,,21,0,27,7
2024-07-04 23:00:00,1.08125,1.0812599999999999,1.08117,1.08121,83,12,0,1.08117,1.081323784473225,-6.758825338865192e-05,-2.2745882331972052e-05,2.8496539025503763e-05,1.2084372782152455e-05,1.0811318250358637,1.0811907836719319,2024-07-04 23:00:00,2024-07-04 23:00:00,8.797619047684613e-05,0.0006374687929455725,1.0811888095238094,0.00013117944090122356,0.00012470376537668975,1.0812834523809525,1.0771685396502173,1.0789059908002783,1.0770273088898086,1.0787897306926957,0.0001238101234784907,0.00013117690928352762,1.0810287790634492,1.0797826666526715,81.25738308666288,73.6009774627724,0.000598099333788329,1.078482163273728,1.0,1.0809231271094795,bullish,1.081139756971982,1.080901099768699,1.0811772308221534,0.00023865720328308804,0.0002857814492475402,0.0003107903902898547,1.839353285149059e-05,9.466804266056172e-06,2.0096319229612192e-05,1.0814880212124434,1.0808664404318635,,True,False,even,1.08621,1.08201,1.08201,1.08221,2024-07-05 06:30:00,True,2024-07-05 06:30:00,,2024-07-05 06:46:36,0.01,True,14.6,835.2600000000002,,22,0,27,7
2024-07-04 23:15:00,1.08122,1.08131,1.08121,1.0812599999999999,76,12,0,1.0811666703827594,1.0813775814438389,-0.00010483774306548371,-6.399287157352938e-05,2.708489020134751e-05,9.249381156426826e-06,1.0811507811462335,1.0812244300170863,2024-07-04 23:00:00,2024-07-04 23:00:00,8.797619047684613e-05,0.0006374687929455725,1.0811888095238094,0.00013117944090122356,0.00012470376537668975,1.0812834523809525,1.0771685396502173,1.0789059908002783,1.0770273088898086,1.0787897306926957,0.0001238101234784907,0.00013117690928352762,1.0810287790634492,1.0797826666526715,83.83190883190667,79.32272485118575,0.000598099333788329,1.078482163273728,1.0,1.0809231271094795,bullish,1.0811582558993695,1.0809276849710177,1.0811851599587199,0.00023057092835188087,0.00027473934506840834,0.00024016175111123229,7.929136566442452e-06,1.839353285149059e-05,9.466804266056172e-06,1.081425321709831,1.0809449982076087,,True,False,even,1.0862599999999998,1.0820599999999998,1.0820599999999998,1.0822599999999998,2024-07-05 06:30:00,True,2024-07-05 06:30:00,,2024-07-05 06:46:23,0.01,True,14.6,849.8600000000002,,23,0,27,7
2024-07-05 11:45:00,1.08292,1.08299,1.08268,1.08273,373,12,0,1.0825950007402783,1.0829799956767636,-2.3093612053384507e-05,1.3852475449237473e-05,5.502831516554536e-05,0.0001585883383317996,1.0820420288965686,1.082834736265756,2024-07-05 11:00:00,2024-07-05 11:00:00,0.0002649999999995156,0.0005499016513486055,1.082515595238095,0.00011263686550067482,9.410013083118863e-05,1.0823357142857137,1.0789334437649278,1.080717741510099,1.0788119193871302,1.080616005331711,9.410756733035733e-05,0.00011263985807669691,1.0826649740399763,1.081152039832228,82.8606187000387,78.87730274591924,0.0005167550543863459,1.0803551051596538,1.0,1.0820180281600642,bullish,1.0824804106490822,1.0821971828833814,1.0826795321637421,0.00028322776570077757,0.0002469076248872142,0.00032041743612137516,6.970760233904194e-05,0.00011691434468508177,6.546611627111787e-05,1.0829999495998635,1.0823591147276208,,True,False,even,1.0877299999999999,1.0835299999999999,1.0835299999999999,1.0837299999999999,2024-07-05 22:15:00,True,2024-07-05 22:15:00,,2024-07-05 23:59:00,0.01,True,14.6,864.4600000000003,,24,0,27,7
2024-07-05 12:00:00,1.08273,1.08288,1.08257,1.08285,582,12,0,1.08257,1.0830683500529725,-1.822115983201904e-05,-6.387357273718654e-05,3.540636061068645e-05,0.00011727409882896372,1.0822101019539143,1.082924708923109,2024-07-05 12:00:00,2024-07-05 12:00:00,0.00017988095238119506,0.000571461208609847,1.082582619047619,0.0001126387093954494,9.410141049029219e-05,1.082515595238095,1.0790549556401563,1.080819421079158,1.0789334437649278,1.080717741510099,9.410013083118863e-05,0.00011263686550067482,1.0826083246799922,1.08126627664565,89.50295446646773,83.40748464836645,0.0005276962852310462,1.0806676925404954,1.0,1.0820887188715447,bullish,1.0825372705492233,1.0822455397068345,1.0827634502923975,0.0002917308423888709,0.00025587226838754557,0.000327394766865469,8.391812865538029e-05,6.970760233904194e-05,0.00011691434468508177,1.083090845059263,1.0824360555255321,,True,False,even,1.08785,1.08365,1.08365,1.08385,2024-07-05 22:30:00,True,2024-07-05 22:30:00,,2024-07-05 23:57:56,0.01,True,14.6,879.0600000000003,,25,0,27,7
2024-07-08 00:30:00,1.08128,1.08196,1.08109,1.08179,140,21,0,1.0809602024321314,1.0820166431808147,0.0003651888274676074,0.0005603781675469129,-0.0006096310561768899,6.550019585664582e-05,1.079554846076454,1.083878051285837,2024-07-08 00:00:00,2024-07-08 00:00:00,0.0002332142857144337,0.0005082241638598717,1.0830690476190472,-3.196808720422776e-05,0.00013619661714612212,1.0836104761904766,1.0804113857298192,1.0821063256610022,1.0806549138060009,1.0815156518956368,0.00016367896051220547,-4.559681675990535e-05,1.0823729079772255,1.0822162577099197,37.928519328957954,46.081780874121044,0.000425941774437365,1.0800054,1.0,1.0826825800286066,bullish,1.0827467094304786,1.082872378928288,1.0828152700378393,-0.00012566949780934422,0.00015944029999873511,0.0008434862180508672,-0.00031218782249742283,-0.0004479910560717393,-0.000518348813209224,1.0836587562558901,1.0819717838197884,,True,False,even,1.08679,1.08259,1.08259,1.08279,2024-07-08 01:15:00,True,2024-07-08 01:15:00,,2024-07-08 01:25:11,0.01,True,14.6,893.6600000000003,,26,0,28,7
2024-07-08 16:00:00,1.08435,1.08439,1.0838,1.08426,822,12,0,1.0838,1.0844833451680085,-4.227714293461898e-06,-1.998464727241359e-05,0.00013065873082994167,5.20397471872016e-05,1.0836353731571222,1.0841181260411386,2024-07-08 16:00:00,2024-07-08 16:00:00,0.00038428571428617,0.00032522715874905295,1.0839100000000004,0.00018413275980432215,1.2259791647697265e-05,1.0837955952380955,1.0782453636020013,1.0841246148449242,1.0781438519213709,1.0841241336893253,1.0264047963811163e-05,0.000172775696676559,1.0840113934381415,1.0829512393678993,94.86486486486048,90.93392603109952,0.0002148443864349466,1.0803846683842562,1.0,1.082943406308566,bearish,1.0837024794648384,1.0834438729304003,1.0836563536291715,0.00025860653443809944,0.00017061127525806063,0.0005167768700092919,0.00018667010663953043,0.00014969384244989392,0.00015055039559741523,1.0841731304991808,1.083139576759162,,True,False,even,1.08926,1.08506,1.08506,1.08526,2024-07-11 15:00:00,True,2024-07-11 15:00:00,2024-07-11 15:33:07,2024-07-11 15:18:03,0.01,True,14.6,908.2600000000003,,27,0,28,7
2024-07-08 16:15:00,1.08426,1.08443,1.08411,1.08435,819,12,0,1.083763335086903,1.0844337456825541,1.537677501316806e-05,-4.2251758044306465e-06,5.0721771666730235e-05,1.076012500737143e-05,1.0837776209670547,1.0843394531129353,2024-07-08 16:00:00,2024-07-08 16:00:00,0.00038428571428617,0.00032522715874905295,1.0839100000000004,0.00018413275980432215,1.2259791647697265e-05,1.0837955952380955,1.0782453636020013,1.0841246148449242,1.0781438519213709,1.0841241336893253,1.0264047963811163e-05,0.000172775696676559,1.0840113934381415,1.0829512393678993,95.42056074766161,94.70574779292035,0.0002148443864349466,1.0803846683842562,1.0,1.082943406308566,bearish,1.0838020980087095,1.0835109934540743,1.0838235466116268,0.0002911045546352131,0.00019470993113349116,0.0005019505288142134,0.0001671929824553775,0.00018667010663953043,0.00014969384244989392,1.084325497140441,1.0833215960828126,,True,False,even,1.0893499999999998,1.0851499999999998,1.0851499999999998,1.0853499999999998,2024-07-11 15:00:00,True,2024-07-11 15:00:00,2024-07-11 15:42:56,2024-07-11 15:17:10,0.01,True,14.6,922.8600000000004,,28,0,28,7
2024-07-09 10:45:00,1.08198,1.08198,1.08164,1.0817,1220,12,0,1.0813833432539572,1.08198,7.088515801580438e-05,3.979496707475758e-05,-0.0002186056520226489,-0.00023080002828803706,1.082380381005434,1.0830948512592686,2024-07-09 10:00:00,2024-07-09 10:00:00,-0.00011333333333363171,-8.446581873733372e-05,1.0823534523809524,-2.813496308363418e-05,-8.200280347913389e-05,1.0826295238095234,1.0823485105884967,1.084946697083714,1.0820193361206298,1.0850611190868344,-8.539961557981011e-05,-7.74789050764006e-06,1.0819801601590344,1.082665180231631,16.319202053338657,25.326270616647292,-8.051784893626294e-05,,-1.0,1.082206093107522,bearish,1.0824387681339698,1.0825679606710836,1.0823318747850017,-0.0001291925371138536,-3.055422029698826e-05,0.0003218498615400005,-0.0001968902648767923,-0.0001468421052635005,-3.3508771930756964e-05,1.0826537246465417,1.0820100249234617,,False,True,even,1.0767000000000002,1.0809000000000002,1.0809000000000002,1.0807000000000002,2024-07-09 18:15:00,True,2024-07-09 18:15:00,,2024-07-09 18:17:12,0.01,True,14.6,937.4600000000004,,29,0,28,7
2024-07-09 11:00:00,1.08169,1.08185,1.08146,1.08178,845,12,0,1.081416709079892,1.0819150241857214,0.00012634185840898715,0.00013399028443050038,-0.00036996327473230294,-0.0003057957361077162,1.0822757081405494,1.083009114599745,2024-07-09 11:00:00,2024-07-09 11:00:00,-0.00027607142857100087,-0.00018101844956475155,1.0822635714285713,-3.441757568514372e-05,-8.200190945648555e-05,1.0823534523809524,1.0823243084449046,1.084857687820337,1.0823485105884967,1.084946697083714,-8.200280347913389e-05,-2.813496308363418e-05,1.0821133867196782,1.0826263658131006,9.287238583016753,18.071940707483787,-0.00010061796906196067,,-1.0,1.0821495424946332,bearish,1.0823374191902821,1.0825095932139663,1.0821847781217753,-0.00017217402368419066,-5.8878180974428736e-05,0.0003550643134794205,-0.00014709666322643145,-0.0001968902648767923,-0.0001468421052635005,1.0825398424352546,1.081829713808296,,False,True,even,1.07678,1.08098,1.08098,1.08078,2024-07-09 18:15:00,True,2024-07-09 18:15:00,,2024-07-09 18:19:53,0.01,True,14.6,952.0600000000004,,30,0,28,7
2024-07-09 14:30:00,1.08162,1.08169,1.08115,1.08129,746,12,0,1.081113338381256,1.08169,4.932709353249377e-05,-3.106564888036089e-05,-0.0002972524035552262,-0.00029917608746343456,1.0820954963801022,1.0826366242134435,2024-07-09 14:00:00,2024-07-09 14:00:00,-7.083333333235409e-05,-0.00018666086565777285,1.0817816666666669,-5.77393395368364e-05,-7.616615216169197e-05,1.0820896428571438,1.0825925843473607,1.0845787470086687,1.0825957508294541,1.084661309990929,-7.617162069565462e-05,-4.970319287756282e-05,1.0815975328414695,1.082459275062272,19.529652351735987,37.08007881787276,-0.00014326549266814798,,-1.0,1.0819885159403555,bearish,1.0819837829501786,1.0821810492666826,1.0819501995184038,-0.00019726631650396342,-0.00013910106771862878,0.00040967995643665105,-0.00010865497075940311,-7.723426212735696e-05,2.1362229096766328e-06,1.0823598794748404,1.0815405195619672,,False,True,running,1.0762900000000002,1.09029,1.0804900000000002,1.0802900000000002,,False,,,,0.01,False,0.0,952.0600000000004,2024-07-09 17:30:00,0,1,28,7
2024-07-09 14:45:00,1.08129,1.0816,1.08118,1.08131,914,12,0,1.08118,1.0815892021234923,1.5660255156700435e-05,3.722643528756117e-05,-0.0002313028969651645,-0.0002604480374475596,1.0816912899530737,1.082320429625862,2024-07-09 14:00:00,2024-07-09 14:00:00,-7.083333333235409e-05,-0.00018666086565777285,1.0817816666666669,-5.77393395368364e-05,-7.616615216169197e-05,1.0820896428571438,1.0825925843473607,1.0845787470086687,1.0825957508294541,1.084661309990929,-7.617162069565462e-05,-4.970319287756282e-05,1.0815975328414695,1.082459275062272,10.427898618082033,21.517836855258214,-0.00014326549266814798,,-1.0,1.0819885159403555,bearish,1.0818801240347664,1.0821165270987803,1.0818660302717575,-0.00023640306401384592,-0.00015856146697767223,0.00043069594848237536,-8.416924664622627e-05,-0.00010865497075940311,-7.723426212735696e-05,1.0822967262202399,1.0814353343232752,,False,True,running,1.07631,1.09031,1.08051,1.08031,,False,,,,0.01,False,0.0,952.0600000000004,2024-07-09 17:45:00,0,2,28,7
2024-07-09 15:00:00,1.08131,1.08151,1.08122,1.0814300000000001,774,12,0,1.0812308054014867,1.0815933345711466,-9.497152128370304e-06,5.392929743236881e-05,-0.00013891845875344382,-2.620294802296377e-05,1.0811761118935228,1.0819382337215322,2024-07-09 15:00:00,2024-07-09 15:00:00,-0.0003079761904769551,-0.0002765908609287937,1.0816408333333327,-5.7739685158960076e-05,-7.617340692571173e-05,1.0817816666666669,1.0825300697827345,1.084496135466932,1.0825925843473607,1.0845787470086687,-7.616615216169197e-05,-5.77393395368364e-05,1.08152584428049,1.0823817330572902,11.860940695296877,13.939497221704956,-0.00016993056632027713,,-1.0,1.0819394426533095,bearish,1.081810874183264,1.0820656732396114,1.0817671035431728,-0.00025479905634751,-0.0001778089848516398,0.00043415550214063564,-9.892672858469176e-05,-8.416924664622627e-05,-0.00010865497075940311,1.0822012590453134,1.0813329480410323,,False,True,running,1.0764300000000002,1.09043,1.0806300000000002,1.0804300000000002,,False,,,,0.01,False,0.0,952.0600000000004,2024-07-09 18:00:00,0,3,28,7
2024-07-09 18:15:00,1.08054,1.081,1.08049,1.08079,1236,12,0,1.080500781776677,1.081,0.00016322328550959217,0.00016931723428997852,-0.00014948502953564133,-0.00032074480375183807,1.0811764157137218,1.0821709238818118,2024-07-09 18:00:00,2024-07-09 18:00:00,-8.035714285647977e-05,-0.00028323352398729185,1.0814663095238093,-7.771484186809124e-05,-3.228316946585217e-05,1.0816978571428575,1.0824164722172596,1.0835365576510272,1.0824394593389945,1.083571471187207,-3.228087474708961e-05,-6.330175780799567e-05,1.0813491053437216,1.0822053123909152,16.204005589190416,23.90208559747137,-0.00022496588245924246,1.08087,1.0,1.0818131946725804,bearish,1.0814394928751532,1.0817077791172958,1.0814068627450977,-0.0002682862421425902,-0.00018177351040997707,0.0005074977832838372,-0.00010917440660596078,-0.0001487547299603431,-3.7598899222945903e-06,1.0819143605283814,1.080899364961814,,False,True,fail,1.07579,1.0897899999999998,1.07999,1.07979,,False,,,2024-07-11 15:51:14,0.01,False,-164.22,787.8400000000004,,0,4,28,7
2024-07-09 18:30:00,1.0808,1.08117,1.08075,1.0811,1103,12,0,1.08075,1.0812433262851973,5.8841436429925e-05,0.00014641817553045917,-0.000323991938578335,-3.0832543641357265e-05,1.0805407174465904,1.0821832294556613,2024-07-09 18:00:00,2024-07-09 18:00:00,-8.035714285647977e-05,-0.00028323352398729185,1.0814663095238093,-7.771484186809124e-05,-3.228316946585217e-05,1.0816978571428575,1.0824164722172596,1.0835365576510272,1.0824394593389945,1.083571471187207,-3.228087474708961e-05,-6.330175780799567e-05,1.0813491053437216,1.0822053123909152,13.894064068722875,17.539288240262803,-0.00022496588245924246,1.08087,1.0,1.0818131946725804,bearish,1.0813872632020527,1.0816627584419405,1.0813569315445473,-0.0002754952398877908,-0.0002005178563055398,0.0005174495144822295,-4.993120055041267e-05,-0.00010917440660596078,-0.0001487547299603431,1.0818743810590294,1.080839482030065,,False,True,fail,1.0761,1.0900999999999998,1.0803,1.0801,,False,,,2024-07-12 17:33:42,0.01,False,-164.22,623.6200000000003,,0,5,28,7
2024-07-09 20:15:00,1.08117,1.08133,1.08059,1.08064,936,12,0,1.0804962149443105,1.08133,8.75362607081434e-05,-4.95722895461718e-05,2.8490513828506104e-05,2.9300494766396006e-05,1.080490795948759,1.0812399700457236,2024-07-09 20:00:00,2024-07-09 20:00:00,-0.0002198809523814571,-0.00037918570405781615,1.081074642857143,-7.771530225140764e-05,-3.226326013099177e-05,1.0812464285714278,1.0822482832968185,1.083466181500711,1.082332351227711,1.0835011284572633,-3.226295805074018e-05,-7.771380243845721e-05,1.0809254561493025,1.0820037604076709,18.859649122809955,20.662768031191877,-0.000272242113730024,,-1.0,1.0817511131408561,bearish,1.0811147841903643,1.0813953550981168,1.0807719848641217,-0.0002805709077524643,-0.0002522380379517463,0.00046151850815574416,-0.00013847609219053147,-5.8947368421380375e-05,-9.452356381078886e-05,1.0812335033722775,1.080310466355966,,False,True,fail,1.0756400000000002,1.08964,1.0798400000000001,1.0796400000000002,,False,,,2024-07-11 15:43:43,0.01,False,-164.22,459.4000000000003,,0,6,28,7
2024-07-09 20:30:00,1.0806499999999999,1.08097,1.08058,1.08086,693,12,0,1.08058,1.081010003570634,6.501764353442539e-05,7.862233635139335e-05,2.848743050485625e-05,2.1833865426131687e-05,1.0805218344396086,1.0812707882463868,2024-07-09 20:00:00,2024-07-09 20:00:00,-0.0002198809523814571,-0.00037918570405781615,1.081074642857143,-7.771530225140764e-05,-3.226326013099177e-05,1.0812464285714278,1.0822482832968185,1.083466181500711,1.082332351227711,1.0835011284572633,-3.226295805074018e-05,-7.771380243845721e-05,1.0809254561493025,1.0820037604076709,19.170832108205495,20.327899201762705,-0.000272242113730024,,-1.0,1.0817511131408561,bearish,1.0810755866226158,1.081355699164923,1.0807180323357413,-0.00028011254230708715,-0.00025781293882281447,0.0004698137929402335,-5.395252838047426e-05,-0.00013847609219053147,-5.8947368421380375e-05,1.0811878461286815,1.080248218542801,,False,True,fail,1.07586,1.0898599999999998,1.08006,1.07986,,False,,,2024-07-11 15:51:16,0.01,False,-164.22,295.1800000000003,,0,7,28,7
2024-07-09 20:45:00,1.08085,1.08107,1.08083,1.08085,429,12,0,1.0808112105144254,1.0812016685594859,-1.8878489042711198e-05,-2.0041382889590842e-05,-0.00012523383073936997,7.415434033677055e-07,1.0805892609954943,1.0814548977780116,2024-07-09 20:00:00,2024-07-09 20:00:00,-0.0002198809523814571,-0.00037918570405781615,1.081074642857143,-7.771530225140764e-05,-3.226326013099177e-05,1.0812464285714278,1.0822482832968185,1.083466181500711,1.082332351227711,1.0835011284572633,-3.226295805074018e-05,-7.771380243845721e-05,1.0809254561493025,1.0820037604076709,17.533817035314474,18.521432755443303,-0.000272242113730024,,-1.0,1.0817511131408561,bearish,1.0810408809883674,1.0813182399675212,1.0806944547643613,-0.0002773589791538189,-0.00026172214688901537,0.0004802801266311523,-2.357757137994021e-05,-5.395252838047426e-05,-0.00013847609219053147,1.0811747348909926,1.08021417463773,,False,True,fail,1.0758500000000002,1.08985,1.0800500000000002,1.0798500000000002,,False,,,2024-07-11 15:51:16,0.01,False,-164.22,130.9600000000003,,0,8,28,7
2024-07-10 22:45:00,1.08254,1.08289,1.08252,1.08281,486,12,0,1.08252,1.08289,8.338219876395382e-05,6.474297552154627e-10,0.00014494771984460372,6.598961576511653e-05,1.0823113982049684,1.082431697555249,2024-07-10 22:00:00,2024-07-10 22:00:00,-3.571428575099844e-07,0.00017195332577601974,1.0824826190476193,4.986667338210433e-05,6.170414147967736e-05,1.082317976190476,1.0804882731123011,1.0816900595594872,1.0804344762879277,1.081623277119458,6.170498326278375e-05,4.986259094637872e-05,1.0826640210556722,1.0821035658489864,82.33801717409109,74.96584699454299,0.00014644395453038107,,-1.0,1.0829112486277426,bullish,1.082407049490893,1.0823308216850114,1.0823781458548327,7.622780588167899e-05,3.5102004259895744e-05,0.00022880632284222728,0.00010719642242773553,4.542139662855327e-05,3.4723082215970535e-05,1.0826069521776749,1.0821493395319906,,True,False,even,1.08781,1.08361,1.08361,1.08381,2024-07-11 05:00:00,True,2024-07-11 05:00:00,2024-07-11 15:30:09,2024-07-11 05:59:00,0.01,True,14.6,145.5600000000003,,1,0,28,7
2024-07-10 23:15:00,1.08273,1.0829,1.08272,1.08286,138,12,0,1.0827307923091452,1.0830375189000134,-0.0001264919713151109,-2.6937335910253372e-05,3.8481383089712316e-05,9.390694767807613e-05,1.0824264403021007,1.0828516468312916,2024-07-10 23:00:00,2024-07-10 23:00:00,0.00016464285714334892,0.00021227261093614835,1.082695476190477,4.986585463115886e-05,6.296193716517329e-05,1.0824826190476193,1.0805421802859043,1.0817433202068958,1.0804882731123011,1.0816900595594872,6.170414147967736e-05,4.986667338210433e-05,1.082854673685224,1.0821712805810675,92.08538806699816,86.71744265257495,0.00015960968581153452,1.08167,1.0,1.0830241264439122,bullish,1.0825174733041307,1.0823967126929108,1.0825265944272449,0.00012076061121990556,6.190476732545301e-05,0.0002559576788703998,7.432404540774762e-05,7.412452700439331e-05,0.00010719642242773553,1.0827825521061152,1.0822706367483745,,True,False,even,1.0878599999999998,1.0836599999999998,1.0836599999999998,1.0838599999999998,2024-07-11 05:00:00,True,2024-07-11 05:00:00,2024-07-11 15:30:10,2024-07-11 05:58:26,0.01,True,14.6,160.16000000000028,,2,0,28,7
2024-07-10 23:45:00,1.08282,1.08299,1.08275,1.08295,164,12,0,1.0821983660774963,1.08299,0.00011238890326638216,-4.642210176438908e-05,4.541216203512738e-05,2.1296398104435225e-05,1.0826826635868947,1.0828439186324978,2024-07-10 23:00:00,2024-07-10 23:00:00,0.00016464285714334892,0.00021227261093614835,1.082695476190477,4.986585463115886e-05,6.296193716517329e-05,1.0824826190476193,1.0805421802859043,1.0817433202068958,1.0804882731123011,1.0816900595594872,6.170414147967736e-05,4.986667338210433e-05,1.082854673685224,1.0821712805810675,96.00886917960413,93.48947289771111,0.00015960968581153452,1.08167,1.0,1.0830241264439122,bullish,1.0826246998213007,1.0824674148601772,1.082713832129343,0.0001572849611235494,9.295544895668753e-05,0.0002883470132314515,9.99277605793214e-05,8.730994151884275e-05,7.432404540774762e-05,1.0830021791425746,1.0824254851161115,,True,False,even,1.08795,1.08375,1.08375,1.08395,2024-07-11 11:30:00,True,2024-07-11 11:30:00,2024-07-11 15:30:11,2024-07-11 11:37:09,0.01,True,14.6,174.76000000000028,,3,0,28,7
2024-07-11 01:00:00,1.08287,1.0832600000000001,1.08286,1.08322,114,12,0,1.08286,1.0832600000000001,0.00010181896243172792,-7.25345434529754e-06,0.00015414371227787105,7.055871315514395e-05,1.082636915044313,1.0827725244428552,2024-07-11 01:00:00,2024-07-11 01:00:00,9.821428571399338e-05,0.00025956906389845713,1.082981785714285,4.986824087860008e-05,5.897147307461067e-05,1.082793690476191,1.0806499141252934,1.0819245601692793,1.0805961442709384,1.0818114284608877,6.296168849881349e-05,4.986188461264213e-05,1.0830905192983584,1.0823043318838157,90.85858585859121,86.14478114478759,0.000194137920307316,1.0817227999999999,1.0,1.0832668106311574,bullish,1.0827813992478186,1.08259852933634,1.0830450601995176,0.0001828699114785337,0.00013754904775496393,0.000336985162937164,0.00010126246989861087,4.223942208581022e-05,7.273133814855726e-05,1.0833820453624547,1.0827080750365805,,True,False,success,1.08822,1.08402,1.08402,1.08422,2024-07-11 11:45:00,True,2024-07-11 11:45:00,2024-07-11 15:30:13,,0.01,True,91.28,266.0400000000003,,4,0,28,7
2024-07-11 01:15:00,1.08321,1.08325,1.08319,1.08319,58,12,0,1.0831892854950123,1.083239174999567,-5.9348404307895396e-06,8.64040038061909e-05,0.00018619594224370328,8.926136012957117e-05,1.0826744247335987,1.0828727898029997,2024-07-11 01:00:00,2024-07-11 01:00:00,9.821428571399338e-05,0.00025956906389845713,1.082981785714285,4.986824087860008e-05,5.897147307461067e-05,1.082793690476191,1.0806499141252934,1.0819245601692793,1.0805961442709384,1.0818114284608877,6.296168849881349e-05,4.986188461264213e-05,1.0830905192983584,1.0823043318838157,92.46843434343783,89.9473905723966,0.000194137920307316,1.0817227999999999,1.0,1.0832668106311574,bullish,1.0828442609020004,1.0826423419780926,1.0831201891984867,0.00020191892390775124,0.0001504230229855214,0.0003613433271002528,7.512899896910952e-05,0.00010126246989861087,4.223942208581022e-05,1.083481532525587,1.0827588458713864,,True,False,success,1.08819,1.08399,1.08399,1.08419,2024-07-11 11:45:00,True,2024-07-11 11:45:00,2024-07-11 15:30:13,,0.01,True,91.28,357.3200000000003,,5,0,28,7
2024-07-11 01:30:00,1.0832,1.08324,1.08318,1.08321,98,13,0,1.0830900170704973,1.0832291707761534,3.692212795721087e-05,0.0001342237622682344,5.386212507884429e-05,0.00015273392265004713,1.0827078406257613,1.083206318228328,2024-07-11 01:00:00,2024-07-11 01:00:00,9.821428571399338e-05,0.00025956906389845713,1.082981785714285,4.986824087860008e-05,5.897147307461067e-05,1.082793690476191,1.0806499141252934,1.0819245601692793,1.0805961442709384,1.0818114284608877,6.296168849881349e-05,4.986188461264213e-05,1.0830905192983584,1.0823043318838157,94.58427358692829,92.63709792965244,0.000194137920307316,1.0817227999999999,1.0,1.0832668106311574,bullish,1.0829005284555389,1.0826843907204562,1.0831590161678706,0.00021613773508266654,0.00016356596540495044,0.0003826630372011137,3.882696938384278e-05,7.512899896910952e-05,0.00010126246989861087,1.0835416792050716,1.0827763531306696,,True,False,success,1.08821,1.08401,1.08401,1.08421,2024-07-11 11:45:00,True,2024-07-11 11:45:00,2024-07-11 15:30:13,,0.01,True,91.28,448.60000000000025,,6,0,28,7
2024-07-11 01:45:00,1.08321,1.08324,1.08318,1.08321,111,13,0,1.08318,1.0834083541623982,-8.981249050300007e-06,9.305220594763142e-05,-7.25345434529754e-06,0.00010181896243172792,1.0828688126462562,1.0832593719690387,2024-07-11 01:00:00,2024-07-11 01:00:00,9.821428571399338e-05,0.00025956906389845713,1.082981785714285,4.986824087860008e-05,5.897147307461067e-05,1.082793690476191,1.0806499141252934,1.0819245601692793,1.0805961442709384,1.0818114284608877,6.296168849881349e-05,4.986188461264213e-05,1.0830905192983584,1.0823043318838157,94.0233451536571,93.6920176946744,0.000194137920307316,1.0817227999999999,1.0,1.0832668106311574,bullish,1.082948139462379,1.0827233247411632,1.0831699346405224,0.0002248147212158269,0.00017581571656712574,0.0004018444973370446,1.0918472651777478e-05,3.882696938384278e-05,7.512899896910952e-05,1.0835717791378594,1.0827680901431853,,True,False,success,1.08821,1.08401,1.08401,1.08421,2024-07-11 11:45:00,True,2024-07-11 11:45:00,2024-07-11 15:30:13,,0.01,True,91.28,539.8800000000002,,7,0,28,7
2024-07-11 02:00:00,1.08322,1.08352,1.08317,1.08347,152,12,0,1.08317,1.0837316887335615,-3.975494587220986e-05,-0.00011229307711105092,8.64040038061909e-05,-5.9348404307895396e-06,1.083188770125205,1.083246678525751,2024-07-11 02:00:00,2024-07-11 02:00:00,0.0001880952380939327,0.0002994562421410052,1.0831138095238086,4.9868085532636716e-05,6.8714183958907e-05,1.082981785714285,1.0807038105777877,1.0819047317268342,1.0806499141252934,1.0819245601692793,5.897147307461067e-05,4.986824087860008e-05,1.0831968397661194,1.0823799853331104,95.06501182032127,94.55754352030222,0.00021520158467405384,1.0817734879999998,1.0,1.083396618024721,bullish,1.0830284256989362,1.0827786340195955,1.0832433677330582,0.000249791679340694,0.0001906109091218394,0.00043638400525244274,7.343309253582397e-05,1.0918472651777478e-05,3.882696938384278e-05,1.0836797517383105,1.0828069837278058,,True,False,even,1.0884699999999998,1.0842699999999998,1.0842699999999998,1.0844699999999998,2024-07-11 12:00:00,True,2024-07-11 12:00:00,2024-07-11 15:30:13,2024-07-11 12:38:58,0.01,True,14.6,554.4800000000002,,8,0,28,7
2024-07-11 03:30:00,1.0834,1.08359,1.08327,1.08357,208,12,0,1.08327,1.0836966784896194,-2.7442335760046915e-05,-7.998728608722164e-05,7.537695379017904e-05,7.052745202670399e-05,1.083046954120328,1.083394888756373,2024-07-11 03:00:00,2024-07-11 03:00:00,0.00013202380952370696,0.0003240830260582417,1.0833139285714286,4.9865127394033756e-05,6.74785639206476e-05,1.0831138095238086,1.0807577685946714,1.0819976956695327,1.0807038105777877,1.0819047317268342,6.8714183958907e-05,4.9868085532636716e-05,1.083365613255373,1.0824655865064616,86.50849581082097,78.87923159241193,0.00023697787295089145,1.0818626787199999,1.0,1.083531935001147,bullish,1.0832543094702178,1.0829980415624594,1.0834588820089435,0.0002562679077584562,0.0002339933284718649,0.00037803968051144477,6.045751634009555e-05,5.0065359475492954e-05,2.074647402938723e-05,1.083836921689455,1.083080842328432,,True,False,even,1.0885699999999998,1.0843699999999998,1.0843699999999998,1.0845699999999998,2024-07-11 12:00:00,True,2024-07-11 12:00:00,2024-07-11 15:30:14,2024-07-11 12:36:13,0.01,True,14.6,569.0800000000003,,9,0,28,7
2024-07-11 03:45:00,1.08357,1.08361,1.08337,1.08345,333,12,0,1.0833033236885432,1.08361,-6.153950166557679e-05,5.511935837606751e-05,3.9991387069211065e-05,3.5384780661754206e-05,1.0831964122233775,1.0835001415639014,2024-07-11 03:00:00,2024-07-11 03:00:00,0.00013202380952370696,0.0003240830260582417,1.0833139285714286,4.9865127394033756e-05,6.74785639206476e-05,1.0831138095238086,1.0807577685946714,1.0819976956695327,1.0807038105777877,1.0819047317268342,6.8714183958907e-05,4.9868085532636716e-05,1.083365613255373,1.0824655865064616,87.54208754208996,84.20118497638047,0.00023697787295089145,1.0818626787199999,1.0,1.083531935001147,bullish,1.083284415705569,1.08303151996524,1.0834965359477122,0.00025289574032894,0.00023777381084327996,0.000355598087792054,3.765393876875578e-05,6.045751634009555e-05,5.0065359475492954e-05,1.0838521340355043,1.0831409378599202,,True,False,success,1.08845,1.08425,1.08425,1.08445,2024-07-11 12:00:00,True,2024-07-11 12:00:00,2024-07-11 15:30:13,,0.01,True,91.28,660.3600000000002,,10,0,28,7
2024-07-11 04:45:00,1.08381,1.08393,1.08376,1.08386,363,12,0,1.0837708372071382,1.0839335711458655,-2.486387321295122e-05,1.977007706211935e-06,0.00013803885891793696,0.00011924750237559419,1.0830620672174978,1.0835020442456318,2024-07-11 04:00:00,2024-07-11 04:00:00,0.00020011904761996213,0.0003553291229378974,1.083531904761905,4.986187820105359e-05,7.748269452781959e-05,1.0833139285714286,1.0808117383586897,1.0820067976562693,1.0807577685946714,1.0819976956695327,6.74785639206476e-05,4.9865127394033756e-05,1.0836952044184578,1.0825771395859447,83.64117364117267,75.75437769236297,0.00026064812294829265,1.0820024644223998,1.0,1.083672540634884,bullish,1.0834467816373807,1.0831807354841303,1.0836265393876854,0.0002660461532504321,0.00024272682667444493,0.0003346475758792602,6.54317165480478e-05,5.671826625297527e-05,2.6625386995160483e-06,1.0839611869635646,1.0832918918118062,,True,False,even,1.08886,1.08466,1.08466,1.08486,2024-07-11 12:15:00,True,2024-07-11 12:15:00,2024-07-11 15:30:27,2024-07-11 12:25:24,0.01,True,14.6,674.9600000000003,,11,0,28,7
2024-07-11 05:00:00,1.0838700000000001,1.08394,1.08381,1.08393,157,12,0,1.08381,1.0840274888501036,-5.81879591498474e-05,-4.535521037057879e-05,0.00012457646021087347,0.00023571736163890153,1.083075250369932,1.0836758725269118,2024-07-11 05:00:00,2024-07-11 05:00:00,0.00021797619047636552,0.00041371335972040235,1.0836189285714284,4.986573473354237e-05,7.638352908038892e-05,1.083531904761905,1.08086555837142,1.082105971296989,1.0808117383586897,1.0820067976562693,7.748269452781959e-05,4.986187820105359e-05,1.083665068139486,1.0826629684190692,96.60820660820939,84.98156164822878,0.0002912611703027146,1.0821310672686077,1.0,1.0838181063333148,bullish,1.0835211229239377,1.08323623655938,1.0836936876504986,0.00028488636455770155,0.00025115873425109625,0.0003574646836289929,6.714826281317698e-05,6.54317165480478e-05,5.671826625297527e-05,1.0840511523341276,1.0833362229668695,,True,False,even,1.08893,1.08473,1.08473,1.08493,2024-07-11 12:15:00,True,2024-07-11 12:15:00,2024-07-11 15:30:29,2024-07-11 12:24:33,0.01,True,14.6,689.5600000000003,,12,0,28,7
2024-07-11 05:15:00,1.08393,1.08394,1.08385,1.08388,90,12,0,1.0838062459689166,1.0839966706136337,-9.727818604991255e-05,-5.38179202387158e-05,2.460156202055723e-05,0.00016944658069717867,1.0833247855999222,1.0839054818075962,2024-07-11 05:00:00,2024-07-11 05:00:00,0.00021797619047636552,0.00041371335972040235,1.0836189285714284,4.986573473354237e-05,7.638352908038892e-05,1.083531904761905,1.08086555837142,1.082105971296989,1.0808117383586897,1.0820067976562693,7.748269452781959e-05,4.986187820105359e-05,1.083665068139486,1.0826629684190692,94.84330484331217,91.69756169756472,0.0002912611703027146,1.0821310672686077,1.0,1.0838181063333148,bullish,1.0835763347817933,1.0832839227401665,1.0837362813897484,0.00029241204162677725,0.0002594093957262325,0.00036464000517690817,4.2593739249863205e-05,6.714826281317698e-05,6.54317165480478e-05,1.0841009213949253,1.0833716413845715,,True,False,even,1.0888799999999998,1.0846799999999999,1.0846799999999999,1.0848799999999998,2024-07-11 12:15:00,True,2024-07-11 12:15:00,2024-07-11 15:30:27,2024-07-11 12:25:24,0.01,True,14.6,704.1600000000003,,13,0,28,7
2024-07-11 12:00:00,1.08465,1.0852,1.08463,1.08512,818,12,0,1.084573325093118,1.0853354712165886,-0.00014446711587866388,-0.00018933378109661352,0.00032421250777149596,0.0003520396767651185,1.083399700461122,1.084177162695859,2024-07-11 12:00:00,2024-07-11 12:00:00,0.00032833333333326387,0.0004145616804160923,1.0842167857142861,0.00010736453456764563,0.00010765792407883905,1.0839185714285715,1.0807507592311234,1.0825256909332182,1.0806347762521962,1.0824633974245172,9.046323816584573e-05,0.00010736041062371982,1.0845214106392957,1.0832309286980397,93.68019363954461,91.28305326076803,0.00035227838764320083,1.08315,1.0,1.0849262147048675,bullish,1.0841067167631122,1.0838223106694347,1.0842872342621255,0.000284406093677525,0.00014366359280669252,0.00041321584356921495,0.0002575232198140931,0.00018876504987930254,0.00015478156174686397,1.0847004501056947,1.0838740184185562,,True,False,even,1.09012,1.08592,1.08592,1.08612,2024-07-11 15:45:00,True,2024-07-11 15:45:00,2024-07-12 17:33:42,2024-07-11 20:46:38,0.01,True,14.6,718.7600000000003,,14,0,28,7
2024-07-11 13:15:00,1.0851,1.08517,1.08487,1.0849199999999999,603,12,0,1.0847299911027843,1.08517,-7.836255356800931e-05,-1.5619956696196e-05,0.0001997078648694757,0.00014753896129026848,1.0841930729228335,1.0846943324440113,2024-07-11 13:00:00,2024-07-11 13:00:00,0.0002982142857146375,0.0004628527081484979,1.0845070238095238,0.00010736374493783117,0.00010765318158837393,1.0842167857142861,1.0808668270643214,1.0826423737052835,1.0807507592311234,1.0825256909332182,0.00010765792407883905,0.00010736453456764563,1.0847138035464319,1.0833572544021965,84.18278665545343,77.22082048406818,0.00037439325174426025,1.08317,1.0,1.085087812335078,bullish,1.0844947882168963,1.0841251903069133,1.084915679394564,0.00036959790998292164,0.0002746154253448962,0.0005861148920735816,0.0001049191606463662,0.0001767870657036763,0.00010272445820436182,1.0855017942866376,1.0843295645024904,,True,False,success,1.0899199999999998,1.0857199999999998,1.0857199999999998,1.0859199999999998,2024-07-11 15:45:00,True,2024-07-11 15:45:00,2024-07-11 15:51:25,,0.01,True,91.28,810.0400000000003,,15,0,28,7
2024-07-11 16:00:00,1.08861,1.08984,1.08859,1.08899,3496,12,0,1.0881964077456268,1.0901857786084077,-0.0006512291079640978,-0.00046404565129401596,0.0007354082522854493,0.0018790834669185563,1.0826374646113475,1.0889272167356496,2024-07-11 16:00:00,2024-07-11 16:00:00,0.0013790476190482792,0.0009897403321670328,1.0873549999999996,0.00010583140050956517,0.00029833784562720435,1.086312023809524,1.0812326972405046,1.0828172292018154,1.0811182804101256,1.0828361994781568,0.0002845542878669835,0.00010583122582645408,1.0882138445757938,1.084300117395938,86.59605481186595,73.02620896701158,0.0005488579809442478,1.08411725824,1.0,1.0855593210693708,bullish,1.086527940083518,1.0854708849967762,1.0871770175438606,0.0010570550867416983,0.0006280571160697829,0.001605723824337807,0.0005901444788460886,0.0005562435500507945,0.0008331166150663538,1.0887827413681985,1.0855712937195228,,True,False,running,1.0939899999999998,1.0897899999999998,1.0897899999999998,1.0899899999999998,2024-07-12 17:45:00,True,2024-07-12 17:45:00,,,0.01,False,0.0,810.0400000000003,2024-07-11 19:00:00,0,1,28,7
2024-07-12 17:45:00,1.09024,1.09087,1.09001,1.09084,1269,12,0,1.09001,1.0911550318969134,4.6135197805282324e-05,-0.00012375899743319722,0.00023815354778392516,0.0003299720620499014,1.0889627577064167,1.0901025725034674,2024-07-12 17:00:00,2024-07-12 17:00:00,0.00017869047618979117,0.0007106300368679985,1.0896978571428575,1.970040839837732e-05,0.00011371955304537432,1.0891341666666658,1.0857695648066463,1.0880207579614314,1.0858934132219578,1.0889329644530046,3.189569044451811e-05,1.1790669378859993e-05,1.0902365009803774,1.0875438799537114,94.81073491579501,90.14054103749426,0.000575525534064705,1.0867760796531198,1.0,1.0887327494229875,bullish,1.089577263710638,1.0889818313582211,1.0898746474028218,0.0005954323524168803,0.0004833967095905926,0.0005964640252255823,0.0003002889576886325,0.00019868593051364236,0.00011608531131734878,1.0904711114280474,1.0892781833775962,,True,False,even,1.09584,1.09164,1.09164,1.09184,2024-07-15 18:15:00,True,2024-07-15 18:15:00,,2024-07-15 18:16:33,0.01,True,14.6,824.6400000000003,,1,0,28,7
2024-07-12 18:00:00,1.09085,1.09102,1.09053,1.09058,1068,12,0,1.090463357967808,1.0910091091559144,-0.00014064548936316225,-0.00012501755668723057,0.0003790356018069419,0.00033994789202167034,1.089312108926829,1.0900791822412768,2024-07-12 18:00:00,2024-07-12 18:00:00,0.0005636904761916472,0.0008995254684840415,1.0898863095238096,4.72326996014573e-05,0.00016241474185393735,1.0896978571428575,1.0853451940536574,1.0869943634117063,1.0857695648066463,1.0880207579614314,0.00011371955304537432,1.970040839837732e-05,1.090112166993459,1.0877443695574145,94.21971836732995,93.44523019966825,0.0006403255209485723,1.0871317500947455,1.0,1.088837061763887,bullish,1.0897315308320783,1.0891002142205752,1.0900869315445474,0.0006313166115030633,0.0005129806899730867,0.0006647054485925493,0.00021228414172558274,0.0003002889576886325,0.00019868593051364236,1.09075163699314,1.0894222260959547,,True,False,even,1.09558,1.09138,1.09138,1.09158,2024-07-15 17:30:00,True,2024-07-15 17:30:00,,2024-07-15 17:33:31,0.01,True,14.6,839.2400000000004,,2,0,28,7
2024-07-12 22:15:00,1.09071,1.09106,1.09066,1.09095,306,12,0,1.090629995326835,1.0911133738712062,-0.00010086716798058315,-0.00015890891913736518,0.00018920136090175318,0.0001360371471618512,1.0901362742905527,1.090447959274677,2024-07-12 22:00:00,2024-07-12 22:00:00,0.00017571428571461212,0.0009522660997267618,1.0906624999999992,0.00019474338009991106,0.0002112747856182672,1.0906141666666667,1.0838041474370013,1.0867492628334283,1.0841524154458773,1.086937183570088,0.00019096201834151096,0.0001514278181789763,1.0905490390986845,1.0885328760865698,89.777595478992,70.62398015445359,0.0008233411411436188,1.0890256133222143,1.0,1.089196566277732,bullish,1.0904638706817125,1.090079822386883,1.0905317750258001,0.00038404829482940883,0.00040900617187240385,0.00047945003221694875,0.00014442380460977233,5.1124871002450334e-05,-6.553147575916185e-06,1.091011225058017,1.0900523249935832,,True,False,even,1.09595,1.09175,1.09175,1.09195,2024-07-15 18:15:00,True,2024-07-15 18:15:00,,2024-07-15 18:16:25,0.01,True,14.6,853.8400000000004,,3,0,28,7
2024-07-12 22:30:00,1.09094,1.09094,1.0906,1.09067,477,12,0,1.0903899985906722,1.09094,1.83431853827863e-05,-7.361189433835973e-05,0.00017876906786725658,9.808605428437414e-05,1.090299281790684,1.0906868968732608,2024-07-12 22:00:00,2024-07-12 22:00:00,0.00017571428571461212,0.0009522660997267618,1.0906624999999992,0.00019474338009991106,0.0002112747856182672,1.0906141666666667,1.0838041474370013,1.0867492628334283,1.0841524154458773,1.086937183570088,0.00019096201834151096,0.0001514278181789763,1.0905490390986845,1.0885328760865698,84.27672955975476,82.61553185671552,0.0008233411411436188,1.0890256133222143,1.0,1.089196566277732,bullish,1.090495582884526,1.0901235392471138,1.090598307533539,0.00037204363741216717,0.0004016136649803565,0.0004542117715263053,6.65325077389145e-05,0.00014442380460977233,5.1124871002450334e-05,1.0910525193050653,1.0901440957620128,,True,False,even,1.09567,1.09147,1.09147,1.09167,2024-07-15 17:30:00,True,2024-07-15 17:30:00,,2024-07-15 17:31:50,0.01,True,14.6,868.4400000000004,,4,0,28,7
2024-07-15 17:15:00,1.09124,1.09169,1.09123,1.09168,587,12,0,1.0904917609567266,1.09169,0.00020010899304067685,0.00014319742928192237,2.7203981802065114e-05,0.00010914121171136086,1.0908832076517934,1.0915926048351512,2024-07-15 17:00:00,2024-07-15 17:00:00,0.00028904761904735565,0.0005256323792626194,1.091318571428572,4.8785337728475585e-05,4.5841839177883755e-05,1.091160833333333,1.0874762891106924,1.091013707721236,1.0874232446682428,1.0909635873641474,4.584640474331618e-05,4.8783221179319025e-05,1.0914904609427518,1.089863918379077,88.49842845532633,78.14168078099576,0.0003796132412634542,1.088666528455168,1.0,1.089920514255478,bearish,1.091110559578067,1.090756489176957,1.0911391916064683,0.0003540704011100182,0.00032994413586172973,0.00037973367868433236,0.00015343309253723625,5.179222566153996e-05,9.781561747490564e-05,1.0915189252851527,1.090759457927784,,True,False,even,1.0966799999999999,1.09248,1.09248,1.0926799999999999,2024-07-17 11:45:00,True,2024-07-17 11:45:00,,2024-07-17 19:21:47,0.01,True,14.61,883.0500000000004,,5,0,29,7
2024-07-15 17:45:00,1.09121,1.0917,1.09112,1.09164,1113,12,0,1.09112,1.092228170314674,-5.4728321369329364e-05,-6.325558095696521e-05,1.8320609751321714e-05,-0.000135972838675224,1.0909936470225856,1.0916717533864755,2024-07-15 17:00:00,2024-07-15 17:00:00,0.00028904761904735565,0.0005256323792626194,1.091318571428572,4.8785337728475585e-05,4.5841839177883755e-05,1.091160833333333,1.0874762891106924,1.091013707721236,1.0874232446682428,1.0909635873641474,4.584640474331618e-05,4.8783221179319025e-05,1.0914904609427518,1.089863918379077,87.74053903086201,85.66465567624353,0.0003796132412634542,1.088666528455168,1.0,1.089920514255478,bearish,1.0912036550825215,1.0908523535467738,1.091339545923632,0.0003513015357476945,0.0003350210040953125,0.00037776447697026683,0.0001403611971102503,5.999312005333657e-05,0.00015343309253723625,1.0917173104006022,1.0909617814466617,,True,False,even,1.0966399999999998,1.0924399999999999,1.0924399999999999,1.0926399999999998,2024-07-17 11:45:00,True,2024-07-17 11:45:00,,2024-07-17 19:22:38,0.01,True,14.61,897.6600000000004,,6,0,29,7
2024-07-15 18:00:00,1.09165,1.09217,1.09142,1.09209,1047,12,0,1.0912391237067174,1.0924935504629882,-0.00013666472699246988,-0.00036945299482169116,0.00014319742928192237,0.00020010899304067685,1.0905109845983003,1.0917037714646005,2024-07-15 18:00:00,2024-07-15 18:00:00,0.00015773809523911275,0.0005853775491218016,1.0912250000000001,4.68057550595079e-05,5.430946782353113e-05,1.091318571428572,1.087550619621739,1.0908874162914144,1.0874762891106924,1.091013707721236,4.5841839177883755e-05,4.8785337728475585e-05,1.0912434869809173,1.089964404908751,86.63685723411108,85.04413193583845,0.0004207661028351237,1.088864136747858,1.0,1.089914163258648,bearish,1.0913400158390567,1.0909440310618275,1.0915265049879594,0.0003959847772292413,0.00034721375872209825,0.0004305798416794657,0.00018695906432752984,0.0001403611971102503,5.999312005333657e-05,1.091957084829639,1.09109592514628,,True,False,even,1.09709,1.09289,1.09289,1.09309,2024-07-17 11:45:00,True,2024-07-17 11:45:00,,2024-07-17 14:03:24,0.01,True,14.61,912.2700000000004,,7,0,29,7
2024-07-16 13:00:00,1.08971,1.09002,1.08963,1.08994,863,12,0,1.08963,1.0903050092706215,-2.420040202954498e-05,-6.87989601928454e-05,-7.06025984867954e-05,5.0484377209264935e-05,1.0892597441770075,1.090233370834589,2024-07-16 13:00:00,2024-07-16 13:00:00,0.00014738095238198134,-4.177158357920874e-05,1.0897617857142858,-6.635050612231081e-05,-9.372025757064628e-05,1.089635238095239,1.0896775006152792,1.092570702252637,1.0897498747823118,1.0926730729172691,-9.371271902588366e-05,-6.635897587282282e-05,1.0898037079280058,1.0895756387362012,69.43090311630529,71.45518121305899,-0.0001422049865679229,1.0883382000000001,1.0,1.0894553212687712,bullish,1.0896827406943412,1.0894945576867971,1.0900789576883394,0.0001881830075440849,0.00013772419227209924,0.0004983031206579294,6.1056071552823e-05,2.3006535947445172e-05,2.0557275541399633e-05,1.0905772608089974,1.0895806545676814,,True,False,even,1.0949399999999998,1.0907399999999998,1.0907399999999998,1.0909399999999998,2024-07-17 10:45:00,True,2024-07-17 10:45:00,,2024-07-17 10:49:51,0.01,True,14.61,926.8800000000005,,8,0,29,7
2024-07-16 13:15:00,1.08994,1.09023,1.08992,1.08998,705,12,0,1.0898666641457146,1.0902191021134158,-0.00014988673455723243,-7.31132351299832e-05,6.394294774467806e-05,0.00016601867072770876,1.089294725538153,1.0900160051897252,2024-07-16 13:00:00,2024-07-16 13:00:00,0.00014738095238198134,-4.177158357920874e-05,1.0897617857142858,-6.635050612231081e-05,-9.372025757064628e-05,1.089635238095239,1.0896775006152792,1.092570702252637,1.0897498747823118,1.0926730729172691,-9.371271902588366e-05,-6.635897587282282e-05,1.0898037079280058,1.0895756387362012,74.8104908488332,71.66434265068806,-0.0001422049865679229,1.0883382000000001,1.0,1.0894553212687712,bullish,1.0897284728952117,1.089530516376664,1.0901228551771578,0.0001979565185477039,0.0001497706575272202,0.000514589804333629,4.389748881838962e-05,6.1056071552823e-05,2.3006535947445172e-05,1.0906374449814915,1.089608265372824,,True,False,even,1.0949799999999998,1.0907799999999999,1.0907799999999999,1.0909799999999998,2024-07-17 10:45:00,True,2024-07-17 10:45:00,,2024-07-17 10:49:42,0.01,True,14.6,941.4800000000005,,9,0,29,7
2024-07-16 14:45:00,1.08945,1.09032,1.08944,1.09013,1069,12,0,1.08944,1.0905500493343019,-0.0004130833005980104,-2.753243083983248e-05,0.00010064060018017701,3.589824312261384e-05,1.0893260539994019,1.0899894664927348,2024-07-16 14:00:00,2024-07-16 14:00:00,0.0001265476190468462,-3.72370474233108e-07,1.0899715476190472,-6.788530415884814e-05,-8.526214974414095e-05,1.0897617857142858,1.0896242618338858,1.0924413599534148,1.0896775006152792,1.092570702252637,-9.372025757064628e-05,-6.635050612231081e-05,1.090021235976002,1.0896199876373052,38.187702265367626,30.52858683926266,-0.00011383846334918494,1.0884182720000002,1.0,1.0894666585201558,bullish,1.0897402175413848,1.0896091757555226,1.089787031303749,0.00013104178586220705,0.00014411246605000147,0.0005029055577915328,5.0192638459289896e-05,-9.644306845668638e-05,-0.00011477124182923681,1.0902899368615404,1.0892841257459576,,True,False,even,1.09513,1.09093,1.09093,1.09113,2024-07-17 10:45:00,True,2024-07-17 10:45:00,,2024-07-17 10:47:00,0.01,True,14.6,956.0800000000005,,10,0,29,7
2024-07-16 15:15:00,1.09001,1.09049,1.08999,1.09008,737,12,0,1.0888251104938689,1.090709770808785,-0.0006845594871132589,-0.000816912580110841,0.00015746340826928846,0.00025735753920291165,1.0891838372236584,1.0901631338435371,2024-07-16 15:00:00,2024-07-16 15:00:00,0.00020976190476140744,6.159183538789748e-05,1.0894097619047614,-8.514942259424385e-05,-7.377779497410787e-05,1.0899715476190472,1.08962406156161,1.0923243706651113,1.0896242618338858,1.0924413599534148,-8.526214974414095e-05,-6.788530415884814e-05,1.0886737453253341,1.0894903886263207,70.08350105272935,53.60347056084918,-7.875240360176846e-05,1.0884951411200001,1.0,1.0894862638919505,bullish,1.0898250078254885,1.0896701712581642,1.0898580495356032,0.00015483656732429019,0.0001458009962366507,0.00043582947742328823,5.4327485378591334e-05,1.6690746475589435e-05,5.0192638459289896e-05,1.0902938790130265,1.0894222200581798,,True,False,even,1.0950799999999998,1.0908799999999998,1.0908799999999998,1.0910799999999998,2024-07-17 10:45:00,True,2024-07-17 10:45:00,,2024-07-17 10:48:21,0.01,True,14.6,970.6800000000005,,11,0,29,7
2024-07-16 16:00:00,1.08803,1.08804,1.08709,1.08715,1644,12,0,1.0867764382959686,1.08804,0.0002984747244073325,6.405995005823685e-05,-0.000816912580110841,-0.0006845594871132589,1.0887628298323235,1.09063532053801,2024-07-16 16:00:00,2024-07-16 16:00:00,-0.0005617857142858895,-0.000133756166371235,1.0889425,-9.974247541141646e-05,-7.377885467958878e-05,1.0894097619047614,1.0895775408804376,1.0922437676402281,1.08962406156161,1.0923243706651113,-7.377779497410787e-05,-8.514942259424385e-05,1.0883845817751114,1.0893903575362152,8.928623031946692,28.44431971743659,-8.975315615566176e-05,,-1.0,1.089514591453338,bullish,1.0890057102483959,1.089280654671992,1.0887791021671824,-0.00027494442359610183,4.957230083542801e-06,0.0007065144490555461,-0.0004480151358792206,-0.00032854145166827387,-0.00030239078087324067,1.0894856166162379,1.088072587718127,,False,True,running,1.0821500000000002,1.09615,1.0863500000000001,1.0861500000000002,,False,,,,0.01,False,0.0,970.6800000000005,2024-07-16 19:00:00,0,1,29,7
2024-07-16 16:15:00,1.08714,1.08792,1.08709,1.08775,1037,12,0,1.08709,1.0880636961771022,0.00018418192235069376,0.00010607489427468194,-0.0005879829758821946,-0.0003662734856209023,1.0878531214097686,1.089776102659395,2024-07-16 16:00:00,2024-07-16 16:00:00,-0.0005617857142858895,-0.000133756166371235,1.0889425,-9.974247541141646e-05,-7.377885467958878e-05,1.0894097619047614,1.0895775408804376,1.0922437676402281,1.08962406156161,1.0923243706651113,-7.377779497410787e-05,-8.514942259424385e-05,1.0883845817751114,1.0893903575362152,12.632959538334708,17.217794245828753,-8.975315615566176e-05,,-1.0,1.089514591453338,bullish,1.0888125240563349,1.089167272844437,1.0884937082903337,-0.00035474878810215493,-6.698397355359675e-05,0.0007918568894635209,-0.0002853938768487829,-0.0004480151358792206,-0.00032854145166827387,1.0892855651797972,1.08770185140087,,False,True,running,1.08275,1.09675,1.08695,1.08675,,False,,,,0.01,False,0.0,970.6800000000005,2024-07-16 19:15:00,0,2,29,7
2024-07-16 17:30:00,1.0877,1.08808,1.08735,1.08755,884,12,0,1.0869401424454646,1.08808,0.0002850326202701748,5.181006494394965e-05,-0.00014662458989442325,-0.00011927220422045018,1.0877391114451542,1.088545327596962,2024-07-16 17:00:00,2024-07-16 17:00:00,-0.00046726190476142904,-0.0002388422869361584,1.0883627380952383,-9.974429550032663e-05,-7.376615510013929e-05,1.0889425,1.0894689565417637,1.0921632198722417,1.0895775408804376,1.0922437676402281,-7.377885467958878e-05,-9.974247541141646e-05,1.0879948605917038,1.089263128933318,17.352941176472886,22.61437908497058,-0.00011957098231176109,,-1.0,1.0895520414361508,bullish,1.0882378709854394,1.0887374817448783,1.0875494496044031,-0.0004996107594388288,-0.0003273299446035989,0.0010230254151570232,-0.00017434124527038186,-0.00019767113863111696,-0.00022438940488411774,1.0885724750195602,1.086526424189246,,False,True,running,1.0825500000000001,1.09655,1.08675,1.0865500000000001,,False,,,,0.01,False,0.0,970.6800000000005,2024-07-16 20:30:00,0,3,29,7
2024-07-16 17:45:00,1.08751,1.0878700000000001,1.08725,1.0878,974,12,0,1.08725,1.0879487301503985,0.0002117337777453969,0.00017498371094014744,-0.00015661910493059585,-0.00010195931250290745,1.0875732845605195,1.088395654151709,2024-07-16 17:00:00,2024-07-16 17:00:00,-0.00046726190476142904,-0.0002388422869361584,1.0883627380952383,-9.974429550032663e-05,-7.376615510013929e-05,1.0889425,1.0894689565417637,1.0921632198722417,1.0895775408804376,1.0922437676402281,-7.377885467958878e-05,-9.974247541141646e-05,1.0879948605917038,1.089263128933318,17.4509803921598,19.640522875819702,-0.00011957098231176109,,-1.0,1.0895520414361508,bullish,1.0881705062184488,1.0886680386526653,1.0874625490196077,-0.0004975324342164633,-0.0003613704425261718,0.0010427986383080756,-8.690058479543517e-05,-0.00017434124527038186,-0.00019767113863111696,1.0885053476579158,1.0864197503812996,,False,True,running,1.0828000000000002,1.0968,1.0870000000000002,1.0868000000000002,,False,,,,0.01,False,0.0,970.6800000000005,2024-07-16 20:45:00,0,4,29,7
2024-07-17 07:00:00,1.09055,1.09059,1.09046,1.09049,196,12,0,1.0904700012412796,1.090721691486041,-0.00013298844052197356,-0.00012074522565021005,9.323283471385601e-05,0.00010395317956872688,1.089943187438445,1.090377143518312,2024-07-17 07:00:00,2024-07-17 07:00:00,0.0001835714285720602,0.00029485865171907655,1.0903147619047608,0.0001541457306197229,4.2526068358405605e-05,1.0903011904761912,1.0857647224015072,1.0901585492659132,1.0858673532392022,1.0901121995473502,4.252684359021329e-05,0.00012625263376208232,1.0903040161110935,1.0897262677756245,84.50292397660944,75.04873294347117,0.0001603430829263469,1.0878423652480451,1.0,1.091048019170222,bullish,1.0902513717296667,1.0900531714714254,1.090420147918817,0.00019820025824124343,0.00017282181159660777,0.00027035470538128766,8.017199862475621e-05,9.914000687927249e-05,5.496044031683134e-05,1.0906905026241982,1.0901497932134356,,True,False,even,1.0954899999999999,1.0912899999999999,1.0912899999999999,1.0914899999999998,2024-07-17 11:45:00,True,2024-07-17 11:45:00,,2024-07-18 16:30:02,0.01,True,14.6,985.2800000000005,,1,0,29,7
2024-07-17 07:15:00,1.09053,1.09059,1.09043,1.09043,218,12,0,1.0902850075647053,1.0905791007720858,-9.631667045538663e-05,-5.168932217178826e-05,2.7510140896162863e-05,4.668342515739621e-05,1.0901244057101307,1.0905325961748014,2024-07-17 07:00:00,2024-07-17 07:00:00,0.0001835714285720602,0.00029485865171907655,1.0903147619047608,0.0001541457306197229,4.2526068358405605e-05,1.0903011904761912,1.0857647224015072,1.0901585492659132,1.0858673532392022,1.0901121995473502,4.252684359021329e-05,0.00012625263376208232,1.0903040161110935,1.0897262677756245,88.59649122807257,82.94346978557677,0.0001603430829263469,1.0878423652480451,1.0,1.091048019170222,bullish,1.0902788530020258,1.0900810846957643,1.0904896009631928,0.0001977683062615032,0.00017781111052958686,0.00027433252338802716,6.945304437588895e-05,8.017199862475621e-05,9.914000687927249e-05,1.0907639334865809,1.0902152684398048,,True,False,even,1.09543,1.09123,1.09123,1.09143,2024-07-17 11:45:00,True,2024-07-17 11:45:00,,2024-07-18 16:30:06,0.01,True,14.6,999.8800000000006,,2,0,29,7
2024-07-17 11:30:00,1.09122,1.09327,1.09122,1.09317,1286,12,0,1.09122,1.0942009430425275,0.0007051123772445546,9.966315947351582e-05,0.0006284232080657357,0.00033830276052372734,1.0901459263866669,1.091261088207636,2024-07-17 11:00:00,2024-07-17 11:00:00,0.00020107142857117566,0.00025047677429745896,1.0915973809523811,0.00012050959875646969,0.00015844975393916605,1.0903733333333328,1.0865778866718705,1.0903447573591287,1.08644654009463,1.0902976647995333,4.252239639849875e-05,0.00012051100642444622,1.0929128890877913,1.0901929717263323,90.9775040678087,85.09636609023464,0.00021103513699394493,1.0885442011882376,1.0,1.0916774108922385,bullish,1.0910171374311823,1.09060415449198,1.0912379635362917,0.0004129829392023332,0.00020131839693134567,0.0006442170959556248,0.0005171551427582965,0.00016405228758253898,9.558995527991776e-05,1.0918821806322472,1.0905937464403361,,True,False,even,1.0981699999999999,1.0939699999999999,1.0939699999999999,1.0941699999999999,2024-07-17 12:45:00,True,2024-07-17 12:45:00,,2024-07-17 13:37:46,0.01,True,14.6,1014.4800000000006,,3,0,29,7
2024-07-17 11:45:00,1.09316,1.0943100000000001,1.09292,1.09413,1470,12,0,1.09292,1.0944454656020057,0.00022892632811523898,-1.4131093567540015e-05,0.000920917030862099,0.00047945834796947777,1.0902211346988906,1.0913704111208173,2024-07-17 11:00:00,2024-07-17 11:00:00,0.00020107142857117566,0.00025047677429745896,1.0915973809523811,0.00012050959875646969,0.00015844975393916605,1.0903733333333328,1.0865778866718705,1.0903447573591287,1.08644654009463,1.0902976647995333,4.252239639849875e-05,0.00012051100642444622,1.0929128890877913,1.0901929717263323,96.44836976432288,89.95113668800457,0.00021103513699394493,1.0885442011882376,1.0,1.0916774108922385,bullish,1.0914960393648465,1.090865328233315,1.0918877915376675,0.0006307111315315694,0.00028719694385139047,0.0009671845739334365,0.0006498280013758073,0.0005171551427582965,0.00016405228758253898,1.0928549761116009,1.090920606963734,,True,False,running,1.09913,1.0851300000000001,1.09493,1.09513,,False,,,,0.01,False,0.0,1014.4800000000006,2024-07-17 14:45:00,0,1,29,7
2024-07-17 12:00:00,1.09412,1.09443,1.0939,1.09391,1578,12,0,1.093401868536153,1.09443,0.00011802659483900414,-1.4131756957386552e-05,0.000960758295829492,0.001135130878796266,1.0900930865244434,1.0923034761008468,2024-07-17 12:00:00,2024-07-17 12:00:00,0.001224047619048374,0.0006573133502416617,1.0926876190476194,0.00011942253721154483,0.00017023570349336442,1.0915973809523811,1.0867229429957197,1.090235999456675,1.0865778866718705,1.0903447573591287,0.00015844975393916605,0.00012050959875646969,1.0938509630292637,1.090523133988226,94.42403123218708,93.94996835477286,0.0003002907796434883,1.0888177810694137,1.0,1.0918305272529427,bullish,1.091867417924101,1.0910908594752915,1.0924236188510494,0.0007765584488095278,0.00038506924484301797,0.0011613207998028652,0.0005358273133819758,0.0006498280013758073,0.0005171551427582965,1.0935849396508524,1.0912622980512465,,True,False,running,1.0989099999999998,1.08491,1.0947099999999998,1.0949099999999998,,False,,,,0.01,False,0.0,1014.4800000000006,2024-07-17 15:00:00,0,2,29,7
2024-07-17 12:45:00,1.09426,1.09432,1.09398,1.09432,843,12,0,1.09398,1.0946172070227012,-0.0002222440381223334,-9.965612797978702e-05,-1.4131756957386552e-05,0.00011802659483900414,1.093413500328076,1.0944286059816275,2024-07-17 12:00:00,2024-07-17 12:00:00,0.001224047619048374,0.0006573133502416617,1.0926876190476194,0.00011942253721154483,0.00017023570349336442,1.0915973809523811,1.0867229429957197,1.090235999456675,1.0865778866718705,1.0903447573591287,0.00015844975393916605,0.00012050959875646969,1.0938509630292637,1.090523133988226,94.78957915831518,92.88702890608812,0.0003002907796434883,1.0888177810694137,1.0,1.0918305272529427,bullish,1.0927837930163762,1.0917278229589709,1.09380221878225,0.00105597005740532,0.0006786878899395811,0.001577040265831725,0.0004314654282775443,0.0004705538355675998,0.0004765806673554529,1.0953792590480818,1.0922251785164183,,True,False,running,1.0993199999999999,1.08532,1.0951199999999999,1.0953199999999998,,False,,,,0.01,False,0.0,1014.4800000000006,2024-07-17 15:45:00,0,3,29,7
2024-07-17 13:00:00,1.09432,1.09442,1.09417,1.09436,631,12,0,1.09417,1.094726862090945,-0.0004201727728177714,-0.00019957000072053145,5.635491856099362e-05,0.0001380118709684898,1.0935336083849303,1.0943538873043055,2024-07-17 13:00:00,2024-07-17 13:00:00,0.0010902380952382273,0.0009434642336045851,1.0931221428571425,0.00011942939474648845,0.000174413619736101,1.0926876190476194,1.086852426087606,1.0903261298492513,1.0867229429957197,1.090235999456675,0.00017023570349336442,0.00011942253721154483,1.0932903210097544,1.090722083269168,97.79559118236365,94.87864618125,0.00042892547043570767,1.08944,1.0,1.0919790401537108,bullish,1.093026286398472,1.091922799036084,1.094202717578259,0.001103487362388078,0.0007636477844292805,0.0016837188007664961,0.0004004987960088968,0.0004314654282775443,0.0004705538355675998,1.0958864363790255,1.0925189987774924,,True,False,running,1.09936,1.08536,1.09516,1.09536,,False,,,,0.01,False,0.0,1014.4800000000006,2024-07-17 16:00:00,0,4,29,7
2024-07-17 13:15:00,1.09437,1.0944099999999999,1.09411,1.09426,454,12,0,1.0935683405946723,1.0947707540066174,-0.0003002920658794432,-0.00043923314002745954,9.566274454925359e-06,0.0001404497098150373,1.0936738365008922,1.0944000042156181,2024-07-17 13:00:00,2024-07-17 13:00:00,0.0010902380952382273,0.0009434642336045851,1.0931221428571425,0.00011942939474648845,0.000174413619736101,1.0926876190476194,1.086852426087606,1.0903261298492513,1.0867229429957197,1.090235999456675,0.00017023570349336442,0.00011942253721154483,1.0932903210097544,1.090722083269168,97.66199064796213,96.74905366288029,0.00042892547043570767,1.08944,1.0,1.0919790401537108,bullish,1.093216088491015,1.0920959250334112,1.09451209494324,0.0011201634576036845,0.0008349509190641614,0.0017624837588059,0.000309377364981156,0.0004004987960088968,0.0004314654282775443,1.096274578702046,1.0927496111844341,,True,False,running,1.09926,1.0852600000000001,1.09506,1.09526,,False,,,,0.01,False,0.0,1014.4800000000006,2024-07-17 16:15:00,0,5,29,7
2024-07-17 16:00:00,1.09417,1.09423,1.09392,1.09408,894,12,0,1.0935299924068356,1.0944266477276126,-2.7427522202787495e-05,0.00014770497167251713,7.312955762820357e-05,0.00016549231461873847,1.0932162669888703,1.0942571701667811,2024-07-17 16:00:00,2024-07-17 16:00:00,0.00047797619047562634,0.001101440837822043,1.0941735714285716,0.00011777931871758573,0.00028951453686348096,1.094037380952381,1.087272334172909,1.088650355705498,1.0871122950057026,1.0883354054804448,0.00028951090178581164,0.00011942452820929148,1.0938366785559168,1.091404823496702,85.7442348008381,73.21497204751871,0.0007264376797264588,1.09125608056,1.0,1.09238343787794,bullish,1.0937125989992587,1.0930248900204496,1.0937317199862397,0.0006877089788090984,0.0007513371276949019,0.001365844305447272,-4.939800481551515e-06,-0.0001203577571384784,-6.79084967325494e-05,1.095097564291687,1.0923658756807926,,True,False,running,1.0990799999999998,1.08508,1.0948799999999999,1.0950799999999998,,False,,,,0.01,False,0.0,1014.4800000000006,2024-07-17 19:00:00,0,6,29,7
2024-07-18 03:00:00,1.09396,1.094,1.09379,1.09387,402,12,0,1.09379,1.0940071426236875,-5.762318692664685e-05,-1.4364208302858625e-05,-8.711821626150422e-06,-4.613565748805433e-05,1.0938964029614322,1.094027737435055,2024-07-18 03:00:00,2024-07-18 03:00:00,0.00011857142857074621,0.0005706648702399342,1.0938639285714284,0.00022421878715246768,9.967021570933207e-05,1.0939426190476187,1.0879971817834007,1.093556530758453,1.087557771552653,1.0934476783273082,9.965816030350299e-05,0.0002502384810936338,1.0937272822948092,1.092711763948861,71.23931623928775,82.98534798534119,0.0006632052223462793,,-1.0,1.0929870630411564,bearish,1.0938673793807066,1.0937219403073908,1.0939579669762651,0.00014543907331576733,0.0001560562171480393,0.00014137774479460114,-1.2380460955530026e-05,2.9363605090981793e-05,3.559683522569301e-05,1.0940993447210596,1.0938165892314706,,False,True,even,1.08887,1.09307,1.09307,1.09287,2024-07-18 10:30:00,True,2024-07-18 10:30:00,2024-07-19 04:34:54,2024-07-18 10:47:16,0.01,True,14.6,1029.0800000000006,,1,0,29,7
2024-07-18 03:45:00,1.09393,1.09396,1.09359,1.09363,272,12,0,1.0933883301951408,1.09396,-1.6764719620178118e-05,-3.9892327526292055e-05,-1.4364208302858625e-05,-5.762318692664685e-05,1.0937843588847873,1.0940057361343634,2024-07-18 03:00:00,2024-07-18 03:00:00,0.00011857142857074621,0.0005706648702399342,1.0938639285714284,0.00022421878715246768,9.967021570933207e-05,1.0939426190476187,1.0879971817834007,1.093556530758453,1.087557771552653,1.0934476783273082,9.965816030350299e-05,0.0002502384810936338,1.0937272822948092,1.092711763948861,48.58585858584437,58.04713804710779,0.0006632052223462793,,-1.0,1.0929870630411564,bearish,1.0938470104486666,1.0937432483515206,1.0938907361541106,0.00010376209714602069,0.00014009733051392206,0.00013914381070151747,-5.1148950809265514e-05,-1.3367733057378928e-05,-2.7141382878959064e-06,1.094029879964812,1.0937515923434091,,False,True,success,1.0886300000000002,1.0928300000000002,1.0928300000000002,1.0926300000000002,2024-07-18 16:15:00,True,2024-07-18 16:15:00,2024-07-19 04:49:00,,0.01,True,91.23,1120.3100000000006,,2,0,29,7
2024-07-18 04:00:00,1.09362,1.09365,1.09337,1.09355,400,12,0,1.09337,1.0937299948983852,-8.865180648987559e-06,5.028643744608633e-05,-6.247107590126461e-05,-0.00014049016593262368,1.0938171775891903,1.0940905778347436,2024-07-18 04:00:00,2024-07-18 04:00:00,-7.869047619024627e-05,0.0005047001309608223,1.0936713095238102,0.00019856867326992314,9.966994739056342e-05,1.0938639285714284,1.0883781810573647,1.093665505028099,1.0879971817834007,1.093556530758453,9.967021570933207e-05,0.00022421878715246768,1.0934757607649364,1.0927628228329522,34.34343434343944,48.01346801345261,0.0006315042040691879,,-1.0,1.0929603560398098,bearish,1.093801316533487,1.0937289336588154,1.0938371585827313,7.238287467159488e-05,0.00012655443934545663,0.00014352700114103766,-5.357757137924857e-05,-5.1148950809265514e-05,-1.3367733057378928e-05,1.0939806855838723,1.0936936315815904,,False,True,success,1.0885500000000001,1.09275,1.09275,1.0925500000000001,2024-07-18 16:15:00,True,2024-07-18 16:15:00,2024-07-19 07:57:03,,0.01,True,91.23,1211.5400000000006,,3,0,29,7
2024-07-18 04:30:00,1.09366,1.09384,1.09336,1.09349,709,12,0,1.09336,1.09384,-6.069579648446467e-05,-0.00013743351604261658,-3.9892327526292055e-05,-1.6764719620178118e-05,1.0933866919321473,1.0939560996528586,2024-07-18 04:00:00,2024-07-18 04:00:00,-7.869047619024627e-05,0.0005047001309608223,1.0936713095238102,0.00019856867326992314,9.966994739056342e-05,1.0938639285714284,1.0883781810573647,1.093665505028099,1.0879971817834007,1.093556530758453,9.967021570933207e-05,0.00022421878715246768,1.0934757607649364,1.0927628228329522,29.699984923866918,30.102015176646105,0.0006315042040691879,,-1.0,1.0929603560398098,bearish,1.093733723671905,1.093705821038079,1.0937361747506018,2.7902633825904744e-05,9.5367423253676e-05,0.00015828455406811614,-6.879256965963698e-05,-3.21912624698939e-05,-5.357757137924857e-05,1.09389445930467,1.0935778901965336,,False,True,success,1.0884900000000002,1.0926900000000002,1.0926900000000002,1.0924900000000002,2024-07-18 16:15:00,True,2024-07-18 16:15:00,2024-07-19 08:01:29,,0.01,True,91.23,1302.7700000000007,,4,0,29,7
2024-07-18 04:45:00,1.0935,1.09365,1.09333,1.09335,658,12,0,1.0932799980648558,1.09365,-5.945676976801186e-05,-8.563045292460265e-05,5.028643744608633e-05,-8.865180648987559e-06,1.0933691349421155,1.0937349034409725,2024-07-18 04:00:00,2024-07-18 04:00:00,-7.869047619024627e-05,0.0005047001309608223,1.0936713095238102,0.00019856867326992314,9.966994739056342e-05,1.0938639285714284,1.0883781810573647,1.093665505028099,1.0879971817834007,1.093556530758453,9.967021570933207e-05,0.00022421878715246768,1.0934757607649364,1.0927628228329522,21.561456785342784,25.841355990613888,0.0006315042040691879,,-1.0,1.0929603560398098,bearish,1.0936746892608427,1.0936794639241474,1.0936462779497755,-4.774663304729643e-06,7.533900594199488e-05,0.00017351080674281194,-8.989680082627238e-05,-6.879256965963698e-05,-3.21912624698939e-05,1.0938197887565184,1.0934727671430327,,False,True,success,1.0883500000000002,1.0925500000000001,1.0925500000000001,1.0923500000000002,2024-07-18 16:15:00,True,2024-07-18 16:15:00,2024-07-19 09:12:14,,0.01,True,91.23,1394.0000000000007,,5,0,29,7
2024-07-18 05:00:00,1.09336,1.09351,1.09323,1.09335,505,12,0,1.0931150035136226,1.09351,3.20148621728844e-05,-2.8230105088795695e-07,-0.00010820248033519598,-6.555166931086804e-05,1.093425277093431,1.0939477986503512,2024-07-18 05:00:00,2024-07-18 05:00:00,-0.00019261904761824766,0.00041552203637373886,1.0935714285714297,0.00017945182345114572,9.965773445775812e-05,1.0936713095238102,1.0886757241658962,1.0937745906150336,1.0883781810573647,1.093665505028099,9.966994739056342e-05,0.00019856867326992314,1.0934519202549788,1.0928169970063162,12.420042643932128,21.227161451047248,0.0005883077705300981,,-1.0,1.0929199319309642,bearish,1.0936247370668668,1.0936550591890253,1.0935610526315793,-3.0322122158477072e-05,5.4206780321900495e-05,0.00018821795891079204,-8.52253181962137e-05,-8.989680082627238e-05,-6.879256965963698e-05,1.09374927059049,1.0933728346726685,,False,True,success,1.0883500000000002,1.0925500000000001,1.0925500000000001,1.0923500000000002,2024-07-18 16:15:00,True,2024-07-18 16:15:00,2024-07-19 09:12:14,,0.01,True,91.23,1485.2300000000007,,6,0,29,7
2024-07-18 05:15:00,1.09336,1.0934,1.09315,1.09321,333,12,0,1.0931166731729791,1.0934,7.012795547719387e-05,4.987255827383046e-05,-0.00013743351604261658,-6.069579648446467e-05,1.0933540859141482,1.0938266028999208,2024-07-18 05:00:00,2024-07-18 05:00:00,-0.00019261904761824766,0.00041552203637373886,1.0935714285714297,0.00017945182345114572,9.965773445775812e-05,1.0936713095238102,1.0886757241658962,1.0937745906150336,1.0883781810573647,1.093665505028099,9.966994739056342e-05,0.00019856867326992314,1.0934519202549788,1.0928169970063162,8.22510822511652,14.068869218130446,0.0005883077705300981,,-1.0,1.0929199319309642,bearish,1.0935609313642718,1.0936220918416901,1.0934567354661164,-6.116047741833164e-05,3.113332877385407e-05,0.00021355171127828928,-0.00010431716546288605,-8.52253181962137e-05,-8.989680082627238e-05,1.0936702871773947,1.0932431837548382,,False,True,success,1.0882100000000001,1.09241,1.09241,1.0922100000000001,2024-07-18 16:15:00,True,2024-07-18 16:15:00,2024-07-19 10:14:56,,0.01,True,91.23,1576.4600000000007,,7,0,29,7
2024-07-18 16:15:00,1.09196,1.09225,1.09144,1.09146,1465,12,0,1.0913900237722318,1.09225,-0.0003253900147819239,-0.0003301125331942843,-0.00037510689497690833,-0.00042122699905461266,1.0927299240176351,1.0936242692210287,2024-07-18 16:00:00,2024-07-18 16:00:00,-9.535714285524577e-05,-6.686442271530701e-05,1.092259404761905,-7.1139794338867e-05,-2.123781340457687e-05,1.0928419047619051,1.0924592742763446,1.0942261968379912,1.092296964171254,1.0947456355550338,-4.493804455903516e-05,9.546657215888308e-07,1.0916455201156117,1.0928016674291186,12.315052936765868,27.932212988400178,8.802719750491679e-05,,-1.0,1.0917001917097906,bearish,1.0925901079877822,1.0928513999830247,1.0924848710010318,-0.00026129199524249636,-0.00013713103068507435,0.00041934790654578715,-0.00026372893016834986,-0.00017941864465154111,-7.705538355384789e-06,1.0929042189075775,1.092065523094486,,False,True,running,1.0864600000000002,1.0906600000000002,1.0906600000000002,1.0904600000000002,2024-07-18 21:15:00,True,2024-07-18 21:15:00,,,0.01,False,0.0,1576.4600000000007,2024-07-18 19:15:00,0,1,29,7
2024-07-18 16:30:00,1.09139,1.09183,1.0912,1.0913,1587,12,0,1.090864995077197,1.09183,-0.00016960005689336876,-0.00025375329754763953,-0.00044244271154749646,-0.000393411007611302,1.0922724555687402,1.0932813633031493,2024-07-18 16:00:00,2024-07-18 16:00:00,-9.535714285524577e-05,-6.686442271530701e-05,1.092259404761905,-7.1139794338867e-05,-2.123781340457687e-05,1.0928419047619051,1.0924592742763446,1.0942261968379912,1.092296964171254,1.0947456355550338,-4.493804455903516e-05,9.546657215888308e-07,1.0916455201156117,1.0928016674291186,2.0706334330855083,14.354330656747045,8.802719750491679e-05,,-1.0,1.0917001917097906,bearish,1.0923916298358158,1.0927364814657636,1.092202229102168,-0.0003448516299477955,-0.0001786751505376186,0.0005275060821681505,-0.0002826418988637336,-0.00026372893016834986,-0.00017941864465154111,1.0927297351843361,1.09167472302,,False,True,running,1.0863,1.0905,1.0905,1.0903,2024-07-18 21:15:00,True,2024-07-18 21:15:00,,,0.01,False,0.0,1576.4600000000007,2024-07-18 19:30:00,0,2,29,7
2024-07-18 16:45:00,1.09129,1.09154,1.09068,1.09107,1675,12,0,1.0905633243639428,1.09154,-6.113011104595483e-05,-9.800002629894591e-05,-0.0004000668336628034,-0.00035328108981373245,1.091802943782008,1.09280189402032,2024-07-18 16:00:00,2024-07-18 16:00:00,-9.535714285524577e-05,-6.686442271530701e-05,1.092259404761905,-7.1139794338867e-05,-2.123781340457687e-05,1.0928419047619051,1.0924592742763446,1.0942261968379912,1.092296964171254,1.0947456355550338,-4.493804455903516e-05,9.546657215888308e-07,1.0916455201156117,1.0928016674291186,6.082935776544427,6.822874048798572,8.802719750491679e-05,,-1.0,1.0917001917097906,bearish,1.0921883021687673,1.0926130383942254,1.0918988648090815,-0.0004247362254581333,-0.00022788736552172156,0.0006333048239653601,-0.0003033642930865277,-0.0002826418988637336,-0.00026372893016834986,1.0925321696330468,1.0912655599851162,,False,True,running,1.08607,1.09027,1.09027,1.09007,2024-07-18 21:15:00,True,2024-07-18 21:15:00,,,0.01,False,0.0,1576.4600000000007,2024-07-18 19:45:00,0,3,29,7
2024-07-18 18:15:00,1.09072,1.09093,1.09058,1.09058,1104,12,0,1.0901667767858403,1.0918133117664832,0.0002505937507838286,-3.9670358584914676e-05,-8.322479399852594e-06,-3.0290155541287105e-05,1.0906871353618468,1.0915973817153781,2024-07-18 18:00:00,2024-07-18 18:00:00,-0.0003948809523812713,-0.00037506772695916624,1.091483452380952,-7.832691500946436e-05,-3.865123812896963e-05,1.0918645238095237,1.0923031761705688,1.0944720393632166,1.0923887483592665,1.0945142617228623,-3.8648132788738305e-05,-7.832821289901927e-05,1.09127172445729,1.092568643312006,14.895833333333345,19.166666666666753,-6.285379061031729e-05,,-1.0,1.0913730335301484,bearish,1.091360824552702,1.091976678038665,1.0906600550395598,-0.0006158534859630471,-0.0004857505177195378,0.0009802861827334804,-0.00016898520811814421,-0.00015822841417190148,-0.00010353973168397701,1.0916403412222933,1.0896797688568263,,False,True,even,1.0855800000000002,1.0897800000000002,1.0897800000000002,1.0895800000000002,2024-07-18 21:45:00,True,2024-07-18 21:45:00,,2024-07-18 21:55:08,0.01,True,14.6,1591.0600000000006,,1,0,29,7
2024-07-18 18:30:00,1.09057,1.09177,1.09044,1.09121,1550,12,0,1.09044,1.09177,0.00020806867187395567,-7.966873815239909e-05,5.521892199535266e-05,-9.501892420164129e-05,1.090741835037027,1.0915944172591736,2024-07-18 18:00:00,2024-07-18 18:00:00,-0.0003948809523812713,-0.00037506772695916624,1.091483452380952,-7.832691500946436e-05,-3.865123812896963e-05,1.0918645238095237,1.0923031761705688,1.0944720393632166,1.0923887483592665,1.0945142617228623,-3.8648132788738305e-05,-7.832821289901927e-05,1.09127172445729,1.092568643312006,12.708333333332954,15.902777777777393,-6.285379061031729e-05,,-1.0,1.0913730335301484,bearish,1.0913376207753633,1.091919887072838,1.0906446508427934,-0.0005822662974745985,-0.0005050536736705499,0.000992240730228759,-1.540419676637761e-05,-0.00016898520811814421,-0.00015822841417190148,1.0916368915730221,1.0896524101125646,,False,True,running,1.0862100000000001,1.09041,1.09041,1.0902100000000001,2024-07-18 21:15:00,True,2024-07-18 21:15:00,,,0.01,False,0.0,1591.0600000000006,2024-07-18 21:30:00,0,1,29,7
2024-07-18 21:15:00,1.09004,1.09013,1.08984,1.08987,825,12,0,1.0896249980472839,1.0901191224743527,-8.718796728944832e-05,-5.7834316018327374e-05,-0.0003835376587976124,-0.00039437493247714467,1.090783023914461,1.0915625594759928,2024-07-18 21:00:00,2024-07-18 21:00:00,-0.0003617857142865777,-0.0005636960953121495,1.0905147619047622,-0.00015657502543371928,-3.865193430961127e-05,1.0909701190476184,1.09340584386092,1.0943452027080562,1.092969677075035,1.0943874309516586,-3.864988913849945e-05,-0.00011682441704489775,1.0901967305354552,1.0921387522033397,6.635638419036099,20.68142680551229,-0.00027945017937956376,,-1.0,1.09086589563754,bearish,1.0908280988531378,1.0913217673200777,1.0907691984864119,-0.0004936684669398783,-0.00042457018990991585,0.0007804631104193427,-0.00021496388028974245,-0.000185662194701397,-6.769177846677188e-05,1.0915496615968312,1.0899887353759925,,False,True,even,1.08487,1.08907,1.08907,1.08887,2024-07-19 04:45:00,True,2024-07-19 04:45:00,,2024-07-19 05:56:33,0.01,True,14.6,1605.6600000000005,,1,0,29,7
2024-07-18 21:30:00,1.08987,1.09004,1.0895299999999999,1.08955,799,12,0,1.089540887751172,1.09004,-7.370516850122996e-05,-5.545377302417382e-05,-0.00035176038730046834,-0.00024771337451686857,1.0902068693354512,1.0911470810716273,2024-07-18 21:00:00,2024-07-18 21:00:00,-0.0003617857142865777,-0.0005636960953121495,1.0905147619047622,-0.00015657502543371928,-3.865193430961127e-05,1.0909701190476184,1.09340584386092,1.0943452027080562,1.092969677075035,1.0943874309516586,-3.864988913849945e-05,-0.00011682441704489775,1.0901967305354552,1.0921387522033397,1.9207261383362086,9.53473884002925,-0.00027945017937956376,,-1.0,1.09086589563754,bearish,1.0906314682603473,1.0911905252963683,1.0904735810113524,-0.0005590570360209934,-0.00045146755913213143,0.0007701843935441277,-0.000295617475059462,-0.00021496388028974245,-0.000185662194701397,1.0912437654048965,1.0897033966178082,,False,True,even,1.0845500000000001,1.08875,1.08875,1.0885500000000001,2024-07-19 09:15:00,True,2024-07-19 09:15:00,,2024-07-19 09:21:29,0.01,True,14.6,1620.2600000000004,,2,0,29,7
2024-07-18 23:30:00,1.08972,1.08973,1.08951,1.08959,215,12,0,1.0894399993910342,1.0897191164090982,-1.376845172660525e-05,2.779915174338664e-05,-5.8386484198299246e-05,2.1688711757874657e-05,1.0894520273850368,1.0899045399496636,2024-07-18 23:00:00,2024-07-18 23:00:00,-0.0003948809523812713,-0.0008034301582420245,1.0898973809523815,-0.00018440288483646046,-7.55577460028484e-05,1.0901198809523809,1.0937108125613255,1.094863087942515,1.0934448544928606,1.094541390123844,-5.2344340792020464e-05,-0.0001657422407135391,1.089670747837273,1.091751679864907,17.61257983669183,18.054095813011887,-0.00045204949359810124,,-1.0,1.090531729868851,bearish,1.0899202472320457,1.0904898613374219,1.0893035362917103,-0.0005696141053761483,-0.0005741453920194141,0.000769712717009562,-6.658066735409918e-05,-7.44134846912825e-05,-8.464396284946218e-05,1.09007324900872,1.0885338235747006,,False,True,even,1.0845900000000002,1.0887900000000001,1.0887900000000001,1.0885900000000002,2024-07-19 08:15:00,True,2024-07-19 08:15:00,,2024-07-19 08:30:00,0.01,True,14.6,1634.8600000000004,,3,0,29,7
2024-07-18 23:45:00,1.08959,1.08961,1.08945,1.08959,174,12,0,1.0893516739744258,1.0897282136075452,5.3540528351279556e-05,3.7524642597484686e-05,-5.047364977973594e-05,-4.2560183227295125e-05,1.0895960210859024,1.0898352910783653,2024-07-18 23:00:00,2024-07-18 23:00:00,-0.0003948809523812713,-0.0008034301582420245,1.0898973809523815,-0.00018440288483646046,-7.55577460028484e-05,1.0901198809523809,1.0937108125613255,1.094863087942515,1.0934448544928606,1.094541390123844,-5.2344340792020464e-05,-0.0001657422407135391,1.089670747837273,1.091751679864907,15.883078779085785,17.256837472316494,-0.00045204949359810124,,-1.0,1.090531729868851,bearish,1.0898694399655773,1.0904232049420575,1.0892834021327822,-0.0005537649764801866,-0.0005700693089115686,0.0007812728930360719,-2.013415892809789e-05,-6.658066735409918e-05,-7.44134846912825e-05,1.0900646750258183,1.088502129239746,,False,True,even,1.0845900000000002,1.0887900000000001,1.0887900000000001,1.0885900000000002,2024-07-19 08:15:00,True,2024-07-19 08:15:00,,2024-07-19 08:30:00,0.01,True,14.6,1649.4600000000003,,4,0,29,7
2024-07-19 03:45:00,1.0894,1.08944,1.08901,1.08914,537,12,0,1.08901,1.089566699935907,-7.319935857893526e-05,-0.0001438289231653809,-0.00015639292162686688,-0.0001012624974061822,1.0893314587727427,1.0899554444847654,2024-07-19 03:00:00,2024-07-19 03:00:00,4.4642857144561177e-05,-0.0007856762875997347,1.0894890476190475,-0.0002075497234730088,-0.00020260768193502415,1.089592023809525,1.0933215101689786,1.096051112073099,1.0935481121256352,1.0958644639446258,-0.00017131965465236304,-0.00020754107834537608,1.0893838363930528,1.091143522060993,18.498780912576365,24.396369913619324,-0.0006768339593091421,,-1.0,1.0899143854024944,bearish,1.0896049004035646,1.0898751213334135,1.0895993360853116,-0.00027022092984885226,-0.0002749268405002061,0.00020543287645025172,-0.00010545579635312663,-6.08943928435135e-05,-5.969040247855162e-05,1.0898047689617618,1.0893939032088613,,False,True,even,1.08414,1.08834,1.08834,1.08814,2024-07-19 11:30:00,True,2024-07-19 11:30:00,,2024-07-19 12:49:02,0.01,True,14.6,1664.0600000000002,,5,0,29,7
2024-07-19 04:30:00,1.08896,1.08907,1.08876,1.08883,529,12,0,1.0885400041035427,1.08907,2.755570127615028e-05,-3.7137397512040666e-05,-0.0001438289231653809,-7.319935857893526e-05,1.0890032159918437,1.0895533633101824,2024-07-19 04:00:00,2024-07-19 04:00:00,-0.00010297619047738849,-0.000814322505984677,1.0892503571428565,-0.0002102147380177991,-0.00023451809111598376,1.0894890476190475,1.0931410721483374,1.0961759249268281,1.0933215101689786,1.096051112073099,-0.00020260768193502415,-0.0002075497234730088,1.0889212787976843,1.0909472402961138,6.571699905034175,9.676507684172295,-0.000704331668644249,,-1.0,1.089776157692402,bearish,1.08934521731322,1.0896851298498496,1.0892054213966291,-0.00033991253662946086,-0.0002964744286570548,0.000313162364799242,-0.00014050223598305323,-0.00013305125558904507,-0.00012036119711034132,1.0895185837614283,1.08889225903183,,False,True,even,1.08383,1.08803,1.08803,1.08783,2024-07-19 21:45:00,True,2024-07-19 21:45:00,,2024-07-19 22:02:13,0.01,True,14.6,1678.66,,6,0,29,7
2024-07-19 04:45:00,1.08882,1.08887,1.08857,1.08869,730,12,0,1.0885550065328125,1.0889716685661048,7.807611810212612e-05,2.601634750862507e-05,-0.00016106858567624112,-0.00010995333897941109,1.0889298257541902,1.0893950895375892,2024-07-19 04:00:00,2024-07-19 04:00:00,-0.00010297619047738849,-0.000814322505984677,1.0892503571428565,-0.0002102147380177991,-0.00023451809111598376,1.0894890476190475,1.0931410721483374,1.0961759249268281,1.0933215101689786,1.096051112073099,-0.00020260768193502415,-0.0002075497234730088,1.0889212787976843,1.0909472402961138,5.180498513829598,6.84496573385411,-0.000704331668644249,,-1.0,1.089776157692402,bearish,1.0892444146496478,1.0896114165276385,1.089045627794978,-0.0003670018779906581,-0.0003105799185237755,0.0003606013496831954,-0.00015979360165108147,-0.00014050223598305323,-0.00013305125558904507,1.0894062291446613,1.0886850264452947,,False,True,even,1.08369,1.08789,1.08789,1.08769,2024-07-19 21:45:00,True,2024-07-19 21:45:00,,2024-07-19 22:01:09,0.01,True,14.6,1693.26,,7,0,29,7
2024-07-19 07:00:00,1.08877,1.08881,1.08868,1.0887,299,12,0,1.0886413251124492,1.0888033306921863,-2.796419755715719e-05,4.4390485386485874e-05,-2.7552037580236174e-05,-1.1976033829570162e-05,1.0887288919182379,1.0889374536380172,2024-07-19 07:00:00,2024-07-19 07:00:00,-0.00019511904761837506,-0.0008229141050075661,1.088770357142858,-0.00021809465222222117,-0.00027151070750633486,1.088965,1.092563101041839,1.0956852363288376,1.0928013470649323,1.096001659889468,-0.00027369272824162425,-0.00021809243778169775,1.0887156029184326,1.0904793672117001,19.622587460163402,20.386798482189405,-0.0007683003877042735,,-1.0,1.0894105343856622,bearish,1.0889230044826164,1.0892290400302558,1.0886686824905396,-0.0003060355476394161,-0.0003206618862682193,0.00047332159616213774,6.852425180170485e-06,-5.479876160618957e-06,-1.244926040655514e-05,1.0891420040867017,1.0881953608943775,,False,True,even,1.0837,1.0879,1.0879,1.0877000000000001,2024-07-19 21:45:00,True,2024-07-19 21:45:00,,2024-07-19 22:01:09,0.01,True,14.6,1707.86,,8,0,29,7
2024-07-19 07:15:00,1.08869,1.08875,1.0886,1.08866,227,12,0,1.088610868709598,1.0889182313004735,-6.45743860042587e-05,-2.673885690032371e-05,-5.510384486311176e-05,-5.052060644498549e-05,1.0887603311413114,1.088934905878647,2024-07-19 07:00:00,2024-07-19 07:00:00,-0.00019511904761837506,-0.0008229141050075661,1.088770357142858,-0.00021809465222222117,-0.00027151070750633486,1.088965,1.092563101041839,1.0956852363288376,1.0928013470649323,1.096001659889468,-0.00027369272824162425,-0.00021809243778169775,1.0887156029184326,1.0904793672117001,14.782801078317597,18.491901505112946,-0.0007683003877042735,,-1.0,1.0894105343856622,bearish,1.0888825422545216,1.0891868889169036,1.088682992776057,-0.0003043466623819935,-0.00031739884149097416,0.00047883539279538275,1.4310285517460386e-05,6.852425180170485e-06,-5.479876160618957e-06,1.0891618281688524,1.0882041573832617,,False,True,even,1.08366,1.08786,1.08786,1.08766,2024-07-19 21:45:00,True,2024-07-19 21:45:00,,2024-07-19 22:00:17,0.01,True,14.6,1722.4599999999998,,9,0,29,7
2024-07-22 11:30:00,1.08891,1.08918,1.0886,1.0887,653,12,0,1.0882433913591572,1.08918,0.00016227464653608353,1.5030706556772328e-05,2.3362639676305168e-05,9.2135623126363e-05,1.0883185215916873,1.0891058266873677,2024-07-22 11:00:00,2024-07-22 11:00:00,5.29761904759507e-05,-9.119054709350038e-05,1.0885266666666673,2.534172089743346e-05,6.746109267755298e-05,1.0884452380952372,1.0872643367577237,1.089177088664766,1.0872367831243597,1.0890193937055073,7.264561308823105e-05,2.534158689386566e-05,1.0886696073350435,1.0888504459856674,80.76901328809812,78.75472288279428,-5.567427240545809e-05,,-1.0,1.0886335633948374,bearish,1.0886790035725322,1.0887226160644043,1.088618087375302,-4.361249187212479e-05,-9.634693728853123e-05,0.0003461897361195114,4.964224286374552e-05,9.602339181191688e-05,0.00013918128655077133,1.0889642771114214,1.0882718976391825,,False,True,even,1.0837,1.0879,1.0879,1.0877000000000001,2024-07-22 16:15:00,True,2024-07-22 16:15:00,,2024-07-22 16:19:02,0.01,True,14.6,1737.0599999999997,,10,0,30,7
2024-07-22 13:00:00,1.08911,1.08913,1.0884800000000001,1.08868,812,12,0,1.0884800000000001,1.089231667090039,9.226205713202408e-05,-1.0711360013530499e-05,3.6717082867092685e-05,-0.00013444762819980201,1.0889175607108983,1.0894033964911893,2024-07-22 13:00:00,2024-07-22 13:00:00,0.00013440476190473838,-1.0977864168149054e-05,1.0887739285714293,2.5340584652244086e-05,2.4743548704450288e-05,1.088661071428572,1.0873194562858934,1.0898786393190056,1.087291861758247,1.089523933181281,4.8032608332270676e-05,2.5346120432324494e-05,1.0889099563705604,1.088872649482269,73.10245310245665,84.90893398694864,-4.887999918479225e-05,,-1.0,1.0886219553852863,bearish,1.088878828171564,1.0888256187558494,1.0890581389748888,5.3209415714627895e-05,6.711598510042294e-06,0.0003222835191686715,-4.1991744065050796e-05,6.810457516270851e-05,9.595115239191543e-05,1.0893804224940575,1.08873585545572,,False,True,even,1.0836800000000002,1.0878800000000002,1.0878800000000002,1.0876800000000002,2024-07-22 16:15:00,True,2024-07-22 16:15:00,,2024-07-22 16:18:59,0.01,True,14.6,1751.6599999999996,,11,0,30,7
