time,open,high,low,close,tick_volume,spread,real_volume,bb_lower,bb_middle,bb_upper,ema_50,ema_50_grad,lsma,lsma_high,lsma_low,lsma_long,long_smooth,long_smooth_grad,lsma2,lsma2_grad,lsma2_smooth,lsma2_smooth_grad,lsma3,lsma3_grad,lsma3_smooth,lsma3_smooth_grad,lsma_grad,lsma_long_grad,support_trendline_15,resistance_trendline_15,support_gradient_15,resistance_gradient_15,supertrend_dir,Span_A,Span_B,sr_levels,fixed_resistance_gradient_15,fixed_support_gradient_15,fixed_support_trendline_15,fixed_resistance_trendline_15,ema_short,ema_long,macd_line,macd_signal,lsma_stddev,lsma_slope,prev_lsma_slope_1,prev_lsma_slope_2,lsma_upper_band,lsma_lower_band,stoch_k,stoch_d,is_doji,is_doji_star,3whitesoldiers,3blackcrows,engulfing,inverted_hammer,two_crows,three_inside,three_line_strike,three_outside,three_stars_in_south,abandoned_baby,advance_block,belt_hold,breakaway,closing_marubozu,conceal_baby_swallow,counterattack,dark_cloud_cover,doji,doji_star,dragonfly_doji,evening_doji_star,evening_star,gap_side_side_white,gravestone_doji,hammer,hanging_man,harami,harami_cross,high_wave,hikkake,hikkake_mod,homing_pigeon,identical_three_crows,in_neck,kicking,kicking_by_length,ladder_bottom,long_legged_doji,long_line,matching_low,mat_hold,morning_doji_star,morning_star,on_neck,piercing,rickshaw_man,rise_fall_3_methods,separating_lines,shooting_star,short_line,spinning_top,stalled_pattern,stick_sandwich,takuri,tasuki_gap,thrusting,tristar,unique_3_river,upside_gap_two_crows,xside_gap_3_methods,be_increment,be_condition_increment,ticket,sr_cross_signal_sell,sr_cross_signal_buy,in_session,is_buy2,is_sell2,signal,tp,sl,be,be_condition,conditions_arr,order_type,lot,first_time_to_trail,last_time_to_trail,sl_updated,time_to_trail,time_tp_hit,time_sl_hit,entry_time,entry_price,exit_time,exit,exit_price,lot_size,profit,type,duration,account_balance,success,win_streak,losing_streak,Week,Month
2024-10-28 01:04:00,2735.56,2736.88,2735.56,2736.44,191,27,0,,,,2734.1080446992837,0.07904933222744148,2734.706406377456,2734.8300875046334,2734.255160548756,2734.706406377456,2734.371619082931,0.2965722407611793,2736.1077738927734,0.4398834498811084,2735.714724164723,0.3911810411809711,2735.1912470862485,0.2613752913780445,2734.9061266511253,0.2814763014775963,0.38778123841257184,0.38778123841257184,,,,,,,,[],6.842265604411557e-06,1.5195920027169686e-05,2730.4094299174703,2735.9235149809806,2734.903058540877,2734.3614864253937,0.4991195419079304,0.2301943247579591,0.9687169349207402,0.38778123841257184,0.22879940674920363,0.27313607712267185,2736.6438402472977,2732.7689725076143,88.992655897884,90.35472862011072,0,0,0,0,0,0,0,0,0,0,0,0,0,100,0,0,0,0,0,0,0,0,0,0,0,0,0,0,0,0,0,-100,0,0,0,0,0,0,0,0,0,0,0,0,0,0,0,0,0,0,0,0,0,0,0,0,0,0,0,0,0,0,4.0,5.0,,,,True,True,False,0.0,2836.44,2726.44,2746.44,2749.44,"5.0,4.0,2749.44",0,0.01,2024-10-29 03:09:00,2024-10-29 03:09:00,False,2024-10-29 03:09:00,,2024-10-28 03:10:09,2024-10-28 01:05:00,2736.44,2024-10-28 01:14:00,manual,2735.57,0.01,-15.77,fail,0 days 00:09:00,684.23,False,0,1,44,10
2024-10-28 01:13:00,2736.06,2736.1,2735.47,2735.53,141,32,0,,,,2734.7175667522392,0.027540110093468684,2736.718551724136,2736.987827956989,2736.426055617355,2736.718551724136,2736.6717609689767,0.09692646149915163,2736.6803030303063,-0.24152680652377967,2736.8877544677557,-0.19438228438093574,2736.2440559440593,-0.25525641025387813,2736.451433566434,-0.1646192696180151,0.023472747492178314,0.023472747492178314,,,,,,,,[],1.0053000036807368e-05,-8.798889747030337e-07,2731.9451085844803,2735.77765049926,2736.009027694594,2735.3885826226733,0.5460104756157307,0.6028519898987985,0.4977933449657735,0.023472747492178314,0.09342677049016856,0.17387986651556275,2737.7141384140677,2735.722965034204,65.39867681058355,76.03008805558731,0,0,0,0,0,0,0,0,0,0,0,0,0,-100,0,0,0,0,0,0,0,0,0,0,0,0,0,0,0,0,0,0,0,0,0,0,0,0,0,0,-100,0,0,0,0,0,0,0,0,0,0,0,0,0,0,0,0,0,0,0,0,0,4.0,5.0,,,,True,False,True,1.0,2635.53,2745.53,2725.53,2722.53,"5.0,4.0,2722.53",1,0.01,,,False,,,2024-10-28 16:52:20,2024-10-28 01:14:00,2735.53,2024-10-28 01:16:00,manual,2735.87,0.01,-6.16,fail,0 days 00:02:00,678.07,False,0,2,44,10
2024-10-28 01:15:00,2735.58,2736.02,2735.54,2735.86,131,31,0,,,,2734.7836414578187,0.03648673024326854,2736.852074156472,2737.0845732295143,2736.538694104563,2736.852074156472,2736.7800951674694,0.05233172660928176,2736.1935897435897,-0.23466200466646114,2736.4340481740496,-0.24274669774740687,2735.7273543123515,-0.20182983683025668,2735.9668648018633,-0.2573193473203901,0.08241453466780513,0.08241453466780513,,,,,,,,[],1.0021415207328739e-05,5.543299664354729e-06,2731.50013636836,2735.8360443340957,2735.9354576984965,2735.439374676503,0.4291214409940949,0.5474252045643901,0.5271876190890294,0.08241453466780513,0.05110789766831658,0.023472747492178314,2737.9064493946503,2735.797698918294,39.135030793269216,51.10942845439042,0,0,0,0,0,0,0,0,0,0,0,0,0,100,0,0,0,0,0,0,0,0,0,0,0,0,0,0,0,0,0,0,0,0,0,0,0,0,0,0,0,0,0,0,0,0,0,0,0,0,0,0,0,0,0,0,0,0,0,0,0,0,4.0,5.0,,,,True,True,False,0.0,2835.86,2725.86,2745.86,2748.86,"5.0,4.0,2748.86",0,0.01,2024-10-29 03:07:00,2024-10-29 03:07:00,False,2024-10-29 03:07:00,,2024-10-28 03:10:23,2024-10-28 01:16:00,2735.86,2024-10-28 01:21:00,manual,2735.97,0.01,1.99,success,0 days 00:05:00,680.0600000000001,True,1,0,44,10
2024-10-28 01:20:00,2735.98,2735.98,2735.68,2735.97,113,27,0,,,,2734.988654651636,0.033265944012327964,2736.827977753061,2737.1522217278466,2736.533597330365,2736.827977753061,2736.8760336175997,-0.05598244963448451,2736.1670396270397,-0.08749417249418912,2736.25357031857,-0.05546231546168201,2735.5646969696963,0.02003496503266433,2735.5830031080027,-0.013100233101340564,-0.040689655172172934,-0.040689655172172934,,,,,,,,[],1.0022726166337719e-05,2.4426889978453163e-05,2730.5399793205434,2735.973111787602,2736.027663429692,2735.6543080504475,0.3150839171039479,0.42247513923364466,0.2888864087308141,-0.040689655172172934,-0.06278828327594965,-0.06446941045624044,2737.4057505705227,2736.2502049355994,43.23809523808628,49.968253968247524,100,0,0,0,0,0,0,0,0,0,0,0,0,0,0,0,0,0,0,100,0,100,0,0,0,0,0,-100,0,0,0,0,0,0,0,0,0,0,0,100,0,0,0,0,0,0,0,0,0,0,0,0,0,0,0,100,0,0,0,0,0,0,4.0,5.0,,,,True,False,True,1.0,2635.97,2745.97,2725.97,2722.97,"5.0,4.0,2722.97",1,0.01,,,False,,,2024-10-29 02:32:53,2024-10-28 01:21:00,2735.97,2024-10-28 01:25:00,manual,2736.39,0.01,-7.61,fail,0 days 00:04:00,672.45,False,0,1,44,10
2024-10-28 01:24:00,2735.08,2736.51,2735.08,2736.4,131,27,0,,,,2735.0576372759297,0.04550382115485263,2736.3666125324457,2736.673653689287,2735.9655424545767,2736.3666125324457,2736.422947719688,-0.11645433197327293,2735.9353496503472,0.15284382284244202,2735.910217560215,-0.06808080808286832,2735.163461538462,-0.04332167831989864,2735.241095571095,-0.13132478632405764,-0.00796218019695516,-0.00796218019695516,,,,,,,,[],1.0020453466410203e-05,3.1676341053942784e-05,2730.4883715577735,2736.0828189020585,2735.8146556589095,2735.6284225007216,0.145645656452416,0.26619657742502717,0.5292295613229618,-0.00796218019695516,-0.1530812013374998,-0.18831961438490907,2737.425071655092,2735.3081534097996,36.15687770150231,25.531933698978502,0,0,0,0,100,0,0,0,-100,0,0,0,0,100,0,0,0,0,0,0,0,0,0,0,0,0,0,0,0,0,0,-100,0,0,0,0,0,0,0,0,100,0,0,0,0,0,0,0,0,0,0,0,0,0,0,0,0,0,0,0,0,0,4.0,5.0,,,,True,True,False,0.0,2836.4,2726.4,2746.4,2749.4,"5.0,4.0,2749.4",0,0.01,2024-10-29 03:09:00,2024-10-29 03:09:00,False,2024-10-29 03:09:00,,2024-10-28 03:10:10,2024-10-28 01:25:00,2736.4,2024-10-28 01:55:00,manual,2736.32,0.01,-1.45,fail,0 days 00:30:00,671.0,False,0,2,44,10
2024-10-28 01:54:00,2736.76,2736.96,2736.16,2736.37,112,27,0,,,,2737.033246093446,-0.02248291842170147,2737.8778190582175,2738.3015602521327,2737.6064649610707,2737.8778190582175,2738.2296519589695,-0.3436922506475639,2737.209766899769,-0.185536130532455,2737.404199689197,-0.20381507381534902,2736.447832167834,-0.20206293706087308,2736.6537956487937,-0.19314296814263798,-0.3443114571728074,-0.3443114571728074,,,,,,,,[],3.958919562582361e-05,1.7228508802695507e-05,2733.7528858824667,2736.736898123049,2737.5221974888796,2737.7443056230604,-0.23585836136317084,0.06804457628536165,0.6168685319523246,-0.3443114571728074,-0.36687578791179476,-0.3198895068580896,2739.1115561221222,2736.6440819943127,11.78979741260101,14.918272983541724,0,0,0,0,0,0,0,0,0,0,0,0,0,0,0,0,0,0,0,0,0,0,0,0,0,0,0,0,0,0,0,0,0,0,0,0,0,0,0,0,0,0,0,0,0,0,0,0,0,0,0,0,0,0,0,0,0,0,0,0,0,0,4.0,5.0,,,,True,False,True,1.0,2636.37,2746.37,2726.37,2723.37,"5.0,4.0,2723.37",1,0.01,,,False,,,2024-10-29 02:33:21,2024-10-28 01:55:00,2736.37,2024-10-28 01:56:00,manual,2737.2,0.01,-15.04,fail,0 days 00:01:00,655.96,False,0,3,44,10
2024-10-28 01:55:00,2736.32,2737.21,2736.31,2737.21,95,27,0,,,,2737.039041303497,0.0057952100510192395,2737.645010011121,2738.0247979236183,2737.308344086022,2737.645010011121,2737.914986528243,-0.3146654307265635,2737.146666666669,-0.06310023310015822,2737.2505788655767,-0.1536208236202583,2736.327307692309,-0.12052447552468948,2736.47501165501,-0.17878399378378163,-0.23280904709645256,-0.23280904709645256,,,,,,,,[],3.833542396053083e-05,1.722999196397347e-05,2733.7997961507895,2736.941651762016,2737.474167105975,2737.7047274287597,-0.24004428014040968,0.0064268050002073765,0.5688585061319443,-0.23280904709645256,-0.3443114571728074,-0.36687578791179476,2738.7827270233847,2736.5072929988573,16.817206734610902,15.560301508809104,0,0,0,0,100,0,0,0,0,0,0,0,0,100,0,100,0,0,0,0,0,0,0,0,0,0,0,0,0,0,0,0,0,0,0,0,0,0,0,0,100,0,0,0,0,0,0,0,0,0,0,0,0,0,0,0,0,0,0,0,0,0,4.0,5.0,,,,True,True,False,0.0,2837.21,2727.21,2747.21,2750.21,"5.0,4.0,2750.21",0,0.01,2024-10-29 03:38:00,2024-10-29 03:38:00,False,2024-10-29 03:38:00,,2024-10-28 03:10:03,2024-10-28 01:56:00,2737.21,2024-10-28 01:57:00,manual,2736.66,0.01,-9.97,fail,0 days 00:01:00,645.99,False,0,4,44,10
2024-10-28 01:56:00,2737.2,2737.24,2736.53,2736.54,98,27,0,,,,2737.0226792935464,-0.01636200995062609,2737.349783463109,2737.7672339636615,2737.0488461253235,2737.349783463109,2737.624204177482,-0.29078235076076453,2737.0748717948727,-0.07179487179610078,2737.143768453767,-0.1068104118098745,2736.2669230769225,-0.060384615386738005,2736.3473543123528,-0.12765734265713036,-0.2952265480121241,-0.2952265480121241,,,,,,,,[],3.4617235406978915e-05,1.62547524740429e-05,2733.9777612136054,2737.3222095087417,2737.330449089671,2737.6184513229255,-0.28982538884838505,-0.05282363376951111,0.5623928469354997,-0.2952265480121241,-0.23280904709645256,-0.3443114571728074,2738.47456915698,2736.2249977692377,16.748078072853428,15.118360740021751,0,0,0,0,0,0,0,0,0,0,0,0,0,-100,0,-100,0,0,0,0,0,0,0,0,0,0,0,0,0,0,0,0,0,0,0,0,0,0,0,0,-100,0,0,0,0,0,0,0,0,0,0,0,0,0,0,0,0,0,0,0,0,0,4.0,5.0,,,,True,False,True,1.0,2636.54,2746.54,2726.54,2723.54,"5.0,4.0,2723.54",1,0.01,,,False,,,2024-10-29 02:36:30,2024-10-28 01:57:00,2736.54,2024-10-28 04:02:00,manual,2732.59,0.01,71.46,success,0 days 02:05:00,717.45,True,1,0,44,10
2024-10-28 04:01:00,2731.72,2732.65,2731.63,2732.59,252,27,0,,,,2729.954884059469,0.08932596408567406,2732.217880608083,2732.431609195403,2731.6904738598446,2732.217880608083,2731.941669509332,0.2571301446041616,2732.8813519813507,0.0476456876449447,2732.8152525252476,0.08510878010838496,2732.0471911421923,-0.011666666665860248,2732.0333916083873,0.08268842268944354,0.3203411197623609,0.3203411197623609,,,,,,,,[],5.645631804795049e-06,3.249967729591619e-05,2723.6998566999164,2732.062049177659,2731.485056186564,2730.365041676183,1.0050423804600541,0.8911628360240641,0.43157518794777366,0.3203411197623609,0.18795105673052603,0.2630982573195979,2733.0810309839785,2731.354730232187,84.46338108327905,84.7326409368069,0,0,0,0,0,0,0,0,0,0,0,0,0,0,0,100,0,0,0,0,0,0,0,0,0,0,0,0,0,0,0,0,0,0,0,0,0,0,0,0,100,0,0,0,0,0,0,0,0,0,0,0,0,0,0,0,0,0,0,0,0,0,4.0,5.0,,,,True,True,False,0.0,2832.59,2742.59,2746.59,2750.59,"5.0,4.0,2745.59",0,0.01,2024-10-28 16:53:00,2024-10-28 16:53:00,True,2024-10-29 03:38:00,,2024-10-28 17:01:29,2024-10-28 04:02:00,2732.59,2024-10-28 04:55:00,manual,2734.17,0.01,28.58,success,0 days 00:53:00,746.0300000000001,True,2,0,44,10
2024-10-28 04:54:00,2734.08,2734.59,2734.03,2734.11,151,30,0,,,,2733.089520801999,0.03459251518643214,2734.338393770859,2734.7335980719313,2733.9520800889863,2734.338393770859,2734.3217495983213,0.029464837473824446,2734.713636363637,-0.09235431235401848,2734.7647591297537,-0.08437062937082374,2733.935699300698,-0.0759440559468203,2734.0244677544633,-0.14160839160967953,0.011952539862704725,0.011952539862704725,,,,,,,,[],1.3327843590437217e-05,2.5503873182227017e-05,2730.017274174365,2734.1244020384097,2734.2069633997453,2733.9689956064235,0.1920432379279191,0.2736727141622322,0.3188343726076004,0.011952539862704725,0.026027437892025773,0.05041453466810708,2734.9760625160743,2733.700725025644,48.841159314361725,47.75370998191917,100,0,0,0,0,0,0,0,0,0,0,0,0,0,0,0,0,0,0,100,0,0,0,0,0,100,0,0,0,0,0,0,0,0,0,0,0,0,0,100,0,0,0,0,0,0,0,0,0,0,0,0,100,0,0,0,0,0,0,0,0,0,4.0,5.0,,,,True,False,True,1.0,2634.11,2744.11,2724.11,2721.11,"5.0,4.0,2721.11",1,0.01,,,False,,,2024-10-28 08:42:00,2024-10-28 04:55:00,2734.11,2024-10-28 06:42:00,manual,2731.78,0.01,42.15,success,0 days 01:47:00,788.1800000000001,True,3,0,44,10
2024-10-28 06:41:00,2730.84,2731.9,2730.83,2731.79,112,27,0,2727.1708046588033,2732.9467750000013,2738.7227453411992,2731.0016043600085,0.0267252759317671,2731.42830404153,2731.626433815352,2731.1894245457934,2731.42830404153,2731.376259300457,-0.009189469780267245,2731.144452214453,0.1896270396291584,2731.06222999222,-0.04961538461429882,2730.5692424242416,-0.009347319347853045,2730.624821289818,-0.10571095571094702,0.10787467556747288,0.10787467556747288,,,,,,7.912369924664561,7.912241706852663,[2734.1047819608116],1.3575384423884388e-06,5.94712919769201e-06,2728.7851459058543,2731.7893442077666,2731.0736872872,2730.925325512239,0.13112437571271585,0.16557791584455467,0.52013734448063,0.10787467556747288,-0.05961512792055146,-0.0758279569881779,2732.468578730491,2730.3880293525685,37.642842083075216,20.008433480917464,0,0,0,0,0,0,0,0,0,100,0,0,0,100,0,0,0,0,0,0,0,0,0,0,0,0,0,0,0,0,0,0,0,0,0,0,0,0,0,0,0,0,0,0,0,0,0,0,0,0,0,0,0,0,0,0,0,0,0,0,0,0,4.0,5.0,,,,True,True,False,0.0,2831.79,2741.79,2745.79,2749.79,"5.0,4.0,2744.79",0,0.01,2024-10-28 16:52:00,2024-10-28 16:52:00,True,2024-10-29 03:10:00,,2024-10-28 17:03:20,2024-10-28 06:42:00,2731.79,2024-10-28 07:14:00,manual,2731.35,0.01,-7.98,fail,0 days 00:32:00,780.2,False,0,1,44,10
2024-10-28 07:13:00,2731.64,2731.81,2731.28,2731.34,154,27,0,2727.121667062708,2732.847025000003,2738.5723829372982,2732.176746092442,-0.028364274320210825,2733.1218034853564,2733.5229529106414,2732.911983685578,2733.1218034853564,2733.3089778766534,-0.10198887652904887,2733.389615384613,-0.4541958041968428,2733.6688539238435,-0.06730380730459729,2732.5124708624694,-0.4436480186504923,2732.9418609168583,-0.22744366744382205,-0.18359807192928201,-0.18359807192928201,,,,,,7.912972947147649,7.912895132689644,"[2732.918701023215, 2734.1047819608116]",2.0656131250819763e-05,1.3772514565471873e-05,2729.3589399770394,2731.486404818086,2732.790551688004,2732.6760853215665,0.08064671114971134,0.2695614216314518,0.9943698650845548,-0.18359807192928201,-0.1943270300353106,0.07195847237790076,2735.1105432155255,2731.1330637551873,28.770487856370394,60.72279889911861,0,0,0,0,0,0,0,0,0,0,0,0,0,0,0,0,0,0,0,0,0,0,0,0,0,0,0,0,0,0,0,0,0,0,0,0,0,0,0,0,0,0,0,0,0,0,0,0,0,0,0,0,0,0,0,0,0,0,0,0,0,0,4.0,5.0,,,,True,False,True,1.0,2631.34,2741.34,2721.34,2718.34,"5.0,4.0,2718.34",1,0.01,,,False,,,2024-10-28 08:13:06,2024-10-28 07:14:00,2731.34,2024-10-28 07:17:00,manual,2731.94,0.01,-10.88,fail,0 days 00:03:00,769.32,False,0,2,44,10
2024-10-28 07:16:00,2731.48,2732.44,2731.41,2731.93,158,30,0,2727.105538634581,2732.820175000003,2738.534811365425,2732.1193520855036,-0.006418714762730815,2732.587449758995,2732.990834260288,2732.3128794957365,2732.587449758995,2732.7309986404653,-0.17811790878704414,2732.2807226107225,-0.15555944055995496,2732.5283061382966,-0.369630924629746,2731.4783216783235,-0.22262237762424775,2731.7596853146847,-0.34471639471576054,-0.12991472005796822,-0.12991472005796822,,,,,,7.912940908833443,7.912895132689644,"[2732.918701023215, 2734.1047819608116]",1.9154523853184857e-05,1.0943195311140133e-05,2729.433548063719,2731.737414655129,2732.3220684099833,2732.4507073692766,-0.13871967663317264,0.0875049165514469,1.2070743852115504,-0.12991472005796822,-0.1708172042986007,-0.23362180200501825,2735.001598529418,2730.1733009885716,18.43120647468337,10.640023115028301,0,0,0,0,0,0,0,0,0,0,0,0,0,0,0,0,0,0,0,0,0,0,0,0,0,0,0,0,0,0,0,0,0,0,0,0,0,0,0,0,0,0,0,0,0,0,0,0,0,0,0,0,0,0,0,0,0,0,0,0,0,0,4.0,5.0,,,,True,True,False,0.0,2831.93,2741.93,2745.93,2749.93,"5.0,4.0,2744.93",0,0.01,2024-10-28 16:52:00,2024-10-28 16:52:00,True,2024-10-29 03:38:00,,2024-10-28 17:01:46,2024-10-28 07:17:00,2731.93,2024-10-28 08:50:00,manual,2741.89,0.01,180.18,success,0 days 01:33:00,949.5,True,1,0,44,10
2024-10-28 08:49:00,2742.73,2742.89,2741.81,2741.89,228,27,0,2725.6044141496777,2733.4912500000005,2741.3780858503233,2740.89260857279,0.033809878888405365,2743.3406436781606,2743.7726266221716,2743.0016870596983,2743.3406436781606,2743.3922031887255,0.010123594115611922,2743.8345454545442,-0.3107342657353911,2744.1474669774598,-0.21301864802035197,2742.9930536130555,-0.4248601398589926,2743.3825291375265,-0.2645221445222887,-0.09387393400402289,-0.09387393400402289,,,,,,7.916616654871439,7.9163694331308125,"[2732.9252971299443, 2732.930887363411, 2732.918701023215, 2732.948407855572, 2734.1047819608116, 2732.9123545075618, 2732.9580944989425, 2732.909785539427, 2732.9273206617913, 2732.9107814377658, 2732.9848387111897, 2732.9640383911014]",3.005183584924065e-05,3.386425306159852e-05,2737.071021497059,2742.489202095986,2743.0185497064913,2742.559843236668,0.3750740533928365,0.5356254771958009,0.8183247261346719,-0.09387393400402289,0.03306933630437925,0.09117538004693415,2744.97729313043,2741.703994225891,39.63893735228769,60.623637705621654,0,0,0,0,0,0,0,0,0,0,0,0,0,0,0,0,0,0,0,0,0,0,0,0,0,0,0,0,0,0,0,0,0,0,0,0,0,0,0,0,-100,0,0,0,0,0,0,0,0,0,0,0,0,0,0,0,0,0,0,0,0,0,4.0,5.0,,,,True,False,True,1.0,2641.89,2731.89,2727.89,2723.89,"5.0,4.0,2728.89",1,0.01,2024-10-28 12:18:00,2024-10-28 12:18:00,True,,,2024-10-28 12:38:18,2024-10-28 08:50:00,2741.89,2024-10-28 12:38:18,auto,2731.93,0.01,180.18,even,0 days 03:48:18,1129.68,True,2,0,44,10
2024-10-28 12:42:00,2732.35,2732.52,2732.08,2732.32,130,27,0,2726.4534429369273,2735.352725000002,2744.2520070630767,2730.9149176414553,0.0476299104593636,2732.0742195031517,2732.2499391916926,2731.654100111232,2732.0742195031517,2731.872063527375,0.2185109380789072,2732.3580652680653,0.21248251748420444,2732.1148368298313,0.24155400155405005,2731.9190326340304,0.23069930069505062,2731.6350777000685,0.26980963480900755,0.20594883203557401,0.20594883203557401,,,,,,7.9123990470289005,7.9121315693542575,"[2731.7151233249624, 2732.9252971299443, 2732.930887363411, 2732.918701023215, 2732.948407855572, 2734.1047819608116, 2732.9123545075618, 2732.9580944989425, 2732.909785539427, 2732.9273206617913, 2732.9107814377658, 2732.9848387111897, 2732.9640383911014, 2738.9282624365596]",2.6635692398953394e-06,-1.3665394376861904e-05,2728.824455628895,2732.2784764693115,2731.6250778731905,2731.0773976600376,0.49461289378405127,0.38679346329660963,0.46340355745623163,0.20594883203557401,0.19457026325471816,0.2550137189459747,2733.0010266180643,2731.147412388239,91.87574671445832,90.10767716387382,100,0,0,0,0,0,0,0,0,0,0,0,0,0,0,0,0,0,0,100,0,0,0,0,0,0,0,0,0,0,-100,0,0,0,0,0,0,0,0,100,0,0,0,0,0,0,0,100,0,0,0,0,-100,0,0,0,0,0,0,0,0,0,4.0,5.0,,,,False,True,False,0.0,2832.32,2742.32,2746.32,2750.32,"5.0,4.0,2745.32",0,0.01,2024-10-28 16:52:00,2024-10-28 16:52:00,True,2024-10-29 03:38:00,,2024-10-28 17:01:40,2024-10-28 12:43:00,2732.32,2024-10-28 12:47:00,manual,2732.24,0.01,-1.45,fail,0 days 00:04:00,1128.23,False,0,1,44,10
2024-10-28 12:46:00,2732.52,2732.62,2731.99,2732.21,165,27,0,2726.539448840978,2735.3818500000016,2744.2242511590252,2731.1126252386393,0.03719914445309769,2732.8396922506454,2732.9747801260664,2732.4800815721132,2732.8396922506454,2732.71838561364,0.16581881102365514,2732.8203146853143,0.06503496503273709,2732.739001553997,0.11309246309247101,2732.272797202798,-0.00607226107194947,2732.232839937831,0.09093628593655012,0.08939265850904121,0.08939265850904121,,,,,,7.9124548753944675,7.912153525420173,"[2731.7151233249624, 2732.9252971299443, 2732.930887363411, 2732.918701023215, 2732.948407855572, 2734.1047819608116, 2732.9123545075618, 2732.9580944989425, 2732.909785539427, 2732.9273206617913, 2732.9107814377658, 2732.9848387111897, 2732.9640383911014, 2738.9282624365596]",3.2931239119827876e-06,7.831722091607833e-07,2727.686407129116,2732.3211980306933,2732.0382075256953,2731.4517581837913,0.5224535153215584,0.47633792425995586,0.3304001901524638,0.08939265850904121,0.1851345939917337,0.2229291805711,2733.5004926309502,2732.1788918703405,85.25854238352784,90.9997854335558,0,0,0,0,0,0,0,0,0,0,0,0,0,0,0,0,0,0,0,0,0,0,0,0,0,0,0,0,0,0,0,0,0,0,0,0,0,0,0,0,0,0,0,0,0,0,0,0,0,0,0,0,0,0,0,0,0,0,0,0,0,0,4.0,5.0,,,,False,False,True,1.0,2632.21,2742.21,2722.21,2719.21,"5.0,4.0,2719.21",1,0.01,,,False,,,2024-10-28 15:37:30,2024-10-28 12:47:00,2732.21,2024-10-28 12:51:00,manual,2731.16,0.01,19.0,success,0 days 00:04:00,1147.23,True,1,0,44,10
2024-10-28 12:50:00,2731.28,2731.28,2730.76,2731.14,138,27,0,2726.5923591330566,2735.398450000001,2744.2045408669455,2731.1439282319,-0.00013316040349309333,2732.367597330365,2732.602930663701,2732.157267334075,2732.367597330365,2732.535909281915,-0.1563999505628999,2731.9649883449874,-0.30230769230956867,2732.2657031856997,-0.26698523698541976,2731.373624708626,-0.2909324009319789,2731.6448640248564,-0.29625874125849805,-0.16786355209706016,-0.16786355209706016,,,,,,7.912430158222971,7.912153525420173,"[2731.7151233249624, 2732.9252971299443, 2732.930887363411, 2732.918701023215, 2732.948407855572, 2734.1047819608116, 2732.9123545075618, 2732.9580944989425, 2732.909785539427, 2732.9273206617913, 2732.9107814377658, 2732.9848387111897, 2732.9640383911014, 2738.9282624365596]",1.4665159722831167e-05,1.6958559883668032e-05,2726.764696209271,2730.9567371032977,2731.6924049012187,2731.425247168629,0.22365554309544677,0.3828780519269426,0.6626664210899949,-0.16786355209706016,-0.16920875046298534,-0.13212754912910896,2733.692930172545,2731.0422644881846,21.51067323480557,35.636552392258494,0,0,0,0,-100,0,0,0,0,0,0,0,0,0,0,0,0,0,0,0,0,0,0,0,0,0,100,0,0,0,0,100,0,0,0,0,0,0,0,0,0,0,0,0,0,0,0,0,0,0,0,0,0,0,0,0,0,0,0,0,0,0,4.0,5.0,,,,False,True,False,0.0,2831.14,2741.14,2745.14,2749.14,"5.0,4.0,2744.14",0,0.01,2024-10-28 16:46:00,2024-10-28 16:46:00,True,2024-10-29 03:09:00,,2024-10-28 17:03:21,2024-10-28 12:51:00,2731.14,2024-10-28 12:52:00,manual,2730.92,0.01,-3.99,fail,0 days 00:01:00,1143.24,False,0,1,44,10
2024-10-28 12:51:00,2731.16,2731.33,2730.87,2730.87,122,27,0,2726.596159017985,2735.399650000001,2744.2031409820174,2731.1349469783954,-0.008981253504771303,2732.1288246199492,2732.4415328142372,2731.9904812754908,2732.1288246199492,2732.343960944256,-0.1919483376586868,2731.6654312354294,-0.29955710955800896,2731.9659052059,-0.2997979797996777,2731.118694638694,-0.2549300699320156,2731.3856254856178,-0.25923853923859497,-0.23877271041556014,-0.23877271041556014,,,,,,7.912430158222971,7.912153525420173,"[2731.7151233249624, 2732.9252971299443, 2732.930887363411, 2732.918701023215, 2732.948407855572, 2734.1047819608116, 2732.9123545075618, 2732.9580944989425, 2732.909785539427, 2732.9273206617913, 2732.9107814377658, 2732.9848387111897, 2732.9640383911014, 2738.9282624365596]",1.466402002607079e-05,2.005280220711542e-05,2726.6414516991968,2730.9967649518144,2731.565881070262,2731.3841177487307,0.14503166078884533,0.3353087736993231,0.6800932183405606,-0.23877271041556014,-0.16786355209706016,-0.16920875046298534,2733.4890110566303,2730.768638183268,16.256157635459036,24.147695881542873,0,0,0,0,0,0,0,0,0,-100,0,0,0,0,0,-100,0,0,0,0,0,0,0,0,0,0,0,0,0,0,0,0,0,0,0,0,0,0,0,0,0,0,0,0,0,0,0,0,0,0,0,0,0,0,0,0,0,0,0,0,0,0,4.0,5.0,,,,False,False,True,1.0,2630.87,2740.87,2720.87,2717.87,"5.0,4.0,2717.87",1,0.01,,,False,,,2024-10-28 15:35:01,2024-10-28 12:52:00,2730.87,2024-10-28 12:55:00,manual,2731.33,0.01,-8.34,fail,0 days 00:03:00,1134.9,False,0,2,44,10
2024-10-28 12:54:00,2730.6,2731.38,2730.05,2731.32,123,27,0,2726.601480788719,2735.401400000001,2744.201319211283,2731.10215231881,0.007384667158930824,2731.6008527994077,2731.843649981462,2731.295179087876,2731.6008527994077,2731.726064021752,-0.17599060684733558,2730.9634382284376,-0.074545454544932,2731.1164646464617,-0.23399766899683527,2730.2619463869487,-0.26498834498488577,2730.517533022525,-0.28558275058185245,-0.08282091212731757,-0.08282091212731757,,,,,,7.912361490260974,7.912153525420173,"[2731.7151233249624, 2732.9252971299443, 2732.930887363411, 2732.918701023215, 2732.948407855572, 2734.1047819608116, 2732.9123545075618, 2732.9580944989425, 2732.909785539427, 2732.9273206617913, 2732.9107814377658, 2732.9848387111897, 2732.9640383911014, 2738.9282624365596]",1.6827593680135373e-05,2.5188896298128307e-05,2726.5661944612643,2730.919137475384,2731.276699000691,2731.2645125145514,-0.008075064272816235,0.17396564221599617,0.4629640527989827,-0.08282091212731757,-0.20999184278480243,-0.235159065629432,2732.5267809050056,2730.6749246938098,20.180105504416215,11.769584730171365,0,0,0,0,0,0,0,100,0,0,0,0,0,0,0,0,0,0,0,0,0,0,0,0,0,0,0,0,0,0,0,0,0,0,0,0,0,0,0,0,0,0,0,0,0,0,0,0,0,0,0,0,0,0,0,0,0,0,0,0,0,0,4.0,5.0,,,,False,True,False,0.0,2831.32,2741.32,2745.32,2749.32,"5.0,4.0,2744.32",0,0.01,2024-10-28 16:51:00,2024-10-28 16:51:00,True,2024-10-29 03:09:00,,2024-10-28 17:03:21,2024-10-28 12:55:00,2731.32,2024-10-28 13:04:00,manual,2730.99,0.01,-5.98,fail,0 days 00:09:00,1128.92,False,0,3,44,10
2024-10-28 13:03:00,2731.82,2732.38,2730.91,2730.97,228,27,0,2726.7464398423363,2735.449750000002,2744.153060157668,2731.358385656596,-0.013165615477646497,2731.836729699669,2732.347485354099,2731.539936225437,2731.836729699669,2731.944884933875,-0.05156989247234378,2732.9098834498836,-0.01744755244726548,2732.9053379953343,0.07480963480884384,2731.988811188813,-0.18673659673368093,2732.0882167832083,0.057024087024274195,-0.15456729699099014,-0.15456729699099014,,,,,,7.91255107743902,7.9124814719551235,"[2731.8111734486815, 2731.7151233249624, 2732.9252971299443, 2732.930887363411, 2732.918701023215, 2732.948407855572, 2734.1047819608116, 2732.9123545075618, 2732.9580944989425, 2732.909785539427, 2732.9273206617913, 2732.9107814377658, 2732.9848387111897, 2732.9640383911014, 2738.9282624365596]",1.6226253978074544e-05,2.5191048434098407e-05,2727.1843209961776,2731.353391169453,2731.8367357479424,2731.6637940309656,0.14321020918441718,0.1954401557478773,0.5591064298791225,-0.15456729699099014,-0.015331108641021274,0.015188728214525327,2732.9549425594273,2730.7185168399105,57.94183445189437,69.94780014913592,0,0,0,0,0,0,0,0,0,0,0,0,0,0,0,-100,0,0,0,0,0,0,0,0,0,0,0,0,0,0,0,-200,0,0,0,0,0,0,0,0,0,0,0,0,0,0,0,0,0,0,0,0,0,0,0,0,0,0,0,0,0,0,4.0,5.0,,sell,,False,False,True,1.0,2630.97,2740.97,2720.97,2717.97,"5.0,4.0,2717.97",1,0.01,,,False,,,2024-10-28 15:35:02,2024-10-28 13:04:00,2730.97,2024-10-28 13:06:00,manual,2731.68,0.01,-12.87,fail,0 days 00:02:00,1116.0500000000002,False,0,4,44,10
2024-10-28 13:05:00,2730.89,2731.72,2730.58,2731.69,162,27,0,2726.751394279823,2735.4514500000023,2744.1515057201814,2731.353770618278,0.011397606160244322,2731.6717271041916,2732.1240778642955,2731.241915461621,2731.6717271041916,2731.741232727723,-0.10652329748927514,2732.166608391607,-0.3055594405600459,2732.516219891216,-0.2535742035743169,2731.2504195804186,-0.3386480186482004,2731.6094327894243,-0.30837606837621934,-0.043514275119832746,-0.043514275119832746,,,,,,7.912630754199002,7.912589546992592,"[2731.8111734486815, 2731.7151233249624, 2732.9252971299443, 2732.930887363411, 2732.918701023215, 2732.948407855572, 2734.1047819608116, 2732.9123545075618, 2732.9580944989425, 2732.909785539427, 2732.9273206617913, 2732.9107814377658, 2732.9848387111897, 2732.9640383911014, 2738.9282624365596]",1.6829441673441904e-05,2.179662916819616e-05,2727.3780988756002,2731.4245565358265,2731.688313760361,2731.6112911788114,0.055681744356206764,0.14587623665847044,0.7035014467921499,-0.043514275119832746,-0.12148832035745727,-0.15456729699099014,2733.078729997776,2730.2647242106073,37.80760626397299,45.15287099178877,0,0,0,0,0,0,0,0,0,0,0,0,0,0,0,100,0,0,0,0,0,0,0,0,0,0,0,0,0,0,0,0,0,0,0,0,0,0,0,0,0,0,0,0,0,0,0,0,0,0,0,0,0,0,0,0,0,0,0,0,0,0,4.0,5.0,,,,False,True,False,0.0,2831.69,2741.69,2745.69,2749.69,"5.0,4.0,2744.69",0,0.01,2024-10-28 16:52:00,2024-10-28 16:52:00,True,2024-10-29 03:10:00,,2024-10-28 17:03:20,2024-10-28 13:06:00,2731.69,2024-10-28 13:13:00,manual,2731.74,0.01,0.9,success,0 days 00:07:00,1116.9500000000003,True,1,0,44,10
2024-10-28 13:12:00,2732.13,2732.14,2731.71,2731.71,73,27,0,2726.776111922053,2735.460550000002,2744.144988077951,2731.4817200711404,0.007738302673260478,2731.824041527625,2732.0970389321474,2731.4379213941415,2731.824041527625,2731.790504511184,0.04228228896317887,2732.031689976689,0.049603729603404645,2731.9680380730347,0.058593628594280744,2731.607634032634,0.10486013985882892,2731.5001204351124,0.12690753690731071,0.016277345199341653,0.016277345199341653,,,,,,7.9125868572746985,7.912620682922917,"[2731.8111734486815, 2731.7151233249624, 2732.9252971299443, 2732.930887363411, 2732.918701023215, 2732.948407855572, 2734.1047819608116, 2732.9123545075618, 2732.9580944989425, 2732.909785539427, 2732.9273206617913, 2732.9107814377658, 2732.9848387111897, 2732.9640383911014, 2738.9282624365596]",1.3528910684929343e-05,2.17954800313932e-05,2727.794261740856,2731.927471820607,2731.8755236419343,2731.7591166809166,0.09557024132027436,0.10923311637090857,0.19762880048895373,0.016277345199341653,0.06805635891987549,0.04251316276986472,2732.219299128603,2731.428783926647,59.87654320986945,62.92181069958185,0,0,0,0,0,0,0,0,0,0,0,0,0,-100,0,-100,0,0,0,0,0,0,0,0,0,0,0,0,0,0,0,0,0,0,0,0,0,0,0,0,-100,0,0,0,0,0,0,0,0,0,0,0,0,0,0,0,0,0,0,0,0,0,4.0,5.0,,sell,,False,False,True,1.0,2631.71,2741.71,2721.71,2718.71,"5.0,4.0,2718.71",1,0.01,,,False,,,2024-10-28 15:36:12,2024-10-28 13:13:00,2731.71,2024-10-28 13:16:00,manual,2732.16,0.01,-8.16,fail,0 days 00:03:00,1108.7900000000002,False,0,1,44,10
2024-10-28 13:15:00,2731.47,2732.55,2731.47,2732.15,163,27,0,2726.782260650573,2735.462850000002,2744.1434393494314,2731.518235828068,0.021415734641777817,2732.005505376341,2732.261793103448,2731.6161349647755,2732.005505376341,2731.937474477811,0.06048794957177961,2732.328613053611,0.1855128205093024,2732.1882867132827,0.09897435897391915,2731.7979370629364,-0.031375291378026304,2731.8001165501087,0.06343434343398258,0.09599703374124147,0.09599703374124147,,,,,,7.91269945002556,7.912620682922917,"[2731.8111734486815, 2731.7151233249624, 2732.9252971299443, 2732.930887363411, 2732.918701023215, 2732.948407855572, 2734.1047819608116, 2732.9123545075618, 2732.9580944989425, 2732.909785539427, 2732.9273206617913, 2732.9107814377658, 2732.9848387111897, 2732.9640383911014, 2738.9282624365596]",1.130600873736405e-05,2.1796407212039553e-05,2727.9726478012235,2732.1421332127566,2731.8753673042393,2731.7816338027396,0.07575431062196003,0.09223191349806778,0.2415870146350173,0.09599703374124147,0.012098628102194198,0.07336818687235791,2732.488679405611,2731.5223313470706,64.6929187251725,60.17375798737339,0,0,0,0,0,0,0,0,0,0,0,0,0,100,0,0,0,0,0,0,0,0,0,0,0,0,0,0,0,0,0,0,0,0,0,0,0,0,0,0,0,0,0,0,0,0,0,0,0,0,0,0,0,0,0,0,0,0,0,0,0,0,4.0,5.0,,,buy,False,True,False,0.0,2832.15,2742.15,2746.15,2750.15,"5.0,4.0,2745.15",0,0.01,2024-10-28 16:52:00,2024-10-28 16:52:00,True,2024-10-29 03:38:00,,2024-10-28 17:01:45,2024-10-28 13:16:00,2732.15,2024-10-28 13:19:00,manual,2731.67,0.01,-8.7,fail,0 days 00:03:00,1100.0900000000001,False,0,2,44,10
2024-10-28 13:18:00,2732.66,2732.74,2731.36,2731.68,157,27,0,2726.8160933741883,2735.4750000000017,2744.133906625815,2731.5956876396385,0.0028580461139426916,2732.224601408972,2732.5453392658524,2731.8344886911395,2732.224601408972,2732.214918798662,0.07303201087688649,2732.5851398601394,0.10881118880570284,2732.4820940170935,0.08550893550955152,2731.772109557112,-0.12332167831891638,2731.8290675990606,-0.00860916860801808,-0.045325176119604293,-0.045325176119604293,,,,,,7.912714086581997,7.912620682922917,"[2731.8111734486815, 2731.7151233249624, 2732.9252971299443, 2732.930887363411, 2732.918701023215, 2732.948407855572, 2734.1047819608116, 2732.9123545075618, 2732.9580944989425, 2732.909785539427, 2732.9273206617913, 2732.9107814377658, 2732.9848387111897, 2732.9640383911014, 2738.9282624365596]",7.1471393051746255e-06,2.1794646893510694e-05,2728.150990213784,2732.456276997867,2732.0371842885493,2731.892037197978,0.12352596577511576,0.11545299116859654,0.44633227524953784,-0.045325176119604293,0.1196981831640187,0.1447230255866998,2733.117265959471,2731.331936858473,82.66450824887382,83.84120983761049,0,0,0,0,0,0,0,0,0,0,0,0,0,0,0,0,0,0,0,0,0,0,0,0,0,0,0,0,0,0,0,0,0,0,0,0,0,0,0,0,0,0,0,0,0,0,0,0,0,0,0,0,0,0,0,0,0,0,0,0,0,0,4.0,5.0,,sell,,False,False,True,1.0,2631.68,2741.68,2721.68,2718.68,"5.0,4.0,2718.68",1,0.01,,,False,,,2024-10-28 15:36:12,2024-10-28 13:19:00,2731.68,2024-10-28 14:02:00,manual,2732.93,0.01,-22.66,fail,0 days 00:43:00,1077.43,False,0,3,44,10
2024-10-28 14:01:00,2731.86,2733.09,2731.67,2732.92,226,27,0,2726.6045176887505,2735.3874500000006,2744.1703823112507,2731.804007730883,0.037830246410521795,2732.529597330369,2732.6411323692987,2732.198781609196,2732.529597330369,2732.4044703992054,0.0930433815356082,2732.6355944055913,0.1307459207400825,2732.5975951825944,-0.02366744366781859,2731.9879953379977,-0.11532634032482747,2732.118306138298,-0.13031857031819527,0.15727771598585605,0.15727771598585605,,,,,,7.912772638583784,7.912617007669361,"[2731.8111734486815, 2731.907226949629, 2731.7151233249624, 2732.9252971299443, 2732.930887363411, 2732.918701023215, 2732.948407855572, 2734.1047819608116, 2732.9123545075618, 2732.9580944989425, 2732.909785539427, 2732.9273206617913, 2732.9107814377658, 2732.9848387111897, 2732.9640383911014, 2738.9282624365596]",3.2101955469078668e-06,-4.431674762275528e-06,2730.285626094263,2732.6418131195555,2732.258602711927,2732.024448862139,0.21080606277655534,0.17490434933637025,0.3134115276366044,0.15727771598585605,0.060825361509614595,0.06102706711044448,2733.1564203856424,2731.902774275096,65.45545545545308,69.88947280613688,0,0,0,0,100,0,0,0,-100,0,0,0,0,0,0,0,0,0,0,0,0,0,0,0,0,0,0,0,0,0,0,200,0,0,0,0,0,0,0,0,0,0,0,0,100,0,0,0,0,0,0,0,0,0,0,0,0,0,0,0,0,0,4.0,5.0,,,buy,False,True,False,0.0,2832.92,2750.92,2754.92,2760.92,"5.0,4.0,2745.92",0,0.01,2024-10-29 02:33:00,2024-10-29 04:12:00,True,2024-10-29 15:47:00,,2024-10-29 04:51:41,2024-10-28 14:02:00,2732.92,2024-10-28 14:03:00,manual,2732.56,0.01,-6.53,fail,0 days 00:01:00,1070.9,False,0,4,44,10
2024-10-28 14:02:00,2732.93,2733.11,2732.48,2732.55,187,27,0,2726.5956906772194,2735.3827000000006,2744.1697093227817,2731.8284664938046,0.02445876292176763,2732.6244123099714,2732.7655053763438,2732.351420096403,2732.6244123099714,2732.5087764182376,0.10430601903226489,2732.7658624708615,0.13026806527022927,2732.6354351204322,0.03783993783781625,2732.0689627039637,0.0809673659659893,2732.053426573419,-0.06487956487899282,0.0948149796022335,0.0948149796022335,,,,,,7.91277629743271,7.912620666518286,"[2731.8111734486815, 2731.907226949629, 2731.7151233249624, 2732.9252971299443, 2732.930887363411, 2732.918701023215, 2732.948407855572, 2734.1047819608116, 2732.9123545075618, 2732.9580944989425, 2732.909785539427, 2732.9273206617913, 2732.9107814377658, 2732.9848387111897, 2732.9640383911014, 2738.9282624365596]",3.3033912246204236e-06,-3.1847328016787644e-06,2730.188120818488,2732.6487982384456,2732.303433063938,2732.0633785760547,0.21546014671957892,0.18301550881301198,0.31863268139977247,0.0948149796022335,0.15727771598585605,0.060825361509614595,2733.261677672771,2731.987146947172,65.8645117720485,65.14677919928954,0,0,0,0,0,0,0,0,0,0,0,0,0,0,0,0,0,0,0,0,0,0,0,0,0,0,0,0,0,0,0,0,0,0,0,0,0,0,0,0,0,0,0,0,0,0,0,0,0,0,0,0,0,0,0,0,0,0,0,0,0,0,4.0,5.0,,sell,,False,False,True,1.0,2632.55,2742.55,2722.55,2719.55,"5.0,4.0,2719.55",1,0.01,,,False,,,2024-10-28 15:40:08,2024-10-28 14:03:00,2732.55,2024-10-28 14:04:00,manual,2732.69,0.01,-2.54,fail,0 days 00:01:00,1068.3600000000001,False,0,5,44,10
2024-10-28 14:03:00,2732.56,2733.39,2732.42,2732.71,220,27,0,2726.5867927048553,2735.3776250000005,2744.168457295146,2731.8573692317127,0.02890273790808351,2732.703144975898,2732.9317538005184,2732.4619021134595,2732.703144975898,2732.6190515387425,0.11027512050486621,2732.9300932400956,0.16423076923410918,2732.7771833721804,0.14174825174814032,2732.136305361305,0.06734265734121436,2732.0644211344134,0.01099456099427698,0.07873266592650907,0.07873266592650907,,,,,,7.912827518506568,7.912671887592145,"[2731.8111734486815, 2731.907226949629, 2731.7151233249624, 2732.9252971299443, 2732.930887363411, 2732.918701023215, 2732.948407855572, 2734.1047819608116, 2732.9123545075618, 2732.9580944989425, 2732.909785539427, 2732.9273206617913, 2732.9107814377658, 2732.9848387111897, 2732.9640383911014, 2738.9282624365596]",5.50633673684873e-06,-1.310619720227317e-06,2730.0561833270676,2732.6212001876092,2732.3659818233323,2732.11127645931,0.22824673949116914,0.19206175494864342,0.32966433136165046,0.07873266592650907,0.0948149796022335,0.15727771598585605,2733.3624736386214,2732.0438163131744,71.12472888571386,67.48156537107162,0,0,0,0,0,0,0,0,0,0,0,0,0,0,0,0,0,0,0,0,0,0,0,0,0,0,0,0,100,0,0,0,0,0,0,0,0,0,0,0,0,0,0,0,0,0,0,0,0,0,0,0,0,0,0,0,0,0,0,0,0,0,4.0,5.0,,,,False,True,False,0.0,2832.71,2750.71,2754.71,2760.71,"5.0,4.0,2745.71",0,0.01,2024-10-29 02:33:00,2024-10-29 04:07:00,True,2024-10-29 15:47:00,,2024-10-29 04:51:52,2024-10-28 14:04:00,2732.71,2024-10-28 14:27:00,manual,2732.29,0.01,-7.61,fail,0 days 00:23:00,1060.7500000000002,False,0,6,44,10
2024-10-28 14:26:00,2733.39,2733.44,2732.27,2732.31,247,27,0,2726.4209102767945,2735.2527250000003,2744.084539723206,2732.7388457422735,-0.014537143805682717,2733.799405265112,2734.3527126436766,2733.4542691879883,2733.799405265112,2733.9209353602764,-0.04866023977274381,2733.734848484851,-0.11322843822836148,2733.8157264957263,-0.06153457653408623,2732.7947319347313,-0.17787878788340095,2732.908578088569,-0.031111111110931233,-0.1637834631064834,-0.1637834631064834,,,,,,7.913213584728029,7.913151319581264,"[2731.8111734486815, 2731.907226949629, 2731.7151233249624, 2732.9252971299443, 2732.930887363411, 2732.918701023215, 2732.948407855572, 2734.1047819608116, 2732.9123545075618, 2732.9580944989425, 2732.909785539427, 2732.9273206617913, 2732.9107814377658, 2732.9848387111897, 2732.9640383911014, 2738.9282624365596]",1.968125136491861e-05,1.7473450824042618e-05,2729.8320786131117,2732.607043109728,2733.3743289955137,2733.248718338306,0.09366260692604556,0.23726161754126301,0.5535018389176768,-0.1637834631064834,-0.037023359288014035,0.05482610307626601,2734.9064089429476,2732.6924015872764,35.814166546122046,49.55639133998832,0,0,0,0,0,0,0,0,0,-100,0,0,0,-100,0,-100,0,0,0,0,0,0,0,0,0,0,0,0,0,0,0,0,0,0,0,0,0,0,0,0,-100,0,0,0,0,0,0,0,0,0,0,0,0,0,0,0,0,0,0,0,0,0,4.0,5.0,,sell,,False,False,True,1.0,2632.31,2742.31,2722.31,2719.31,"5.0,4.0,2719.31",1,0.01,,,False,,,2024-10-28 15:37:33,2024-10-28 14:27:00,2732.31,2024-10-28 14:28:00,manual,2733.12,0.01,-14.68,fail,0 days 00:01:00,1046.0700000000002,False,0,7,44,10
2024-10-28 14:27:00,2732.29,2733.12,2732.25,2733.12,194,27,0,2726.4109077620237,2735.244550000001,2744.078192237978,2732.7513426031824,0.012496860908868257,2733.741183537265,2734.231775305896,2733.3412658509496,2733.741183537265,2733.8345925101953,-0.08634285008110965,2733.58438228438,-0.1504662004713282,2733.7224358974345,-0.09329059829178732,2732.679324009323,-0.11540792540836264,2732.8155555555472,-0.09302253302166719,-0.05822172784701252,-0.05822172784701252,,,,,,7.913198955491312,7.913153150254933,"[2731.8111734486815, 2731.907226949629, 2731.7151233249624, 2732.9252971299443, 2732.930887363411, 2732.918701023215, 2732.948407855572, 2734.1047819608116, 2732.9123545075618, 2732.9580944989425, 2732.909785539427, 2732.9273206617913, 2732.9107814377658, 2732.9848387111897, 2732.9640383911014, 2738.9282624365596]",1.968148433393483e-05,1.69563666373471e-05,2729.8842227490363,2732.6608164595423,2733.335201457742,2733.2391836465795,0.06738838024148208,0.20328697008130683,0.5545767369018191,-0.05822172784701252,-0.1637834631064834,-0.037023359288014035,2734.8503370110684,2732.6320300634616,25.291595544625725,38.85388880852515,0,0,0,0,0,0,0,0,0,0,0,0,0,100,0,100,0,0,0,0,0,0,0,0,0,0,0,0,0,0,0,0,0,0,0,0,0,0,0,0,100,0,0,0,0,0,0,0,0,0,0,0,0,0,0,0,0,0,0,0,0,0,4.0,5.0,,,buy,False,True,False,0.0,2833.12,2751.12,2755.12,2761.12,"5.0,4.0,2746.12",0,0.01,2024-10-29 02:36:00,2024-10-29 04:12:00,True,2024-10-29 15:47:00,,2024-10-29 04:51:40,2024-10-28 14:28:00,2733.12,2024-10-28 14:34:00,manual,2732.3,0.01,-14.86,fail,0 days 00:06:00,1031.2100000000003,False,0,8,44,10
2024-10-28 14:33:00,2733.07,2733.27,2732.32,2732.33,208,27,0,2726.345258410523,2735.184325000001,2744.023391589479,2732.7968906493693,-0.015826801673483715,2733.1748134964755,2733.741249536525,2732.800694104561,2733.1748134964755,2733.319761216164,-0.10176863181413864,2733.358543123543,-0.0961072261065965,2733.44793317793,-0.012999223000406346,2732.5293589743583,-0.1521328671315132,2732.6338927738816,-0.016142191141625517,-0.171242862442341,-0.171242862442341,,,,,,7.913224596466097,7.913231862882615,"[2731.8111734486815, 2731.907226949629, 2731.7151233249624, 2732.9252971299443, 2732.930887363411, 2732.918701023215, 2732.948407855572, 2734.1047819608116, 2732.9123545075618, 2732.9580944989425, 2732.909785539427, 2732.9273206617913, 2732.9107814377658, 2732.9848387111897, 2732.9640383911014, 2738.9282624365596]",2.0366087699687184e-05,1.5546236691273274e-05,2730.150820195765,2732.923482292516,2733.093444200854,2733.1461159920373,-0.06313010960229803,0.05119581327148144,0.3942963895562353,-0.171242862442341,-0.09235743418639686,-0.04170559881549707,2733.963406275588,2732.386220717363,31.490787269687107,41.520203169997814,0,0,0,0,0,0,0,0,0,0,0,0,0,0,0,-100,0,0,0,0,0,0,0,0,0,0,0,0,0,0,0,0,0,0,0,0,0,0,0,0,-100,0,0,0,0,0,0,0,0,0,0,0,0,0,0,0,0,0,0,0,0,0,4.0,5.0,,sell,,False,False,True,1.0,2632.33,2742.33,2722.33,2719.33,"5.0,4.0,2719.33",1,0.01,,,False,,,2024-10-28 15:37:33,2024-10-28 14:34:00,2732.33,2024-10-28 15:05:00,manual,2734.68,0.01,-42.59,fail,0 days 00:31:00,988.6200000000002,False,0,9,44,10
2024-10-28 15:04:00,2734.18,2735.67,2733.89,2734.74,347,27,0,2726.2720178409772,2734.6521750000043,2743.0323321590313,2733.0636532529034,0.05682531346110409,2733.577698183167,2734.117946607341,2732.97983463107,2733.577698183167,2733.416050673585,0.11198838215386786,2734.8967132867137,0.4563403263418877,2734.530885780885,0.26993395493400385,2733.4657925407937,0.2986363636373426,2733.255543900536,0.1654040404037005,0.18701371894758267,0.18701371894758267,,,,,,7.913326819452224,7.913326819452224,"[2731.8111734486815, 2731.907226949629, 2731.7151233249624, 2732.9252971299443, 2732.930887363411, 2732.918701023215, 2732.948407855572, 2734.1047819608116, 2732.9123545075618, 2732.9580944989425, 2732.909785539427, 2732.9273206617913, 2732.9107814377658, 2732.9848387111897, 2732.9640383911014, 2738.9282624365596]",7.067675078808396e-06,-2.393966305339925e-06,2731.5451974131897,2734.682435311736,2733.5802890505547,2733.317223920358,0.24206591207484962,0.08612580803872899,0.6717235294255459,0.18701371894758267,0.11091509084144491,0.038036336671666504,2734.9211452420177,2732.234251124316,74.83439041578517,66.80526192154157,0,0,0,0,0,0,0,0,0,100,0,0,0,0,0,0,0,0,0,0,0,0,0,0,0,0,0,0,0,0,0,0,0,0,0,0,0,0,0,0,0,0,0,0,0,0,0,0,0,0,0,0,0,0,0,0,0,0,0,0,0,0,4.0,5.0,,,,False,True,False,0.0,2834.74,2748.74,2752.74,2757.74,"5.0,4.0,2747.74",0,0.01,2024-10-29 03:06:00,2024-10-29 04:01:00,True,2024-10-29 15:44:00,,2024-10-29 05:30:13,2024-10-28 15:05:00,2734.74,2024-10-28 16:05:00,manual,2739.26,0.01,81.77,success,0 days 01:00:00,1070.3900000000003,True,1,0,44,10
2024-10-28 16:04:00,2739.14,2739.49,2738.83,2739.31,359,27,0,2726.922913755405,2734.2970000000037,2741.6710862446025,2739.3405262802708,-0.0010347891616220295,2740.5317856878014,2741.071996292177,2740.230788283281,2740.5317856878014,2740.8376225435627,-0.29714917809906183,2739.9434265734285,-0.34787878787528825,2740.2521134421127,-0.34691919191845955,2739.073892773891,-0.2529370629363257,2739.328376068365,-0.30271561771587585,-0.2769684834997861,-0.2769684834997861,,,,,,7.91585971265993,7.915820299770786,"[2731.8111734486815, 2731.907226949629, 2731.7151233249624, 2732.9252971299443, 2732.930887363411, 2732.918701023215, 2732.948407855572, 2734.1047819608116, 2732.9123545075618, 2732.9580944989425, 2732.909785539427, 2732.9273206617913, 2732.9107814377658, 2732.9848387111897, 2732.9640383911014, 2738.9282624365596]",4.4226317403720657e-05,2.8435398296118056e-05,2734.854438502878,2739.4105062718945,2740.3855342949937,2740.5970737693865,-0.23849377502574498,0.11432834072108679,0.7513178898380658,-0.2769684834997861,-0.36357360029887786,-0.2509054504980668,2742.0344214674774,2739.0291499081254,8.666424440608544,11.34173102536527,0,0,0,0,0,0,0,0,0,0,0,0,0,0,0,0,0,0,0,0,0,0,0,0,0,0,0,0,0,0,0,0,0,0,0,0,0,0,0,0,0,0,0,0,0,0,0,0,0,0,0,0,100,0,0,0,0,-100,0,0,0,0,4.0,5.0,,,,False,False,True,1.0,2639.31,2749.31,2729.31,2726.31,"5.0,4.0,2726.31",1,0.01,2024-11-05 04:45:00,2024-11-05 04:45:00,False,2024-11-05 04:45:00,,2024-10-29 03:06:26,2024-10-28 16:05:00,2739.31,2024-10-28 16:06:00,manual,2740.0,0.01,-12.51,fail,0 days 00:01:00,1057.8800000000003,False,0,1,44,10
2024-10-28 16:05:00,2739.26,2740.11,2739.18,2740.01,343,27,0,2726.9159661399285,2734.3012500000036,2741.6865338600787,2739.3624762382947,0.02194995802392441,2740.335096032629,2740.831369670002,2739.987363737485,2740.335096032629,2740.558545297239,-0.2790772463235953,2739.9032634032656,-0.04016317016294124,2740.0459984459994,-0.2061149961132287,2739.000675990675,-0.07321678321613945,2739.1337995337885,-0.1945765345762993,-0.19668965517257675,-0.19668965517257675,,,,,,7.915786767612564,7.915820299770786,"[2731.8111734486815, 2731.907226949629, 2731.7151233249624, 2732.9252971299443, 2732.930887363411, 2732.918701023215, 2732.948407855572, 2734.1047819608116, 2732.9123545075618, 2732.9580944989425, 2732.909785539427, 2732.9273206617913, 2732.9107814377658, 2732.9848387111897, 2732.9640383911014, 2738.9282624365596]",3.906672169169694e-05,2.8435130873287327e-05,2734.93226278503,2739.858006858463,2740.3277597880715,2740.553586823506,-0.24714603634629384,0.042033465307610665,0.6770735348448457,-0.19668965517257675,-0.2769684834997861,-0.36357360029887786,2741.6892431023184,2738.9809489629392,13.021164501773038,10.533651759671708,0,0,0,0,0,0,0,0,0,0,0,0,0,100,0,0,0,0,0,0,0,0,0,0,0,0,0,0,0,0,0,0,0,0,0,0,0,0,0,0,100,0,0,0,0,0,0,0,0,0,0,0,0,0,0,0,0,0,0,0,0,0,4.0,5.0,,,,False,True,False,0.0,2840.01,2750.01,2754.01,2758.01,"5.0,4.0,2753.01",0,0.01,2024-10-29 04:01:00,2024-10-29 04:01:00,True,2024-10-29 15:44:00,,2024-10-29 05:06:37,2024-10-28 16:06:00,2740.01,2024-10-28 16:07:00,manual,2739.7,0.01,-5.62,fail,0 days 00:01:00,1052.2600000000004,False,0,2,44,10
2024-10-28 16:06:00,2740.0,2740.22,2739.36,2739.72,330,27,0,2726.907758685652,2734.3082500000037,2741.7087413143554,2739.3741983288423,0.011722090547664266,2740.188430107531,2740.6728157211714,2739.812969966631,2740.188430107531,2740.3517706093157,-0.20677468792337095,2739.921561771562,0.0182983682966551,2739.9227505827525,-0.1232478632468883,2739.039999999999,0.03932400932399105,2739.0381895881787,-0.09560994560979452,-0.14666592509775,-0.14666592509775,,,,,,7.915817827719538,7.915898835284524,"[2731.8111734486815, 2731.907226949629, 2731.7151233249624, 2732.9252971299443, 2732.930887363411, 2732.918701023215, 2732.948407855572, 2734.1047819608116, 2732.9123545075618, 2732.9580944989425, 2732.909785539427, 2732.9273206617913, 2732.9107814377658, 2732.9848387111897, 2732.9640383911014, 2738.9282624365596]",3.4018603523512035e-05,2.2687155371988273e-05,2735.781777100546,2740.2705158381605,2740.2342582822143,2740.4918396513945,-0.27225507625007594,-0.020824243003926657,0.5933666056714948,-0.14666592509775,-0.19668965517257675,-0.2769684834997861,2741.375163318874,2739.001696896188,19.495412844037585,13.727667262139505,0,0,0,0,0,0,0,0,0,0,0,0,0,0,0,0,0,0,0,0,0,0,0,0,0,0,0,0,-100,0,0,0,0,0,0,0,0,0,0,0,0,0,0,0,0,0,0,0,0,0,0,0,0,0,0,0,0,0,0,0,0,0,4.0,5.0,,,,False,False,True,1.0,2639.72,2749.72,2729.72,2726.72,"5.0,4.0,2726.72",1,0.01,2024-11-05 04:44:00,2024-11-05 04:44:00,False,2024-11-05 04:44:00,,2024-10-29 03:09:00,2024-10-28 16:07:00,2739.72,2024-10-28 16:10:00,manual,2742.96,0.01,-58.73,fail,0 days 00:03:00,993.5300000000004,False,0,3,44,10
2024-10-28 16:09:00,2740.25,2743.01,2740.2,2743.0,353,27,0,2726.860281119972,2734.3370750000036,2741.813868880035,2739.5189021044903,0.11800331849190115,2740.2763366703757,2740.704107526881,2739.6063663329614,2740.2763366703757,2740.076900259542,0.02930218761503056,2740.7824825174816,0.6929137529127729,2740.291515151515,0.28697358197314315,2739.193205128204,0.25059440559107315,2739.0531196581105,0.05106837606808767,0.31422766036712346,0.31422766036712346,,,,,,7.916012988598193,7.915977358464545,"[2731.8111734486815, 2731.907226949629, 2731.7151233249624, 2732.9252971299443, 2732.930887363411, 2732.918701023215, 2732.948407855572, 2734.1047819608116, 2732.9123545075618, 2732.9580944989425, 2732.909785539427, 2732.9273206617913, 2732.9107814377658, 2732.9848387111897, 2732.9640383911014, 2738.9282624365596]",2.9713393481924742e-05,2.244134482680608e-05,2735.963228655816,2740.771007483704,2740.56039953283,2740.58608924214,-0.04581282124581776,-0.10580612948334474,1.2429084554908916,0.31422766036712346,-0.030146088245601277,-0.19617500927688525,2742.7621535813573,2737.790519759394,51.563799740342176,32.176159106927365,0,0,0,0,0,0,0,0,0,0,0,0,0,100,0,100,0,0,0,0,0,0,0,0,0,0,0,0,0,0,0,0,0,0,0,0,0,0,0,0,100,0,0,0,0,0,0,0,0,0,0,0,0,0,0,0,0,0,0,0,0,0,4.0,5.0,,,,False,True,False,0.0,2843.0,2733.0,2753.0,2756.0,"5.0,4.0,2756.0",0,0.01,2024-10-29 04:12:00,2024-10-29 04:12:00,False,2024-10-29 04:12:00,,2024-10-28 14:10:40,2024-10-28 16:10:00,2743.0,2024-10-28 14:10:40,auto,2733.08,0.01,-179.8,fail,-1 days +22:00:40,813.7300000000005,False,0,4,44,10
2024-10-28 16:28:00,2742.49,2742.59,2741.96,2741.97,300,27,0,2726.4426800289634,2734.530875000003,2742.619069971043,2741.0330766301336,0.03176011423283853,2743.46532295143,2743.9866807563994,2743.158242491659,2743.46532295143,2743.466279569889,0.06569546409764371,2743.3143939393944,-0.1563053613053853,2743.3492501942515,0.07147630147710515,2742.5212587412584,-0.24162004662139225,2742.6575291375193,0.02134032634057803,-0.028091212457184156,-0.028091212457184156,,,,,,7.916500009553372,7.916239977692601,"[2731.8111734486815, 2731.907226949629, 2731.7151233249624, 2732.9252971299443, 2732.930887363411, 2732.918701023215, 2732.948407855572, 2734.1047819608116, 2732.9123545075618, 2732.9580944989425, 2732.909785539427, 2732.9273206617913, 2732.9107814377658, 2732.9848387111897, 2732.9640383911014, 2738.9282624365596]",1.77880839380928e-05,1.0149415445702598e-05,2738.0772473436296,2742.415631837439,2742.6188372664556,2742.2392084594703,0.3194728110647702,0.4160041119531184,0.4765632174611244,-0.028091212457184156,0.05331256952513286,0.17186503522543717,2744.418449386352,2742.512196516508,48.28431372548334,58.946078431368655,0,0,0,0,0,0,0,0,0,0,0,0,0,0,0,-100,0,0,0,0,0,0,0,0,0,0,0,0,0,0,0,0,0,0,0,0,0,0,0,0,-100,0,0,0,0,0,0,0,0,0,0,0,0,0,0,0,0,0,0,0,0,0,4.0,5.0,,,,False,False,True,1.0,2641.97,2751.97,2731.97,2728.97,"5.0,4.0,2728.97",1,0.01,2024-11-05 04:36:00,2024-11-05 04:36:00,False,2024-11-05 04:36:00,,2024-10-29 03:57:07,2024-10-28 16:29:00,2741.97,2024-10-28 16:38:00,manual,2743.18,0.01,-21.93,fail,0 days 00:09:00,791.8000000000005,False,0,5,44,10
2024-10-28 16:38:00,2743.18,2743.7,2743.05,2743.09,231,27,0,2726.3305765751857,2734.5806000000034,2742.830623424821,2741.3783693166115,0.058021379098136094,2742.3024560622885,2742.7190307749343,2742.050164627364,2742.3024560622885,2742.37041230997,-0.09054826350302392,2742.968403263404,0.3722144522162125,2742.659005439006,0.21278554778564285,2742.0423543123557,0.4610023310028737,2741.706612276604,0.20912587412658468,-0.0589899888805121,-0.0589899888805121,,,,,,7.916402440035071,7.916239977692601,"[2731.8111734486815, 2731.907226949629, 2731.7151233249624, 2732.9252971299443, 2732.930887363411, 2732.918701023215, 2732.948407855572, 2734.1047819608116, 2732.9123545075618, 2732.9580944989425, 2732.909785539427, 2732.9273206617913, 2732.9107814377658, 2732.9848387111897, 2732.9640383911014, 2738.9282624365596]",1.2108364950602719e-05,2.1665986517872004e-05,2737.8164822083086,2743.2631526475257,2742.47406142017,2742.2790875860424,0.1615000704509839,0.12846392480359572,0.6298299091912779,-0.0589899888805121,-0.08588876529393019,-0.12676603633553896,2743.562115880671,2741.0427962439057,68.92052194542796,57.76986951363929,0,0,0,0,0,0,0,0,0,0,0,0,0,0,0,0,0,0,0,0,0,0,0,0,0,0,0,0,0,0,0,0,0,0,0,0,0,0,0,0,0,0,0,0,0,0,0,0,0,0,0,0,0,0,0,0,0,0,0,0,0,0,4.0,5.0,,,,False,False,True,1.0,2643.09,2753.09,2733.09,2730.09,"5.0,4.0,2730.09",1,0.01,2024-11-05 04:36:00,2024-11-05 04:36:00,False,2024-11-05 04:36:00,,2024-10-29 04:00:09,2024-10-28 16:39:00,2743.09,2024-10-28 16:46:00,manual,2744.19,0.01,-19.94,fail,0 days 00:07:00,771.8600000000005,False,0,6,44,10
2024-10-28 16:46:00,2744.19,2744.19,2742.82,2743.06,301,27,0,2726.1561962265446,2734.666025000003,2743.1758537734618,2741.7990580257147,0.04274379573871556,2742.9196121616637,2743.4939065628487,2742.483221357064,2742.9196121616637,2742.8382956371247,0.12586676554246878,2744.0926573426577,0.17199300699621745,2743.878947163948,0.1902020202010135,2743.0306643356616,0.023414918409798702,2742.9598212898113,0.11592851592740772,0.01889358546850417,0.01889358546850417,,,,,,7.916653074870243,7.916404024070655,"[2731.8111734486815, 2731.907226949629, 2731.7151233249624, 2732.9252971299443, 2732.930887363411, 2732.918701023215, 2732.948407855572, 2734.1047819608116, 2732.9123545075618, 2732.9580944989425, 2732.909785539427, 2732.9273206617913, 2732.9107814377658, 2732.9848387111897, 2732.9640383911014, 2738.9282624365596]",7.210198878015152e-06,2.1665383799483883e-05,2738.291077638313,2743.731595664827,2743.0579399238945,2742.7054680275587,0.3080260605552212,0.23411530231302696,0.5296747656746039,0.01889358546850417,0.20616240266826935,0.15254430849017808,2743.978961693013,2741.8602626303145,75.79098907609118,81.6553454455014,0,0,0,0,-100,0,0,0,0,0,0,0,0,-100,0,0,0,0,0,0,0,0,0,0,0,0,0,0,0,0,0,0,0,0,0,0,0,0,0,0,-100,0,0,0,0,0,0,0,0,0,0,0,0,0,0,0,0,0,0,0,0,0,4.0,5.0,,,,False,False,True,1.0,2643.06,2753.06,2733.06,2730.06,"5.0,4.0,2730.06",1,0.01,2024-11-05 04:36:00,2024-11-05 04:36:00,False,2024-11-05 04:36:00,,2024-10-29 04:00:09,2024-10-28 16:47:00,2743.06,2024-10-28 16:49:00,manual,2743.93,0.01,-15.77,fail,0 days 00:02:00,756.0900000000005,False,0,7,44,10
2024-10-28 16:49:00,2743.93,2743.93,2743.33,2743.78,281,27,0,2726.0812779079283,2734.700850000004,2743.3204220920793,2741.986525648681,0.06079574072282412,2743.3291790878766,2743.7473407489797,2742.81545420838,2743.3291790878766,2743.1927123964865,0.13652230873731241,2744.0579370629375,0.004300699300983979,2744.041076146077,-0.01157342657324989,2743.18870629371,0.04428904429050817,2743.1073620823536,0.05268065268273858,0.11766332962406523,0.11766332962406523,,,,,,7.916829169446694,7.916756213223557,"[2731.8111734486815, 2731.907226949629, 2731.7151233249624, 2732.9252971299443, 2732.930887363411, 2732.918701023215, 2732.948407855572, 2734.1047819608116, 2732.9123545075618, 2732.9580944989425, 2732.909785539427, 2732.9273206617913, 2732.9107814377658, 2732.9848387111897, 2732.9640383911014, 2738.9282624365596]",7.210954468848332e-06,2.1667461648074177e-05,2738.469042762272,2743.790925000087,2743.3413555023685,2742.925274497313,0.36523761595253745,0.2909842774853086,0.42341300368463247,0.11766332962406523,0.17407341490979888,0.11783018167898263,2744.1760050952457,2742.4823530805074,67.00223713646761,65.20501671338964,0,0,0,0,0,0,0,0,0,0,0,0,0,0,0,0,0,0,0,0,0,0,0,0,0,0,0,0,0,0,0,0,0,0,0,0,0,0,0,0,0,0,0,0,0,0,0,0,0,0,0,0,0,0,0,0,0,0,0,0,0,0,4.0,5.0,,,,False,False,True,1.0,2643.78,2753.78,2733.78,2730.78,"5.0,4.0,2730.78",1,0.01,2024-11-05 04:35:00,2024-11-05 04:35:00,False,2024-11-05 04:35:00,,2024-10-29 04:00:10,2024-10-28 16:50:00,2743.78,2024-10-28 16:51:00,manual,2744.35,0.01,-10.33,fail,0 days 00:01:00,745.7600000000004,False,0,8,44,10
2024-10-28 17:00:00,2744.23,2744.61,2742.8,2743.28,369,27,0,2725.7491307880846,2734.842675000003,2743.9362192119215,2742.818228718869,0.01565326376703524,2745.038453837598,2745.5064382647406,2744.538021505374,2745.038453837598,2745.1314890619174,-0.027265603756404744,2745.0848368298343,-0.2273892773901025,2745.309825174824,-0.1703069153081742,2744.000081585081,-0.43434731934803494,2744.3548329448226,-0.22899378399415582,-0.13093882091288833,-0.13093882091288833,,,,,,7.917132516215042,7.916965660195558,"[2731.8111734486815, 2731.907226949629, 2731.7151233249624, 2732.9252971299443, 2732.930887363411, 2732.918701023215, 2732.948407855572, 2734.1047819608116, 2732.9123545075618, 2732.9580944989425, 2732.909785539427, 2732.9273206617913, 2732.9107814377658, 2732.9848387111897, 2732.9640383911014, 2738.9282624365596, 2733.0301646696325, 2733.0201634971127, 2733.0310793132808]",1.5986484766381722e-05,2.657093743352775e-05,2739.106732446105,2743.9824880566503,2744.3079703736926,2743.8997217891665,0.34389392846424016,0.49509028833003316,0.6381390356835129,-0.13093882091288833,-0.017228031144895795,0.0663700407876604,2746.314731908965,2743.762175766231,42.20846233230264,53.422772617819284,0,0,0,0,0,0,0,0,0,0,0,0,0,0,0,0,0,0,0,0,0,0,0,0,0,0,0,0,0,0,0,0,0,0,0,0,0,0,0,0,0,0,0,0,0,0,0,0,0,0,0,0,0,0,0,0,0,0,0,0,0,0,4.0,5.0,,,,False,False,True,1.0,2643.28,2753.28,2733.28,2730.28,"5.0,4.0,2730.28",1,0.01,2024-11-05 04:36:00,2024-11-05 04:36:00,False,2024-11-05 04:36:00,,2024-10-29 04:00:09,2024-10-28 17:01:00,2743.28,2024-10-28 18:19:00,manual,2743.43,0.01,-2.7199999999999998,fail,0 days 01:18:00,743.0400000000004,False,0,9,44,10
2024-10-28 18:18:00,2742.92,2743.64,2742.91,2743.44,268,27,0,2726.361485622836,2736.50315,2746.644814377164,2742.048850219557,0.04715761967599974,2742.792527252502,2742.978511679644,2742.412177975531,2742.792527252502,2742.626015325666,0.1461777283398078,2743.5280652680667,0.16356643356903078,2743.369121989121,0.14783993784021732,2742.936923076921,0.07341491841043535,2742.8525524475426,0.10486402486230872,0.20301594364309494,0.20301594364309494,,,,,,7.916524736505614,7.916314944497506,"[2731.8111734486815, 2731.907226949629, 2731.7151233249624, 2732.9252971299443, 2732.930887363411, 2732.918701023215, 2732.948407855572, 2734.1047819608116, 2732.9123545075618, 2732.9580944989425, 2732.909785539427, 2732.9273206617913, 2732.9107814377658, 2732.9848387111897, 2732.9640383911014, 2738.9282624365596, 2733.0301646696325, 2733.0201634971127, 2733.0310793132808, 2742.327125011691, 2742.223662103001, 2741.4995310309023, 2731.8970592041096]",2.163631382041093e-06,7.633120645255994e-06,2739.344599446416,2743.3095071619696,2742.7405020376937,2742.306407939918,0.39294859329993415,0.2953023061426667,0.21944328967836843,0.20301594364309494,0.09350389321025432,0.1420133481656194,2743.231413831859,2742.3536406731455,84.81136507683863,87.4682955081173,0,0,0,0,0,0,0,0,0,0,0,0,0,100,0,0,0,0,0,0,0,0,0,0,0,0,0,0,0,0,0,0,0,0,0,0,0,0,0,0,0,0,0,0,0,0,0,0,0,0,0,0,0,0,0,0,0,0,0,0,0,0,4.0,5.0,,,,False,True,False,0.0,2843.44,2753.44,2757.44,2761.44,"5.0,4.0,2756.44",0,0.01,2024-10-29 04:13:00,2024-10-29 04:13:00,True,2024-10-29 15:47:00,,2024-10-29 04:37:00,2024-10-28 18:19:00,2743.44,2024-10-28 18:21:00,manual,2743.29,0.01,-2.7199999999999998,fail,0 days 00:02:00,740.3200000000004,False,0,10,44,10
2024-10-28 18:20:00,2743.51,2743.75,2743.28,2743.31,249,27,0,2726.394735764299,2736.5610250000004,2746.7273142357017,2742.1359009981934,0.03979996616271819,2743.13401557286,2743.3273741193957,2742.79432999629,2743.13401557286,2742.9665027808624,0.1815014213334507,2743.6635664335663,0.07137529137435195,2743.594607614608,0.09968919969014678,2743.1092424242443,0.07940559440839934,2743.0253341103235,0.08191142191162726,0.16105005562121733,0.16105005562121733,,,,,,7.916586719749338,7.916334990457427,"[2731.8111734486815, 2731.907226949629, 2731.7151233249624, 2732.9252971299443, 2732.930887363411, 2732.918701023215, 2732.948407855572, 2734.1047819608116, 2732.9123545075618, 2732.9580944989425, 2732.909785539427, 2732.9273206617913, 2732.9107814377658, 2732.9848387111897, 2732.9640383911014, 2738.9282624365596, 2733.0301646696325, 2733.0201634971127, 2733.0310793132808, 2742.327125011691, 2742.223662103001, 2741.4995310309023, 2731.8970592041096]",2.8385635627445004e-06,7.633643431039522e-06,2739.3863995339625,2743.3249272151884,2742.925684890893,2742.4619272461573,0.4170516555582253,0.3391014466698246,0.26752837011623515,0.16105005562121733,0.1804382647364946,0.20301594364309494,2743.6690723130923,2742.5989588326274,87.64374993047925,86.0072207458116,0,0,0,0,-100,0,0,0,0,0,0,0,0,0,0,-100,0,0,0,0,0,0,0,0,0,0,0,0,0,0,0,0,0,0,0,0,0,0,0,0,0,0,0,0,0,0,0,0,0,0,0,0,0,0,0,0,0,0,0,0,0,0,4.0,5.0,,,,False,False,True,1.0,2643.31,2753.31,2733.31,2730.31,"5.0,4.0,2730.31",1,0.01,2024-11-05 04:36:00,2024-11-05 04:36:00,False,2024-11-05 04:36:00,,2024-10-29 04:00:09,2024-10-28 18:21:00,2743.31,2024-10-28 18:24:00,manual,2743.42,0.01,-1.99,fail,0 days 00:03:00,738.3300000000004,False,0,11,44,10
2024-10-28 18:23:00,2743.28,2743.49,2743.06,2743.43,224,27,0,2726.4441423841495,2736.6449500000003,2746.845757615851,2742.2420255929264,0.04027031888381316,2743.5019340007416,2743.633639599556,2743.228415276234,2743.5019340007416,2743.3763912989693,0.12263947596056823,2743.5692540792566,-0.0007575757567792607,2743.587183372185,-0.03143745143643173,2743.118228438229,0.02041958042082115,2743.1079292929194,0.002995337994889269,0.1249595847261844,0.1249595847261844,,,,,,7.916620480783316,7.916402512525384,"[2731.8111734486815, 2731.907226949629, 2731.7151233249624, 2732.9252971299443, 2732.930887363411, 2732.918701023215, 2732.948407855572, 2734.1047819608116, 2732.9123545075618, 2732.9580944989425, 2732.909785539427, 2732.9273206617913, 2732.9107814377658, 2732.9848387111897, 2732.9640383911014, 2738.9282624365596, 2733.0301646696325, 2733.0201634971127, 2733.0310793132808, 2742.327125011691, 2742.223662103001, 2741.4995310309023, 2731.8970592041096]",2.8378491452967983e-06,6.5815747744231726e-06,2739.5055750917254,2743.3482793250796,2743.0606857486478,2742.625771133527,0.386326671891311,0.3626596648265052,0.2055480485181061,0.1249595847261844,0.12670893585072918,0.11624990730479112,2743.9130300977777,2743.0908379037055,73.32346297070457,75.56302454548786,0,0,0,0,0,0,0,0,0,0,0,0,0,0,0,0,0,0,0,0,0,0,0,0,0,0,0,0,0,0,0,0,0,0,0,0,0,0,0,0,0,0,0,0,0,0,0,0,0,0,0,0,0,0,0,0,0,0,0,0,0,0,4.0,5.0,,,,False,True,False,0.0,2843.43,2753.43,2757.43,2761.43,"5.0,4.0,2756.43",0,0.01,2024-10-29 04:13:00,2024-10-29 04:13:00,True,2024-10-29 15:47:00,,2024-10-29 04:37:00,2024-10-28 18:24:00,2743.43,2024-10-28 18:25:00,manual,2743.22,0.01,-3.81,fail,0 days 00:01:00,734.5200000000004,False,0,12,44,10
2024-10-28 18:24:00,2743.42,2743.53,2743.21,2743.24,189,27,0,2726.4633124455963,2736.6736250000004,2746.8839375544044,2742.2747460652895,0.03272047236305298,2743.5454467927316,2743.7163574341866,2743.329901371895,2743.5454467927316,2743.4747850698254,0.09839377085609158,2743.5726223776214,0.0033682983648759546,2743.5706293706303,-0.016554001554595743,2743.171561771561,0.053333333331920585,2743.12919968919,0.021270396270665515,0.04351279198999691,0.04351279198999691,,,,,,7.916620480783316,7.916402512525384,"[2731.8111734486815, 2731.907226949629, 2731.7151233249624, 2732.9252971299443, 2732.930887363411, 2732.918701023215, 2732.948407855572, 2734.1047819608116, 2732.9123545075618, 2732.9580944989425, 2732.909785539427, 2732.9273206617913, 2732.9107814377658, 2732.9848387111897, 2732.9640383911014, 2738.9282624365596, 2733.0301646696325, 2733.0201634971127, 2733.0310793132808, 2742.327125011691, 2742.223662103001, 2741.4995310309023, 2731.8970592041096]",2.8396669346834343e-06,6.583813450559417e-06,2739.5234319320434,2743.3560935121327,2743.088272556548,2742.6712695680803,0.36866220593219623,0.3638601730476434,0.20276217657607387,0.04351279198999691,0.1249595847261844,0.12670893585072918,2743.9509711458836,2743.1399224395795,71.39777719663157,72.73286494065722,0,0,0,0,0,0,0,0,0,0,0,0,0,0,0,0,0,0,0,0,0,0,0,0,0,0,0,0,0,0,0,0,0,0,0,0,0,0,0,0,0,0,0,0,0,0,0,0,0,0,0,-100,0,0,0,0,0,0,0,0,0,100,4.0,5.0,,,,False,False,True,1.0,2643.24,2753.24,2733.24,2730.24,"5.0,4.0,2730.24",1,0.01,2024-11-05 04:36:00,2024-11-05 04:36:00,False,2024-11-05 04:36:00,,2024-10-29 04:00:09,2024-10-28 18:25:00,2743.24,2024-10-28 18:26:00,manual,2743.39,0.01,-2.7199999999999998,fail,0 days 00:01:00,731.8000000000004,False,0,13,44,10
2024-10-28 18:25:00,2743.22,2743.61,2743.15,2743.39,189,27,0,2726.4838532276367,2736.703225,2746.9225967723637,2742.311311768067,0.03656570277735227,2743.6517233963677,2743.8108127549162,2743.4035313311065,2743.6517233963677,2743.5663680632765,0.0915829934510839,2743.5837762237757,0.01115384615422954,2743.575217560218,0.004588189587593661,2743.193006993007,0.0214452214463563,2743.160932400923,0.03173271173272951,0.10627660363616087,0.10627660363616087,,,,,,7.916662411033355,7.916402512525384,"[2731.8111734486815, 2731.907226949629, 2731.7151233249624, 2732.9252971299443, 2732.930887363411, 2732.918701023215, 2732.948407855572, 2734.1047819608116, 2732.9123545075618, 2732.9580944989425, 2732.909785539427, 2732.9273206617913, 2732.9107814377658, 2732.9848387111897, 2732.9640383911014, 2738.9282624365596, 2733.0301646696325, 2733.0201634971127, 2733.0310793132808, 2742.327125011691, 2742.223662103001, 2741.4995310309023, 2731.8970592041096]",2.8391684132335727e-06,6.582914866496416e-06,2739.5415361594232,2743.3638747069394,2743.134692163233,2742.7245088593336,0.3614506406665896,0.36337826657143263,0.14510464291152014,0.10627660363616087,0.04351279198999691,0.1249595847261844,2743.941932682191,2743.3615141105447,71.31376829168448,72.01166948634001,0,0,0,0,0,0,0,0,0,0,0,0,0,0,0,0,0,0,0,0,0,0,0,0,0,0,0,0,0,0,0,0,0,0,0,0,0,0,0,0,0,0,0,0,0,0,0,0,0,0,0,0,0,0,0,0,0,0,0,0,0,0,4.0,5.0,,,,False,True,False,0.0,2843.39,2753.39,2757.39,2761.39,"5.0,4.0,2756.39",0,0.01,2024-10-29 04:13:00,2024-10-29 04:13:00,True,2024-10-29 15:47:00,,2024-10-29 04:37:00,2024-10-28 18:26:00,2743.39,2024-10-28 18:28:00,manual,2743.09,0.01,-5.44,fail,0 days 00:02:00,726.3600000000004,False,0,14,44,10
2024-10-28 18:27:00,2743.62,2743.75,2743.07,2743.08,218,27,0,2726.5216178487417,2736.760625000001,2746.99963215126,2742.377698539274,0.023806829176919564,2743.7669773822736,2743.9809595847273,2743.576450129776,2743.7669773822736,2743.7218719564917,0.07384352984763609,2743.616946386945,0.012027972023588518,2743.6018803418806,0.014774669774396898,2743.160524475526,-0.05550116550102757,2743.189852369844,-0.003679098678730952,0.02006229142762095,0.02006229142762095,,,,,,7.916665145370615,7.916402512525384,"[2731.8111734486815, 2731.907226949629, 2731.7151233249624, 2732.9252971299443, 2732.930887363411, 2732.918701023215, 2732.948407855572, 2734.1047819608116, 2732.9123545075618, 2732.9580944989425, 2732.909785539427, 2732.9273206617913, 2732.9107814377658, 2732.9848387111897, 2732.9640383911014, 2738.9282624365596, 2733.0301646696325, 2733.0201634971127, 2733.0310793132808, 2742.327125011691, 2742.223662103001, 2741.4995310309023, 2731.8970592041096]",4.224246507930871e-06,6.800582084448692e-06,2739.5740093613463,2743.2117387898084,2743.188152377226,2742.8115748108144,0.32878475252528006,0.35714052031897275,0.18577540270653733,0.02006229142762095,0.09519169447821696,0.10627660363616087,2744.1385281876865,2743.3954265768607,70.67669172931994,72.22572560432566,0,0,0,0,-100,0,0,0,0,0,0,0,0,0,0,-100,0,0,0,0,0,0,0,0,0,0,0,0,0,0,0,0,0,0,0,0,0,0,0,0,0,0,0,0,0,0,0,0,0,0,0,0,0,0,0,0,0,0,0,0,0,0,4.0,5.0,,,,False,False,True,1.0,2643.08,2753.08,2733.08,2730.08,"5.0,4.0,2730.08",1,0.01,2024-11-05 04:36:00,2024-11-05 04:36:00,False,2024-11-05 04:36:00,,2024-10-29 04:00:09,2024-10-28 18:28:00,2743.08,2024-10-28 18:29:00,manual,2743.28,0.01,-3.63,fail,0 days 00:01:00,722.7300000000004,False,0,15,44,10
2024-10-28 18:28:00,2743.09,2743.3,2742.57,2743.27,252,27,0,2726.544963647529,2736.790350000001,2747.035736352473,2742.4069543248715,0.029255785597342765,2743.782857248798,2743.978817945867,2743.559193177605,2743.782857248798,2743.765583240635,0.04371128414322811,2743.536724941723,-0.0802214452219232,2743.5861965811964,-0.0156837606841691,2743.01212121212,-0.14840326340618049,2743.1295571095484,-0.060295260295788466,0.01587986652430118,0.01587986652430118,,,,,,7.916634154463672,7.916402512525384,"[2731.8111734486815, 2731.907226949629, 2731.7151233249624, 2732.9252971299443, 2732.930887363411, 2732.918701023215, 2732.948407855572, 2734.1047819608116, 2732.9123545075618, 2732.9580944989425, 2732.909785539427, 2732.9273206617913, 2732.9107814377658, 2732.9848387111897, 2732.9640383911014, 2738.9282624365596, 2733.0301646696325, 2733.0201634971127, 2733.0310793132808, 2742.327125011691, 2742.223662103001, 2741.4995310309023, 2731.8970592041096]",4.879284295041283e-06,8.434528843297947e-06,2739.480363042899,2743.145962485363,2743.200744319191,2742.8455322322357,0.30852610446663675,0.34741763714850554,0.18589071357517706,0.01587986652430118,0.02006229142762095,0.09519169447821696,2744.1546386759483,2743.4110758216475,67.66917293233003,71.01086048454084,0,0,0,0,0,0,0,0,0,0,0,0,0,0,0,0,0,0,0,0,0,0,0,0,0,0,100,0,100,0,0,0,0,0,0,0,0,0,0,0,0,0,0,0,0,0,0,0,0,0,0,0,0,0,0,0,0,0,0,0,0,0,4.0,5.0,,,,False,True,False,0.0,2843.27,2753.27,2757.27,2761.27,"5.0,4.0,2756.27",0,0.01,2024-10-29 04:12:00,2024-10-29 04:12:00,True,2024-10-29 15:47:00,,2024-10-29 04:37:04,2024-10-28 18:29:00,2743.27,2024-10-28 18:49:00,manual,2742.79,0.01,-8.7,fail,0 days 00:20:00,714.0300000000003,False,0,16,44,10
2024-10-28 18:48:00,2743.28,2743.28,2742.7,2742.8,240,27,0,2727.286092633224,2737.4784250000016,2747.670757366779,2743.0764718239698,-0.009371926236326544,2743.82768928439,2744.165871709308,2743.571118279568,2743.82768928439,2743.9363979730533,-0.0828602150536426,2743.8737296037266,-0.15775058275221454,2744.001379176378,-0.09252913753061875,2743.3184615384607,-0.1392657342671555,2743.427020202011,-0.07088189588239402,-0.11900185391232299,-0.11900185391232299,,,,,,7.917018806915039,7.9169768485229834,"[2731.8111734486815, 2731.907226949629, 2731.7151233249624, 2732.9252971299443, 2732.930887363411, 2732.918701023215, 2732.948407855572, 2734.1047819608116, 2732.9123545075618, 2732.9580944989425, 2732.909785539427, 2732.9273206617913, 2732.9107814377658, 2732.9848387111897, 2732.9640383911014, 2738.9282624365596, 2733.0301646696325, 2733.0201634971127, 2733.0310793132808, 2742.327125011691, 2742.223662103001, 2741.4995310309023, 2731.8970592041096]",1.900949755399162e-05,2.1149694542125175e-05,2739.7654333239157,2742.9835152877868,2743.594596312486,2743.538613560243,0.031177800277873757,0.17355150015508863,0.5003124026688609,-0.11900185391232299,-0.08812235817640612,-0.041456433072198706,2744.828314089728,2742.8270644790523,11.690996068994835,22.261786076192795,0,0,0,0,0,0,0,0,0,0,0,0,0,-100,0,0,0,0,0,0,0,0,0,0,0,0,0,0,0,0,0,0,0,0,0,0,0,0,0,0,-100,0,0,0,0,0,0,0,0,0,0,0,0,0,0,0,0,0,0,0,0,0,4.0,5.0,,,,False,False,True,1.0,2642.8,2752.8,2732.8,2729.8,"5.0,4.0,2729.8",1,0.01,2024-11-05 04:36:00,2024-11-05 04:36:00,False,2024-11-05 04:36:00,,2024-10-29 04:00:08,2024-10-28 18:49:00,2742.8,2024-10-28 18:50:00,manual,2743.05,0.01,-4.53,fail,0 days 00:01:00,709.5000000000003,False,0,17,44,10
2024-10-28 18:49:00,2742.79,2743.28,2742.78,2743.04,118,27,0,2727.328443711281,2737.5103250000016,2747.692206288722,2743.0752760264627,-0.0011957975070799876,2743.7444234334425,2744.073499443825,2743.481151649979,2743.7444234334425,2743.839601285375,-0.09679668767830663,2743.7166550116544,-0.15707459207214924,2743.873954933953,-0.12742424242514971,2743.1527622377594,-0.16569930070136252,2743.30965034964,-0.11736985237121189,-0.08326585094755501,-0.08326585094755501,,,,,,7.917040688114726,7.917020610922357,"[2731.8111734486815, 2731.907226949629, 2731.7151233249624, 2732.9252971299443, 2732.930887363411, 2732.918701023215, 2732.948407855572, 2734.1047819608116, 2732.9123545075618, 2732.9580944989425, 2732.909785539427, 2732.9273206617913, 2732.9107814377658, 2732.9848387111897, 2732.9640383911014, 2738.9282624365596, 2733.0301646696325, 2733.0201634971127, 2733.0310793132808, 2742.327125011691, 2742.223662103001, 2741.4995310309023, 2731.8970592041096]",1.9011536906850432e-05,2.1149842900876562e-05,2739.8233825491925,2743.035455640347,2743.5092738028725,2743.5016792224474,-0.012271228358713415,0.13638695445232824,0.5111454226708613,-0.08326585094755501,-0.11900185391232299,-0.08812235817640612,2744.766714278784,2742.722132588101,10.243281304700107,14.137751639296878,0,0,0,0,0,0,0,0,0,0,0,0,0,0,0,0,0,0,0,0,0,0,0,0,0,0,0,0,0,0,0,0,0,0,0,0,0,0,0,0,0,0,0,0,0,0,0,0,0,0,0,0,0,0,0,0,0,0,0,0,0,0,4.0,5.0,,,,False,True,False,0.0,2843.04,2753.04,2757.04,2761.04,"5.0,4.0,2756.04",0,0.01,2024-10-29 04:12:00,2024-10-29 04:12:00,True,2024-10-29 15:47:00,,2024-10-29 04:45:45,2024-10-28 18:50:00,2743.04,2024-10-28 18:53:00,manual,2742.51,0.01,-9.61,fail,0 days 00:03:00,699.8900000000003,False,0,18,44,10
2024-10-28 18:52:00,2742.93,2743.06,2742.26,2742.5,203,27,0,2727.4621753963643,2737.605750000002,2747.7493246036397,2743.058107661165,-0.01891890376828087,2743.4036952169095,2743.7615031516516,2743.1742721542464,2743.4036952169095,2743.5482968730666,-0.11357607217769328,2743.1508041958045,-0.23367132866997053,2743.3703846153835,-0.18861693861663298,2742.6380186480155,-0.27181818182179995,2742.8728088577977,-0.17158119658188298,-0.1579035965910407,-0.1579035965910407,,,,,,7.91697325569458,7.917031550923744,"[2731.8111734486815, 2731.907226949629, 2731.7151233249624, 2732.9252971299443, 2732.930887363411, 2732.918701023215, 2732.948407855572, 2734.1047819608116, 2732.9123545075618, 2732.9580944989425, 2732.909785539427, 2732.9273206617913, 2732.9107814377658, 2732.9848387111897, 2732.9640383911014, 2738.9282624365596, 2733.0301646696325, 2733.0201634971127, 2733.0310793132808, 2742.327125011691, 2742.223662103001, 2741.4995310309023, 2731.8970592041096, 2742.9479844448065]",2.3755903280785776e-05,1.5854455536949424e-05,2740.039945240452,2742.7483485060866,2743.253738475932,2743.3742944597234,-0.12630750134712798,0.03024096719559817,0.3957181539817222,-0.1579035965910407,-0.1179977753017738,-0.06482684464026534,2744.195131524873,2742.612258908946,16.86002026594111,17.555602502041925,0,0,0,0,0,0,0,0,0,0,0,0,0,0,0,0,0,0,0,0,0,0,0,0,0,0,0,0,0,0,0,0,0,0,0,0,0,0,0,0,0,0,0,0,0,0,0,0,0,0,0,0,0,0,0,0,0,0,0,0,0,0,4.0,5.0,,sell,,False,False,True,1.0,2642.5,2752.5,2732.5,2729.5,"5.0,4.0,2729.5",1,0.01,2024-11-05 04:36:00,2024-11-05 04:36:00,False,2024-11-05 04:36:00,,2024-10-29 04:00:07,2024-10-28 18:53:00,2742.5,2024-10-28 18:54:00,manual,2742.88,0.01,-6.89,fail,0 days 00:01:00,693.0000000000003,False,0,19,44,10
2024-10-28 18:53:00,2742.51,2743.02,2742.49,2742.89,177,27,0,2727.50286231923,2737.636300000002,2747.7697376807737,2743.0525959345696,-0.005511726595614164,2743.30694771969,2743.634322580645,2743.0540296625873,2743.30694771969,2743.424080583363,-0.12421628970378151,2743.012622377623,-0.1381818181816925,2743.1826340326334,-0.1877505827501409,2742.485955710954,-0.15206293706160068,2742.677937062925,-0.1948717948725971,-0.09674749721943954,-0.09674749721943954,,,,,,7.916968700807277,7.917031550923744,"[2731.8111734486815, 2731.907226949629, 2731.7151233249624, 2732.9252971299443, 2732.930887363411, 2732.918701023215, 2732.948407855572, 2734.1047819608116, 2732.9123545075618, 2732.9580944989425, 2732.909785539427, 2732.9273206617913, 2732.9107814377658, 2732.9848387111897, 2732.9640383911014, 2738.9282624365596, 2733.0301646696325, 2733.0201634971127, 2733.0310793132808, 2742.327125011691, 2742.223662103001, 2741.4995310309023, 2731.8970592041096, 2742.9479844448065]",2.6491463702530916e-05,1.6249277122348384e-05,2740.05629415417,2742.565298377386,2743.1977787104042,2743.3384207960403,-0.14306358869271207,-0.004419943982063877,0.3263652646335352,-0.09674749721943954,-0.1579035965910407,-0.1179977753017738,2743.959678248957,2742.654217190423,16.121761068710693,17.414920969732496,0,0,0,0,0,0,0,0,0,0,0,0,0,100,0,0,0,0,0,0,0,0,0,0,0,0,0,0,0,0,0,0,0,0,0,0,0,0,0,0,100,0,0,0,0,0,0,0,0,0,0,0,0,0,0,0,0,0,0,0,0,0,4.0,5.0,,,,False,True,False,0.0,2842.89,2752.89,2756.89,2760.89,"5.0,4.0,2755.89",0,0.01,2024-10-29 04:12:00,2024-10-29 04:12:00,True,2024-10-29 15:47:00,,2024-10-29 04:45:48,2024-10-28 18:54:00,2742.89,2024-10-28 18:55:00,manual,2742.62,0.01,-4.89,fail,0 days 00:01:00,688.1100000000004,False,0,20,44,10
2024-10-28 18:54:00,2742.88,2743.05,2742.44,2742.61,116,27,0,2727.548185003385,2737.667075000002,2747.7859649966194,2743.0380845924524,-0.01451134211720273,2743.168367074531,2743.515968854282,2742.9401549870236,2743.168367074531,2743.2930033370394,-0.13107724632345708,2742.96878787879,-0.04383449883289359,2743.044071484072,-0.1385625485613673,2742.4046153846148,-0.08134032633915922,2742.5095299145178,-0.16840714840736837,-0.1385806451589815,-0.1385806451589815,,,,,,7.916968700807277,7.917031550923744,"[2731.8111734486815, 2731.907226949629, 2731.7151233249624, 2732.9252971299443, 2732.930887363411, 2732.918701023215, 2732.948407855572, 2734.1047819608116, 2732.9123545075618, 2732.9580944989425, 2732.909785539427, 2732.9273206617913, 2732.9107814377658, 2732.9848387111897, 2732.9640383911014, 2738.9282624365596, 2733.0301646696325, 2733.0201634971127, 2733.0310793132808, 2742.327125011691, 2742.223662103001, 2741.4995310309023, 2731.8970592041096, 2742.9479844448065]",2.6491850052197483e-05,1.6249145588694048e-05,2740.100813574183,2742.6379124954483,2743.1073512164958,2743.284463700037,-0.17502369867361267,-0.03854069492037364,0.2836213526348249,-0.1385806451589815,-0.09674749721943954,-0.1579035965910407,2743.7356097798006,2742.6011243692615,16.735253772283,16.572345035644744,0,0,0,0,0,0,0,0,0,0,0,0,0,0,0,0,0,0,0,0,0,0,0,0,0,0,0,0,-100,0,0,0,0,0,0,0,0,0,0,0,0,0,0,0,0,0,0,0,0,0,0,0,0,0,0,0,0,0,0,0,0,0,4.0,5.0,,,,False,False,True,1.0,2642.61,2752.61,2732.61,2729.61,"5.0,4.0,2729.61",1,0.01,2024-11-05 04:36:00,2024-11-05 04:36:00,False,2024-11-05 04:36:00,,2024-10-29 04:00:08,2024-10-28 18:55:00,2742.61,2024-10-28 19:46:00,manual,2744.14,0.01,-27.73,fail,0 days 00:51:00,660.3800000000003,False,0,21,44,10
2024-10-28 19:45:00,2743.93,2744.16,2743.72,2744.13,153,27,0,2729.9719203791105,2739.124900000001,2748.277879620892,2743.0045945829615,0.038149336170590686,2744.739087133852,2744.9863663329616,2744.448180941792,2744.739087133852,2744.748241502899,0.0032428624394924555,2744.0790909090906,-0.06489510489655004,2744.148348873348,-0.0899922299931859,2743.708484848487,-0.05731934731466026,2743.7508158508094,-0.0383255633250883,-0.010284019280788925,-0.010284019280788925,,,,,,7.916929407428466,7.916654054912976,"[2731.8111734486815, 2731.907226949629, 2731.7151233249624, 2732.9252971299443, 2732.930887363411, 2732.918701023215, 2732.948407855572, 2734.1047819608116, 2732.9123545075618, 2732.9580944989425, 2732.909785539427, 2732.9273206617913, 2732.9107814377658, 2732.9848387111897, 2732.9640383911014, 2738.9282624365596, 2733.0301646696325, 2733.0201634971127, 2733.0310793132808, 2742.327125011691, 2742.223662103001, 2741.4995310309023, 2731.8970592041096, 2742.9479844448065, 2742.534062540049]",6.518192478249959e-06,1.2758534187211154e-05,2739.692963532376,2744.0216042144953,2743.94465489705,2743.5129307812313,0.3747447371852104,0.4522270788982402,0.2433068321107095,-0.010284019280788925,-0.006895068594985787,0.026907675193342584,2745.2257007980734,2744.252473469631,47.90804359824975,52.13379639936625,0,0,0,0,0,0,0,0,0,0,0,0,0,0,0,100,0,0,0,0,0,0,0,0,0,0,0,0,0,0,0,0,0,0,0,0,0,0,0,0,0,0,0,0,0,0,0,0,0,0,0,0,0,0,0,0,0,0,0,0,0,0,4.0,5.0,,,,False,True,False,0.0,2844.13,2754.13,2758.13,2762.13,"5.0,4.0,2757.13",0,0.01,2024-10-29 04:15:00,2024-10-29 04:15:00,True,2024-10-29 15:47:00,,2024-10-29 04:21:03,2024-10-28 19:46:00,2744.13,2024-10-28 19:51:00,manual,2743.51,0.01,-11.24,fail,0 days 00:05:00,649.1400000000003,False,0,22,44,10
2024-10-28 19:50:00,2743.7,2743.86,2743.38,2743.47,197,27,0,2730.2039542329762,2739.2726750000015,2748.341395767027,2743.1267895724577,0.011634251781288185,2744.3935609936952,2744.6395995550624,2744.1855802743753,2744.3935609936952,2744.492064021746,-0.0889024842431354,2743.9921794871766,-0.045349650350544835,2744.038927738926,-0.03450271950350725,2743.582587412588,-0.057634032631085574,2743.6323232323157,-0.06624320124274163,-0.11224397478827086,-0.11224397478827086,,,,,,7.916883859483921,7.916654054912976,"[2731.8111734486815, 2731.907226949629, 2731.7151233249624, 2732.9252971299443, 2732.930887363411, 2732.918701023215, 2732.948407855572, 2734.1047819608116, 2732.9123545075618, 2732.9580944989425, 2732.909785539427, 2732.9273206617913, 2732.9107814377658, 2732.9848387111897, 2732.9640383911014, 2738.9282624365596, 2733.0301646696325, 2733.0201634971127, 2733.0310793132808, 2742.327125011691, 2742.223662103001, 2741.4995310309023, 2731.8970592041096, 2742.9479844448065, 2742.534062540049]",1.2468023602819277e-05,2.7773142714304763e-05,2739.2061889168335,2743.5708019809845,2743.8412287757237,2743.6007779686956,0.1976140794731691,0.32718843199245734,0.2204176236923585,-0.11224397478827086,-0.07102113459359316,-0.08344234334617795,2744.83439624108,2743.9527257463105,17.84722222222183,29.733796296302256,0,0,0,0,0,0,0,0,0,0,0,0,0,0,0,0,0,0,0,0,0,0,0,0,0,0,0,0,0,0,0,0,0,0,0,0,0,0,0,0,0,0,0,0,0,0,0,0,0,0,0,0,0,0,0,0,0,0,0,0,0,0,4.0,5.0,,,,False,False,True,1.0,2643.47,2753.47,2733.47,2730.47,"5.0,4.0,2730.47",1,0.01,2024-11-05 04:36:00,2024-11-05 04:36:00,False,2024-11-05 04:36:00,,2024-10-29 04:00:09,2024-10-28 19:51:00,2743.47,2024-10-28 19:52:00,manual,2743.6,0.01,-2.36,fail,0 days 00:01:00,646.7800000000003,False,0,23,44,10
2024-10-28 19:51:00,2743.51,2743.65,2743.39,2743.63,161,27,0,2730.2504603725074,2739.301400000001,2748.352339627495,2743.143288275,0.016498702542321553,2744.2999977753057,2744.5123003337058,2744.0980237300705,2744.2999977753057,2744.399787912489,-0.09227610925699992,2743.9129487179507,-0.07923076922588734,2743.9808857808835,-0.05804195804239498,2743.555745920745,-0.026841491843242693,2743.592851592845,-0.0394716394707757,-0.09356321838959047,-0.09356321838959047,,,,,,7.916883859483921,7.916654054912976,"[2731.8111734486815, 2731.907226949629, 2731.7151233249624, 2732.9252971299443, 2732.930887363411, 2732.918701023215, 2732.948407855572, 2734.1047819608116, 2732.9123545075618, 2732.9580944989425, 2732.909785539427, 2732.9273206617913, 2732.9107814377658, 2732.9848387111897, 2732.9640383911014, 2738.9282624365596, 2733.0301646696325, 2733.0201634971127, 2733.0310793132808, 2742.327125011691, 2742.223662103001, 2741.4995310309023, 2731.8970592041096, 2742.9479844448065, 2742.534062540049]",1.496747470712529e-05,2.9684187853689248e-05,2739.203314229765,2743.385066529166,2743.808732040997,2743.602942563607,0.16620652044639428,0.2949920496832447,0.23182120629946024,-0.09356321838959047,-0.11224397478827086,-0.07102113459359316,2744.7636401879045,2743.836355362707,16.02853997289063,21.96900406503976,0,0,0,0,0,0,0,0,0,0,0,0,0,0,0,0,0,0,0,0,0,0,0,0,0,0,0,0,100,0,0,0,0,0,0,0,0,0,0,0,0,0,0,0,0,0,0,0,0,0,0,100,0,0,0,0,0,0,0,0,0,0,4.0,5.0,,,,False,True,False,0.0,2843.63,2753.63,2757.63,2761.63,"5.0,4.0,2756.63",0,0.01,2024-10-29 04:14:00,2024-10-29 04:14:00,True,2024-10-29 15:47:00,,2024-10-29 04:36:10,2024-10-28 19:52:00,2743.63,2024-10-28 19:53:00,manual,2743.33,0.01,-5.44,fail,0 days 00:01:00,641.3400000000003,False,0,24,44,10
2024-10-28 19:52:00,2743.6,2743.6,2743.24,2743.32,173,27,0,2730.302615949397,2739.3304250000015,2748.358234050606,2743.1490821020493,0.005793827049274114,2744.169708565072,2744.3893333333363,2743.9924123099695,2744.169708565072,2744.287755778019,-0.11203213447015514,2743.8380419580426,-0.07490675990811724,2743.914390054388,-0.06649572649530455,2743.4668648018637,-0.08888111888109052,2743.53506604506,-0.05778554778498801,-0.13028921023351359,-0.13028921023351359,,,,,,7.916871101173703,7.916654054912976,"[2731.8111734486815, 2731.907226949629, 2731.7151233249624, 2732.9252971299443, 2732.930887363411, 2732.918701023215, 2732.948407855572, 2734.1047819608116, 2732.9123545075618, 2732.9580944989425, 2732.909785539427, 2732.9273206617913, 2732.9107814377658, 2732.9848387111897, 2732.9640383911014, 2738.9282624365596, 2733.0301646696325, 2733.0201634971127, 2733.0310793132808, 2742.327125011691, 2742.223662103001, 2741.4995310309023, 2731.8970592041096, 2742.9479844448065, 2742.534062540049]",1.5725611648635633e-05,2.7968956605406197e-05,2739.3507874979837,2743.3615230647756,2743.733542496228,2743.5819838551915,0.11681901732163169,0.25935744321092213,0.29110319766055187,-0.13028921023351359,-0.09356321838959047,-0.11224397478827086,2744.751914960393,2743.587502169751,10.987339724145272,14.95436730641906,0,0,0,0,0,0,0,0,0,0,0,0,0,-100,0,0,0,0,0,0,0,0,0,0,0,0,0,0,0,0,0,100,0,0,0,0,0,0,0,0,-100,0,0,0,0,0,0,0,0,0,0,0,0,0,0,0,0,0,0,0,0,0,4.0,5.0,,,,False,False,True,1.0,2643.32,2753.32,2733.32,2730.32,"5.0,4.0,2730.32",1,0.01,2024-11-05 04:36:00,2024-11-05 04:36:00,False,2024-11-05 04:36:00,,2024-10-29 04:00:09,2024-10-28 19:53:00,2743.32,2024-10-28 19:54:00,manual,2743.91,0.01,-10.69,fail,0 days 00:01:00,630.6500000000002,False,0,25,44,10
2024-10-28 19:53:00,2743.33,2744.12,2743.33,2743.92,141,27,0,2730.351046445265,2739.3603000000016,2748.369553554738,2743.1743580987036,0.025275996654272603,2744.128377456433,2744.3278791249527,2743.9043529847972,2744.128377456433,2744.1993612655983,-0.08839451242056384,2743.8890093240075,0.05096736596487972,2743.8799999999987,-0.03439005438940512,2743.375361305362,-0.09150349650190037,2743.4659906759844,-0.06907536907556278,-0.04133110863904221,-0.04133110863904221,,,,,,7.916871101173703,7.916654054912976,"[2731.8111734486815, 2731.907226949629, 2731.7151233249624, 2732.9252971299443, 2732.930887363411, 2732.918701023215, 2732.948407855572, 2734.1047819608116, 2732.9123545075618, 2732.9580944989425, 2732.909785539427, 2732.9273206617913, 2732.9107814377658, 2732.9848387111897, 2732.9640383911014, 2738.9282624365596, 2733.0301646696325, 2733.0201634971127, 2733.0310793132808, 2742.327125011691, 2742.223662103001, 2741.4995310309023, 2731.8970592041096, 2742.9479844448065, 2742.534062540049]",1.5850732633866838e-05,2.7966959023935928e-05,2739.42749370087,2743.394253841495,2743.762228266039,2743.60702208814,0.12124266544515194,0.2317344876577681,0.261588554198273,-0.04133110863904221,-0.13028921023351359,-0.09356321838959047,2744.6515545648294,2743.6052003480368,27.04468739440799,18.020189030481117,0,0,0,0,0,0,0,0,0,0,0,0,0,100,0,0,0,0,0,0,0,0,0,0,0,0,0,0,0,0,0,200,0,0,0,0,0,0,0,0,0,0,0,0,0,0,0,0,0,0,0,0,0,0,0,0,0,0,0,0,0,0,4.0,5.0,,,,False,True,False,0.0,2843.92,2753.92,2757.92,2761.92,"5.0,4.0,2756.92",0,0.01,2024-10-29 04:14:00,2024-10-29 04:14:00,True,2024-10-29 15:47:00,,2024-10-29 04:21:52,2024-10-28 19:54:00,2743.92,2024-10-28 20:01:00,manual,2742.7,0.01,-22.11,fail,0 days 00:07:00,608.5400000000002,False,0,26,44,10
2024-10-28 20:00:00,2743.26,2743.29,2742.64,2742.68,155,27,0,2730.6978427373756,2739.554100000003,2748.4103572626304,2743.185135519164,-0.017123237937994418,2743.2382261772304,2743.511970337411,2743.1250967741926,2743.2382261772304,2743.360514398708,-0.12779236188498544,2743.444533799535,-0.055990675991779426,2743.478543123542,-0.03867521367601512,2743.0067249417243,-0.1415850815851627,2743.095932400927,-0.04580419580361195,-0.12866963293026856,-0.12866963293026856,,,,,,7.916915848056119,7.916885716698216,"[2731.8111734486815, 2731.907226949629, 2731.7151233249624, 2732.9252971299443, 2732.930887363411, 2732.918701023215, 2732.948407855572, 2734.1047819608116, 2732.9123545075618, 2732.9580944989425, 2732.909785539427, 2732.9273206617913, 2732.9107814377658, 2732.9848387111897, 2732.9640383911014, 2738.9282624365596, 2733.0301646696325, 2733.0201634971127, 2733.0310793132808, 2742.327125011691, 2742.223662103001, 2741.4995310309023, 2731.8970592041096, 2742.9479844448065, 2742.534062540049]",2.2176980968760306e-05,1.7693672421171727e-05,2740.1621811229143,2743.325282591414,2743.3594626678,2743.4421060891523,-0.09043013941663958,0.032824141801450456,0.334354388922412,-0.12866963293026856,-0.10952539858953969,-0.1451820541356028,2743.9069349550755,2742.5695173993854,13.975255862149112,17.420955049216456,0,0,0,0,0,0,0,0,0,-100,0,0,0,-100,0,-100,0,0,0,0,0,0,0,0,0,0,0,0,0,0,0,0,0,0,0,0,0,0,0,0,-100,0,0,0,0,0,0,0,0,0,0,0,0,0,0,0,0,0,0,0,0,0,4.0,5.0,,sell,,False,False,True,1.0,2642.68,2752.68,2732.68,2729.68,"5.0,4.0,2729.68",1,0.01,2024-11-05 04:36:00,2024-11-05 04:36:00,False,2024-11-05 04:36:00,,2024-10-29 04:00:08,2024-10-28 20:01:00,2742.68,2024-10-28 23:59:59,auto,2752.49,0.01,-177.81,fail,0 days 03:58:59,430.7300000000002,False,0,27,44,10
