time,open,high,low,close,tick_volume,spread,real_volume,support_trendline_15,resistance_trendline_15,support_gradient_15,resistance_gradient_15,supertrend_dir,Span_A,Span_B,fixed_resistance_gradient_15,fixed_support_gradient_15,fixed_support_trendline_15,fixed_resistance_trendline_15,hourly_time,time2,prev_hour_lsma_slope,prev_hour_macd_line,hour_lsma,fixed_support_gradient,fixed_resistance_gradient,prev_hour_lsma,fixed_support_trendline,fixed_resistance_trendline,prev_fixed_support_trendline,prev_fixed_resistance_trendline,prev_fixed_resistance_gradient,prev_fixed_support_gradient,ema_50,ema_24,prev_stochk,prev_stochd,prev_hour_macd_signal,prev_psar,prev_psar_direction,prev_nadaraya_watson,prev_nadaraya_watson_trend,nadaraya_upper_envelope,nadaraya_lower_envelope,wma_50,prev_supertrend_dir,HSpan_A,HSpan_B,nadaraya_watson,prev_nadaraya_lower_band,prev_nadaraya_upper_band,prev_HSpan_A,prev_HSpan_B,support_trendline,resistance_trendline,4_hour_time,time4h,4H_ema_50,prev_4fixed_support_gradient,prev_4fixed_support_trendline,prev_4fixed_resistance_gradient,prev_4fixed_resistance_trendline,prev_4nadaraya_watson_trend,4H_hour_lsma,4lsma_upper_band,4lsma_lower_band,4HSpan_A,4HSpan_B,ema_short,ema_long,lsma,macd_line,macd_signal,lsma_stddev,lsma_slope,prev_lsma_slope_1,prev_lsma_slope_2,lsma_upper_band,lsma_lower_band,stoch_k,stoch_d,is_doji,is_doji_star,3whitesoldiers,3blackcrows,engulfing,ticket,is_buy2,is_sell2,signal,tp,sl,be,be_condition,order_type,lot,sl_updated,time_to_trail,time_tp_hit,time_sl_hit,entry_time,entry_price,exit_time,exit_price,lot_size,type,success,profit,account_balance,win_streak,losing_streak,Week,Month
2024-02-07 17:30:00,2038.9,2041.12,2037.23,2040.49,3754,28,0,2034.9817929372323,2041.7758000360975,-6.278001816622867e-05,-0.00015607717905883435,1.0,7.619716660767679,7.619455773629365,0.0003221438499288614,0.00012921623667392306,2030.6528619430787,2038.948910229596,2024-02-07 17:00:00,2024-02-07 17:00:00,2.571757575759193,1.2889868621534788,2037.575272727274,0.00017673804106367616,4.899417889068279e-05,2036.7769090909098,2013.2003842974802,2039.4014651514651,2012.844156228045,2039.301575424858,4.8991517273712e-05,0.00017673570407424863,2036.7686441456276,2036.5600177727868,75.68928978809068,62.27417044965946,0.7500793249752753,2030.4699999999991,-1.0,2034.8489150483508,bullish,2039.0782897961792,2031.241738276925,2032.9531702970296,1.0,7.618923310441655,7.615572167757415,2035.1562421220465,2030.92101070313,2038.7844161599967,7.618709760236969,7.615572167757415,2019.9291990659872,2043.1604879129989,2024-02-07 16:00:00,2024-02-07 16:00:00,2034.7706499704063,0.0006274897013499491,2028.7312023245963,0.0003309126687001536,2041.2128743039098,bullish,2035.5219047619055,2041.9802770413578,2029.0635324824532,,,2037.724211413207,2036.0957362984923,2040.410714285715,1.486987822213905,0.8800247957351299,2.722234726253388,0.4842857142853063,0.10285714285782888,0.5450000000012096,2043.1329490119683,2037.6884795594615,65.73743149868993,71.69246043197761,0,0,0,0,0,,True,False,0.0,2049.49,2037.49,2043.49,2044.49,0,0.01,False,,,2024-02-07 18:44:29,2024-02-07 17:45:00,2040.49,2024-02-07 18:44:29,2037.5,0.01,fail,False,-54.58,645.42,0,1,6,2
2024-02-07 18:00:00,2038.21,2040.8,2037.8,2040.75,2782,29,0,2034.1113005126356,2041.1287961663168,-1.2397399285740254e-05,-0.0001512984029575372,1.0,7.619716660767679,7.619455773629365,0.00032212993265660304,0.0001292202154994728,2031.1777063713773,2040.2632680863528,2024-02-07 18:00:00,2024-02-07 18:00:00,0.798363636364229,1.3829064178612498,2038.206727272728,0.00017675340635916646,8.653959024560371e-05,2037.575272727274,2013.5564994644553,2035.7221720538414,2013.2003842974802,2039.4014651514651,4.899417889068279e-05,0.00017673804106367616,2036.7987700041301,2036.9444582677231,77.22549674435714,72.6126255194272,0.8766447435524702,2031.0295999999992,-1.0,2035.1562421220465,bullish,2039.3664207736979,2031.5584636736864,2032.9914316831685,1.0,7.619001031991877,7.615572167757415,2035.4586983416584,2031.241738276925,2039.0782897961792,7.618923310441655,7.615572167757415,2019.935558465544,2040.8010796110168,2024-02-07 16:00:00,2024-02-07 16:00:00,2034.7706499704063,0.0006274897013499491,2028.7312023245963,0.0003309126687001536,2041.2128743039098,bullish,2035.5219047619055,2041.9802770413578,2029.0635324824532,,,2038.2542578757282,2036.5861936715469,2039.6607142857142,1.5100798283115182,1.0899743752035318,1.356132455972614,-0.11642857143033325,-0.6335714285703489,0.4842857142853063,2041.0168467416868,2038.3045818297417,65.55307801106466,64.55613282602182,0,0,0,0,100,,True,False,0.0,2049.75,2037.75,2043.75,2044.75,0,0.01,False,,,2024-02-07 18:44:28,2024-02-07 18:15:00,2040.75,2024-02-07 18:44:28,2037.98,0.01,fail,False,-50.56,594.8599999999999,0,2,6,2
2024-02-08 15:30:00,2025.34,2025.68,2021.64,2022.76,4262,29,0,2018.700544862695,2033.5457280750259,0.0003390772450618422,4.600799995033844e-05,-1.0,7.614758839105097,7.6158414594602135,-0.0004336391158699541,-0.0001941473053252308,2026.133380601058,2037.8289217782635,2024-02-08 15:00:00,2024-02-08 15:00:00,-2.0187878787894533,-1.6276527308868936,2027.2872121212106,-1.9473601102832648e-05,0.00013317461112321926,2030.3883030303018,2022.8733244339353,2036.4747018876737,2022.780208944279,2036.2039928317715,0.00013317263046243508,8.26981413113711e-06,2035.4901970336837,2028.923015552026,30.900926363406526,44.591267632018344,-0.6767735927802039,,-1.0,2033.2916524919508,bearish,2035.9911802390636,2028.4802229630232,2032.1517920792069,-1.0,7.616335427676068,7.617081234446932,2032.2322316216926,2029.5954854839488,2036.9945507183897,7.617025255180291,7.617563472066696,2020.2426716159798,2046.8865045962673,2024-02-08 12:00:00,2024-02-08 12:00:00,2030.327698761535,-0.00016556091358893308,2029.2741346725304,0.0002562068585684162,2045.8319689228774,bullish,2030.4383333333335,2037.2816309667849,2023.5950356998821,,,2027.1981905674681,2029.6451562395969,2024.0285714285703,-2.204222374248502,-1.4366543661104476,1.6269691366529724,-0.8242857142863613,-0.09000000000060027,-0.602857142856692,2025.6555405652232,2022.4016022919175,11.251128066289409,10.513913404536751,0,0,0,0,0,,False,True,1.0,2013.76,2025.76,2019.76,2018.76,1,0.01,False,2024-02-12 16:30:00,2024-02-12 16:34:17,2024-02-08 16:25:50,2024-02-08 15:45:00,2022.76,2024-02-08 16:25:50,2025.68,0.01,fail,False,-53.3,541.56,0,3,6,2
2024-02-09 12:00:00,2031.48,2032.11,2030.96,2031.29,702,28,0,2030.9800086619266,2032.703911793618,-0.0002102030687353607,0.0001557128851457848,1.0,7.616986901795098,7.617208053637761,-6.63823052041006e-05,-7.590406713781703e-05,2031.0956962245245,2034.7567364550614,2024-02-09 12:00:00,2024-02-09 12:00:00,-0.3999999999969077,-0.0006176955173486931,2032.3670909090931,-0.0001763863602198376,-0.00012118163886102031,2032.6007272727295,2031.641766107746,2046.785898570234,2032.1448561419957,2047.0339918072727,-0.00012118647007084907,-0.00017851973244949494,2034.5749889498745,2032.7011457788497,41.14795054200525,57.13603323963398,0.18681031355985092,2026.1638451448787,-1.0,2032.6985329458523,bearish,2036.2595696145745,2029.19888343578,2032.5580039603944,-1.0,7.6162605590421,7.616888209093872,2032.7261608606598,2029.1595738407025,2036.2436641784727,7.6162605590421,7.616888209093872,2024.2805187393155,2037.6020246660146,2024-02-09 12:00:00,2024-02-09 12:00:00,2030.5815400833171,-0.00038162658656356105,2018.0538914957212,-0.0002552305756430181,2036.489352787421,bearish,2030.9651190476186,2038.061551954368,2023.8686861408692,,,2032.2108653970754,2032.6376970399156,2031.6885714285718,-0.3909926022079162,-0.26268020539272674,0.5030478535795739,-0.23071428571415709,-0.3528571428569194,0.2542857142861976,2032.1916192821514,2031.1855235749922,30.165912518853116,35.24384112619362,0,0,0,0,0,,False,True,1.0,2022.29,2028.2892,2028.2884,2027.288,1,0.01,True,2024-02-09 16:00:00,2024-02-09 17:25:05,2024-02-09 15:30:59,2024-02-09 12:15:00,2031.29,2024-02-09 15:30:59,2027.36,0.01,even,True,71.72,613.28,1,0,6,2
2024-02-09 12:30:00,2032.94,2032.94,2031.56,2031.86,615,29,0,2031.2200697755418,2035.901150583506,-0.00025681686470696303,5.069305746803823e-05,1.0,7.6169820770779095,7.617208053637761,-6.638119592559876e-05,-5.988702786480349e-05,2030.7098191578482,2034.4865787149133,2024-02-09 12:00:00,2024-02-09 12:00:00,-0.3999999999969077,-0.0006176955173486931,2032.3670909090931,-0.0001763863602198376,-0.00012118163886102031,2032.6007272727295,2031.641766107746,2046.785898570234,2032.1448561419957,2047.0339918072727,-0.00012118647007084907,-0.00017851973244949494,2034.5749889498745,2032.7011457788497,41.14795054200525,57.13603323963398,0.18681031355985092,2026.1638451448787,-1.0,2032.6985329458523,bearish,2036.2595696145745,2029.19888343578,2032.5580039603944,-1.0,7.6162605590421,7.616888209093872,2032.7261608606598,2029.1595738407025,2036.2436641784727,7.6162605590421,7.616888209093872,2024.2805187393155,2037.6020246660146,2024-02-09 12:00:00,2024-02-09 12:00:00,2030.5815400833171,-0.00038162658656356105,2018.0538914957212,-0.0002552305756430181,2036.489352787421,bearish,2030.9651190476186,2038.061551954368,2023.8686861408692,,,2032.250501260628,2032.6001380657713,2032.062857142857,-0.31615934996534634,-0.2804044605656329,0.6085971379526909,-0.027142857142507637,0.4014285714276866,-0.23071428571415709,2032.6714542808097,2031.4542600049042,37.766410912190025,33.85577196318828,0,0,0,0,0,,False,True,1.0,2022.86,2028.8591999999999,2028.8583999999998,2027.858,1,0.01,True,2024-02-09 16:00:00,2024-02-09 17:02:18,2024-02-09 15:31:00,2024-02-09 12:45:00,2031.86,2024-02-09 15:31:00,2028.24,0.01,even,True,66.06,679.3399999999999,2,0,6,2
2024-02-09 13:45:00,2032.12,2032.36,2031.38,2031.44,1005,29,0,2028.3948298977034,2044.4175923328173,-0.00023725721959005834,-0.000509441371731782,1.0,7.6169697827618155,7.617124522532056,-3.987855604679858e-05,3.1410559582586e-05,2030.5868784170843,2034.2220416654952,2024-02-09 13:00:00,2024-02-09 13:00:00,-0.23363636363637852,-0.0007127453748125845,2032.0217575757586,-0.00016802185291653235,-0.0001211905153384107,2032.3670909090931,2030.7502032426828,2046.5379878752178,2031.641766107746,2046.785898570234,-0.00012118163886102031,-0.0001763863602198376,2034.5129099607682,2032.4208911613275,35.501355013549755,45.65532368017475,0.14930570177291821,2026.5308913390836,-1.0,2032.7261608606598,bullish,2036.1720170417113,2029.132662365592,2032.5661425742558,-1.0,7.616240902249686,7.616888209093872,2032.6492924196652,2029.19888343578,2036.2595696145745,7.6162605590421,7.616888209093872,2023.6055933400635,2037.4415376415861,2024-02-09 12:00:00,2024-02-09 12:00:00,2030.5815400833171,-0.00038162658656356105,2018.0538914957212,-0.0002552305756430181,2036.489352787421,bearish,2030.9651190476186,2038.061551954368,2023.8686861408692,,,2032.2431339091377,2032.5029673952552,2032.0842857142852,-0.2298301309897397,-0.22940378801710726,0.5599234642747367,-0.4700000000007094,-0.1528571428568739,0.2564285714292964,2032.64420917856,2031.5243622500104,47.140965353965534,57.185680165618216,0,0,0,0,0,,False,True,1.0,2022.44,2028.4392,2028.4384,2027.438,1,0.01,True,2024-02-09 16:00:00,2024-02-09 17:25:03,2024-02-09 15:31:00,2024-02-09 14:00:00,2031.44,2024-02-09 15:31:00,2028.24,0.01,even,True,58.4,737.7399999999999,3,0,6,2
2024-02-09 14:30:00,2030.96,2031.17,2029.46,2030.04,1349,29,0,2026.9580281110473,2040.8116779591012,-0.00023819246013345814,-0.00045018666738035886,-1.0,7.616672997500247,7.616888062336708,-2.1771072657418668e-05,-2.7241395998134883e-05,2030.1094049795809,2033.726919159002,2024-02-09 14:00:00,2024-02-09 14:00:00,-0.3453333333345654,-0.14076086020531875,2031.010848484847,-0.00015948171534564014,-0.00012118698898785284,2032.0217575757586,2029.8827091524154,2046.2900908909305,2030.7502032426828,2046.5379878752178,-0.0001211905153384107,-0.00016802185291653235,2034.3978028328322,2031.5940264588103,29.674796747967594,35.441367434507534,0.09129238937727081,2026.8832556855202,-1.0,2032.6492924196652,bearish,2035.8747989863443,2028.8425453885825,2032.5201663366322,-1.0,7.615996991378522,7.616888209093872,2032.3556306089552,2029.132662365592,2036.1720170417113,7.616240902249686,7.616888209093872,2022.929525685747,2037.279435878862,2024-02-09 12:00:00,2024-02-09 12:00:00,2030.5815400833171,-0.00038162658656356105,2018.0538914957212,-0.0002552305756430181,2036.489352787421,bearish,2030.9651190476186,2038.061551954368,2023.8686861408692,,,2031.682435700074,2032.166777704154,2030.8300000000004,-0.4354659624048054,-0.28688947797977477,0.9759000730180363,-0.630714285712429,-0.49500000000170985,-0.12857142857069448,2031.8059000730184,2029.8540999269824,18.754386319396847,25.229740593109053,0,0,0,0,0,,False,True,1.0,2021.04,2033.04,2027.04,2026.04,1,0.01,False,2024-02-09 16:30:00,2024-02-09 18:01:29,2024-02-09 15:31:18,2024-02-09 14:45:00,2030.04,2024-02-09 15:31:18,2032.89,0.01,fail,False,-52.02,685.7199999999999,0,1,6,2
2024-02-09 21:15:00,2025.54,2026.06,2024.52,2025.0,1050,29,0,2023.6852406454157,2026.5107058746705,-7.67147958590163e-06,6.379931799042425e-06,-1.0,7.613934174537426,7.615129443887614,-3.222221875120374e-05,3.717198794312844e-05,2020.3311566299885,2026.7833748633368,2024-02-09 21:00:00,2024-02-09 21:00:00,-0.5787878787905356,-2.4668636427684305,2022.6387272727272,-9.20061289662647e-05,-7.992790117469313e-05,2022.6629696969685,2024.4214587428867,2044.523101790278,2025.221972076289,2044.6864685778294,-7.991390533882751e-05,-0.00010444338558891678,2033.0535692439166,2025.2974604501865,17.93660169324642,13.208953275688884,-1.6276683454135152,,-1.0,2028.5819307849054,bearish,2031.6300280446114,2024.5417634463035,2031.5825386138592,-1.0,7.615129443887614,7.616888209093872,2028.0827990118896,2025.0299684572176,2032.140123359342,7.615129443887614,7.616888209093872,2023.2885348484008,2032.923471274815,2024-02-09 20:00:00,2024-02-09 20:00:00,2027.1773511481408,1.3152701138236966e-05,2020.1925713777634,-9.895412487396947e-05,2037.2179905747166,bearish,2026.3658333333349,2034.0400472995982,2018.6916193670716,,,2024.1147327990125,2025.0612215742178,2024.5278571428576,-0.7641154287532572,-1.2807908873185592,0.916603461127114,0.21214285714404468,0.4128571428559553,-0.06642857142810499,2025.4444606039847,2023.6112536817304,74.90326147042582,63.530729318504974,0,0,0,0,0,,False,True,1.0,2016.0,2021.9959999999999,2021.9951999999998,2020.9940000000001,1,0.01,True,2024-02-12 14:45:00,2024-02-12 16:20:23,2024-02-12 13:34:31,2024-02-09 21:30:00,2025.0,2024-02-12 13:34:31,2022.0,0.01,even,True,54.75,740.4699999999999,1,0,6,2
2024-02-12 21:15:00,2020.73,2020.89,2018.56,2019.04,1145,29,0,2018.563690454629,2020.8699502219417,-1.1682281698393406e-05,5.991080199929842e-06,1.0,7.610386705936958,7.610657119184877,9.034928026152808e-05,0.00025955435428020874,2012.6210605191084,2019.7459186457022,2024-02-12 21:00:00,2024-02-12 21:00:00,1.3073939393918863,-1.5536807328774103,2017.780363636363,-8.54829367125186e-05,-0.00012919873865217598,2017.445696969694,2020.1373262175107,2043.0410711730651,2020.3100705913962,2042.535265776597,-0.00011308804832848268,-8.547596044723398e-05,2028.6789996626856,2018.9337308931308,44.91921768707488,28.799971121065976,-1.8308400202586834,,-1.0,2020.3719329392097,bearish,2023.4852529790548,2016.789803450468,2027.3725881188086,-1.0,7.610657119184877,7.613038661846105,2020.1347543271831,2017.015946849771,2023.7335028430205,7.610657119184877,7.613038661846105,1995.0598080996026,2043.3220180202209,2024-02-12 20:00:00,2024-02-12 20:00:00,2020.6718113490824,-0.0006952612873183377,2013.7446064585927,-0.0007954861736199593,2028.0683797723239,bearish,2019.5672619047618,2025.4563291059385,2013.6781947035852,,,2018.7798847959248,2018.5655080743124,2020.25,0.26734711960125424,-0.3610510355843919,1.1945152434712878,-0.455000000000382,0.35214285714369,0.7757142857133204,2021.4445152434712,2019.0554847565288,88.65979381443323,92.7431337812413,0,0,0,0,0,,False,True,1.0,2010.04,2022.04,2016.04,2015.04,1,0.01,False,2024-02-13 15:45:00,2024-02-13 15:47:27,2024-02-13 08:23:42,2024-02-12 21:30:00,2019.04,2024-02-13 08:23:42,2022.03,0.01,fail,False,-54.58,685.8899999999999,0,1,7,2
2024-02-12 23:15:00,2020.0,2020.28,2019.75,2019.84,130,30,0,2018.7786320381522,2020.3847323209984,-3.8824442959382613e-05,3.2178439083852796e-05,1.0,7.6099433781766495,7.610657119184877,7.719415333514914e-05,0.00014238330591834602,2016.4971627704897,2021.2632277903028,2024-02-12 23:00:00,2024-02-12 23:00:00,0.686545454545012,-1.0997577405673837,2019.221757575756,-8.548403915509305e-05,-0.00016034987372695627,2018.466909090908,2019.7918852555504,2043.811057453503,2019.9646426222032,2043.4847977295724,-0.00014538918899573928,-8.546998151939573e-05,2028.331574913634,2019.2779359723877,53.231292517007,49.971655328798306,-1.6097709365185662,,-1.0,2019.9946850091121,bearish,2023.1944005819971,2016.5393570750018,2026.965037623759,-1.0,7.610657119184877,7.613038661846105,2019.86413795269,2016.6598340148494,2023.3350506821353,7.610657119184877,7.613038661846105,1994.5352294904283,2040.7312123033134,2024-02-12 20:00:00,2024-02-12 20:00:00,2020.6718113490824,-0.0006952612873183377,2013.7446064585927,-0.0007954861736199593,2028.0683797723239,bearish,2019.5672619047618,2025.4563291059385,2013.6781947035852,,,2019.4702937845384,2019.075548222198,2019.907857142857,0.39045163756213697,0.23668875763959124,0.3643650710226081,0.0892857142853245,0.12214285714253492,0.2885714285712311,2020.2722222138796,2019.5434920718344,62.31722893456121,65.33951746682293,0,0,0,0,0,,False,True,1.0,2010.84,2022.84,2016.84,2015.84,1,0.01,False,2024-02-13 15:45:00,2024-02-13 15:43:00,2024-02-13 08:45:55,2024-02-12 23:30:00,2019.84,2024-02-13 08:45:55,2022.76,0.01,fail,False,-53.3,632.5899999999999,0,2,7,2
2024-02-16 08:00:00,2004.4,2004.64,2003.87,2003.9,373,29,0,2002.5788337870933,2005.8717500091195,5.2697037926829294e-05,4.1394148582008436e-05,-1.0,7.602857845704666,7.602082250664571,-2.8365680751805794e-05,1.4262323347977928e-05,2003.0071829326885,2005.2681691006417,2024-02-16 08:00:00,2024-02-16 08:00:00,0.1428484848474909,1.4743527738562534,2004.051393939395,0.00021184369650441043,0.00011802248644678543,2004.042787878788,1978.007717243248,1999.543487338964,1977.9415367751953,1999.3074636011092,0.00011801869149742965,0.00020026279353964902,2005.6598900130414,2003.8168663931729,61.459054702242554,65.98470971531685,1.8739478496805038,,-1.0,2002.762659629569,bullish,2006.7299934114553,1999.1962041411118,2000.1963702970252,1.0,7.601692608310762,7.5989373138613985,2002.959556647188,1998.9910317386725,2006.5414036989382,7.601666230046426,7.5989373138613985,1990.8942533784198,2018.0880471231885,2024-02-16 08:00:00,2024-02-16 08:00:00,2003.6267647772654,0.0009356383281851196,1998.21435109726,0.0010798864794412909,2011.6494758278452,bullish,2005.7894047619059,2014.5490864056599,1997.0297231181519,7.602384396834289,7.6078922320338656,2003.990663458922,2003.8758034754824,2004.069285714286,0.0834011461213322,0.11956061810824233,0.31409734668085476,-0.02642857142836874,0.20000000000050022,0.24714285714298967,2004.383383060967,2003.7551883676051,52.40549828179085,44.248989465937846,0,0,0,0,-100,,True,False,0.0,2012.9,2000.9,2006.9,2007.9,0,0.01,False,2024-02-16 17:45:00,2024-02-16 19:49:09,2024-02-16 15:30:06,2024-02-16 08:15:00,2003.9,2024-02-16 15:30:06,2001.24,0.01,fail,False,-48.56,584.03,0,3,7,2
2024-02-22 07:00:00,2028.79,2029.88,2028.52,2029.65,475,29,0,2028.0699200757533,2030.1585268794904,9.86290678299101e-06,0.00019030432524505216,1.0,7.6145593268993235,7.6133563506643815,4.892224234954263e-05,7.900463068444154e-06,2025.2818415455167,2028.7295835425066,2024-02-22 07:00:00,2024-02-22 07:00:00,0.7853333333334831,0.31040418726638563,2027.8952727272738,7.164540099723411e-05,4.692781395884027e-05,2027.7101212121213,2013.8253211812423,2029.4249290936673,2013.6808647536534,2029.3297247089922,4.692507108298408e-05,7.164525639652247e-05,2020.4854165207953,2027.1134855965388,68.8897830957781,63.58826103192623,-0.11142442105035079,2021.7234120208634,-1.0,2026.2895819969658,bullish,2029.932873540176,2022.9505671761203,2023.307287128705,-1.0,7.614041634115588,7.612602123969326,2026.4387130770942,2022.797724839551,2029.7874669772607,7.61342759833792,7.612602123969326,2010.070706225861,2034.1927276729975,2024-02-22 04:00:00,2024-02-22 04:00:00,2026.987986134592,-0.00021393219453312768,2020.1166878619586,-0.00014344686569010582,2031.0966896574266,bullish,2026.8147619047616,2030.4419788130813,2023.1875449964418,7.610730401034197,7.604872557005848,2027.6455167526835,2026.9561282699137,2028.781428571428,0.6229006288699566,0.4252480944868976,1.3166461722428964,0.7999999999999545,0.6364285714280413,0.6857142857145391,2030.0980747436708,2027.4647823991852,96.35740036946696,81.86680900952251,0,0,0,0,0,,True,False,0.0,2038.65,2032.65,2032.6508000000001,2033.651,0,0.01,True,2024-02-22 10:30:00,2024-02-23 19:00:11,2024-02-22 10:21:12,2024-02-22 07:15:00,2029.65,2024-02-22 10:21:12,2032.78,0.01,even,True,57.12,641.15,1,0,8,2
2024-02-22 08:00:00,2028.33,2030.06,2028.23,2029.9,609,29,0,2028.2500161763353,2035.614536658305,6.338181646943948e-06,-5.0027869510657805e-05,1.0,7.614618478003212,7.613324332931473,4.892296643088853e-05,1.0968337958500854e-05,2025.3248191801492,2029.126644337542,2024-02-22 08:00:00,2024-02-22 08:00:00,0.18515151515248363,0.44684546219150434,2028.581151515151,7.164631085379007e-05,4.693456036176677e-05,2027.8952727272738,2013.969540374847,2029.520026390515,2013.8253211812423,2029.4249290936673,4.692781395884027e-05,7.164540099723411e-05,2020.6569924312746,2027.5660443528636,73.76536179948134,67.7870544712594,0.00022955559802023684,2022.2903390591944,-1.0,2026.4387130770942,bullish,2030.14780358224,2023.1714032888697,2023.5109247524672,-1.0,7.614115519190356,7.61264182541448,2026.6566015626074,2022.9505671761203,2029.932873540176,7.614041634115588,7.612602123969326,2009.3691419639674,2034.3887639601858,2024-02-22 08:00:00,2024-02-22 08:00:00,2028.0486574230613,-0.00026546299686531106,2019.6202728035869,-0.00017230883672524357,2030.534680553838,bullish,2027.5480952380954,2031.4276728568575,2023.6685176193332,7.611381995072737,7.6055241510443885,2028.3298984901103,2027.5030163375334,2029.1607142857142,0.7402171878277386,0.5841229247241493,0.5939656876425735,0.27285714285881113,-0.272142857145127,0.03285714285743779,2029.7546799733568,2028.5667485980716,78.91503167790621,78.68596294025285,0,0,0,0,0,,True,False,0.0,2038.9,2032.9,2032.9008000000001,2033.901,0,0.01,True,2024-02-23 18:45:00,2024-02-23 19:00:30,2024-02-22 10:19:28,2024-02-22 08:15:00,2029.9,2024-02-22 10:19:28,2032.89,0.01,even,True,54.57,695.72,2,0,8,2
2024-02-22 09:00:00,2029.21,2030.44,2028.75,2029.84,778,29,0,2028.7499999999998,2036.3724557120627,-4.6850481696936225e-05,-0.00017218954241514725,1.0,7.615109272335939,7.613427767450403,9.14570664721842e-05,0.00012956672690146877,2025.561584393235,2029.2518147939738,2024-02-22 09:00:00,2024-02-22 09:00:00,0.6858787878773001,0.6234753445548904,2029.5482424242437,7.165122391241169e-05,4.692958615607654e-05,2028.581151515151,2014.1134763974408,2029.615465711436,2013.969540374847,2029.520026390515,4.693456036176677e-05,7.164631085379007e-05,2020.8687351554079,2028.4069233855605,84.74614092262182,75.80042860596045,0.12487871338939427,2023.0493051532749,-1.0,2026.6566015626074,bullish,2030.5357458698234,2023.5586358166424,2023.7533465346455,-1.0,7.61443106623647,7.613046104344306,2027.0441889335486,2023.1714032888697,2030.14780358224,7.614115519190356,7.61264182541448,2008.7629924314233,2034.5841550412201,2024-02-22 08:00:00,2024-02-22 08:00:00,2028.0486574230613,-0.00026546299686531106,2019.6202728035869,-0.00017230883672524357,2030.534680553838,bullish,2027.5480952380954,2031.4276728568575,2023.6685176193332,7.611381995072737,7.6055241510443885,2028.8447331603832,2027.998949454124,2029.47,0.7486131851844675,0.6790146712231376,0.6438093477015733,0.2571428571429806,0.06642857142924186,-0.23285714285839276,2030.1138093477016,2028.8261906522985,75.32808398950108,79.27822998593444,0,0,0,0,0,,True,False,0.0,2038.84,2032.84,2032.8408,2033.841,0,0.01,True,2024-02-23 18:45:00,2024-02-23 19:00:23,2024-02-22 10:19:29,2024-02-22 09:15:00,2029.84,2024-02-22 10:19:29,2032.87,0.01,even,True,55.3,751.02,3,0,8,2
2024-02-22 11:30:00,2029.75,2030.53,2028.43,2029.97,1633,29,0,2028.450209985322,2031.6251241881419,-0.00017093683206509646,-7.448616287462987e-05,1.0,7.616211372647288,7.615454864968848,0.00020256517038940634,9.852706813766363e-06,2028.2024930596322,2032.5819425684049,2024-02-22 11:00:00,2024-02-22 11:00:00,1.2967878787851532,1.3900216883771463,2031.0122424242431,5.866344900350541e-05,4.896457238075502e-05,2030.8450303030288,2015.4066030589045,2029.7672734525931,2014.2581882957832,2029.6681846958147,4.8954421396184256e-05,7.164849205935712e-05,2021.2907139749193,2029.6133240233637,90.43146154257222,87.75343870404772,0.5138690858637356,2025.0580501399984,-1.0,2027.564292380347,bullish,2031.3412578450711,2024.3650221523678,2024.233297029695,1.0,7.615164038602265,7.613918301749015,2027.8501400341586,2024.0755325853077,2031.059065510715,7.615110957031741,7.613749759636677,2008.755337076352,2033.6069121003575,2024-02-22 08:00:00,2024-02-22 08:00:00,2028.0486574230613,-0.00026546299686531106,2019.6202728035869,-0.00017230883672524357,2030.534680553838,bullish,2027.5480952380954,2031.4276728568575,2023.6685176193332,7.611381995072737,7.6055241510443885,2030.90308706953,2029.890184173413,2030.528571428572,0.8740187456194235,1.0563230781922859,1.7322322509922965,-0.8842857142835783,-1.182857142859575,-0.34499999999934516,2032.260803679564,2028.7963391775797,33.59370845407211,47.895109474482865,0,0,0,0,0,,True,False,0.0,2038.97,2026.97,2032.97,2033.97,0,0.01,False,2024-02-23 18:45:00,2024-02-23 19:00:36,2024-02-22 15:19:14,2024-02-22 11:45:00,2029.97,2024-02-22 15:19:14,2026.89,0.01,fail,False,-56.22,694.8,0,1,8,2
2024-02-23 08:15:00,2021.76,2022.0,2018.89,2019.19,861,29,0,2018.2352475993885,2022.0707356149173,-8.198734879274822e-05,3.101741070616703e-05,-1.0,7.612264455185356,7.612391501183675,-9.36462922094371e-05,-0.0001582552363295941,2022.5322411998682,2027.292682947182,2024-02-23 08:00:00,2024-02-23 08:00:00,-0.9063030303007054,-0.4241760003078525,2023.5779393939406,-2.88171057665273e-05,5.049504161696091e-05,2024.8530909090916,2021.0407731409553,2031.6801222380373,2020.3116244002556,2031.577097223851,5.050468974771079e-05,-9.232999270020387e-06,2022.3493157043167,2023.6881385655508,62.16332061673214,63.14676437380711,-0.5064460192442892,2021.88747138476,-1.0,2024.7927739216216,bearish,2027.8720333420408,2021.0287094737623,2025.308328712863,-1.0,7.613101659032869,7.6140198952810785,2024.447479813492,2021.3713670035338,2028.2199719701716,7.613784918410484,7.614383975672242,2015.203613755601,2041.88669060516,2024-02-23 08:00:00,2024-02-23 08:00:00,2021.9099232854264,-3.381915235372978e-05,2019.4983649184867,-0.0003362292598785857,2032.3303161435617,bearish,2021.0744047619046,2026.7186028891847,2015.4302066346245,7.613146885730318,7.6055241510443885,2023.4775841082926,2024.308210829386,2021.0092857142872,-0.7790590996553419,-0.13039841892703097,2.436024278580219,-1.5264285714270045,-0.8864285714280413,-0.932857142857074,2023.4453099928674,2018.573261435707,3.244022642378533,7.962258653372875,0,0,0,0,0,,False,True,1.0,2010.19,2022.19,2016.19,2015.19,1,0.01,False,,,2024-02-23 09:55:29,2024-02-23 08:30:00,2019.19,2024-02-23 09:55:29,2022.29,0.01,fail,False,-56.59,638.2099999999999,0,2,8,2
2024-02-23 09:00:00,2020.89,2021.02,2019.49,2020.51,715,29,0,2016.6942938166535,2022.17544524913,-3.491052835941113e-05,4.382948975872568e-05,-1.0,7.612027998471291,7.612183422784659,-0.00010256039919467018,-0.00020284571941274715,2021.8970325679954,2026.7843197236634,2024-02-23 09:00:00,2024-02-23 09:00:00,-1.2751515151510375,-0.783922271542906,2022.8683636363621,-2.8816235282531386e-05,5.0500105808044605e-05,2023.5779393939406,2020.9824032455906,2031.7824020724158,2021.0407731409553,2031.6801222380373,5.049504161696091e-05,-2.88171057665273e-05,2022.3376460864094,2023.2596633287617,49.48220501286129,59.09771283798583,-0.5619412697040126,,-1.0,2024.447479813492,bearish,2027.6066956437533,2020.7718106455234,2025.2705326732587,-1.0,7.613101659032869,7.6140198952810785,2024.1863683053036,2021.0287094737623,2027.8720333420408,7.613101659032869,7.6140198952810785,2015.4727279577112,2041.8337784464532,2024-02-23 08:00:00,2024-02-23 08:00:00,2021.9099232854264,-3.381915235372978e-05,2019.4983649184867,-0.0003362292598785857,2032.3303161435617,bearish,2021.0744047619046,2026.7186028891847,2015.4302066346245,7.613146885730318,7.6055241510443885,2022.239546858506,2023.4836343143402,2020.1392857142844,-1.1438181278047068,-0.5975410264935079,1.3268742360365582,0.10428571428451505,-0.05571428571397519,-0.9185714285733866,2021.4661599503208,2018.812411478248,26.714513556618613,17.42475143370964,0,0,0,0,0,,False,True,1.0,2011.51,2023.51,2017.51,2016.51,1,0.01,False,,,2024-02-23 13:22:53,2024-02-23 09:15:00,2020.51,2024-02-23 13:22:53,2023.38,0.01,fail,False,-52.39,585.8199999999999,0,3,8,2
2024-02-23 10:00:00,2021.84,2022.53,2020.11,2020.58,1479,29,0,2011.646256948003,2022.5300000000007,0.0003031781040529164,0.00016059866135818894,-1.0,7.611595756584853,7.612183422784659,-0.00014532237575346586,-0.00026332498206625194,2020.9156890843426,2025.8801724336613,2024-02-23 10:00:00,2024-02-23 10:00:00,-0.7095757575784774,-0.911057415321693,2021.4671515151501,-2.8218385997169066e-05,4.254219727053473e-05,2022.8683636363621,2020.8844412913181,2032.344088993484,2020.9824032455906,2031.7824020724158,5.0500105808044605e-05,-2.8816235282531386e-05,2022.2798709163815,2022.406404811259,35.25777793684044,48.967767855477994,-0.6317644988275487,,-1.0,2024.1863683053036,bearish,2027.1781774409346,2020.3468857268358,2025.1844297029616,-1.0,7.613101659032869,7.6140198952810785,2023.7596491693857,2020.7718106455234,2027.6066956437533,7.613101659032869,7.6140198952810785,2015.696364400806,2041.7806791070311,2024-02-23 08:00:00,2024-02-23 08:00:00,2021.9099232854264,-3.381915235372978e-05,2019.4983649184867,-0.0003362292598785857,2032.3303161435617,bearish,2021.0744047619046,2026.7186028891847,2015.4302066346245,7.613146885730318,7.6055241510443885,2021.707528642393,2022.8682467744097,2021.2135714285714,-1.0453636741103765,-0.8771513853418431,0.7177511176113305,-0.20428571428465148,0.5828571428569376,0.45428571428487885,2021.9313225461829,2020.49582031096,38.60026485499563,37.83243066227644,0,0,0,0,-100,,False,True,1.0,2011.58,2017.58,2017.5792,2016.579,1,0.01,True,,,2024-02-23 12:04:58,2024-02-23 10:15:00,2020.58,2024-02-23 12:04:58,2017.5,0.01,even,True,56.21,642.03,1,0,8,2
2024-02-23 18:30:00,2033.2,2037.79,2033.19,2037.25,2835,29,0,2033.1899999999996,2042.720745217818,4.9673839541319667e-05,-8.002806708100223e-05,1.0,7.615544566815403,7.614226056069715,0.00029172456470777396,9.066570122679617e-05,2023.3862036963815,2031.035728281439,2024-02-23 18:00:00,2024-02-23 18:00:00,2.0410909090903715,1.01348118613123,2031.4747272727275,-5.5742459821334806e-05,5.4727453723547774e-05,2027.5718181818188,2020.9137273162087,2032.7560519333808,2021.0269765499454,2036.9681912131955,-4.980369727782047e-05,-5.574623133027734e-05,2022.9462077894664,2028.5787776021862,84.00025439032537,82.01040232532335,-0.15291591479826233,2017.1902099200004,-1.0,2024.1669300178328,bullish,2028.7483784771694,2021.8432455214352,2025.588201980189,1.0,7.614395328469872,7.614395328469872,2025.2928691640202,2020.75510729116,2027.5845132318977,7.612562177380967,7.613491879406407,2022.8563731526338,2041.356165299658,2024-02-23 16:00:00,2024-02-23 16:00:00,2027.949965904634,-0.0004695827957503919,2016.285949564152,-0.0004014192152743249,2030.2200454226374,bullish,2027.2665476190468,2035.6170699081013,2018.9160253299924,7.6143568418248435,7.606734107138914,2029.8092077090873,2027.0846395368972,2034.2700000000002,2.4620810613851063,1.5785936572062305,4.148734172981404,2.636428571429178,1.384285714284033,2.096428571430124,2038.4187341729817,2030.1212658270188,92.09162748109922,87.2427421542621,0,0,0,0,0,,True,False,0.0,2046.25,2034.25,2040.25,2041.25,0,0.01,False,2024-02-29 15:45:00,2024-02-29 15:45:02,2024-02-26 01:00:05,2024-02-23 18:45:00,2037.25,2024-02-26 01:00:05,2034.23,0.01,fail,False,-55.13,586.9,0,1,8,2
2024-02-26 03:15:00,2032.13,2032.92,2031.41,2032.53,819,32,0,2029.8902406990871,2033.897533397094,4.9238321321542045e-05,7.981312540993152e-06,-1.0,7.617728636024372,7.616575076309669,-0.00016022205952501213,-0.0002053571814745889,2033.754985906363,2036.6310262946101,2024-02-26 03:00:00,2024-02-26 03:00:00,-2.36460606060632,2.185444162301792,2033.3789696969686,-5.574632895982684e-05,9.434893772592173e-05,2035.390787878787,2020.0130225106614,2032.528523167081,2020.125147184759,2032.336933014603,9.434718860140034e-05,-5.573990543395396e-05,2024.7580010829058,2033.0020000338668,67.9331356888373,75.11180848793589,2.5369581937219854,,-1.0,2031.0950734398787,bullish,2034.8574762700598,2027.853689605739,2027.2221999999906,1.0,7.6167909265074725,7.6150742950744394,2031.352564444701,2027.5917343427388,2034.6044657205177,7.616271866595852,7.6150742950744394,2025.1579833192266,2039.974505512572,2024-02-26 00:00:00,2024-02-26 00:00:00,2030.6955404020596,0.00028762543678812055,2016.8787586982407,0.0003506289125805547,2040.242753277309,bullish,2031.8995238095229,2041.4825577758613,2022.3164898431844,7.614955214375168,7.607106566712421,2033.0157907144642,2033.6541584608754,2031.471428571428,-0.6686840205418321,-0.11450390225891163,1.3651617730536252,0.3371428571422257,0.0878571428579562,-0.978571428571513,2032.8365903444817,2030.1062667983745,26.69181405247001,14.643294484269376,0,0,0,0,0,,True,False,0.0,2041.53,2029.53,2035.53,2036.53,0,0.01,False,2024-02-27 10:30:00,2024-02-29 15:36:16,2024-02-26 16:13:10,2024-02-26 03:30:00,2032.53,2024-02-26 16:13:10,2030.05,0.01,fail,False,-45.27,541.63,0,2,9,2
2024-02-26 12:00:00,2032.99,2035.33,2032.85,2035.25,1232,29,0,2032.3852693382655,2037.4274545773098,-0.00018770656043671518,-0.00010798342190601823,1.0,7.617960345734839,7.617489989209924,0.0001219697813786066,1.147564326662395e-05,2031.8979137206811,2035.6133933884473,2024-02-26 12:00:00,2024-02-26 12:00:00,0.33103030303004743,0.830833710732577,2033.4512727272745,-2.6791547074559534e-05,9.618746231633354e-05,2033.8415151515142,2017.3995098974835,2034.119228675328,2018.1202320954246,2033.9229950997026,9.619389528491774e-05,-3.843241149244475e-05,2026.0837091749365,2032.9726834743649,37.257187257187766,37.09414949031596,1.1714467615429351,,-1.0,2032.862211281823,bullish,2036.3200424057184,2029.4010720566762,2028.3626019801882,1.0,7.616356089058862,7.6150742950744394,2032.8576135845474,2029.4012801661656,2036.3290446526448,7.616263732942483,7.6150742950744394,2025.0371049422583,2040.5269002736188,2024-02-26 12:00:00,2024-02-26 12:00:00,2032.1638638228326,0.0010208051285357752,2023.9798260597474,0.0007548941534885335,2043.7436222212407,bullish,2034.5090476190474,2044.2746090468409,2024.7434861912539,7.6150742950744394,7.607106566712421,2033.9121124880244,2033.6044451112662,2033.8178571428564,0.2708950869114233,0.29430384911895957,0.8442550956747888,0.7971428571424894,-0.3250000000016371,-0.24785714285576432,2034.662112238531,2032.9736020471817,38.08726415730247,30.48240655244499,0,0,0,0,100,,True,False,0.0,2044.25,2032.25,2038.25,2039.25,0,0.01,False,2024-02-29 15:45:00,2024-02-29 15:45:02,2024-02-26 12:53:05,2024-02-26 12:15:00,2035.25,2024-02-26 12:53:05,2032.25,0.01,fail,False,-54.76,486.87,0,3,9,2
