time,open,high,low,close,tick_volume,spread,real_volume,ema_50,lsma,support_trendline_15,resistance_trendline_15,support_gradient_15,resistance_gradient_15,supertrend_dir,Span_A,Span_B,fixed_resistance_gradient_15,fixed_support_gradient_15,fixed_support_trendline_15,fixed_resistance_trendline_15,hourly_time,time2,prev_hour_lsma_slope,prev_hour_macd_line,hour_lsma,fixed_support_gradient,fixed_resistance_gradient,prev_hour_lsma,fixed_support_trendline,fixed_resistance_trendline,prev_fixed_support_trendline,prev_fixed_resistance_trendline,prev_fixed_resistance_gradient,prev_fixed_support_gradient,ema_24,prev_stochk,prev_stochd,prev_hour_macd_signal,prev_psar,prev_psar_direction,prev_nadaraya_watson,prev_nadaraya_watson_trend,nadaraya_upper_envelope,nadaraya_lower_envelope,wma_50,prev_supertrend_dir,HSpan_A,HSpan_B,nadaraya_watson,prev_nadaraya_lower_band,prev_nadaraya_upper_band,prev_HSpan_A,prev_HSpan_B,support_trendline,resistance_trendline,support,resistance,is_buy,is_sell,4_hour_time,time4h,4H_ema_50,prev_4fixed_support_gradient,prev_4fixed_support_trendline,prev_4fixed_resistance_gradient,prev_4fixed_resistance_trendline,prev_4nadaraya_watson_trend,4H_hour_lsma,4lsma_upper_band,4lsma_lower_band,4HSpan_A,4HSpan_B,ema_short,ema_long,macd_line,macd_signal,lsma_stddev,lsma_slope,prev_lsma_slope_1,prev_lsma_slope_2,lsma_upper_band,lsma_lower_band,stoch_k,stoch_d,is_doji,is_doji_star,3whitesoldiers,3blackcrows,engulfing,inverted_hammer,two_crows,three_inside,three_line_strike,three_outside,three_stars_in_south,abandoned_baby,advance_block,belt_hold,breakaway,closing_marubozu,conceal_baby_swallow,counterattack,dark_cloud_cover,doji,doji_star,dragonfly_doji,evening_doji_star,evening_star,gap_side_side_white,gravestone_doji,hammer,hanging_man,harami,harami_cross,high_wave,hikkake,hikkake_mod,homing_pigeon,identical_three_crows,in_neck,kicking,kicking_by_length,ladder_bottom,long_legged_doji,long_line,matching_low,mat_hold,morning_doji_star,morning_star,on_neck,piercing,rickshaw_man,rise_fall_3_methods,separating_lines,shooting_star,short_line,spinning_top,stalled_pattern,stick_sandwich,takuri,tasuki_gap,thrusting,tristar,unique_3_river,upside_gap_two_crows,xside_gap_3_methods,ticket,is_buy2,is_sell2,signal,tp,sl,be,be_condition,order_type,lot,sl_updated,time_to_trail,time_tp_hit,time_sl_hit,entry_time,entry_price,exit_time,exit_price,exit,lot_size,profit,type,account_balance,success,win_streak,losing_streak,Week,Month
2024-04-01 13:30:00,2249.92,2250.66,2248.6,2249.59,976,27,0,2254.3209968176316,2253.821644061583,2246.6862561276844,2259.835595229625,-0.0005099408696757146,-8.393845597502753e-05,,,,-0.00030474560236037554,-0.0003188131336919955,2254.587812739433,2262.4945483523734,2024-04-01 13:00:00,2024-04-01 13:00:00,-3.0069696969653705,,2254.0236363636373,,,2257.894787878789,,,,,,,2253.5138316906296,,,,,,,,,,,,,,,,,,,2224.753109072126,2254.8172009604978,,,,,2024-04-01 12:00:00,2024-04-01 12:00:00,,,,,,,,,,,,2253.6651582519667,2255.050815930507,-1.4002174755137275,-0.1299156684768183,3.2248208698799354,-1.1020399560125043,-1.032888563049255,-0.8198643695022838,2260.271285801343,2247.372002321823,11.452083285718418,13.505991702125144,0,0,0,0,0,0,0,0,0,0,0,0,0,0,0,0,0,0,0,0,0,0,0,0,0,0,0,0,0,0,-100,-200,0,0,0,0,0,0,0,0,0,0,0,0,0,0,0,0,0,0,0,0,-100,0,0,0,0,0,0,0,0,0,,False,True,1.0,2149.59,2279.59,2219.59,2214.59,1,0.01,False,,,2024-04-02 23:33:58,2024-04-01 13:45:00,2249.59,2024-04-02 01:30:00,2254.63,manual,0.01,-89.67,fail,610.33,False,0,1,14,4
2024-04-02 01:15:00,2250.49,2255.09,2250.44,2254.93,627,27,0,2245.045419490022,2246.6061473607037,2249.4486666177104,2255.8207032745026,-0.00010522797874706204,-1.891828652463183e-05,,,,0.00027469895315037366,0.0002546982182420073,2237.370192874741,2248.0929637687054,2024-04-02 01:00:00,2024-04-02 01:00:00,3.1297575757571394,,2245.924848484849,,,2242.5114545454544,,,,,,,2246.609666680874,48.20681489976255,37.38458052709917,,,,,,,,,,,,,,,,,2238.531891846077,2260.423744734865,,,,,2024-04-02 00:00:00,2024-04-02 00:00:00,2251.1244444444446,,,,,,,,,,,2247.112519448911,2244.855173794099,2.173174099380958,0.5540963139705666,4.418022949879193,2.2506121700876065,1.7993200146620438,1.7489552785941669,2255.4421932604623,2237.770101460945,94.60219288831989,94.9256543987248,0,0,0,0,0,0,0,0,0,0,0,0,0,100,0,100,0,0,0,0,0,0,0,0,0,0,0,0,0,0,0,0,0,0,0,0,0,0,0,0,100,0,0,0,0,0,0,0,0,0,0,0,0,0,0,0,0,0,0,0,0,0,,True,False,0.0,2354.93,2284.93,2304.93,2319.93,0,0.01,True,2024-04-05 17:45:00,2024-04-09 10:14:59,2024-04-04 15:08:32,2024-04-02 01:30:00,2254.93,2024-04-04 15:08:32,2285.1,auto,0.01,536.63,even,1146.96,True,1,0,14,4
2024-04-03 11:00:00,2270.96,2271.27,2267.6,2269.6,2370,27,0,2278.719101300444,2278.063616202347,2267.6226732927,2276.186727656745,-6.028245463326576e-05,-2.588166657506754e-05,,,,-0.00022979812973534407,-0.0003735557843347763,2277.168906565224,2287.6397654300386,2024-04-03 11:00:00,2024-04-03 11:00:00,-3.6529090909107254,3.619457148107358,2277.9203636363623,0.00046501631306808145,0.0006223283393196386,2280.4583030303015,2234.861606763676,2258.2097910707353,2235.6123299064047,2256.947904958033,0.0006195545597268214,0.00041525833050396567,2278.1332013500023,71.71774747879807,83.31976671163567,5.42956773613693,2267.8017847921597,-1.0,2276.9259968603233,bullish,2282.676911257916,2271.3810163631833,,-1.0,,,2277.0219592093918,2271.2797641878606,2282.586265647532,,,2265.0512974718117,2304.114552159476,,,,,2024-04-03 08:00:00,2024-04-03 08:00:00,2274.6532628833684,0.0016609062343970415,2257.2598258372873,0.0016788763094341616,2287.2549414083655,bullish,2279.256190476191,2298.9930608588024,2259.5193200935796,,,2276.763191416976,2279.1807689630195,-2.323285313444103,-0.6566053098822746,5.277924206420369,-1.2591898826981378,-1.42902675952746,-1.3892467008831773,2288.6194646151876,2267.5077677895065,7.961324130449266,9.374226013104124,0,0,0,0,0,0,0,0,0,0,0,0,0,0,0,0,0,0,0,0,0,0,0,0,0,0,100,0,0,0,0,0,0,0,0,0,0,0,0,0,0,0,0,0,0,0,0,0,0,0,0,0,0,0,0,0,0,0,0,0,0,0,,False,True,1.0,2169.6,2299.6,2239.6,2234.6,1,0.01,False,,,2024-04-03 23:40:26,2024-04-03 11:15:00,2269.6,2024-04-03 18:00:00,2282.65,manual,0.01,-232.2,fail,914.76,False,0,1,14,4
2024-04-03 17:45:00,2283.74,2284.94,2281.96,2282.66,4289,27,0,2275.6492171283385,2276.3801961143686,2275.624403914895,2292.137556780634,0.0004403254654621005,0.00018513707830210928,,,,0.00032801493884029344,0.00021815065251885727,2264.674012454129,2279.0216638259844,2024-04-03 17:00:00,2024-04-03 17:00:00,0.3766060606026258,0.37448409424951024,2275.093515151515,0.0003212690520618933,0.0005329082793192958,2272.2900606060593,2244.097503648179,2269.7595927987804,2243.3753231519254,2267.1452420986725,0.0005708998485445918,0.0003212770223915552,2276.8570606438466,38.27554757527736,31.618618747000877,2.0192771545963346,,-1.0,2276.568936269388,bearish,2282.727226093186,2271.3773471461077,,-1.0,,,2277.045214979653,2270.8946726699496,2282.2573780990115,,,2274.060000000001,2304.3183185176335,2271.0699999999993,2285.880000000001,,,2024-04-03 16:00:00,2024-04-03 16:00:00,2281.031450170386,0.0012851000380088144,2261.6047698262287,0.0020511554476985764,2296.4326690688135,bullish,2284.9059523809515,2304.451014992773,2265.36088976913,,,2277.0453456088844,2275.678290885877,1.328335120337215,0.05909058668202011,3.801063760901735,1.5417925219940116,1.6840084310838392,0.7308504398815785,2283.982323636172,2268.778068592565,77.78335844634093,71.84245710497963,0,0,0,0,0,0,0,0,0,0,0,0,0,0,0,0,0,0,0,0,0,0,0,0,0,0,0,0,0,0,0,0,0,0,0,0,0,0,0,0,0,0,0,0,0,0,0,0,0,0,0,-100,0,0,0,0,0,0,0,0,0,0,,True,False,0.0,2382.66,2312.66,2332.66,2347.66,0,0.01,True,2024-04-08 06:00:00,,2024-04-08 01:18:10,2024-04-03 18:00:00,2282.66,2024-04-08 01:18:10,2312.13,auto,0.01,524.19,even,1438.95,True,1,0,14,4
2024-04-04 10:15:00,2294.64,2294.81,2292.89,2294.6,1732,27,0,2296.7053540146912,2296.6677089442815,2292.6555311099974,2298.330971433172,-0.0001970037224610826,-9.179753450270008e-05,,,,-9.105926878961075e-05,-0.0001161262137139307,2295.9127569702364,2301.293398201727,2024-04-04 10:00:00,2024-04-04 10:00:00,-1.2653939393935616,3.1818955142516643,2295.5335757575763,0.00033953918900917325,0.0002758252469972786,2297.186424242425,2255.1216389275546,2288.767017352102,2254.9444105211956,2288.1355772285374,0.00027581514123651543,0.0003212731117418437,2296.2519806901637,67.78524183982125,75.21938584714881,4.638566995248011,,-1.0,2294.9429066811413,bullish,2301.0953506504156,2289.136319698967,,1.0,,,2295.108045880258,2288.9892859866436,2300.9120126378857,,,2249.2729263745455,2298.098351434508,2271.0699999999993,2302.1600000000008,,,2024-04-04 08:00:00,2024-04-04 08:00:00,2293.4695457126686,0.001594843380065593,2275.2212144325194,0.0011092733642424466,2302.916956527742,bullish,2297.8061904761917,2313.593461931388,2282.0189190209953,,,2296.5095606181676,2297.348659143938,-0.8314340248803092,-0.3341774165916922,1.0176504803727882,-0.3579490469205666,-0.3711290322576133,-0.2424505131980368,2298.703009905027,2294.632407983536,18.092189681378418,17.762930719359165,100,100,0,0,0,0,0,0,0,-100,0,0,0,0,0,0,0,0,0,100,100,100,0,0,0,0,0,0,0,0,-100,0,0,0,0,0,0,0,0,100,0,100,0,0,0,0,0,0,0,0,0,0,-100,0,0,100,0,0,0,0,0,0,,False,True,1.0,2194.6,2324.6,2264.6,2259.6,1,0.01,False,,,2024-04-05 17:48:19,2024-04-04 10:30:00,2294.6,2024-04-04 21:30:00,2299.35,manual,0.01,-84.52,fail,1354.43,False,0,1,14,4
2024-04-04 21:15:00,2294.9,2302.54,2294.88,2299.34,3770,27,0,2292.3482696617543,2292.5138746334324,2276.472719694442,2307.3358064450663,0.0002478075488898464,-0.0003914717256223631,,,,9.365782949807265e-05,5.628289574028786e-05,2285.5168874310853,2300.1131321216976,2024-04-04 21:00:00,2024-04-04 21:00:00,1.0724242424239492,-0.4180553536102707,2294.545515151516,0.0003298872679949613,0.0003045679717396944,2290.7588484848484,2263.6099136978,2294.803824858517,2262.861142945238,2293.7567663813634,0.00031441459844257485,0.0003298907218992039,2294.3098591505454,44.46534144682898,42.903592182823466,0.20415072470565646,2283.649741280001,-1.0,2292.9529254965655,bearish,2298.9638736479496,2288.444907133141,,-1.0,,,2293.698360363177,2287.540897225115,2298.3777579325433,,,2248.6102901210197,2305.5300000000007,,2302.1600000000008,1.0,,2024-04-04 20:00:00,2024-04-04 20:00:00,2290.2709765074574,0.0012164859387543258,2281.158914676697,0.0008169482126501818,2308.058924206715,bullish,2289.896071428571,2304.698329364442,2275.0938134926996,,,2292.8252640710057,2292.182162265531,0.6351863636123198,-0.09241972690837635,4.144807207329308,1.1092943548401308,0.5771260997053105,0.4510355571856053,2300.803489048091,2284.224260218774,70.00339783794458,54.84449911693802,0,0,0,0,0,0,0,0,0,0,0,0,0,100,0,0,0,0,0,0,0,0,0,0,0,0,0,0,0,0,0,0,0,0,0,0,0,0,0,0,0,0,0,0,0,0,0,0,0,0,0,0,0,0,0,0,0,0,0,0,0,0,,True,False,0.0,2399.34,2269.34,2329.34,2334.34,0,0.01,False,2024-04-08 05:45:00,2024-04-12 10:58:08,2024-04-05 04:23:21,2024-04-04 21:30:00,2299.34,2024-04-05 01:45:00,2289.15,manual,0.01,-181.31,fail,1173.1200000000001,False,0,2,14,4
2024-04-05 01:30:00,2291.57,2291.73,2288.24,2289.25,586,28,0,2292.1886953078247,2291.7422580645166,2285.6598279725754,2295.2796359554104,-0.0007031196509786438,-0.00036654564317385475,,,,-0.00026537426828176787,-0.00023839876154930665,2282.1787408415316,2305.6915408628665,2024-04-05 01:00:00,2024-04-05 01:00:00,0.13987878787975205,-0.2979279221995057,2291.842484848486,0.0002138555804623653,0.00018448768997928136,2292.576606060607,2265.656357355505,2300.0062027788317,2265.171125598609,2298.2360840104616,0.00023221541019073001,0.00021389380672679455,2291.3669158966213,51.68729720367758,56.55114887737329,0.15047959946815936,,-1.0,2292.732157807583,bearish,2296.047620120674,2288.7737741332317,,-1.0,,,2292.407812125325,2288.661288401905,2296.8102681177156,,,2259.051203195525,2293.2889557184394,,2302.1600000000008,,,2024-04-05 00:00:00,2024-04-05 00:00:00,2287.8606510049717,0.0008020849465781412,2277.5733366993886,0.0008169299877725639,2309.9484338454226,bullish,2286.2136904761896,2298.763737886461,2273.663643065918,,,2291.3056103671415,2291.9110209658343,-0.5574926387043888,-0.19939734435753226,2.3962351423372628,-0.6652785923747615,-0.20977456011632967,-0.34012280058777833,2296.534728349191,2286.949787779842,42.7866510842743,43.74323680907179,0,0,0,0,0,0,0,0,0,0,0,0,0,0,0,0,0,0,0,0,0,0,0,0,0,0,0,0,0,0,0,0,0,0,0,0,0,0,0,0,0,0,0,0,0,0,0,0,0,0,0,-100,0,0,0,0,0,0,0,0,0,0,,False,True,1.0,2189.25,2319.25,2259.25,2254.25,1,0.01,False,,,2024-04-05 17:33:52,2024-04-05 01:45:00,2289.25,2024-04-05 11:15:00,2290.81,manual,0.01,-27.76,fail,1145.3600000000001,False,0,3,14,4
2024-04-05 11:00:00,2289.05,2291.73,2288.16,2290.79,2786,27,0,2282.8317639235293,2283.503858137829,2285.416856841031,2295.4243765413603,-0.0001257418615155047,3.515323171224227e-05,,,,0.0002856055921855523,0.00011378174894135807,2275.4059528583507,2284.369635697793,2024-04-05 11:00:00,2024-04-05 11:00:00,3.6281212121216413,-2.2103284722593344,2282.7178181818185,-0.00017613713912161604,1.944189094261989e-05,2279.5121818181838,2277.4254582273697,2304.7115298984727,2272.570696249828,2304.665447740198,1.947009527092971e-05,-8.473445795127214e-05,2283.3987064431976,39.48202959830863,32.20871505755209,-2.8551312158544744,,-1.0,2284.332610004959,bullish,2289.1806451482776,2279.517922704219,2282.1321009901,-1.0,,,2284.3441747957127,2279.515293458171,2289.1601070224715,,,2274.1619617080933,2344.2043631302154,2271.739999999999,2304.020000000001,,,2024-04-05 08:00:00,2024-04-05 08:00:00,2285.69695600221,-0.00018800268799781705,2268.250801424971,8.265912706326629e-05,2305.669319924815,bullish,2283.5057142857145,2295.0875811473247,2271.923847424104,,,2284.067642563995,2282.3216909207536,1.711993642823927,0.23782689151625147,4.831203451103106,1.8340450879754826,1.687423020528513,1.5313013196464453,2293.1662650400353,2273.8414512356226,93.73520922213201,95.12994557380294,0,0,0,0,0,0,0,0,0,0,0,0,0,0,0,0,0,0,0,0,0,0,0,0,0,0,0,0,0,0,0,0,0,0,0,0,0,0,0,0,100,0,0,0,0,0,0,0,0,0,0,0,0,0,0,0,0,0,0,0,0,0,,True,False,0.0,2390.79,2320.79,2340.79,2355.79,0,0.01,True,2024-04-09 11:30:00,2024-04-12 04:57:42,2024-04-05 22:14:06,2024-04-05 11:15:00,2290.79,2024-04-05 22:14:06,2320.82,auto,0.01,534.14,even,1679.5,True,1,0,14,4
2024-04-08 03:00:00,2311.27,2311.96,2308.16,2308.17,1903,27,0,2314.0913258518744,2313.0099541788854,2293.03622882781,2326.026264369065,0.001065499462948858,0.001198015136449519,,,,-0.0003393079063375921,-0.0007510153806984288,2311.3456455064993,2331.844127606862,2024-04-08 03:00:00,2024-04-08 03:00:00,-5.296181818180685,6.447462394964987,2313.6282424242427,0.0004796865917311482,0.0004232282310196051,2320.0746060606075,2257.6430318369635,2305.644484083898,2258.7176289756094,2304.7676605944657,0.00042161253667616035,0.00038652335588376327,2313.6307936635753,71.3079310413323,80.81480715141802,7.517932680889588,,-1.0,2308.912121078706,bullish,2319.8706921140374,2299.0457723862246,2292.2417920792086,1.0,,,2309.434759240339,2298.57917023715,2319.291522299034,,,2301.8829083037836,2353.3158454323348,2271.739999999999,,,,2024-04-08 00:00:00,2024-04-08 00:00:00,2308.868411062165,0.0001818717393929303,2268.8258445138554,0.0015539233285132537,2328.495648839385,bullish,2313.7371428571428,2340.866493614212,2286.6077921000738,,,2313.828340774563,2315.877056800548,-2.0979127633067947,-0.42799551322793317,1.9307802827057077,-1.4571645894420726,-1.5127181085053962,-1.2451759530790696,2316.8715147442967,2309.148393613474,24.364379711256344,27.924705080704044,0,0,0,0,0,0,0,0,0,-100,0,0,0,0,0,-100,0,0,0,0,0,0,0,0,0,0,0,0,0,0,0,-200,0,0,0,0,0,0,0,0,-100,0,0,0,0,0,0,0,0,0,0,0,0,0,0,0,0,0,0,0,0,0,,False,True,1.0,2208.17,2338.17,2278.17,2273.17,1,0.01,False,,,2024-04-08 05:36:51,2024-04-08 03:15:00,2308.17,2024-04-08 05:36:51,2338.13,auto,0.01,-533.1,fail,1146.4,False,0,1,15,4
2024-04-08 05:45:00,2344.68,2350.06,2341.3,2348.06,3797,27,0,2317.9525230558625,2319.360962243401,2340.5409482877176,2351.117721399953,-0.00033663450640389754,-0.00027444122936910145,,,,0.0006117105192238669,0.00011550630194599383,2301.702830196763,2339.340152982271,2024-04-08 05:00:00,2024-04-08 05:00:00,0.9266060606059909,5.3228324662418345,2323.272121212121,0.0005030039935705908,0.0006627357835710112,2314.5548484848487,2259.435334503515,2305.8288823569706,2258.2897979841914,2305.4942497520783,0.00044346779871354985,0.0005030078318141241,2323.1188751791997,66.98558235333196,64.716755699579,6.621569126213118,,-1.0,2311.1821712910833,bullish,2325.451582071044,2303.7687770866446,2294.357136633664,-1.0,,,2314.5847894173185,2300.8006537641386,2321.6105316012067,,,2308.960317839783,2354.0600000000004,2271.739999999999,2329.3600000000006,,,2024-04-08 04:00:00,2024-04-08 04:00:00,2319.93894070811,0.0017152510815250704,2282.297101227718,0.002062727231869406,2332.984374840126,bullish,2326.8433333333314,2360.851565461746,2292.835101204917,,,2325.9710073868982,2320.7461616455466,4.786533275451347,0.9690156891614992,14.34712216041049,3.7043676686198523,3.503335777124903,1.4237719941374962,2348.055206564222,2290.66671792258,83.50844859584986,86.89689412782722,0,0,0,0,0,0,0,0,0,0,0,0,0,0,0,0,0,0,0,0,0,0,0,0,0,0,0,0,0,0,0,0,0,0,0,0,0,0,0,0,0,0,0,0,0,0,0,0,0,0,0,0,0,0,0,0,0,0,0,0,0,0,,True,False,0.0,2448.06,2398.06,2418.06,2443.06,0,0.01,True,,,2024-04-12 18:27:50,2024-04-08 06:00:00,2348.06,2024-04-08 17:00:00,2327.32,manual,0.01,-369.05,fail,777.3500000000001,False,0,2,15,4
2024-04-08 16:45:00,2331.21,2334.13,2326.87,2327.28,4986,27,0,2333.1803527632223,2332.5209035923735,2317.4275004212527,2334.1300000000006,0.0003051853851032093,0.00018434690781617632,,,,-0.0002740712665095968,-0.0003829969717318828,2327.212519992893,2342.8667891291334,2024-04-08 16:00:00,2024-04-08 16:00:00,-1.9306060606068058,4.801206013011779,2332.3883636363653,0.0007993104800040403,0.0009608551338020921,2334.3260606060603,2267.0772103740874,2308.7124148960766,2265.2972399293194,2317.707039312784,0.0007322271365940051,0.0007985844819486538,2333.1031988250234,63.582536274318535,67.0375431062529,7.03630223461384,2311.3471021460737,-1.0,2331.7707387728424,bullish,2342.3979569307207,2321.382974180818,2304.7753643564365,1.0,,,2331.866792073447,2320.9691165288514,2342.622630984784,,,2317.865695826806,2354.7111507326827,2306.13,2348.0599999999995,,,2024-04-08 16:00:00,2024-04-08 16:00:00,2327.178204654255,0.0025614361264245577,2307.2768662727326,0.0035118711318177704,2360.294767456814,bullish,2333.417976190478,2367.608215294646,2299.22773708631,,,2331.7740067920968,2333.651834164736,-1.7932742171560676,-0.8908517684008801,3.338698420470313,-1.0148148826979195,-0.4531726539603369,-0.09015945747978549,2339.198300433314,2325.843506751433,37.6749363867683,36.540500424087675,0,0,0,0,0,0,0,-100,0,0,0,0,0,0,0,-100,0,0,0,0,0,0,0,0,0,0,0,0,0,0,0,0,0,0,0,0,0,0,0,0,0,0,0,0,0,0,0,0,0,0,0,0,0,0,0,0,0,0,0,0,0,0,,False,True,1.0,2227.28,2357.28,2297.28,2292.28,1,0.01,False,,,2024-04-09 11:33:30,2024-04-08 17:00:00,2327.28,2024-04-08 22:00:00,2338.86,manual,0.01,-206.05,fail,571.3000000000002,False,0,3,15,4
2024-04-08 21:45:00,2339.86,2340.51,2337.55,2338.83,1629,27,0,2332.834615603011,2332.9455993401766,2335.9508317072286,2340.5099999999998,3.65799978176537e-05,2.8064016440616142e-05,,,,0.00034261690850467146,0.00032082508825990536,2323.5115804417032,2334.48336555218,2024-04-08 21:00:00,2024-04-08 21:00:00,2.0361818181822855,1.961439173821418,2332.2224242424236,0.0006676521853177515,0.0010065623108942803,2330.098545454544,2276.857011815432,2318.2213578267383,2275.329806166302,2312.9205559213783,0.0010854550145279072,0.0006676749180227348,2333.657306011146,42.79333997877956,40.03605166729496,3.681639229313493,2315.4509233382414,-1.0,2332.364209260016,bullish,2341.9662778024945,2324.0019888369384,2308.4507287128718,1.0,,,2332.9668423280345,2322.8019004160474,2341.9658833853773,,,2332.4244609790785,2367.7515966282176,2327.2799999999997,2340.0199999999995,,,2024-04-08 20:00:00,2024-04-08 20:00:00,2331.12213643617,0.0024684448964856238,2311.5235553937887,0.0035119205095168245,2368.596845313624,bullish,2333.8497619047625,2363.1986419941327,2304.5008818153924,,,2335.4708266170996,2333.4487020299985,1.9016266183011794,0.5584724976151562,4.198094593298646,1.2665102639302859,1.5114241202340963,1.5817063782983496,2341.341788526774,2324.549410153579,88.52037233779926,90.85811582769357,0,0,0,0,0,0,0,0,0,0,0,0,0,0,0,0,0,0,0,0,0,0,0,0,0,0,0,0,0,0,0,0,0,0,0,0,0,0,0,0,0,0,0,0,0,0,0,0,0,0,0,0,0,0,0,0,0,0,0,0,0,0,,True,False,0.0,2438.83,2388.83,2408.83,2433.83,0,0.01,True,,,2024-04-12 18:31:22,2024-04-08 22:00:00,2338.83,2024-04-12 18:31:22,2389.19,auto,0.01,895.74,even,1467.0400000000002,True,1,0,15,4
2024-04-09 18:15:00,2344.34,2350.37,2344.18,2345.69,4507,27,0,2351.5795163145754,2351.0936675219914,2337.1213002928857,2350.3700000000003,0.0002157530489759008,6.729127806941435e-05,,,,0.00014299082617684895,-6.657711068410703e-05,2345.451268141927,2361.3562187152465,2024-04-09 18:00:00,2024-04-09 18:00:00,-0.9921818181819617,3.9488808707078533,2350.610424242426,0.0004113817797106526,0.0001580581781633672,2355.484484848483,2308.290414350682,2355.83313482957,2308.380196721113,2355.4626455145926,0.00015807769872257566,0.0005057179040548984,2349.995243224665,53.57056933631221,55.82074554243304,4.562260526160712,,-1.0,2349.1775724794516,bullish,2354.015672501191,2343.6868824136045,2325.2707326732684,1.0,,,2348.845599999515,2344.2866847086166,2354.0786641145764,,,2333.753841986484,2369.0023266317,,2363.159999999999,,,2024-04-09 16:00:00,2024-04-09 16:00:00,2345.5931619998246,0.002285398408777212,2338.6934146701674,0.0005926586197195692,2363.5127995588696,bullish,2349.8146428571426,2363.0157901557795,2336.6134955585057,,,2351.430241612866,2352.392225530789,-0.9810828638937892,0.06527068416927634,6.7086378221327685,-1.2252749266890532,-1.2832093108495428,-0.8813178152508954,2364.5109431662568,2337.676391877726,17.076611160037718,25.68052346819889,0,0,0,0,0,0,0,0,0,0,0,0,0,0,0,0,0,0,0,0,0,0,0,0,0,0,0,0,100,0,0,0,0,0,0,0,0,0,0,0,0,0,0,0,0,0,0,0,0,0,0,0,0,0,0,0,0,0,0,0,0,0,,False,True,1.0,2245.69,2375.69,2315.69,2310.69,1,0.01,False,,,2024-04-11 23:24:20,2024-04-09 18:30:00,2345.69,2024-04-10 01:45:00,2353.73,manual,0.01,-143.06,fail,1323.9800000000002,False,0,1,15,4
2024-04-10 01:30:00,2352.68,2354.06,2352.68,2353.83,263,27,0,2350.119001653984,2350.164006598242,2347.593263936721,2356.113024684402,-0.00012502583103765106,-4.997047918921241e-05,,,,0.00018502477445038652,0.00022425207026756085,2344.0042511077677,2351.2568360193422,2024-04-10 01:00:00,2024-04-10 01:00:00,1.4998787878789699,1.371116949970201,2350.1159393939433,0.00034899413021370623,0.0003412164065538,2348.7507878787906,2317.6487083334027,2349.795977528682,2316.8400545956097,2350.993385332868,0.0002991816797155105,0.0003489935954304983,2350.480907250548,47.50675509702773,40.76803406206492,2.1295689059980063,,-1.0,2349.672179841434,bullish,2354.8532406290346,2345.07814244945,2329.5051148514863,1.0,,,2349.960608877392,2344.6795631380933,2354.675427516247,,,2317.6766705015602,2363.1375507493876,2340.2200000000007,2363.159999999999,,,2024-04-10 00:00:00,2024-04-10 00:00:00,2349.099183111033,0.0013959918570317779,2337.3796631269097,0.0013161967095737179,2367.647157494026,bullish,2351.628095238096,2366.136941591281,2337.1192488849115,,,2351.5497418132068,2350.4423533125137,1.0419564225057911,0.4486067736304185,0.8703324487724475,0.8182129765418722,0.5908266129026742,0.5264827712585429,2351.9046714957867,2348.423341700697,83.81981981982211,82.42321848204433,0,0,0,0,0,0,0,0,0,0,0,0,0,0,0,0,0,0,0,0,0,0,0,0,0,0,0,0,0,0,0,200,0,0,0,0,0,0,0,0,0,0,0,0,0,0,0,0,0,0,0,100,0,0,0,0,0,0,0,0,0,0,,True,False,0.0,2453.83,2323.83,2383.83,2388.83,0,0.01,False,2024-04-12 05:00:00,,2024-04-10 16:13:29,2024-04-10 01:45:00,2353.83,2024-04-10 13:30:00,2348.03,manual,0.01,-103.2,fail,1220.7800000000002,False,0,2,15,4
2024-04-10 13:15:00,2347.63,2348.36,2346.24,2348.03,1653,27,0,2352.5275705482477,2352.0707074780053,2336.368867177547,2353.210577671662,-0.000567358411135126,-2.480800447481038e-05,,,,-0.00022853521220908397,-0.00030898697207233883,2350.826750618677,2358.0696347606727,2024-04-10 13:00:00,2024-04-10 13:00:00,-1.595515151516338,0.6403870315789391,2351.5327272727286,0.00019328029711528013,-2.5144324811018314e-05,2353.3099999999995,2331.0136014807717,2365.700493422227,2329.686935757163,2364.4683978021417,4.115708006356733e-05,0.00020798221608846312,2351.3842419414186,47.81505279086222,64.09211933902337,1.426119510091756,2344.530689281728,-1.0,2352.349722107639,bearish,2355.8838993255727,2348.171146077418,2337.2595821782197,1.0,,,2352.024361248128,2348.4542265480754,2356.2516793156706,,,2306.255811645721,2350.059982057258,2349.3199999999993,2354.7400000000002,,,2024-04-10 12:00:00,2024-04-10 12:00:00,2347.740869069936,0.0009115009528148187,2344.0501568924315,0.0004592621068451994,2369.3623531082008,bullish,2348.328690476191,2358.2314275978333,2338.4259533545483,,,2350.9289530422143,2352.3839330759233,-1.3721115742782786,-0.491116397515418,2.871142132118837,-0.8621260997088029,-0.96705645161137,-0.9870216275649,2357.812991742243,2346.3284232137676,21.863735661110486,20.277334375313583,0,0,0,0,0,0,0,0,0,0,0,0,0,0,0,0,0,0,0,0,0,0,0,0,0,0,0,0,0,0,0,0,0,0,0,0,0,0,0,0,0,0,0,0,0,0,0,0,0,0,0,0,0,0,0,0,0,0,0,0,0,0,,False,True,1.0,2248.03,2378.03,2318.03,2313.03,1,0.01,False,,,2024-04-12 01:24:06,2024-04-10 13:30:00,2348.03,2024-04-12 01:24:06,2377.94,auto,0.01,-532.19,fail,688.5900000000001,False,0,3,15,4
2024-04-11 04:45:00,2340.09,2342.17,2339.09,2340.56,1923,27,0,2336.8291714146108,2337.461913489736,2339.1126297534233,2347.603924420574,-0.0001272743655798029,-6.962389483533363e-05,,,,0.00019352277415003215,0.00011999594038299561,2331.69284054909,2337.0800194232406,2024-04-11 04:00:00,2024-04-11 04:00:00,-0.2814545454530162,-3.397445832206813,2335.756000000002,-0.0003875601940977096,-0.00020258112190588747,2332.861636363637,2337.4680729220327,2366.1685300977706,2337.5552634341293,2365.4711413154673,-0.0001676256117927853,-0.0003710678570697907,2336.6177081062283,46.547784134218695,42.04232673312311,-3.597358651638124,,-1.0,2339.0127897776865,bearish,2343.45810239374,2334.114757862739,2340.1768831683194,-1.0,,,2338.7817643444714,2334.32870884255,2343.7062698236355,,,2321.1068783845776,2343.399848094166,2333.830000000001,2357.3500000000004,1.0,,2024-04-11 04:00:00,2024-04-11 04:00:00,2340.19486302616,-0.0013564273408981416,2316.82354449684,-0.0008501015219670319,2354.5574517109635,bullish,2336.8564285714297,2349.53828135406,2324.1745757887993,,,2337.297711498518,2336.2405309902924,1.0453615159958645,0.26065016557776866,2.930485089053031,0.897531158359925,0.8336052052768537,0.9198790322575405,2343.3228836678422,2331.60094331163,86.33280570140107,85.07206833533921,0,0,0,0,0,0,0,0,0,0,0,0,0,0,0,0,0,0,0,0,0,0,0,0,0,0,0,0,0,0,100,0,0,0,0,0,0,0,0,0,0,0,0,0,0,0,0,0,0,0,0,0,100,0,0,0,0,0,0,0,0,0,,True,False,0.0,2440.56,2390.56,2410.56,2435.56,0,0.01,True,,,2024-04-12 18:31:14,2024-04-11 05:00:00,2340.56,2024-04-11 11:30:00,2332.2,manual,0.01,-148.75,fail,539.8400000000001,False,0,4,15,4
2024-04-11 11:15:00,2332.35,2333.47,2330.56,2332.29,2766,27,0,2338.561075266592,2337.803685850439,2324.752615811226,2333.4469801213777,0.00018489069167394658,0.0002737106953532222,,,,-0.0002514281286203768,-0.0003362123907476235,2336.3078526595496,2344.9145456032215,2024-04-11 11:00:00,2024-04-11 11:00:00,-1.41787878787909,-0.7852804892440872,2336.466787878787,-0.00029789350089481415,-0.0002770946247894481,2340.1784242424255,2328.3709790595617,2363.9158015503085,2330.527181339647,2364.5706063612874,-0.0002771215777923897,-0.00034204884714556655,2336.407603918597,57.58475772784559,63.5726065593403,-1.2707962655171006,2326.4273179388383,-1.0,2338.736331555013,bearish,2343.058411656152,2332.680457724053,2341.270718811884,-1.0,,,2337.8636761317516,2333.756082530281,2343.7272084600672,,,2325.612187807008,2356.5731803332874,2333.830000000001,2343.860000000001,,1.0,2024-04-11 08:00:00,2024-04-11 08:00:00,2336.0999086841066,-0.0013563734567398362,2313.6729464438317,-0.0010525887844427143,2350.760081052227,bullish,2332.726071428571,2347.688122090171,2317.7640207669706,,,2336.723549846613,2338.235482072528,-1.4262380258282974,-0.49828823918313003,2.5798529166348474,-1.223453079180672,-1.2096774193551028,-0.6911620234586735,2342.9633916837083,2332.6439800171693,13.738370517788335,19.951410286127118,100,0,0,0,0,0,0,0,0,0,0,0,0,0,0,0,0,0,0,100,0,0,0,0,0,0,0,0,100,100,-100,0,0,100,0,0,0,0,0,100,0,100,0,0,0,0,0,100,0,0,0,0,-100,0,0,0,0,0,0,0,0,0,,False,True,1.0,2232.29,2362.29,2302.29,2297.29,1,0.01,False,,,2024-04-11 21:15:52,2024-04-11 11:30:00,2332.29,2024-04-11 16:45:00,2342.8,manual,0.01,-186.99,fail,352.85000000000014,False,0,5,15,4
2024-04-11 16:30:00,2342.55,2346.1,2341.33,2342.79,5304,27,0,2337.649636040164,2338.078748167155,2326.95943922857,2346.4776602288925,0.0005709690555226559,0.0003759566671744322,,,,0.00031863630086481274,0.00024733139776834733,2328.066923546654,2338.9273632403288,2024-04-11 16:00:00,2024-04-11 16:00:00,1.766606060607046,-0.6519310906519422,2337.88793939394,-1.388420247004605e-05,-0.00017628506926903537,2335.4344848484834,2319.4654565355445,2360.322479310516,2320.907818027751,2361.0087677380416,-0.0002269292337784639,-7.96168544558961e-05,2338.6181276407706,63.05372290292144,47.19342339511899,-1.3785266925432489,,-1.0,2337.3596114954235,bullish,2342.579236392437,2332.9623987228883,2341.665786138617,-1.0,,,2337.7658724800763,2332.3687087612616,2342.361193977606,,,2332.2242335813726,2385.902188716504,2333.830000000001,2343.860000000001,,,2024-04-11 16:00:00,2024-04-11 16:00:00,2341.7732927484917,-0.0006454028858649244,2313.581108839555,-0.0009579788719152849,2347.0965381067813,bullish,2340.9409523809504,2354.756358274383,2327.125546487518,7.754029049433124,7.7388500199723325,2339.18182901451,2337.8204372050664,1.2841153482613663,0.4003615502590627,3.1239615417469824,1.029255865102641,1.1132313049847653,1.0200568181835479,2344.326671250649,2331.8308250836612,80.97129421640871,80.25722106480391,100,0,0,0,0,0,0,0,0,0,0,0,0,0,0,0,0,0,0,100,0,0,0,0,0,0,0,0,0,0,100,0,0,0,0,0,0,0,0,100,0,0,0,0,0,0,0,100,0,0,0,0,100,0,0,0,0,0,0,0,0,0,,True,False,0.0,2442.79,2392.79,2412.79,2437.79,0,0.01,True,,,2024-04-12 18:30:51,2024-04-11 16:45:00,2342.79,2024-04-12 18:30:51,2392.94,auto,0.01,892.0,even,1244.8500000000001,True,1,0,15,4
2024-04-12 20:00:00,2369.24,2372.95,2359.18,2360.24,5610,27,0,2391.9947487352574,2389.853775659824,2330.1282122170014,2372.95,0.00019788966268840212,2.305105292282772e-06,,,,8.821827162722232e-05,-0.0007474042076288564,2378.68407733665,2430.766519741031,2024-04-12 20:00:00,2024-04-12 20:00:00,-9.826424242420671,4.470742644252823,2383.112242424241,0.00027691555541469267,0.0009970026634254807,2395.2887878787897,2326.100371817718,2361.62843436227,2325.307884091441,2359.303492526779,0.0009969156042574806,0.00048174235202291,2385.513061154655,44.82427431840453,68.77258598340897,8.690773509741117,,-1.0,2392.3846517183865,bearish,2402.8573154313394,2377.1722368944975,2361.1529702970342,-1.0,,,2389.980271772599,2380.8116889202915,2404.0138698971773,,,2307.5519805408576,2372.95,,2399.869999999999,,,2024-04-12 20:00:00,2024-04-12 20:00:00,2367.45378668121,0.002007275954316042,2354.740539498177,0.003938078122115324,2419.7138160246964,bullish,2374.1853571428574,2410.07605315172,2338.294661133995,7.77348485656075,7.75763741891699,2384.661830722799,2391.494954200047,-6.445595129005596,-1.4939114453057756,14.066129531599842,-4.260797287388868,-3.3350824780063704,-3.431774193547426,2417.9860347230237,2361.721516596624,6.160201744329413,6.354603561361846,0,0,0,0,0,0,0,0,0,0,0,0,0,0,0,-100,0,0,0,0,0,0,0,0,0,0,0,0,0,0,0,0,0,0,0,0,0,0,0,0,0,0,0,0,0,0,0,0,0,0,0,0,0,0,0,0,0,0,0,0,0,0,,False,True,1.0,2260.24,2390.24,2330.24,2325.24,1,0.01,False,,,2024-04-16 01:18:27,2024-04-12 20:15:00,2360.24,2024-04-16 01:18:27,2390.26,auto,0.01,-534.12,fail,710.7300000000001,False,0,1,15,4
2024-04-15 05:45:00,2360.13,2360.56,2358.07,2359.47,1784,27,0,2361.7830357779335,2362.714067082111,2354.3592125687856,2360.71283410176,-0.00011076784654423878,6.059404490513503e-05,,,,-0.00021091830688767683,5.357022963868974e-05,2347.850863012412,2369.176033372733,2024-04-15 05:00:00,2024-04-15 05:00:00,5.578848484849004,-7.911640311524025,2355.4123636363624,7.726105290268677e-05,0.001042723099910651,2349.835515151516,2329.273983086677,2378.222068368231,2327.483309406861,2375.735343440169,0.00104277928016346,0.0001036205618792509,2359.2217883777353,24.54253721152519,23.85634302881323,-5.190987121558515,,-1.0,2370.5095130957907,bearish,2383.080262200942,2354.5975554664305,2360.8625762376287,-1.0,,,2368.79609925773,2355.988018993589,2385.1205126578084,,,2304.120808154285,2375.093401755367,2338.68,2426.5700000000006,1.0,,2024-04-15 04:00:00,2024-04-15 04:00:00,2360.6394607472043,0.00032079806465092097,2333.6648082901656,0.004485877030511256,2439.802105265738,bullish,2357.6413095238104,2385.8481247020723,2329.4344943455485,7.774183406143321,7.75763741891699,2358.4300844318436,2358.8452694337698,-0.11757396634811812,-1.0234574429424785,3.5908723571660697,0.8899651759502376,0.6388563049872573,1.2942063783002595,2369.895811796443,2355.5323223677788,68.24671616219281,69.52217780316005,0,0,0,0,0,0,0,0,0,0,0,0,0,0,0,0,0,0,0,0,0,0,0,0,0,0,100,0,0,0,0,0,0,0,0,0,0,0,0,0,0,0,0,0,0,0,0,0,0,0,0,-100,0,0,0,0,0,0,0,0,0,0,,True,False,0.0,2459.47,2329.47,2389.47,2394.47,0,0.01,False,2024-04-16 20:00:00,,2024-04-15 17:08:20,2024-04-15 06:00:00,2359.47,2024-04-15 08:00:00,2356.55,manual,0.01,-51.95,fail,658.7800000000001,False,0,2,16,4
2024-04-15 07:45:00,2356.42,2357.32,2355.45,2356.54,764,27,0,2360.3255424117724,2360.01165872434,2352.5113887931147,2365.079179476448,-0.00022165528380592466,-0.0002801876900892264,,,,-6.121964643827277e-05,0.00020161554397162717,2350.1432519512628,2364.745609618847,2024-04-15 07:00:00,2024-04-15 07:00:00,3.300909090914047,-6.306519030964864,2360.041939393937,3.087988661691136e-05,0.0010184688746682413,2358.7132727272765,2332.146061406412,2384.292580259241,2331.4110587406017,2380.696936760609,0.0010427606190147477,4.261131485109636e-05,2358.490711487766,24.59033183121653,23.973553643770597,-5.703073222009385,,-1.0,2367.161573767495,bearish,2379.533062900152,2351.6591823672447,2360.9600435643615,-1.0,,,2365.5550674451856,2353.0897405982955,2381.317558631093,,,2307.473204796949,2380.786064661059,2338.68,2364.610000000001,,,2024-04-15 04:00:00,2024-04-15 04:00:00,2360.6394607472043,0.00032079806465092097,2333.6648082901656,0.004485877030511256,2439.802105265738,bullish,2357.6413095238104,2385.8481247020723,2329.4344943455485,7.774183406143321,7.75763741891699,2357.5398020497328,2358.149121942502,-0.41189182221478404,-0.409545179840504,0.8695647514088719,-0.7030553519061868,-0.6987426686218896,-0.504693914955169,2361.750788227158,2358.2725292215223,45.86693687855501,51.294377317586,100,0,0,0,0,0,0,0,0,0,0,0,0,0,0,0,0,0,0,100,0,0,0,0,0,0,0,0,0,0,100,0,0,0,0,0,0,0,0,100,0,0,0,0,0,0,0,100,0,0,0,0,100,0,0,0,0,0,0,0,0,0,,False,True,1.0,2256.54,2386.54,2326.54,2321.54,1,0.01,False,2024-04-23 04:45:00,,2024-04-15 22:27:19,2024-04-15 08:00:00,2356.54,2024-04-15 21:00:00,2365.35,manual,0.01,-156.75,fail,502.0300000000001,False,0,3,16,4
2024-04-15 20:45:00,2365.95,2367.06,2363.36,2365.41,3673,27,0,2354.1116161948075,2354.2776246334306,2362.542617622063,2384.0953792068885,0.00047284574494995996,0.00023783948556083947,,,,0.00022209381287640863,0.0009344782138522713,2332.5101261430673,2365.0871597182336,2024-04-15 20:00:00,2024-04-15 20:00:00,1.4167878787866357,-2.509835562470016,2356.982848484848,-0.00045362634163063746,-0.0010161501473931638,2353.468969696968,2344.6819836482796,2446.8993452400505,2348.4455274610777,2452.212682082616,-0.0011749139379413631,-0.0005558280416756665,2356.359170001662,71.89458679068127,57.26363837633051,-3.6254231334525846,,-1.0,2354.968685678031,bearish,2368.8470317092906,2342.3892078258104,2360.6538653465395,-1.0,,,2355.580973362208,2341.7055660856263,2368.306925876489,,,2354.0500000000006,2390.687916029735,2338.68,2364.610000000001,1.0,,2024-04-15 20:00:00,2024-04-15 20:00:00,2365.9334737278427,-0.0019474520217366282,2316.7698202735232,-0.004872853008853856,2375.6518505925756,bullish,2364.027261904761,2392.3557526870204,2335.6987711225015,7.773162608826274,7.760854829217725,2357.373821701285,2354.3959875508267,2.8024076745755337,0.7457901596859777,7.204845095969353,1.2945546187675063,1.3811015395885988,1.5581304985362294,2368.6873148253694,2339.867934441492,91.64481774544917,92.30928263523464,100,0,0,0,0,0,0,0,0,0,0,0,0,0,0,0,0,0,0,100,0,0,0,0,0,0,0,0,0,0,-100,0,0,0,0,0,0,0,0,100,0,0,0,0,0,0,0,100,0,0,0,0,-100,0,0,0,0,0,0,0,0,0,,True,False,0.0,2465.41,2395.41,2415.41,2430.41,0,0.01,True,,,2024-04-19 06:09:00,2024-04-15 21:00:00,2365.41,2024-04-19 06:09:00,2395.46,auto,0.01,534.52,even,1036.5500000000002,True,1,0,16,4
2024-04-16 10:30:00,2371.33,2372.8,2370.03,2371.43,2754,27,0,2379.33339304302,2379.2141239002935,2362.6179818571195,2372.776667149966,0.00013205585660384508,0.00010460462926315099,,,,-0.00012409342010238903,-0.00041142809467945767,2375.6850557506145,2389.569978330402,2024-04-16 10:00:00,2024-04-16 10:00:00,-3.3112121212107013,4.425453172881134,2377.3350909090937,-0.00011306697681541651,-0.00048745510445064,2382.6570909090906,2328.3165499702345,2423.4458782518163,2332.902392043021,2424.621913401567,-0.00048739920157613937,-0.00022735358228847817,2377.6996782817614,79.18959142154917,87.41805268460666,5.375378963218778,2362.4471464646713,-1.0,2376.6509751942394,bullish,2384.351890031247,2368.332146798532,2366.667635643569,1.0,,,2376.3285190479955,2368.9457850106423,2384.3812271399675,,,2362.9531408641083,2399.3333255518637,2348.6199999999994,2386.3100000000004,,,2024-04-16 08:00:00,2024-04-16 08:00:00,2374.125844067509,-0.0007592419160683208,2321.175552655107,-0.0019462126845890305,2394.9335104488737,bullish,2378.95119047619,2401.660539652257,2356.241841300123,7.769079408800879,7.76138207508005,2377.504574900017,2380.083896340636,-2.501708775352654,-0.6740214156423767,6.772844807420031,-1.2468126832823145,-1.3060502199441544,-1.2106873167135745,2392.759813515134,2365.6684342854533,14.880367092755739,15.721539240356288,100,0,0,0,0,0,0,0,0,0,0,0,0,0,0,0,0,0,0,100,0,0,0,0,0,0,0,0,0,0,100,0,0,0,0,0,0,0,0,100,0,0,0,0,0,0,0,100,0,0,0,0,100,0,0,0,0,0,0,0,0,0,,False,True,1.0,2271.43,2401.43,2341.43,2336.43,1,0.01,False,2024-04-22 16:45:00,,2024-04-19 04:31:47,2024-04-16 10:45:00,2371.43,2024-04-16 18:15:00,2385.34,manual,0.01,-247.5,fail,789.0500000000002,False,0,1,16,4
2024-04-16 18:00:00,2382.89,2392.92,2382.11,2385.33,6181,27,0,2374.62511040211,2375.639142228739,2377.707809891567,2399.4017163473277,7.384520236857575e-05,-7.335355986699702e-05,,,,0.0004025265661649969,-0.00014519849364883402,2366.303571068142,2382.134320670117,2024-04-16 18:00:00,2024-04-16 18:00:00,4.2066060606034625,0.44028863900120996,2378.5527272727277,0.0007269876350830298,0.00047076385988380106,2373.245151515151,2312.1318467109413,2376.110636812252,2311.3251845555137,2379.4557339355765,0.0003473071421644761,0.0006805288133579567,2377.31837113722,45.90454487909826,38.94682260125243,1.0474296571923767,,-1.0,2375.729947490868,bullish,2385.046862621978,2367.969852691672,2368.7856356435686,-1.0,,,2376.493018703337,2367.2753499591086,2384.2147401663506,,,2377.882899268252,2401.876667954634,2365.460000000001,2386.3100000000004,,,2024-04-16 16:00:00,2024-04-16 16:00:00,2382.327041807782,0.002252014883187128,2344.1446435736602,0.00132823602844626,2397.6879958902746,bullish,2386.2683333333325,2409.82439842283,2362.712268243835,7.769716120458048,7.76138207508005,2375.3313235897735,2374.4242014343486,0.9123126870649685,-0.28492893842098804,7.137101752691325,1.5651961143698827,1.361222507329785,0.15139846041165583,2389.9133457341213,2361.3649387233563,78.02942461173812,58.783152479729516,0,0,0,0,0,0,0,0,0,0,0,0,-100,0,0,0,0,0,0,0,0,0,0,0,0,0,0,0,0,0,0,0,0,0,0,0,0,0,0,0,0,0,0,0,0,0,0,0,0,0,-100,0,0,-100,0,0,0,0,0,0,0,0,,True,False,0.0,2485.33,2355.33,2415.33,2420.33,0,0.01,False,,,2024-04-17 23:52:14,2024-04-16 18:15:00,2385.33,2024-04-17 03:30:00,2381.82,manual,0.01,-62.46,fail,726.5900000000001,False,0,2,16,4
2024-04-17 03:15:00,2381.5,2384.6,2381.36,2381.81,1776,27,0,2383.9807174438656,2383.8425971407623,2380.780843400904,2388.0347532221595,-1.2778198074476175e-05,-0.00010079047797743026,,,,-0.0002863256998320147,-0.00016946777385936756,2378.6535042581404,2392.2524430153358,2024-04-17 03:00:00,2024-04-17 03:00:00,-1.5515757575753923,2.4933891632649647,2384.950484848484,0.0007270207126026041,0.00014098331007566278,2387.583636363636,2325.6202482373155,2389.972191835097,2323.9312371041074,2389.2297123597855,0.000164501990696223,0.0007270358551489395,2384.4041029691953,57.26632362505495,64.25182546701855,2.9101135134450753,2371.0161322754466,-1.0,2382.081618617562,bullish,2388.699696646459,2376.256052010484,2372.5145227722815,1.0,,,2382.4697501944815,2375.127118950859,2389.0564814325057,,,2359.464567998248,2397.21801523066,2365.460000000001,2397.3999999999996,,,2024-04-17 00:00:00,2024-04-17 00:00:00,2383.007574136792,0.002786717346507698,2362.023932610772,0.0013806527191926828,2404.5727126962474,bullish,2384.0808333333316,2403.458908637673,2364.70275802899,7.77026635100162,7.76138207508005,2384.027381660463,2384.7303687829312,-0.7437315579377355,0.014958137742243666,1.3064674287813802,-1.062412023458819,-0.8058797653970942,-0.8285648826986289,2386.455531998325,2381.2296622831996,27.13981163518673,29.397764512565914,0,0,0,0,0,0,0,0,0,0,0,0,0,0,0,0,0,0,0,0,0,0,0,0,0,0,0,0,0,0,0,0,0,0,0,0,0,0,0,0,0,0,0,0,0,0,0,0,0,0,0,0,0,0,0,0,0,0,0,0,0,0,,False,True,1.0,2281.81,2411.81,2351.81,2346.81,1,0.01,False,2024-04-22 14:30:00,,2024-04-19 04:42:57,2024-04-17 03:30:00,2381.81,2024-04-17 12:15:00,2393.7,manual,0.01,-211.56,fail,515.0300000000002,False,0,3,16,4
2024-04-17 12:00:00,2392.88,2394.25,2389.75,2393.66,3055,27,0,2383.2129960342204,2383.74874633431,2389.7737083327584,2394.2270959815764,-0.00034166426101898305,1.9624783061543905e-05,,,,0.00024883660551238795,0.00030740834935185003,2372.4199703867916,2387.5750483578668,2024-04-17 12:00:00,2024-04-17 12:00:00,3.4200000000018917,1.2961096816775353,2386.632424242421,0.00031190494453576346,0.00014200894216443122,2384.125636363636,2351.8092570647677,2392.992530688376,2348.83390831597,2392.651482194825,0.00014203820375171977,0.00034451574725474586,2386.0011532275635,52.702992710505406,38.29648733501018,1.0418201774075944,,-1.0,2383.3830941199617,bullish,2389.9580709147463,2378.2384791413274,2375.4350831683214,1.0,,,2384.0910737184154,2377.529548565916,2389.251051270101,,,2346.4531600698488,2394.2311967274954,2382.3400000000006,2397.3999999999996,,,2024-04-17 12:00:00,2024-04-17 12:00:00,2385.1307627071974,0.0008015301371876952,2368.775984766303,0.0003182463301572534,2400.292855724164,bullish,2387.5278571428566,2399.2186570513663,2375.837057234347,7.774386139403184,7.76138207508005,2385.900217203674,2383.6951374651817,2.0748554847832565,0.4089839728228883,5.49889583068471,1.4111235337236394,1.4118658357765526,0.9735098973606,2394.7465379956793,2372.7509546729407,95.89586305502957,94.85246134050068,0,0,0,0,0,0,0,0,0,0,0,0,0,0,0,0,0,0,0,0,0,0,0,0,0,0,0,0,0,0,0,0,0,0,0,0,0,0,0,0,0,0,0,0,0,0,0,0,0,0,0,0,0,0,0,0,0,0,0,0,0,0,,True,False,0.0,2493.66,2363.66,2423.66,2428.66,0,0.01,False,,,2024-04-17 19:45:22,2024-04-17 12:15:00,2393.66,2024-04-17 19:15:00,2380.79,manual,0.01,-229.0,fail,286.0300000000002,False,0,4,16,4
2024-04-17 19:00:00,2382.13,2384.35,2380.4,2380.8,4516,27,0,2386.493533901368,2386.257318548387,2362.281361746668,2384.349999999999,-0.00017343120695123836,-0.00022345520027352588,,,,4.00513146701491e-05,6.164739122075616e-05,2378.77693428592,2394.8828531296094,2024-04-17 19:00:00,2024-04-17 19:00:00,-2.5354545454551953,1.1750656715230434,2382.916606060604,-2.5430760897813146e-05,-3.9513553787292715e-05,2388.0388484848486,2362.906070219496,2398.949370047578,2359.0988837480895,2398.2451084801223,-3.3970019629889567e-06,0.00025682504758571246,2383.54391536146,70.56904174238589,71.1219876893423,1.526154829830062,2373.9287679999993,-1.0,2385.776409489458,bearish,2390.1637529070113,2379.524112628418,2377.315590099014,1.0,,,2384.8379993560707,2380.7237000739015,2390.839842481395,,,2351.769923699087,2384.328686553342,2382.3400000000006,2397.3999999999996,,,2024-04-17 16:00:00,2024-04-17 16:00:00,2380.863841804798,0.00046605032682083225,2367.643189961785,-4.036181449087922e-05,2397.8045088934696,bullish,2381.80511904762,2394.6866718461297,2368.92356624911,7.774185036927459,7.76138207508005,2386.4316532636285,2386.9109952119925,-0.5088373400067212,0.49427129752022453,4.722759483863459,-1.15807917888651,-1.054340175950074,-0.7898405425221426,2395.702837516114,2376.81179958066,24.25575638180256,35.08700548787555,0,0,0,0,0,100,0,0,0,0,0,0,0,0,0,0,0,0,0,0,0,0,0,0,0,0,0,0,0,0,0,0,0,0,0,0,0,0,0,0,0,0,0,0,0,0,0,0,0,0,0,0,0,0,0,0,0,0,0,0,0,0,,False,True,1.0,2280.8,2410.8,2350.8,2345.8,1,0.01,False,2024-04-22 14:30:00,,2024-04-19 04:42:52,2024-04-17 19:15:00,2380.8,2024-04-19 04:42:52,2411.16,auto,0.01,-540.19,fail,-254.15999999999985,False,0,5,16,4
2024-04-18 07:30:00,2375.04,2376.53,2374.15,2374.74,1143,27,0,2372.6272988734618,2373.0355315249253,2373.2485119108787,2379.0108185985314,5.318645160051041e-05,8.446525645989328e-05,,,,0.0001737417195718369,0.0003140246747729509,2364.583647068471,2373.102904853606,2024-04-18 07:00:00,2024-04-18 07:00:00,1.9233939393920991,-2.730100818741448,2371.966848484849,-0.0001307853294911533,-5.297465744919975e-05,2370.0995151515144,2362.005403890436,2397.794068071523,2362.3301161160084,2397.9220413064327,-5.299379466113254e-05,-0.0001314325900431329,2372.36975912256,41.86803352046163,37.68068776611548,-3.2228809065601602,,-1.0,2374.5258843206375,bearish,2379.595801383132,2368.907833494031,2376.3093089108957,-1.0,,,2374.2458032912277,2369.192403051406,2379.871372222345,,,2367.9431344093714,2407.993019413812,2360.65,2392.890000000001,,,2024-04-18 04:00:00,2024-04-18 04:00:00,2373.450397571792,-0.0005418210190497811,2354.8256714763406,-0.0001854246329628905,2395.1377747064216,bearish,2370.561904761905,2386.9295442527036,2354.194265271107,7.773426978828559,7.765602009671191,2372.995539909085,2371.971258884303,1.0244617304861094,0.36639193044136914,0.931794543404191,0.7488123167145204,0.6742723607030712,0.4704398826979741,2374.899120611734,2371.1719424381167,88.30213840745544,90.39766462156128,0,0,0,0,0,0,0,0,0,0,0,0,0,0,0,0,0,0,0,0,0,0,0,0,0,0,0,0,0,0,0,0,0,0,0,0,0,0,0,0,0,0,0,0,0,0,0,0,0,0,0,0,-100,0,0,0,0,0,0,0,0,0,,True,False,0.0,2474.74,2404.74,2424.74,2439.74,0,0.01,True,,,2024-04-19 04:53:38,2024-04-18 07:45:00,2374.74,2024-04-19 04:53:38,2404.68,auto,0.01,532.55,even,278.3900000000001,True,1,0,16,4
2024-04-18 23:45:00,2377.74,2379.0,2376.71,2378.29,621,30,0,2381.0110917572574,2380.9934897360713,2363.822115900022,2378.979916293794,0.0004154735067564309,0.001012415904805829,,,,-0.00021384260822157519,-0.00011857873655239675,2379.5478160394587,2387.2725231498666,2024-04-18 23:00:00,2024-04-18 23:00:00,-1.1400606060592509,1.363190178152763,2381.5690909090904,0.00019972766048730406,-5.341670915604005e-05,2382.823393939395,2350.644563243084,2395.764722961731,2351.5541646178035,2395.892298192389,-5.339712631931069e-05,0.00013615722802620654,2381.2833457003408,54.506252695126506,63.60658825395345,1.4822074016570537,,-1.0,2380.5055958622106,bullish,2385.1463801638847,2375.873223591069,2378.0626574257467,1.0,,,2380.5052864836357,2375.2196527922465,2385.803302557533,,,2376.72935305844,2421.8496165347515,2360.65,,,,2024-04-18 20:00:00,2024-04-18 20:00:00,2380.6782266808477,0.000199035823612986,2356.281238416777,-0.00019585506633549177,2393.239287670601,bullish,2382.9891666666676,2397.253112824752,2368.7252205085833,7.77321312572529,7.772493788849543,2380.221972631735,2381.1360004960366,-0.8751804048388294,-0.3059131558637275,2.053768313460416,-0.24348790322528657,-0.42244501466166184,-0.38782074780237963,2385.1010263629923,2376.8859531091503,7.688936473208268,9.28943622350499,0,0,0,0,0,0,0,0,0,0,0,0,0,0,0,0,0,0,0,0,0,0,0,0,0,0,0,0,0,0,0,0,0,0,0,0,0,0,0,0,0,0,0,0,0,0,0,0,0,0,0,0,100,0,0,0,0,0,0,0,0,0,,False,True,1.0,2278.29,2408.29,2348.29,2343.29,1,0.01,False,2024-04-22 14:30:00,,2024-04-19 04:34:18,2024-04-19 00:00:00,2378.29,2024-04-19 01:30:00,2380.27,manual,0.01,-35.23,fail,243.1600000000001,False,0,1,16,4
2024-04-19 01:15:00,2380.06,2380.47,2379.44,2380.25,223,27,0,2380.9298337672744,2381.1734879032256,2362.401741768206,2380.522498644965,0.0005756064796848462,0.0011107459177554073,,,,-0.0002138415702967638,-0.00015200535911528168,2379.239713347547,2386.251334228253,2024-04-19 01:00:00,2024-04-19 01:00:00,-1.254303030304527,0.784103788468201,2380.461878787879,0.0002561580430180733,-5.341132845085442e-05,2381.5690909090904,2350.1558037089103,2395.6367318841744,2350.644563243084,2395.764722961731,-5.341670915604005e-05,0.00019972766048730406,2380.7937133224873,45.235015092711954,55.129126539216486,1.342586679019283,,-1.0,2380.5052864836357,bearish,2384.438824212547,2376.6283011927844,2378.1480653465387,1.0,,,2380.5303594128736,2375.873223591069,2385.1463801638847,,,2376.0428780018797,2424.1879882472645,2360.65,2387.909999999999,,,2024-04-19 00:00:00,2024-04-19 00:00:00,2380.2621511205652,0.0011115192160746972,2367.037522894836,-0.00019578331569016693,2392.7734886255716,bullish,2383.5379761904765,2395.6879288653104,2371.3880235156425,7.769766637357064,7.772493788849543,2380.2051993398813,2380.9965710699903,-0.7478469902748657,-0.4760941423411577,1.1141099905708047,0.33426136363596015,-0.1542631964816792,-0.24348790322528657,2383.401707884367,2378.945267922084,33.1029294211676,19.915371420129222,100,0,0,0,0,0,0,0,0,0,0,0,0,0,0,0,0,0,0,100,0,100,0,0,0,0,0,-100,0,0,0,0,0,0,0,0,0,0,0,100,0,0,0,0,0,0,0,100,0,0,0,0,100,0,0,100,0,0,0,0,0,0,,True,False,0.0,2480.25,2350.25,2410.25,2415.25,0,0.01,False,,,2024-04-22 14:07:42,2024-04-19 01:30:00,2380.25,2024-04-19 01:45:00,2379.43,manual,0.01,-14.59,fail,228.5700000000001,False,0,2,16,4
2024-04-19 01:30:00,2380.27,2380.28,2379.37,2379.44,298,27,0,2380.8571589493586,2380.672723607039,2368.318033191692,2383.169946557377,0.00032195987936125246,0.001110687068238225,,,,-0.0002083323955451739,-0.00015200309852431273,2378.878216263666,2385.830326344946,2024-04-19 01:00:00,2024-04-19 01:00:00,-1.254303030304527,0.784103788468201,2380.461878787879,0.0002561580430180733,-5.341132845085442e-05,2381.5690909090904,2350.1558037089103,2395.6367318841744,2350.644563243084,2395.764722961731,-5.341670915604005e-05,0.00019972766048730406,2380.7937133224873,45.235015092711954,55.129126539216486,1.342586679019283,,-1.0,2380.5052864836357,bearish,2384.438824212547,2376.6283011927844,2378.1480653465387,1.0,,,2380.5303594128736,2375.873223591069,2385.1463801638847,,,2376.0428780018797,2424.1879882472645,2360.65,2387.909999999999,,,2024-04-19 00:00:00,2024-04-19 00:00:00,2380.2621511205652,0.0011115192160746972,2367.037522894836,-0.00019578331569016693,2392.7734886255716,bullish,2383.5379761904765,2395.6879288653104,2371.3880235156425,7.769766637357064,7.772493788849543,2380.087476364515,2380.88126950925,-0.7445262592286781,-0.5297805657186618,0.9642900791799364,-0.5007642961863894,0.33426136363596015,-0.1542631964816792,2382.6013037653993,2378.744143448679,37.939613706957175,29.998930498045524,0,0,0,0,-100,0,0,0,0,0,0,0,0,0,0,0,0,0,0,0,0,0,0,0,0,0,0,0,0,0,0,0,0,0,0,0,0,0,0,0,0,0,0,0,0,0,0,0,0,0,0,-100,0,0,0,0,0,0,0,0,0,0,,False,True,1.0,2279.44,2409.44,2349.44,2344.44,1,0.01,False,2024-04-22 14:30:00,,2024-04-19 04:34:31,2024-04-19 01:45:00,2379.44,2024-04-19 04:34:31,2409.23,auto,0.01,-530.03,fail,-301.45999999999987,False,0,3,16,4
2024-04-19 04:30:00,2395.65,2415.17,2395.45,2412.89,7076,27,0,2382.694715328379,2383.8067063782987,2388.4016781510204,2419.7246355203856,-0.0003324482924561732,-0.0007833030363508433,,,,0.000749063702907617,-0.00013021712692097906,2375.5606554871492,2394.972169583999,2024-04-19 04:00:00,2024-04-19 04:00:00,-0.8491515151499698,0.13065256013442195,2387.2401212121217,0.00031158876221312103,0.00025815667803881677,2379.3891515151513,2351.411912300685,2398.4280300959012,2350.6775353741687,2395.380897721052,-5.339903108753948e-05,0.00031160949056651836,2386.736465939113,42.82018111254833,41.90982703272462,0.8176983408308,,-1.0,2380.5846687770863,bullish,2388.0826406309898,2377.6067592490067,2379.0582514851526,1.0,,,2382.8389429437857,2376.9916519990006,2384.1831166931215,,,2378.710000000001,2431.6763766413414,,2387.909999999999,1.0,,2024-04-19 04:00:00,2024-04-19 04:00:00,2381.3281007470437,0.0011573748718412638,2370.2988247990606,-0.00019587470036743488,2392.303363833484,bullish,2383.3389285714284,2395.5104671964627,2371.167389946394,7.774129465493193,7.772493788849543,2387.2209843066116,2383.765310344449,3.218674828995063,0.3865340665081793,13.2213398256508,3.7349816715523048,1.848850806453811,1.1496792522007127,2410.2493860296004,2357.364026726997,89.80595854924536,79.2090338959599,0,0,0,0,0,0,0,0,0,0,0,0,0,100,0,0,0,0,0,0,0,0,0,0,0,0,0,0,0,0,0,0,0,0,0,0,0,0,0,0,0,0,0,0,0,0,0,0,0,0,0,0,0,0,0,0,0,0,0,0,0,0,,True,False,0.0,2512.89,2382.89,2442.89,2447.89,0,0.01,False,,,2024-04-19 06:19:13,2024-04-19 04:45:00,2412.89,2024-04-19 06:19:13,2383.33,auto,0.01,-525.94,fail,-827.3999999999999,False,0,4,16,4
2024-04-19 10:45:00,2388.44,2389.22,2384.47,2385.28,2293,27,0,2386.4717154646883,2385.7671939149564,2378.869503665344,2389.1962401148594,-0.0001968383394998089,-0.00011702110396498213,,,,-0.00022498418833405705,-5.000092580482909e-05,2379.0222782848105,2398.220117412968,2024-04-19 10:00:00,2024-04-19 10:00:00,0.2950303030311261,1.925968640039173,2388.9507272727274,0.0003116072189497633,0.00028166798325561396,2390.6955757575774,2355.8139178771644,2400.715835900547,2355.078044214323,2400.2809499449563,0.000277825873117333,0.00031157107565031074,2387.1110029171077,27.671548104518536,34.597615108132906,2.2679537634661364,2374.1435078906557,-1.0,2385.82460909938,bullish,2391.2254403807437,2380.728534780003,2380.6242435643608,1.0,,,2385.971215041438,2380.515757523273,2391.1453000867436,,,2379.6111950743993,2427.358369024481,2378.2900000000004,2409.2099999999996,,,2024-04-19 08:00:00,2024-04-19 08:00:00,2382.2587338313624,0.0011573383851335361,2373.047798284807,0.0010329368277068006,2414.775803146536,bullish,2383.2949999999983,2395.569867005417,2371.0201329945794,7.775069505474088,7.772612378282703,2386.4329464862485,2386.8100079326077,-0.3741886899947531,-0.5337301750699124,3.677242755837419,-0.9205150293259976,-0.4705608504373231,-0.6946297653971669,2393.121679426631,2378.4127084032816,53.08480488336577,64.45579950463106,0,0,0,0,-100,0,0,0,0,0,0,0,0,0,0,0,0,0,0,0,0,0,0,0,0,0,0,0,0,0,0,0,0,0,0,0,0,0,0,0,-100,0,0,0,0,0,0,0,0,0,0,0,0,0,0,0,0,0,0,0,0,0,,False,True,1.0,2285.28,2335.28,2315.28,2290.28,1,0.01,True,,,2024-04-24 18:03:56,2024-04-19 11:00:00,2385.28,2024-04-19 18:30:00,2393.06,manual,0.01,-138.43,fail,-965.8299999999999,False,0,5,16,4
2024-04-19 18:15:00,2393.8,2395.96,2391.21,2393.05,4673,27,0,2384.477509121372,2385.274329178886,2389.411104247933,2405.0855653992735,-6.586427165333572e-05,-0.00019291011023319136,,,,0.0002909437198097736,0.00015810865079866969,2371.792311286374,2388.129743583244,2024-04-19 18:00:00,2024-04-19 18:00:00,2.72230303030301,-0.15376253703061593,2385.52309090909,0.00010820098063745114,0.0006125102281734054,2382.3731515151508,2365.5089674085357,2392.4643903528204,2365.2526736098976,2388.647455937623,0.0006664679443750152,0.00010818994018771887,2386.1118166563147,24.274718768502208,17.587366179369912,-0.011341198845336423,,-1.0,2384.4216853650664,bullish,2390.649122578665,2379.6738510663013,2381.597552475252,1.0,,,2385.1551740033697,2379.1316702612176,2389.7234628527076,,,2389.251604228668,2407.3975987940375,2378.2900000000004,2409.2099999999996,1.0,,2024-04-19 16:00:00,2024-04-19 16:00:00,2387.8316594806056,0.00046463709614400346,2371.46391995011,0.0027902522592845244,2423.067083487407,bullish,2387.5663095238083,2397.7353832279773,2377.3972358196393,7.7757160466298965,7.772612378282703,2387.247793467936,2384.894844664779,2.2143433458695654,0.6801766664224801,4.96403044047104,1.362076612902456,1.7783321114407045,1.3706818181799463,2395.2023900598283,2375.346268297944,92.63576042534008,92.85282806958811,0,0,0,0,0,0,0,0,0,0,0,0,0,0,0,0,0,0,0,0,0,0,0,0,0,0,0,0,0,0,-100,0,0,0,0,0,0,0,0,0,0,0,0,0,0,0,0,0,0,0,0,0,-100,0,0,0,0,0,0,0,0,0,,True,False,0.0,2493.05,2363.05,2423.05,2428.05,0,0.01,False,,,2024-04-22 06:18:14,2024-04-19 18:30:00,2393.05,2024-04-22 02:15:00,2386.43,manual,0.01,-117.79,fail,-1083.62,False,0,6,16,4
2024-04-22 02:00:00,2383.79,2387.08,2383.03,2386.46,1048,27,0,2388.767058713124,2388.0115524193548,2383.0523513139697,2392.977528168855,-0.0005249561442696067,-0.0004507257972699771,,,,-0.0003688165654248599,-0.0003623716795559751,2387.2998850656118,2397.472355815934,2024-04-22 02:00:00,2024-04-22 02:00:00,-3.2656969696990927,1.1486299740095092,2389.7967272727274,6.666778743326447e-05,-1.6385125271885648e-05,2391.9753333333315,2369.4867276575237,2418.2349898394673,2369.330282110991,2415.3016738080064,9.323453456701736e-05,6.663783375793787e-05,2388.7047018378316,50.613884107859825,62.46701090074566,1.663561059999777,,-1.0,2388.2341745484146,bearish,2394.2590472783477,2382.180400232053,2383.186263366341,1.0,,,2388.2120876305667,2382.213931314702,2394.2696319189076,,,2368.391822825859,2387.9264877551464,2376.72,2399.5499999999993,1.0,,2024-04-22 00:00:00,2024-04-22 00:00:00,2386.6440708802693,0.00024437132435014755,2372.8721639271266,0.0013197412409245448,2426.715569821338,bullish,2388.818571428572,2398.2901768891506,2379.346965967993,7.778894553693576,7.772612378282703,2387.4157104139,2388.92158748595,-1.453792302252623,-0.4914988196721555,3.2671522658450707,-0.9108669354841368,-1.5947635630514014,-1.2269098240462881,2394.5458569510447,2381.477247887665,21.052631578947658,17.043534762833083,0,0,0,0,0,0,0,0,0,0,0,0,0,0,0,0,0,0,0,0,0,0,0,0,0,0,0,0,0,0,0,0,0,0,0,0,0,0,0,0,100,0,0,0,0,0,0,0,0,0,0,0,0,0,0,0,0,0,0,0,0,0,,False,True,1.0,2286.46,2336.46,2316.46,2291.46,1,0.01,True,,,2024-04-24 18:03:57,2024-04-22 02:15:00,2386.46,2024-04-24 18:03:57,2336.38,auto,0.01,890.75,even,-192.8699999999999,True,1,0,17,4
2024-04-23 16:45:00,2317.34,2330.65,2317.34,2329.53,6760,27,0,2309.1682073395073,2310.0387298387095,2311.615346495862,2332.1160951394154,0.0003009775835036329,-2.8341674833293082e-05,,,,0.0006187842935830037,0.000385942238582567,2297.4315742689,2314.486833309315,2024-04-23 16:00:00,2024-04-23 16:00:00,2.244424242423065,-6.914201370610499,2311.5871515151525,-0.0013371126556839387,-0.0006660286171132673,2304.4724848484825,2355.399022321776,2379.660888606515,2358.565434956796,2381.0754582537993,-0.000921891549771908,-0.0013371865699942115,2311.2361755882566,33.17012512629203,24.25316485589022,-9.47048299717075,2291.43,-1.0,2310.6907044634695,bearish,2321.6903038968326,2301.4582918206074,2351.9803405940647,-1.0,,,2311.55216271294,2301.108865397161,2320.3124423982213,,,2309.489999999999,2331.8110526421797,2298.8500000000004,2309.0099999999998,1.0,,2024-04-23 16:00:00,2024-04-23 16:00:00,2321.484364317455,-0.0040425666367324,2288.6200524540795,-0.003523121945401094,2328.1949909580894,bearish,2315.1076190476188,2347.352561635566,2282.8626764596715,7.758828771637241,7.766589267382177,2312.0620639533536,2308.5936736159706,3.3241249809157125,0.8384895217453587,7.305267668892353,3.043541055719743,1.667762096772094,1.2057899560113583,2324.6492651764943,2295.4281945009247,86.93850472873112,87.31348335383285,0,0,0,0,0,0,0,0,0,100,0,0,0,100,0,0,0,0,0,0,0,0,0,0,0,0,0,0,0,0,0,0,0,0,0,0,0,0,0,0,100,0,0,0,0,0,0,0,0,0,0,0,0,0,0,0,0,0,0,0,0,0,,True,False,0.0,2429.53,2299.53,2359.53,2364.53,0,0.01,False,,,2024-04-30 17:11:21,2024-04-23 17:00:00,2329.53,2024-04-24 04:00:00,2320.79,manual,0.01,-155.5,fail,-348.3699999999999,False,0,1,17,4
2024-04-24 03:45:00,2321.75,2322.29,2320.7,2320.79,992,27,0,2321.343761695695,2320.9143786656905,2311.7275309087995,2322.2672115413716,0.0003088021074383517,0.0002586875848583135,,,,-2.3445556074780186e-05,-1.3383866265514377e-05,2321.0013857587246,2324.547602586603,2024-04-24 03:00:00,2024-04-24 03:00:00,-1.469454545456756,1.484484494199478,2322.2362424242438,-0.0002222353985072678,-0.0004444078652126609,2322.5315757575736,2300.2539237351193,2357.5670358258103,2302.633467630875,2358.8047357822184,-0.0004474575166501681,-0.000301435654855713,2321.663378576403,75.70162481536124,75.83839378521748,0.017496212554058532,2297.4920060227273,-1.0,2318.2579668383196,bullish,2327.632162156448,2309.885729950853,2344.4087069306984,1.0,,,2318.741968382819,2309.330527291431,2327.2199181954156,,,2315.279272873068,2332.075291421437,2298.8500000000004,2330.28,,,2024-04-24 00:00:00,2024-04-24 00:00:00,2321.287495252202,-0.00242979783371535,2280.242367591951,-0.001851398363115361,2336.6609878712898,bearish,2318.664880952381,2336.0803312767293,2301.2494306280323,7.755998980999154,7.766589267382177,2322.3938180581135,2322.319488353752,-0.024563648446473962,0.3091881592931363,1.007272661244678,-0.4752364369487623,-0.5330865102632742,-0.27992302052825835,2322.92892398818,2318.899833343201,27.24435453193654,40.25486737904976,0,0,0,0,0,0,0,0,0,0,0,0,0,0,0,-100,0,0,0,0,0,0,0,0,0,0,0,0,0,0,0,0,0,0,0,0,0,0,0,0,0,0,0,0,0,0,0,0,0,0,0,0,0,0,0,0,0,0,0,0,0,0,,False,True,1.0,2220.79,2350.79,2290.79,2285.79,1,0.01,False,2024-05-01 00:00:00,,2024-04-26 12:11:16,2024-04-24 04:00:00,2320.79,2024-04-24 07:00:00,2327.92,manual,0.01,-126.86,fail,-475.2299999999999,False,0,2,17,4
2024-04-24 06:45:00,2325.13,2328.12,2325.01,2327.91,1133,27,0,2321.6288314485505,2321.9269831378288,2325.0100000000007,2336.0541049837952,-0.000208458497109967,-0.00023254873450303187,,,,9.894956093117018e-05,-4.134477798814031e-05,2316.1166803900214,2325.530446671233,2024-04-24 06:00:00,2024-04-24 06:00:00,-0.47496969697021996,0.6722817190866408,2322.239515151516,-0.00022467675823286366,-0.0003640398917926953,2319.8387878787867,2298.778282380929,2354.734763777331,2299.233252096665,2355.472801828959,-0.0004444269666566799,-0.00022225973430806516,2322.5619188637943,64.11577175810343,68.78705185609427,0.4043419988310603,2306.6253533238696,-1.0,2319.4031800359407,bullish,2328.780877665095,2311.7903462120794,2342.331443564362,1.0,,,2320.270060020915,2310.760416969889,2328.0782689774346,,,2309.5793515370397,2333.102099704738,2295.590000000001,2330.28,,,2024-04-24 04:00:00,2024-04-24 04:00:00,2323.0583301681345,-0.0008988133831229195,2287.8292823408997,-0.0017221766851262831,2332.264284667443,bearish,2322.2677380952387,2338.108876706457,2306.4265994840202,7.755036062286181,7.766589267382177,2322.9454177133234,2322.2560787391635,0.6195796483807499,-0.09207876165636175,3.380967475625374,0.7910410557174146,0.5400329912026791,0.5861455278595713,2328.6889180890794,2315.165048186578,88.06480164535382,85.26113099193894,0,0,0,0,0,0,0,0,0,0,0,0,0,100,0,100,0,0,0,0,0,0,0,0,0,0,0,0,0,0,0,-100,0,0,0,0,0,0,0,0,100,0,0,0,0,0,0,0,0,0,0,0,0,0,0,0,0,0,0,0,0,0,,True,False,0.0,2427.91,2297.91,2357.91,2362.91,0,0.01,False,,,2024-04-30 17:35:38,2024-04-24 07:00:00,2327.91,2024-04-24 12:30:00,2312.7,manual,0.01,-270.62,fail,-745.8499999999999,False,0,3,17,4
2024-04-24 12:15:00,2317.53,2317.53,2312.24,2312.82,2535,27,0,2321.909882461868,2321.2920326246326,2311.227249287239,2317.50737998356,3.326394953516224e-05,0.00023411112077288037,,,,-0.00041024179223994405,-0.00030986933503925805,2320.317319790008,2329.5006094107375,2024-04-24 12:00:00,2024-04-24 12:00:00,-1.5741212121210992,0.6396783883715216,2321.4291515151485,0.0002835932245946437,-6.29775888500317e-05,2323.8941818181843,2286.07237037136,2335.3000644227654,2287.0834534971877,2339.5097852181407,-0.00012239241988145196,0.00020520910657669783,2321.2164530256537,41.60590946366586,59.678392411025335,1.1522412864771938,,-1.0,2322.4495061732337,bearish,2328.087360722599,2315.9668741755195,2338.4477603960445,1.0,,,2322.0192091410986,2316.4933759449677,2328.4209507070204,,,2293.4845743053847,2335.19376840436,2318.1799999999994,2330.28,,1.0,2024-04-24 12:00:00,2024-04-24 12:00:00,2322.2125911858375,0.0006702762650378406,2297.1951956475486,-9.492134105768457e-05,2333.0233385035076,bearish,2324.4650000000006,2339.3085111243877,2309.6214888756135,7.754991085352801,7.766589267382177,2319.4048602585513,2321.51417854378,-1.961110089255726,-0.8936968437981765,2.624527168266334,-1.274583944281403,-0.8135007331406996,-0.610196114367227,2326.541086961165,2316.0429782881,10.948507097508786,11.720934416219597,0,0,0,0,0,0,0,0,0,0,0,0,0,-100,0,0,0,0,0,0,0,0,0,0,0,0,0,0,0,0,0,100,0,0,0,0,0,0,0,0,0,0,0,0,0,0,0,0,0,0,0,0,0,0,0,0,0,0,0,0,0,0,,False,True,1.0,2212.82,2342.82,2282.82,2277.82,1,0.01,False,,,2024-04-25 17:35:54,2024-04-24 12:30:00,2312.82,2024-04-24 18:00:00,2329.6,manual,0.01,-298.55,fail,-1044.3999999999999,False,0,4,17,4
2024-04-24 17:45:00,2325.51,2330.26,2324.47,2329.56,4360,27,0,2320.4397645641784,2320.5383522727275,2323.270327498279,2338.004904148317,-0.00013522821007556893,-0.00032721458269001466,,,,0.00028281805711358996,0.00017783296541934698,2311.637498456895,2322.8598432259955,2024-04-24 17:00:00,2024-04-24 17:00:00,0.5343030303051819,-0.4189851543901568,2321.130363636363,0.00034490567599325004,9.140526990003168e-05,2318.0640606060615,2288.8612647454293,2335.3112057258563,2288.071583048569,2335.0977751485334,9.143640859335836e-05,0.0003449146173942289,2322.4284527426744,43.480492813141375,33.590006844626835,-0.06087748883868217,,-1.0,2321.3563035251104,bearish,2328.0705088369004,2315.8483841688694,2335.3385643564407,1.0,,,2321.9514047716702,2315.3552161021416,2327.372944954656,,,2295.768762709253,2336.8988613518904,2318.1799999999994,2330.28,1.0,,2024-04-24 16:00:00,2024-04-24 16:00:00,2323.191727457225,0.0014687662527255935,2307.474694221242,0.00018290101591804934,2337.1808587583114,bearish,2323.990357142857,2337.556439941506,2310.4242743442082,7.755303614826926,7.766589267382177,2321.899412174863,2320.5013712257346,1.3404050649273813,0.20916677991593674,3.590784832610847,1.6951759530793424,1.1858376099703491,0.7581653225829541,2327.719921937949,2313.356782607506,85.7250953243413,70.62832568240809,0,0,0,0,0,0,0,0,0,0,0,0,0,0,0,0,0,0,0,0,0,0,0,0,0,0,0,0,0,0,0,0,0,0,0,0,0,0,0,0,100,0,0,0,0,0,0,0,0,0,0,0,0,0,0,0,0,0,0,0,0,0,,True,False,0.0,2429.56,2299.56,2359.56,2364.56,0,0.01,False,,,2024-04-30 17:11:21,2024-04-24 18:00:00,2329.56,2024-04-24 23:30:00,2316.06,manual,0.01,-240.2,fail,-1284.6,False,0,5,17,4
2024-04-24 23:15:00,2318.48,2318.48,2315.43,2316.02,610,30,0,2321.5912363934976,2321.262591642229,2313.1055337111793,2318.48,7.66154260499189e-05,5.267970505739998e-05,,,,-0.0003510443555240984,-0.00015848707557171172,2319.5860772437604,2329.7784864456903,2024-04-24 23:00:00,2024-04-24 23:00:00,-1.5838181818212433,-0.014432418290653004,2320.5795757575765,0.00028167673437767083,9.225227983459285e-05,2323.1268484848474,2293.203393451143,2331.5658065406983,2292.812209581901,2331.3510046341917,9.224926719036314e-05,0.00034491556662669327,2320.4361759757394,37.33855185909943,43.739943465970846,0.34369116974346214,2315.854642704384,-1.0,2322.1008642033844,bearish,2324.710214097099,2318.431874913196,2331.945176237629,1.0,,,2321.568922151353,2318.986238360283,2325.219673294313,,,2296.0398046797386,2334.8335517323576,2318.1799999999994,2328.79,,1.0,2024-04-24 20:00:00,2024-04-24 20:00:00,2320.6044849714835,0.0014686959940065911,2310.8682976507375,0.00013780860584570968,2336.814920415606,bearish,2320.185714285714,2332.0303866112704,2308.3410419601573,7.755303614826926,7.766589267382177,2320.336141405696,2321.454349899885,-1.0604846001228907,-0.2660663322516589,1.9399001262524154,-1.210769794720818,-1.0143475073309673,-0.7876942815250914,2325.142391894734,2317.382791389724,6.8968925997471295,10.064324486592282,0,0,0,0,0,0,0,0,0,0,0,0,0,-100,0,0,0,0,0,0,0,0,0,0,0,0,0,0,0,0,0,0,0,0,0,0,0,0,0,0,0,0,0,0,0,0,0,0,0,0,0,0,0,0,0,0,0,0,0,0,0,0,,False,True,1.0,2216.02,2346.02,2286.02,2281.02,1,0.01,False,,,2024-04-26 10:20:56,2024-04-24 23:30:00,2316.02,2024-04-25 10:30:00,2321.96,manual,0.01,-105.69,fail,-1390.29,False,0,6,17,4
2024-04-25 10:15:00,2320.69,2322.45,2320.17,2321.97,1782,27,0,2318.1337426653236,2318.2453097507323,2320.169999999999,2328.375854783083,0.0001430083864637862,5.355881565719815e-05,,,,3.7165278385877204e-05,0.00038670997308153793,2310.121190576846,2322.678921757969,2024-04-25 10:00:00,2024-04-25 10:00:00,1.7111515151491403,-0.43078616933507874,2320.9173333333347,-0.00011666844751373058,9.192804116223695e-05,2318.976363636364,2312.329883340193,2333.7515800188635,2308.5253330071178,2333.492856424088,9.302018321482931e-05,-5.391913802804027e-05,2320.362130256036,48.906712242365906,37.46167786309241,-0.843126583077259,,-1.0,2319.2502268052253,bullish,2322.9892729094813,2316.345265760413,2326.8329821782227,1.0,,,2319.6648906072837,2316.0595401417813,2322.4453090730176,,,2309.434457383109,2341.757781674111,2314.9400000000005,2329.560000000001,,,2024-04-25 08:00:00,2024-04-25 08:00:00,2321.2998473989583,-0.0002156209468041096,2305.6352402442544,0.0002937174473617881,2338.439840478292,bearish,2320.1917857142857,2326.436175196039,2313.9473962325324,7.756778680131963,7.76377853923575,2319.2476368493744,2318.1221089071496,1.073767124159076,0.31834606652016517,1.6155798383654056,0.495907258061834,0.45501282991426706,0.73059017595142,2321.476469427463,2315.0141500740015,86.25778255852462,89.4283755153096,0,0,0,0,0,0,0,0,0,0,0,0,0,0,0,0,0,0,0,0,0,0,0,0,0,0,0,0,0,0,0,100,0,0,0,0,0,0,0,0,100,0,0,0,0,0,0,0,0,0,0,0,0,0,0,0,0,0,0,0,0,0,,True,False,0.0,2421.97,2291.97,2351.97,2356.97,0,0.01,False,,,2024-04-30 20:27:13,2024-04-25 10:30:00,2321.97,2024-04-30 20:27:13,2292.08,auto,0.01,-531.82,fail,-1922.1100000000001,False,0,7,17,4
2024-04-26 17:45:00,2333.49,2335.21,2328.64,2333.49,5295,27,0,2341.618227223692,2341.0959182551314,2328.640000000001,2337.1603201733215,0.00017751299662580226,0.00011759982650051249,,,,-0.00023962924713630368,-0.0004254668817749403,2339.80766158384,2352.711955571325,2024-04-26 17:00:00,2024-04-26 17:00:00,-1.5158181818169396,3.486167946705791,2342.289333333333,0.00029994706502584886,0.00020884245879492254,2346.2369696969718,2306.9169332255055,2340.748484820274,2304.091688361972,2339.3699173486775,0.0002500574318053461,0.0004513256483151285,2341.137973198882,66.3627152988863,73.91928402566765,3.8485843973611047,2331.9470702804665,-1.0,2339.9666400478345,bullish,2343.8051783204382,2335.763061016383,2327.8235722772333,1.0,,,2339.7806644512207,2336.1350403524516,2343.8045241214627,,,2322.866067717176,2351.533626709023,2329.829999999999,2349.25,,1.0,2024-04-26 16:00:00,2024-04-26 16:00:00,2337.242553106864,0.0015731606437290563,2326.3998685013253,0.001115101997161192,2354.6315309965294,bullish,2339.767976190476,2353.1665119313675,2326.3694404495845,7.75356611003165,7.76377853923575,2340.3215705194243,2342.092384719794,-1.7249910243058366,-0.3268956683308416,4.629211403050997,-1.5422837243413596,-1.563253299119424,-0.9610098973616914,2350.3543410612333,2331.8374954490296,16.781399566407107,22.163518681321715,100,100,0,0,0,0,0,0,0,0,0,0,0,0,0,0,0,0,0,100,100,0,0,0,0,0,0,0,0,0,100,0,0,0,0,0,0,0,0,100,0,0,0,0,0,0,0,0,0,0,0,0,100,0,0,0,0,0,0,0,0,0,,False,True,1.0,2233.49,2303.49,2283.49,2268.49,1,0.01,True,,,2024-05-01 17:00:04,2024-04-26 18:00:00,2333.49,2024-04-29 11:15:00,2336.69,manual,0.01,-56.94,fail,-1979.0500000000002,False,0,8,17,4
2024-04-29 11:00:00,2337.21,2337.94,2336.38,2336.68,2102,27,0,2332.592701213115,2333.028289956013,2336.4031060837983,2346.0855394977643,-0.00018240184984950113,-9.454939260791785e-05,,,,5.806122187320945e-05,7.790799678748741e-05,2326.298167637714,2336.5526250362855,2024-04-29 11:00:00,2024-04-29 11:00:00,2.4382424242412526,-1.3029343394400712,2333.3510303030307,-4.3949363412704486e-05,-9.261827219319511e-05,2331.072242424243,2322.3331215305047,2354.5044524464156,2317.6153194888675,2354.053873469929,-6.48785933162779e-05,3.8701326893489566e-05,2333.6659983764966,57.871017871017266,49.33808151854936,-1.513967159124621,2320.516963999999,-1.0,2334.041620874442,bullish,2338.2371459871706,2330.093398499808,2330.692681188124,-1.0,,,2334.1617206165765,2329.8885211683246,2338.202123611654,,,2317.7580675742183,2348.2848648035892,2324.270000000001,2349.25,,,2024-04-29 08:00:00,2024-04-29 08:00:00,2335.7055660458004,0.0003454149864553691,2318.8830315994383,0.0002188317300652018,2353.908550111198,bullish,2334.940476190476,2343.4231681275905,2326.4577842533618,7.753163178781323,7.76377853923575,2333.214309153457,2332.2473020222747,0.9507813925742994,0.14589003869652747,3.396509763168372,1.0054912023451834,1.0974358504417978,0.9526906158339443,2339.8213094823495,2326.2352704296763,88.34354948888684,78.30591817413988,0,0,0,0,0,0,0,0,0,0,0,0,0,0,0,0,0,0,0,0,0,0,0,0,0,0,0,0,0,0,0,-100,0,0,0,0,0,0,0,0,0,0,0,0,0,0,0,0,0,0,0,0,0,0,0,0,0,0,0,0,0,0,,True,False,0.0,2436.68,2306.68,2366.68,2371.68,0,0.01,False,,,2024-04-30 15:30:02,2024-04-29 11:15:00,2336.68,2024-04-29 18:15:00,2334.89,manual,0.01,-31.85,fail,-2010.9,False,0,9,18,4
2024-04-29 18:00:00,2337.76,2337.9,2334.59,2334.88,3243,27,0,2335.6189695969156,2335.2960923753676,2332.7332141503175,2346.4747898860905,8.21905169952671e-06,1.322877889301989e-05,,,,-0.00011808065853968134,-0.0003827528902743027,2330.2928237272945,2341.9850485943907,2024-04-29 18:00:00,2024-04-29 18:00:00,0.2690303030308314,0.31034476620880014,2337.168787878788,-0.00011850540681698207,-0.00014788657943258043,2337.3792121212105,2324.6058298522876,2353.270331625502,2324.881339030906,2353.618308448789,-0.00014788962877380275,-0.00011850883854008337,2336.32800635358,59.8636673483295,62.50852079072917,-0.005218865859188182,,-1.0,2335.1632185163253,bullish,2339.399843700044,2331.3771883959635,2332.195600000005,-1.0,,,2335.385071062022,2331.107169160223,2339.2263252641237,,,2315.6580396253967,2346.9484442325943,2324.270000000001,2343.1300000000006,,,2024-04-29 16:00:00,2024-04-29 16:00:00,2337.186918242578,-0.0004543135556158495,2319.0650228550303,-0.0005821681769145009,2345.987615576315,bullish,2336.0064285714307,2344.2746994003282,2327.738157742533,7.753163178781323,7.76377853923575,2335.7548470225606,2335.818147245692,-0.08315115760387926,-0.16609460344949495,2.657301262535936,-0.534999999998945,-0.3314681085053053,-0.2692338709671276,2340.6106949004393,2329.981489850296,69.57574052566275,69.66226255857052,0,0,0,0,0,0,0,0,0,0,0,0,0,-100,0,-100,0,0,0,0,0,0,0,0,0,0,0,0,0,0,0,0,0,0,0,0,0,0,0,0,-100,0,0,0,0,0,0,0,0,0,0,0,0,0,0,0,0,0,0,0,0,0,,False,True,1.0,2234.88,2304.88,2284.88,2269.88,1,0.01,True,,,2024-05-01 17:00:04,2024-04-29 18:15:00,2334.88,2024-04-29 19:45:00,2344.17,manual,0.01,-165.3,fail,-2176.2000000000003,False,0,10,18,4
2024-04-29 19:30:00,2343.66,2344.55,2341.88,2344.15,3024,27,0,2337.015139219808,2337.343530058651,2332.848254116182,2346.6610432547477,8.21905169952671e-06,1.322877889301989e-05,,,,0.00016592302910763048,0.0003800954981405261,2326.291620297797,2342.624209633589,2024-04-29 19:00:00,2024-04-29 19:00:00,-0.2104242424225049,0.4790039638965027,2337.914,-0.00011853010215694575,-8.345289582138235e-05,2337.168787878788,2324.3307599090267,2352.7333075869774,2324.6058298522876,2353.270331625502,-0.00014788657943258043,-0.00011850540681698207,2337.7484493861175,66.29220938878392,61.69294959630656,0.09162570009195,,-1.0,2335.385071062022,bullish,2339.9222512308174,2332.059300595313,2332.488825742579,-1.0,,,2335.987467571851,2331.3771883959635,2339.399843700044,,,2315.3581909995783,2346.7575891050874,2324.270000000001,2343.1300000000006,1.0,,2024-04-29 16:00:00,2024-04-29 16:00:00,2337.186918242578,-0.0004543135556158495,2319.0650228550303,-0.0005821681769145009,2345.987615576315,bullish,2336.0064285714307,2344.2746994003282,2327.738157742533,7.753163178781323,7.76377853923575,2339.411385220781,2337.7819339544667,1.4794463203993473,0.5873912092280466,3.5262361054357942,0.8173020527865447,0.7277107771265037,0.6369593108488516,2344.396002269523,2330.2910578477795,90.16746463643841,90.59883054922595,0,0,0,0,0,0,0,0,0,0,0,0,-100,0,0,0,0,0,0,0,0,0,0,0,0,0,0,0,0,0,0,0,0,0,0,0,0,0,0,0,0,0,0,0,0,0,0,0,0,0,0,0,0,0,0,0,0,0,0,0,0,0,,True,False,0.0,2444.15,2314.15,2374.15,2379.15,0,0.01,False,,,2024-04-30 11:20:46,2024-04-29 19:45:00,2344.15,2024-04-30 11:20:46,2314.75,auto,0.01,-523.1,fail,-2699.3,False,0,11,18,4
