time,open,high,low,close,tick_volume,spread,real_volume,bb_lower,bb_middle,bb_upper,bb2_lower,bb2_middle,bb2_upper,ema_50,ema_50_grad,lsma,lsma_high,lsma_high_grad,lsma_low,lsma_long,long_smooth,long_smooth_grad,lsma2,lsma2_grad,lsma2_smooth,lsma2_smooth_grad,lsma3,lsma3_grad,lsma3_smooth,lsma3_smooth_grad,lsma_grad,lsma_long_grad,support_trendline,resistance_trendline,support_gradient,resistance_gradient,supertrend_dir,Span_A,Span_B,sr_levels,fixed_resistance_gradient,fixed_support_gradient,fixed_support_trendline,fixed_resistance_trendline,prev_support_grad,prev_resistance_grad,ema_short,ema_long,macd_line,macd_signal,lsma_stddev,lsma_slope,prev_lsma_slope_1,prev_lsma_slope_2,lsma_upper_band,lsma_lower_band,stoch_k,stoch_d,be_increment,be_condition_increment,ticket,sr_cross_signal_sell,sr_cross_signal_buy,in_session,retest_buy,retest_sell,is_buy2,is_sell2,signal,tp,sl,be,be_condition,conditions_arr,order_type,lot,first_time_to_trail,last_time_to_trail,sl_updated,time_to_trail,time_tp_hit,time_sl_hit,entry_time,entry_price,exit_time,exit,exit_price,lot_size,type,profit,duration,account_balance,success,win_streak,losing_streak,Week,Month
2024-12-06 08:47:00,2642.61,2643.608,2642.551,2642.896,154,160,0,2635.8158564975743,2638.8090200000042,2641.802183502434,2637.520235239171,2640.519950000001,2643.5196647608304,2640.146697992719,0.11221640846042646,2641.8252149796094,2643.111000000001,0.4441000000015265,2642.2625000000003,2641.8252149796094,2640.127029256581,0.04142062662231183,2642.1230502039307,0.3954332962543958,2641.925333555803,0.356235409713463,2641.291758991468,0.36918131256652487,2641.107168335188,0.37504931405146635,-0.004423433439569635,0.3339163515047403,,,,,,7.878911350636895,7.8785556408193695,[2644.368174045823],0.00011980566391371987,0.0001259410133996385,2643.8403629237027,2644.837039141219,,,2641.6421244119824,2640.8095823122485,0.7502823355434884,0.505482604655614,0.662744496745194,0.3339163515047403,0.33833978494430994,0.39151360771438704,2643.1507039731,2640.499725986119,91.48227476094273,93.90247174232223,3.0,5.0,,,,True,False,False,False,True,1.0,2630.896,2635.896,2632.896,2627.896,"5.0,3.0,2637.896",1,0.02,2024-12-06 10:26:00,2024-12-06 11:02:00,True,2024-12-06 14:11:00,2024-12-06 14:07:09,2024-12-06 11:11:13,2024-12-06 08:48:00,2642.896,2024-12-06 11:11:13,auto,2635.897,0.02,even,252.29,0 days 02:23:13,952.29,True,1,0,49,12
2024-12-06 09:03:00,2643.716,2644.322,2643.436,2643.701,138,159,0,2635.4311455141565,2639.062910000002,2642.6946744858474,2640.7497679221897,2642.8303999999994,2644.911032077809,2641.532109262368,0.0885261525563692,2644.0558938820923,2644.528899999999,-0.2154000000027736,2643.715,2644.0558938820923,2641.033297367444,0.1042284093437047,2644.5168567296987,0.07665984427012518,2644.478526807563,0.09119918427950324,2643.684426844642,0.09022773452124966,2643.639312977384,0.1034480904704651,-0.05139347423164509,0.04218946978244276,,,,,,7.879436015799882,7.879089266764604,[2644.368174045823],-8.465751108184606e-05,-7.029620269846009e-05,2642.715115141665,2643.700689305551,,,2643.4152989053146,2642.5252836091854,0.780328839590311,0.7265517024233956,0.5832563759781848,0.04218946978244276,0.09358294401408784,0.14734386355075912,2645.2224066340486,2642.889381130136,68.07488807488623,73.52598019264538,3.0,5.0,,,,True,False,False,False,True,1.0,2631.701,2639.701,2636.701,2633.701,"5.0,3.0,2638.701",1,0.02,2024-12-06 10:14:00,2024-12-06 10:14:00,True,2024-12-06 11:02:00,2024-12-06 13:31:47,2024-12-06 10:19:07,2024-12-06 09:04:00,2643.701,2024-12-06 10:19:07,auto,2639.711,0.02,even,143.8,0 days 01:15:07,1096.09,True,2,0,49,12
2024-12-06 09:10:00,2644.774,2645.123,2644.495,2644.568,101,160,0,2635.3488929049895,2639.3311800000015,2643.3134670950135,2641.208700537504,2643.5187999999994,2645.828899462495,2642.2058796156502,0.09641307691208567,2644.5893417871725,2645.3475000000003,0.03129999999919164,2644.3760000000007,2644.5893417871725,2641.8417623618825,0.13536958472377592,2645.1342065257736,0.11426303300504514,2645.0770750092706,0.12885554319836956,2644.1546967000363,0.1430298109034993,2644.0831817945877,0.14419655172378043,-0.0029581757544292486,0.12658806080844442,,,,,,7.879677560064167,7.879180554149451,[2644.368174045823],0.00010856325214420907,0.0001731571802889101,2646.2988356764945,2647.4225235117437,,,2644.0993054205883,2643.2754881106016,0.7137504781881034,0.706992908460718,0.7768512337677725,0.12658806080844442,0.12954623656287367,0.1878441972521614,2646.143044254708,2643.035639319637,71.98895619069997,75.80030423878611,3.0,5.0,,,,True,False,False,False,True,1.0,2632.568,2637.568,2634.568,2629.568,"5.0,3.0,2639.568",1,0.02,2024-12-06 10:08:00,2024-12-06 10:46:00,True,2024-12-06 14:10:00,2024-12-06 11:01:53,2024-12-06 11:20:41,2024-12-06 09:11:00,2644.568,2024-12-06 11:01:53,auto,2632.659,0.02,success,429.24,0 days 01:50:53,1525.33,True,3,0,49,12
2024-12-06 10:49:00,2634.446,2634.894,2633.982,2634.806,145,160,0,2635.1660458334136,2639.940369999998,2644.7146941665824,2633.5991385201064,2635.87145,2638.143761479894,2637.4182326192026,-0.10662173955915932,2634.4443247311797,2634.7243999999996,0.10189999999965949,2633.7951000000003,2634.4443247311797,2637.43505988135,-0.13389349091585245,2634.836358175752,-0.12435773081188017,2634.8985370411574,-0.14977545420879324,2633.984195031517,-0.12373904337937347,2634.046064553209,-0.17685424545925343,0.08894890619103535,-0.06880237300811132,,,,,,7.877268402647296,7.877938902040621,"[2644.333876437621, 2644.339944543269, 2644.2812163239264, 2644.3298131131464, 2644.331384238732, 2644.3062770007577, 2644.3050767485033, 2644.3118149794805, 2644.288748400793, 2644.271399317282, 2644.2839167567636, 2644.281952463107, 2644.3357868501607, 2644.306115068184, 2644.289695477679, 2644.3136369824715, 2644.2768780559622, 2644.332204919096, 2644.3078926643634, 2644.3306404147174, 2644.318408648706, 2644.3085538618147, 2644.282653810486, 2644.2921950449604, 2644.2691571511123, 2644.278326641542, 2644.313168695587, 2644.2889533261737, 2644.2831412404817, 2644.284846857112, 2644.2828827678104, 2644.266191829065, 2644.2995208553684, 2644.368174045823, 2644.286664248194, 2644.2973346612293, 2644.2994873851735, 2644.2950364407416, 2644.2899439322964, 2644.278346382701, 2644.309970418829, 2644.316352389659, 2644.2842068148684, 2644.323629369276, 2644.2904826229014]",-7.430384452399486e-06,-1.9169738961931782e-05,2633.205346879124,2634.7917919136653,,,2635.121387994132,2636.1502966261605,-0.8971900356477818,-0.8440348345356734,0.744676140071786,-0.06880237300811132,-0.15775127919914667,-0.2968405635920135,2635.933677011323,2632.954972451036,23.645751290803172,15.836568479431875,3.0,5.0,,,,True,False,False,True,False,0.0,2646.806,2638.806,2641.806,2644.806,"5.0,3.0,2639.806",0,0.02,2024-12-06 12:19:00,2024-12-06 12:19:00,True,,,2024-12-06 12:29:12,2024-12-06 10:50:00,2634.806,2024-12-06 12:29:12,auto,2638.959,0.02,even,149.9,0 days 01:39:12,1675.23,True,4,0,49,12
2024-12-06 11:04:00,2634.129,2635.313,2634.129,2635.088,141,160,0,2634.4844324745595,2639.780834999996,2645.0772375254323,2632.826802190169,2634.7680500000006,2636.709297809832,2636.2258391509804,-0.046442414325611026,2634.123408527994,2634.465800000001,0.4970999999995911,2633.3102000000003,2634.123408527994,2635.8261280849097,-0.10679009269551898,2634.5428431590644,0.04651093807842699,2634.519587690025,-0.027477345198349212,2633.5573836855756,0.02644590285308368,2633.544160734151,-0.05645406006624398,0.1237821282988989,0.07853155358134245,,,,,,7.876863535508993,7.877433291952244,"[2644.333876437621, 2644.339944543269, 2644.2812163239264, 2644.3298131131464, 2644.331384238732, 2644.3062770007577, 2644.3050767485033, 2644.3118149794805, 2644.288748400793, 2644.271399317282, 2644.2839167567636, 2644.281952463107, 2644.3357868501607, 2644.306115068184, 2644.289695477679, 2644.3136369824715, 2644.2768780559622, 2644.332204919096, 2644.3078926643634, 2644.3306404147174, 2644.318408648706, 2644.3085538618147, 2644.282653810486, 2644.2921950449604, 2644.2691571511123, 2644.278326641542, 2644.313168695587, 2644.2889533261737, 2644.2831412404817, 2644.284846857112, 2644.2828827678104, 2644.266191829065, 2644.2995208553684, 2644.368174045823, 2644.286664248194, 2644.2973346612293, 2644.2994873851735, 2644.2950364407416, 2644.2899439322964, 2644.278346382701, 2644.309970418829, 2644.316352389659, 2644.2842068148684, 2644.323629369276, 2644.2904826229014]",6.459662628849222e-05,7.358203328532486e-05,2633.702612809486,2635.946845555444,,,2634.47684018856,2635.126272608922,-0.5543043914913142,-0.56531983465942,0.9039879898155161,0.07853155358134245,-0.04525057471755645,-0.21333444567835613,2635.931384507625,2632.315432548363,44.5590207914143,28.018174102574402,3.0,5.0,,,,False,False,False,True,False,0.0,2647.088,2639.088,2642.088,2645.088,"5.0,3.0,2640.088",0,0.02,2024-12-06 12:19:00,2024-12-06 12:19:00,True,,,2024-12-06 12:24:13,2024-12-06 11:05:00,2635.088,2024-12-06 12:24:13,auto,2639.044,0.02,even,142.69,0 days 01:19:13,1817.92,True,5,0,49,12
2024-12-06 14:14:00,2629.121,2629.262,2627.693,2628.207,459,159,0,2631.8491213569205,2637.093004999999,2642.336888643077,2624.8279197978604,2632.6281000000013,2640.428280202142,2634.098325492495,-0.24046226499967815,2629.601981312568,2628.681299999999,0.5124999999975444,2626.4520999999995,2629.601981312568,2635.7895529162024,-0.16598285317013506,2630.7258328513176,-0.5259972562075745,2630.9888314794193,-0.472066777901091,2628.5018871338507,-0.437564923991431,2628.720669595852,-0.47968279569886363,-0.1352442714182871,-0.5344878754203819,,,,,,7.87542692853669,7.876172496599505,"[2635.7949575029315, 2644.368174045823, 2635.7915173685888, 2644.3234060434656, 2644.302013283533, 2644.29625654071, 2635.8015278562852, 2644.2799854044665, 2635.8188704805484, 2635.802173892063, 2644.266191829065, 2644.303350366168, 2644.319295895508, 2644.2897088400096, 2644.295165165411, 2644.307757334758, 2635.7898336039852, 2644.309178192542, 2644.3063760419286, 2633.624684645387, 2635.8036957462227, 2635.79736782272, 2635.80991687804, 2635.7834397771057, 2635.84073203095, 2635.75344396999, 2635.768900868448, 2635.8037648955574, 2635.823749325134, 2635.82758230501, 2644.333876437621, 2644.339944543269, 2644.2812163239264, 2644.3298131131464, 2644.331384238732, 2644.3062770007577, 2644.3050767485033, 2644.3118149794805, 2644.288748400793, 2644.271399317282, 2644.296372162277, 2635.7710686417836, 2635.820793271769, 2635.8288907125375, 2635.794330900939, 2644.286664248194, 2644.2950364407416, 2644.321538584508, 2644.283745659549, 2635.8072958888406, 2644.30741473489, 2644.2975236118605, 2635.798931207798, 2635.821224305465, 2635.8100900518975, 2644.313168695587, 2644.2977238424332, 2644.298862385685, 2644.315015377569, 2644.295614396518, 2644.3134887806787, 2644.3085538618147, 2635.8024021324595, 2635.8154974263157, 2644.2931510489766, 2635.791656947898, 2644.293955041974, 2644.2945657009677, 2644.308545874015, 2644.3098708708767, 2635.8173124612986, 2635.8322297053674, 2635.824952474235, 2635.8013776244625, 2644.2949267260615, 2644.2926585426817, 2644.3104827625125, 2644.295909068844, 2644.3020475313265, 2634.1961416536296, 2634.1899153175555, 2644.3000468473992, 2634.196592287186, 2634.197805341404, 2634.188921611294, 2634.192195613268, 2634.195906044873, 2634.193010093655, 2635.79528663883, 2635.7985483779853, 2635.81187875598, 2635.822326554808, 2635.8000288356784, 2644.2995208553684, 2644.3191511199975, 2644.2847133693494, 2644.31778964513, 2644.3018789731786, 2644.2902404452025, 2635.8146960985564, 2635.8207146045975, 2635.8339629614516, 2635.8468217443847, 2635.7761373895887, 2635.7676589689636, 2635.77244417029, 2635.7772397809913, 2635.782107433887, 2635.7873756047584, 2635.801973884407, 2636.0201153660505, 2644.278326641542, 2636.001725805557, 2636.0161610802243, 2636.0245583573032, 2644.309020082735, 2636.0013747213393, 2644.2977888477467, 2635.831362249615, 2635.7985097423916, 2635.80164463744, 2635.811415911195, 2635.9942415154305, 2644.3013344818028, 2644.283473943091, 2635.821450072077, 2635.7882428860917, 2635.8092866372185, 2644.3130120159767, 2644.313115533143, 2635.8128070057587, 2644.3055323618632, 2635.7929678568125, 2635.781081852556, 2635.8175674314134, 2644.282653810486, 2644.2921950449604, 2644.301059884791, 2644.304894193549, 2644.3005157573903, 2635.808354749019, 2635.78950227237, 2635.8018948504564, 2635.806429598359, 2644.2995353299493, 2644.2828827678104, 2644.278346382701, 2644.309970418829, 2644.316352389659, 2644.2842068148684, 2644.323629369276, 2644.318408648706, 2644.3186241188605, 2644.3137581089873, 2644.323470603901, 2644.2889533261737, 2635.8067501501296, 2635.9763353068074, 2635.806341957471, 2635.796918644587, 2635.820800329343, 2644.291991146523, 2644.2981373777598, 2644.3110385627238, 2644.2996189875716, 2644.300702641523, 2644.2831412404817, 2635.8247742639123, 2635.8194972135493, 2635.8298974886598, 2635.7840354316972, 2635.817940200595, 2644.284846857112, 2644.28844519186, 2644.283407039382, 2644.2880355279212, 2633.6189956849726, 2633.636892738881, 2633.631898566764, 2634.187538344148, 2634.1899156611066, 2634.195513206956, 2634.1886548745856, 2634.183470214822, 2635.79045994942, 2635.760857019315, 2635.816377946316, 2635.763631011431, 2635.9798779341377, 2635.9822467077356, 2635.7523077515384, 2635.7574428541725, 2644.2973346612293, 2635.8089929399357, 2644.2994873851735, 2636.014187493903, 2644.281952463107, 2644.3357868501607, 2644.306115068184, 2644.289695477679, 2644.3136369824715, 2644.3093203874123, 2644.2768780559622, 2644.332204919096, 2644.3078926643634, 2644.3306404147174, 2635.8063286165675, 2635.8182833682476, 2635.800307408292, 2644.2691571511123, 2644.2899439322964, 2644.2904826229014, 2644.295185617436, 2644.3159944340687, 2644.3032126601493, 2644.320669211428, 2644.308065436805, 2644.2839167567636]",0.00014985602259405848,0.0002387765502898371,2627.7280339535105,2631.1758904429043,,,2629.8903604322577,2632.257024341828,-2.1216552706932816,-1.645926335425762,1.9693841495536364,-0.5344878754203819,-0.3992436040020948,-0.5429862068954208,2633.5407496116754,2625.663213013461,27.616233519126585,19.289664685646848,3.0,5.0,,,,False,False,False,True,False,0.0,2640.207,2624.207,2632.207,2633.207,"5.0,3.0,2633.207",0,0.02,2024-12-06 14:49:00,2024-12-06 14:49:00,False,2024-12-06 14:49:00,2024-12-06 12:18:38,2024-12-06 14:12:06,2024-12-06 14:15:00,2628.207,2024-12-06 12:18:38,auto,2639.871,0.02,success,420.85,-1 days +22:03:38,2238.77,True,6,0,49,12
2024-12-06 14:38:00,2628.74,2629.272,2627.216,2629.039,591,160,0,2629.333915794986,2636.4177700000023,2643.5016242050187,2627.261801472809,2629.933600000001,2632.6053985271933,2631.450422259262,-0.09842539833744013,2630.564513088614,2629.668100000001,-0.37869999999884385,2627.4495999999995,2630.564513088614,2630.473701991102,-0.12153278642972509,2631.422157656656,-0.07326177233971976,2631.4587885428227,-0.01643759732860417,2629.5719655914,-0.05543974786587569,2629.5996854653386,-0.02717356321772968,0.016546162398299202,0.02093199851378813,,,,,,7.875413542917375,7.876172496599505,"[2635.7949575029315, 2644.368174045823, 2635.7915173685888, 2644.3234060434656, 2644.302013283533, 2644.29625654071, 2635.8015278562852, 2644.2799854044665, 2635.8188704805484, 2635.802173892063, 2644.266191829065, 2644.303350366168, 2644.319295895508, 2644.2897088400096, 2644.295165165411, 2644.307757334758, 2635.7898336039852, 2644.309178192542, 2644.3063760419286, 2633.624684645387, 2635.8036957462227, 2635.79736782272, 2635.80991687804, 2635.7834397771057, 2635.84073203095, 2635.75344396999, 2635.768900868448, 2635.8037648955574, 2635.823749325134, 2635.82758230501, 2644.333876437621, 2644.339944543269, 2644.2812163239264, 2644.3298131131464, 2644.331384238732, 2644.3062770007577, 2644.3050767485033, 2644.3118149794805, 2644.288748400793, 2644.271399317282, 2644.296372162277, 2635.7710686417836, 2635.820793271769, 2635.8288907125375, 2635.794330900939, 2634.194612374166, 2644.286664248194, 2644.2950364407416, 2644.321538584508, 2644.283745659549, 2635.8072958888406, 2644.30741473489, 2644.2975236118605, 2635.798931207798, 2635.821224305465, 2635.8100900518975, 2644.313168695587, 2644.2977238424332, 2644.298862385685, 2644.315015377569, 2644.295614396518, 2644.3134887806787, 2634.191299051274, 2634.195275887978, 2644.3085538618147, 2635.8024021324595, 2635.8154974263157, 2644.2931510489766, 2635.791656947898, 2644.293955041974, 2644.2945657009677, 2644.308545874015, 2644.3098708708767, 2635.8173124612986, 2633.610518580584, 2633.5998287674156, 2633.6067476751487, 2633.607230597592, 2633.6056322344007, 2633.6016113171277, 2633.602872049927, 2635.8322297053674, 2635.824952474235, 2635.8013776244625, 2634.194504184148, 2644.2949267260615, 2644.2926585426817, 2644.3104827625125, 2644.295909068844, 2644.3020475313265, 2633.6083968682688, 2634.1890207220526, 2634.1961416536296, 2634.1899153175555, 2644.3000468473992, 2634.196592287186, 2634.197805341404, 2634.188921611294, 2634.192195613268, 2634.195906044873, 2634.193010093655, 2634.186067977121, 2634.1906588653105, 2635.79528663883, 2635.7985483779853, 2635.81187875598, 2635.822326554808, 2635.8000288356784, 2644.2995208553684, 2644.3191511199975, 2644.2847133693494, 2644.31778964513, 2644.3018789731786, 2644.2902404452025, 2635.8146960985564, 2635.8207146045975, 2635.8339629614516, 2635.8468217443847, 2635.7761373895887, 2635.7676589689636, 2635.77244417029, 2635.7772397809913, 2635.782107433887, 2635.7873756047584, 2635.801973884407, 2634.1960475027763, 2636.0201153660505, 2644.278326641542, 2636.001725805557, 2636.0161610802243, 2636.0245583573032, 2644.309020082735, 2636.0013747213393, 2644.2977888477467, 2634.198275711201, 2634.1910665242435, 2635.831362249615, 2635.7985097423916, 2635.80164463744, 2635.811415911195, 2635.9942415154305, 2644.3013344818028, 2644.283473943091, 2635.821450072077, 2635.7882428860917, 2635.8092866372185, 2644.3130120159767, 2644.313115533143, 2635.8128070057587, 2644.3055323618632, 2635.7929678568125, 2635.781081852556, 2635.8175674314134, 2644.282653810486, 2644.2921950449604, 2644.301059884791, 2644.304894193549, 2633.6196191243125, 2644.3005157573903, 2635.808354749019, 2635.78950227237, 2635.8018948504564, 2635.806429598359, 2644.2995353299493, 2644.2828827678104, 2644.278346382701, 2644.309970418829, 2644.316352389659, 2644.2842068148684, 2644.323629369276, 2644.318408648706, 2644.3186241188605, 2644.3137581089873, 2644.323470603901, 2644.2889533261737, 2635.8067501501296, 2635.9763353068074, 2635.806341957471, 2635.796918644587, 2635.820800329343, 2634.194777580892, 2644.291991146523, 2644.2981373777598, 2644.3110385627238, 2644.2996189875716, 2644.300702641523, 2644.2831412404817, 2635.8247742639123, 2635.8194972135493, 2635.8298974886598, 2635.7840354316972, 2635.817940200595, 2634.1940418689023, 2644.284846857112, 2644.28844519186, 2644.283407039382, 2644.2880355279212, 2633.6189956849726, 2633.636892738881, 2633.631898566764, 2633.6072705430574, 2633.5951547366494, 2634.187538344148, 2634.1899156611066, 2634.195513206956, 2634.1886548745856, 2634.183470214822, 2635.79045994942, 2635.760857019315, 2635.816377946316, 2635.763631011431, 2635.9798779341377, 2635.9822467077356, 2635.7523077515384, 2635.7574428541725, 2644.2973346612293, 2635.8089929399357, 2644.2994873851735, 2636.014187493903, 2644.281952463107, 2644.3357868501607, 2644.306115068184, 2644.289695477679, 2644.3136369824715, 2644.3093203874123, 2644.2768780559622, 2644.332204919096, 2644.3078926643634, 2644.3306404147174, 2635.8063286165675, 2635.8182833682476, 2635.800307408292, 2644.2691571511123, 2644.2899439322964, 2644.2904826229014, 2644.295185617436, 2644.3159944340687, 2644.3032126601493, 2644.320669211428, 2644.308065436805, 2644.2839167567636, 2633.5943523074607]",-0.00022534847053678296,-0.00020470538868932748,2623.9867161774378,2627.0122637852924,,,2629.6107699869576,2630.1768639548955,-0.4706179566642277,-0.40065793824067136,1.3092003011491755,0.02093199851378813,0.004385836115488928,-0.04076581386925682,2633.1829136909123,2627.946112486316,24.80195003047449,28.284315465333265,3.0,5.0,,,,False,False,False,True,False,0.0,2641.039,2625.039,2633.039,2634.039,"5.0,3.0,2634.039",0,0.02,2024-12-06 14:51:00,2024-12-06 14:51:00,False,2024-12-06 14:51:00,2024-12-06 12:39:21,2024-12-06 14:11:51,2024-12-06 14:39:00,2629.039,2024-12-06 12:39:21,auto,2641.013,0.02,success,432.04,-1 days +22:00:21,2670.81,True,7,0,49,12
