time,open,high,low,close,tick_volume,spread,real_volume,hourly_time,time2,prev_hour_lsma_slope,prev_hour_macd_line,hour_lsma,fixed_support_gradient,fixed_resistance_gradient,prev_hour_lsma,fixed_support_trendline,fixed_resistance_trendline,prev_fixed_support_trendline,prev_fixed_resistance_trendline,prev_fixed_resistance_gradient,prev_fixed_support_gradient,ema_50,ema_24,stoch_k,stoch_d,prev_hour_macd_signal,ema_short,ema_long,lsma,macd_line,macd_signal,lsma_stddev,lsma_slope,prev_lsma_slope_1,prev_lsma_slope_2,lsma_upper_band,lsma_lower_band,is_buy2,is_sell2,tp,sl,be,be_condition,time_updated,sl_updated,time_to_trail,time_tp_hit,time_sl_hit,lot_size,type,success,profit,account_balance,win_streak,losing_streak,Week,Month
2024-03-06 05:00:00,62834.84,63099.738,62814.938,62830.34,2047,36422,0,2024-03-06 05:00:00,2024-03-06 05:00:00,64.18271428573644,-913.6751013666435,63322.75507142854,0.003658198051346919,-0.0009485475896240035,63396.909749999984,63754.44273644796,63885.60193183433,65066.057833699735,64495.74714202925,0.0002657779501694581,0.008712420922477792,64653.70576152689,64685.1000809516,11.479472607295419,18.911368444289266,-824.1038482495792,63256.38708064554,63510.470481368095,63107.01505228754,-254.0834007225567,-242.32302014084362,359.43277823745103,-169.93812555908517,-156.53250257992477,-36.45517199860478,63592.2493029081,62620.28080166698,False,True,62330.34,62950.64628218911,62480.34,62430.34,,False,,,2024-03-06 05:15:34,0.02,fail,False,-43.86,656.14,0,1,10,3
2024-03-06 19:15:00,67051.039,67141.734,66749.813,66866.234,4617,36421,0,2024-03-06 19:00:00,2024-03-06 19:00:00,282.11494047616725,436.6434815613029,66813.14178571431,0.0035382721156466644,-0.0008008044335390228,66579.20513095235,66735.00221387463,67177.49651820735,65086.48682187818,66959.37356486783,-0.0013006296031908321,0.0008933850654407121,65443.50616068313,65972.11814878088,86.74899860856476,83.7756475957102,323.94330909611466,66730.70382700874,66572.22602659583,66894.73361747501,158.4778004129039,114.07496784638752,463.27391099586123,28.244816649414133,83.40459201924386,191.86315376682614,67521.65339731942,66269.3138376306,True,False,67366.234,65086.48682187818,67216.234,67266.234,,False,2024-03-06 20:00:00,2024-03-06 19:59:43,,0.02,success,True,181.67,837.81,1,0,10,3
2024-03-08 16:45:00,68399.234,68713.734,68301.438,68487.734,4247,36421,0,2024-03-08 16:00:00,2024-03-08 16:00:00,87.95326190479682,156.43577677173016,67963.2696428571,0.0009173150928020563,0.0021243109061709732,67609.03769047624,67651.77299396829,69319.30517922442,67610.20764882278,68090.935549492,0.0005698601038356332,0.0009905649386635635,66897.26421837577,67338.10371520752,86.48513746816637,80.58588919625821,110.45730037823185,67884.94174876911,67652.65950717016,68037.24883866525,232.28224159895035,145.4419769057339,331.975524502032,130.16168455446314,126.69476848990598,52.03862951499468,68486.915796743,67589.08188058752,True,False,68987.734,67610.20764882278,68837.734,68887.734,,False,2024-03-08 17:30:00,2024-03-08 17:26:06,2024-03-08 17:32:42,0.02,success,True,181.67,1019.4799999999999,2,0,10,3
2024-03-11 09:15:00,70721.688,70977.336,70081.836,70734.938,6262,36421,0,2024-03-11 09:00:00,2024-03-11 09:00:00,278.3088571428525,260.3194006297126,69712.24565476194,0.003692671595689862,0.005121773977967373,68803.81589285712,69803.89804284327,73058.4888231133,69541.34365197305,69586.95121635115,0.0007139498874955451,0.0036955796630196757,67813.00184401718,68489.1824677583,95.62943130661837,89.63240349177848,236.11454818640564,69314.90983966115,68941.56155603578,69538.17100825593,373.3482836253679,149.28221392884961,661.3090533931055,327.6812232542143,372.682804609547,136.12675885800854,70432.43823033661,68645.40378617524,True,False,71234.938,69541.34365197305,71084.938,71134.938,,False,2024-03-11 10:00:00,2024-03-11 09:36:40,2024-03-12 19:18:03,0.02,success,True,181.67,1201.1499999999999,3,0,11,3
2024-03-13 22:00:00,73376.836,73443.336,73073.25,73435.734,2285,36421,0,2024-03-13 22:00:00,2024-03-13 22:00:00,242.98505952383857,238.31008903612383,73231.47734523809,0.002560444788810502,0.0006902955697449179,73128.59741666669,73737.59373281244,73665.26229815772,73639.09524885249,73487.64238199338,0.00027956273301768525,0.0026794934937270577,71995.71638456132,72621.42167607602,82.11966360841487,69.16944372962656,228.2734858312115,73077.15847419783,72973.81054338244,73216.57525730995,103.34793081539101,52.59090768815669,259.01562243719036,82.41745476442156,75.74355865150574,-14.770839353339397,73567.74634760016,72866.90416701973,True,False,73935.734,73185.23920574643,73785.734,73835.734,,False,,,2024-03-13 22:29:53,0.02,fail,False,-91.17,1109.9799999999998,0,1,11,3
2024-03-15 21:00:00,70257.734,70684.219,70104.836,70301.336,5445,36421,0,2024-03-15 21:00:00,2024-03-15 21:00:00,620.5972976190678,-154.71186896327708,69022.76651190475,0.0013613240574992052,0.0052466201223402694,68926.07551190478,68208.84937250275,72434.57554413255,68388.01096147086,72062.26755141576,0.005246251017461863,0.0021287670602829637,70087.66448453763,69134.37053549233,91.88918483706944,85.33010801598361,-548.0586591102395,68921.01196128002,68518.26321796747,69072.75672136218,402.7487433125498,177.83526482289545,647.8456463813112,326.54027657375264,347.92686068105104,178.08919263852295,69948.84834397695,68198.16509874741,True,False,70801.336,68239.82870813149,70651.336,70701.336,,False,,,2024-03-15 22:07:41,0.02,fail,False,-750.28,359.6999999999998,0,2,11,3
2024-03-18 17:00:00,67024.68,67171.336,66699.836,66775.336,4762,36421,0,2024-03-18 17:00:00,2024-03-18 17:00:00,-332.0967500000261,-210.02573470685456,67595.66663095242,-0.0016133305889050897,0.0003202882128470384,67721.99554761905,66135.38624245484,68801.76345971553,66241.50469863042,68779.58044971534,0.00032029529160279525,-0.0016163287005421312,68974.27061280141,68202.1564922561,8.98162899364808,13.587103947556274,-128.01088293856878,67529.48268148716,67817.661247671,67261.7995847953,-288.17856618383667,-134.37048616070192,481.93550793260425,-222.18414619885152,-205.26446026835765,-238.8767963535647,67912.41252050431,66609.68664908629,False,True,66275.336,68612.20643430194,66425.336,66375.336,,False,2024-03-19 03:45:00,2024-03-19 03:29:15,,0.02,success,True,181.67,541.3699999999998,1,0,12,3
2024-03-20 21:00:00,65437.238,65769.359,65111.859,65605.578,5541,36421,0,2024-03-20 21:00:00,2024-03-20 21:00:00,505.60042857150984,357.4057488181934,64859.428857142884,0.0005811553396470584,0.0036739537944627592,64322.33177380954,62295.95223753331,67039.34860578652,60891.43110805174,66298.69144705399,0.0029397848444219507,-0.0030680969376599117,64521.47886543556,63831.30096157535,93.35193879246037,91.08157995474643,62.295472302143864,64481.7459991268,64057.40842139331,64697.43365187473,424.3375777334877,250.94872896677674,663.6713781075216,313.92026487786643,311.6115438596389,111.40149294800358,65594.89001231988,63801.477291429575,True,False,66105.578,61358.05883074796,65955.578,66005.578,,False,2024-03-20 22:15:00,2024-03-20 22:05:28,,0.02,success,True,181.67,723.0399999999997,2,0,12,3
2024-03-25 00:30:00,66988.734,67026.539,66772.336,66986.938,3490,36421,0,2024-03-25 00:00:00,2024-03-25 00:00:00,80.66641666669602,-515.9714570365977,64837.8689761905,0.0022928511217313995,0.006790398182222478,63729.008511904736,64098.784552903046,68960.65925533773,63688.161193575026,64013.91563729316,-0.0006367197134091645,0.001794729060417625,65185.64549992734,64795.29541110526,96.88768825074891,71.60777456492417,-531.4313795399307,64932.33066866298,64393.54406553256,65344.69303887171,538.786603130422,110.47739094318422,1119.6094630164264,509.1158875129622,554.0085022359126,577.4305338837876,66857.66581394388,63833.220263799536,True,False,67486.938,63688.161193575026,67336.938,67386.938,,False,2024-03-25 01:15:00,2024-03-25 01:12:44,,0.02,success,True,181.67,904.7099999999997,3,0,13,3
2024-03-25 00:45:00,66986.938,67003.695,66831.938,66974.641,3166,36421,0,2024-03-25 00:00:00,2024-03-25 00:00:00,80.66641666669602,-515.9714570365977,64837.8689761905,0.0022928511217313995,0.006790398182222478,63729.008511904736,64098.784552903046,68960.65925533773,63688.161193575026,64013.91563729316,-0.0006367197134091645,0.001794729060417625,65185.64549992734,64795.29541110526,97.88327328195889,88.55506089801497,-531.4313795399307,65246.53225809944,64584.73643104867,65797.12152769172,661.7958270507734,220.74107816470206,1266.1093928286907,452.4284888200127,509.1158875129622,554.0085022359126,67507.86920801045,64087.87384737299,True,False,67474.641,63688.161193575026,67324.641,67374.641,,False,2024-03-25 01:15:00,2024-03-25 01:12:40,,0.02,success,True,181.67,1086.3799999999997,4,0,13,3
2024-03-25 16:45:00,69140.352,69480.641,69001.836,69416.438,4738,36421,0,2024-03-25 16:00:00,2024-03-25 16:00:00,369.8497500000085,461.96095256783883,68104.33670238098,0.0009108516150209138,0.00461678467636732,67338.23538095239,67179.05111633732,70855.7015867888,67116.60138720111,68457.63062709206,0.0013575536831523741,0.0009106716941868153,66192.31413495642,66711.70458059583,90.72299229923004,90.15720688492814,454.2856967441254,68144.11164040571,67628.17873119249,68563.53791537667,515.9329092132248,250.894595701376,808.5846803550359,352.36520123844093,348.8626470587915,373.52453835567576,69656.62723385596,67471.94859689737,True,False,69916.438,67116.60138720111,69766.438,69816.438,,False,2024-03-25 18:00:00,2024-03-25 17:46:25,,0.02,success,True,181.67,1268.0499999999997,5,0,13,3
2024-03-27 03:00:00,70646.734,70777.539,70443.367,70708.297,3259,36421,0,2024-03-27 03:00:00,2024-03-27 03:00:00,211.26634523819666,10.77330699772574,70360.41196428573,0.0016979841316337176,0.0006549135729137055,70248.43171428579,70485.55707104469,70976.87136735112,69946.39560651258,70930.58618265948,0.0006549093548391471,0.0009647137503259336,69315.50533965592,70097.45837349653,94.47100765697736,83.44277173927746,10.752137594152089,70286.42300504733,70174.33685646209,70400.29401375988,112.08614858523651,31.970572790494572,286.39250761041603,86.88244994834531,84.73062091505562,65.7826590987097,70788.42389903394,70013.66412848582,True,False,71208.297,69539.70180744176,71058.297,71108.297,,False,2024-03-27 15:15:00,2024-03-27 15:11:11,2024-03-27 11:02:53,0.02,fail,False,-425.27,842.7799999999997,0,1,13,3
2024-03-28 08:15:00,70022.086,70161.438,69916.336,70106.836,2821,36421,0,2024-03-28 08:00:00,2024-03-28 08:00:00,36.25367857146193,3.4542793903383426,69858.91369047621,0.0013536321391076842,0.0009501906265654782,69575.5482142857,69689.44698874735,70729.60318355059,69103.48271030467,69901.97013211402,-0.00023103501298989316,0.00036414292667284547,69516.82236469776,69618.46366043566,90.52943105852025,86.66103944526833,-110.76677267549047,69758.88464317277,69601.42650080626,69916.81066563471,157.45814236650767,103.33726424031845,266.47286647495275,101.45294461651065,95.31182146536594,43.13055108363915,70278.0490353759,69557.07229589352,True,False,70606.836,69103.48271030467,70456.836,70506.836,,False,2024-03-28 10:30:00,2024-03-28 10:08:33,2024-03-29 17:40:18,0.02,success,True,181.67,1024.4499999999998,1,0,13,3
2024-03-28 08:30:00,70113.836,70431.336,70046.0,70406.734,3158,36421,0,2024-03-28 08:00:00,2024-03-28 08:00:00,36.25367857146193,3.4542793903383426,69858.91369047621,0.0013536321391076842,0.0009501906265654782,69575.5482142857,69689.44698874735,70729.60318355059,69103.48271030467,69901.97013211402,-0.00023103501298989316,0.00036414292667284547,69516.82236469776,69618.46366043566,97.24433450641277,91.45056798585925,-110.76677267549047,69858.55377499234,69661.07890815396,70075.6823856209,197.4748668383836,122.16478475993148,309.19153894532025,158.87171998618578,101.45294461651065,95.31182146536594,70494.59096319707,69658.27380804472,True,False,70906.734,69103.48271030467,70756.734,70806.734,,False,2024-03-28 13:00:00,2024-03-28 11:06:57,2024-03-29 17:40:18,0.02,success,True,181.67,1206.12,2,0,13,3
2024-03-28 08:45:00,70396.211,70451.141,70218.086,70401.836,3101,36421,0,2024-03-28 08:00:00,2024-03-28 08:00:00,36.25367857146193,3.4542793903383426,69858.91369047621,0.0013536321391076842,0.0009501906265654782,69575.5482142857,69689.44698874735,70729.60318355059,69103.48271030467,69901.97013211402,-0.00023103501298989316,0.00036414292667284547,69516.82236469776,69618.46366043566,96.46172696607368,94.7451641770022,-110.76677267549047,69942.13565576274,69715.94980384625,70210.31046955622,226.18585191649618,142.96899819124442,347.59924494862213,134.6280839353276,158.87171998618578,101.45294461651065,70681.06945023686,69741.05148887559,True,False,70901.836,69103.48271030467,70751.836,70801.836,,False,2024-03-28 13:00:00,2024-03-28 11:06:56,2024-03-29 17:40:18,0.02,success,True,181.67,1387.79,3,0,13,3
2024-04-01 01:00:00,70901.734,71078.438,70881.68,71002.141,1736,56421,0,2024-04-01 01:00:00,2024-04-01 01:00:00,526.4584523809026,-51.73582520158379,70485.92577380955,0.0024068032988194517,0.0020280195460505093,69997.5893571428,70579.72714616677,71773.14659189068,70187.64485208053,71312.01954065808,0.0009689322341123693,0.001858455212086363,70125.09778331376,70145.5770912984,93.17960383630674,92.5796470549509,-168.99846143177226,70355.05292673846,70065.90775486267,70681.73571964225,289.14517187578895,107.44635294542903,594.3322850645378,173.68719470244832,174.2579814241617,192.61188716893957,71485.58430447937,69879.38713480513,True,False,71502.141,69382.4126995557,71352.141,71402.141,,False,,,2024-04-01 08:50:17,0.02,fail,False,-589.41,798.38,0,1,14,4
2024-04-01 17:45:00,69046.328,69246.141,68635.844,68931.836,4376,36421,0,2024-04-01 17:00:00,2024-04-01 17:00:00,77.51122619042872,-145.33049239318643,69502.12460714283,-0.0013751814619648627,0.0007399656016360663,69731.39346428568,68246.11116740876,70394.00901306105,69932.72233633093,70342.67238816984,0.0007399580432697697,0.001363259987327757,70032.8813319966,69911.79877917083,8.320549001203153,20.55441371139995,-137.17561093895347,69525.99876884115,69642.93159327257,69552.96952872376,-116.9328244314238,-52.45450280730833,261.76864078384114,-164.39595631232078,-131.8692019264272,-72.95053560375527,69906.35719378194,69198.08186366557,False,True,68431.836,70342.67238816984,68581.836,68531.836,,False,2024-04-01 18:15:00,2024-04-01 18:12:39,,0.02,success,True,181.67,980.05,1,0,14,4
2024-04-03 21:15:00,65767.344,65852.641,65581.836,65641.836,2397,36421,0,2024-04-03 21:00:00,2024-04-03 21:00:00,-16.31285714288242,-14.569014385953778,66062.18864285715,-0.00014229365588476378,-0.00045174665518179336,66070.64472619048,65434.075328464234,66665.85145281901,65999.81728142464,67449.40581598064,0.0011310562336805177,0.000697211133669991,66759.35956458517,66173.49915126115,12.667639639417587,19.168682618748274,-5.022208270018538,66015.09030140619,66093.40127573577,65853.50374785002,-78.31097432957904,-16.33425407213812,321.7321859255946,-144.4377358101192,-129.8112229102262,-89.0140846232971,66287.84219884957,65417.665296850464,False,True,65141.835999999996,67449.40581598064,65291.835999999996,65241.835999999996,,False,,2024-04-04 07:21:31,2024-04-04 16:21:30,0.02,success,True,181.67,1161.72,2,0,14,4
2024-04-05 08:30:00,66652.406,66841.734,66503.922,66841.141,2951,36421,0,2024-04-05 08:00:00,2024-04-05 08:00:00,-144.32736904766352,199.75597301327798,67473.75223809527,-0.002606462436820297,-0.002073738244451112,67878.62971428565,65650.62142681637,67460.97721700194,67324.32662606695,68211.74928940987,-0.0009647309516455269,-0.00019678086207643324,67143.79972189954,67455.39163500056,17.32741717646441,18.13053833655857,358.09311682121466,67487.63749792328,67730.93587108408,67294.35143653251,-243.29837316079647,-122.41314464245464,462.5244662277939,-123.50309012728394,-172.20061988300586,-62.96774750608893,67918.75946594003,66668.44340712499,False,True,66341.141,68211.74928940987,66491.141,66441.141,,False,2024-04-05 15:45:00,2024-04-05 15:03:21,2024-04-05 17:43:32,0.02,success,True,181.67,1343.39,3,0,14,4
2024-04-08 00:30:00,69279.75,69339.938,69051.906,69198.938,2209,56421,0,2024-04-08 00:00:00,2024-04-08 00:00:00,-114.2251666666707,56.0854675413284,67968.90996428567,-1.0514650573913956e-05,0.0017637313492677303,67570.10201190478,67301.21308319538,69924.21058883051,67782.36154583024,67583.12647594507,-0.001423819398876016,0.0017133222448431674,67324.2258375368,67568.57675722968,93.31446471144413,76.44968920836057,40.21745565166684,68254.02466428891,67926.78598831886,68443.60813931887,327.23867597004573,150.16060225525638,559.3858135009634,265.57001857577416,314.17395321639196,339.3765455796529,69200.27898754517,67688.43729109256,True,False,69698.938,67782.36154583024,69548.938,69598.938,,False,2024-04-08 04:30:00,2024-04-08 04:16:10,2024-04-10 15:39:15,0.02,success,True,181.67,1525.0600000000002,4,0,15,4
2024-04-08 00:45:00,69198.938,69199.039,69018.18,69018.18,1182,56421,0,2024-04-08 00:00:00,2024-04-08 00:00:00,-114.2251666666707,56.0854675413284,67968.90996428567,-1.0514650573913956e-05,0.0017637313492677303,67570.10201190478,67301.21308319538,69924.21058883051,67782.36154583024,67583.12647594507,-0.001423819398876016,0.0017133222448431674,67324.2258375368,67568.57675722968,88.17383140429861,86.12082272538261,40.21745565166684,68371.58702362908,68007.62998918413,68646.28519332646,363.95703444494575,192.91988869319425,603.1528732356043,202.67705400759587,265.57001857577416,314.17395321639196,69462.04157219453,67832.02881445839,True,False,69518.18,67782.36154583024,69368.18,69418.18,,False,2024-04-08 04:15:00,2024-04-08 04:13:29,2024-04-10 15:39:15,0.02,success,True,181.67,1706.7300000000002,5,0,15,4
2024-04-08 10:15:00,69911.734,70157.234,69856.445,70092.039,2577,36421,0,2024-04-08 10:00:00,2024-04-08 10:00:00,104.70779761907761,510.6262292200263,70013.9359404762,0.0018259249386731481,0.0024314824916463807,69611.31723809529,70172.11259273853,71591.34617453875,69459.65249312881,69816.6732619659,-4.2656761121921314e-05,0.0006593243318919926,68074.97961330155,68742.9632626789,92.36963824656249,88.51470579259198,439.41750588367074,69733.39546676776,69520.74409045292,69888.01099277605,212.65137631483958,191.16025612981986,231.30746795332027,76.27826281389571,58.827920536641614,41.492159270797856,70201.77607451304,69575.74591103906,True,False,70592.039,69459.65249312881,70442.039,70492.039,,False,2024-04-08 10:45:00,2024-04-08 10:36:03,2024-04-09 17:37:33,0.02,success,True,181.67,1888.4000000000003,6,0,15,4
2024-04-12 02:15:00,70074.492,70105.039,69781.844,69999.039,1430,36421,0,2024-04-12 02:00:00,2024-04-12 02:00:00,-63.9089999999851,-15.454327447310789,70216.02610714285,0.0003890094808106999,0.0004279499857552915,70303.22179761909,69895.44555028761,70978.89376590657,70358.3721941468,71369.22638008819,0.001387748537728747,0.0010770285550967332,70075.50737233195,70220.22355314945,15.39679674868515,18.529962001639372,15.42528398771654,70204.9126192354,70246.74066922514,70141.21768868247,-41.82804998973734,-0.6464655089865516,175.6936544682079,-79.34463020296243,-56.36351152390125,-45.817475748219294,70378.40412221456,69902.53125515039,False,True,69499.039,71369.22638008819,69649.039,69599.039,,False,2024-04-12 18:00:00,2024-04-12 17:39:40,,0.02,success,True,181.67,2070.07,7,0,15,4
2024-04-12 06:30:00,70967.234,71044.234,70818.039,70866.336,2009,36421,0,2024-04-12 06:00:00,2024-04-12 06:00:00,113.39715476188576,36.49414906268066,70599.91713095231,0.0010242183651931053,0.0005794554952057518,70351.20732142853,70368.26655672537,71221.35596251134,69566.00381464548,70837.48629909515,0.000105109818980878,-0.0004323199454237536,70151.58034797883,70328.88633424103,90.47513249442238,90.3813992005663,5.274642948649207,70618.67411335527,70463.7974416768,70808.66646680425,154.87667167847394,87.20958064453879,274.6329395685843,63.337750257967855,104.19697626428388,77.42268902633805,71180.92093522185,70437.91199838665,True,False,71366.336,69566.00381464548,71216.336,71266.336,,False,,,2024-04-12 17:38:33,0.02,fail,False,-473.31,1596.7600000000002,0,1,15,4
2024-04-12 15:00:00,70937.141,71009.336,70886.734,70894.602,1316,36421,0,2024-04-12 15:00:00,2024-04-12 15:00:00,28.6308928571234,127.36547230413998,70728.55713095237,-0.0007763937300654306,-0.0003965855203537104,70798.59589285715,70115.27611784542,70892.16039180619,70356.45700663721,70861.75245356228,-0.0005252874696436499,-0.00044939624050168055,70359.56532155088,70591.71699713971,83.3767941558619,79.83163386012082,126.01267232134005,70848.22071417712,70815.42374966512,70852.70947643621,32.79696451200289,22.925938005227493,76.57532124604629,10.769178534552339,32.29886824908317,35.76385724110878,70957.58616011837,70749.33279275405,True,False,71394.602,70456.27135701843,71244.602,71294.602,,False,,,2024-04-12 15:40:08,0.02,fail,False,-159.59,1437.1700000000003,0,2,15,4
2024-04-12 16:45:00,69829.414,70021.438,69649.336,69906.172,3807,36421,0,2024-04-12 16:00:00,2024-04-12 16:00:00,-70.03876190478331,86.47582603899355,70449.7302619048,-0.002220210429648298,-0.00010915172993013485,70728.55713095237,69009.79106412095,70969.39261000771,70115.27611784542,70892.16039180619,-0.0003965855203537104,-0.0007763937300654306,70341.78519129398,70536.87339736853,12.480401650236317,18.02119064833995,118.10530306487075,70399.68230635813,70581.0887699851,70285.03838974884,-181.4064636269759,-72.02656185115563,304.59024213113236,-135.8772851738031,-158.6099570002698,-101.13977777784748,70696.23521662586,69872.3415628718,False,True,69406.172,70892.16039180619,69556.172,69506.172,,False,2024-04-12 18:00:00,2024-04-12 17:50:50,,0.02,success,True,181.67,1618.8400000000004,1,0,15,4
2024-04-12 17:00:00,69908.141,70118.938,69640.141,69793.641,3627,36421,0,2024-04-12 17:00:00,2024-04-12 17:00:00,-278.826869047567,-17.32454239219078,70013.01730952383,-0.00279272457469639,-0.000358967467973441,70449.7302619048,68451.69351759311,70852.85228561264,69009.79106412095,70969.39261000771,-0.00010915172993013485,-0.002220210429648298,70299.81079163539,70435.63856557905,10.882285966887624,13.024482488175975,91.01933397345844,70306.44518230302,70522.75930554175,70134.27183694532,-216.31412323872792,-100.88407412867011,349.48405287243736,-150.76655280351406,-135.8772851738031,-158.6099570002698,70606.07530832311,69660.96836556753,False,True,69293.641,70892.16039180619,69443.641,69393.641,,False,2024-04-12 18:00:00,2024-04-12 17:52:25,,0.02,success,True,181.67,1800.5100000000004,2,0,15,4
2024-04-17 11:00:00,63238.039,63535.738,63238.039,63416.539,2706,36422,0,2024-04-17 11:00:00,2024-04-17 11:00:00,-235.74492857139558,131.92718733008223,63497.048785714294,-0.0010452861623492468,-0.000326841679182542,63650.57182142856,62824.44090764459,64304.280913408315,62957.69075643346,64765.485651474235,0.0007995117975598488,-0.0008166030455215422,64111.18517478898,63501.764019094044,17.283861431860952,21.808601495467645,154.76896143492752,63636.6641778215,63709.78048939034,63545.32998383208,-73.11631156883959,13.381000274727429,232.4333905290963,-70.75193636061158,-108.53939490881021,-56.5788489852348,63859.11506104636,63230.044906617804,False,True,62916.539,64714.17863857018,63066.539,63016.539,,False,2024-04-17 13:15:00,2024-04-17 13:11:06,2024-04-19 09:54:05,0.02,success,True,181.67,1982.1800000000005,3,0,16,4
2024-04-19 04:15:00,62087.137,62250.938,61819.816,62040.84,5040,36422,0,2024-04-19 04:00:00,2024-04-19 04:00:00,-183.61498809524346,270.6647636292473,62438.25847619046,-0.0039305167102336004,-0.002995148776345488,63244.384964285746,59612.85815427951,62485.05708439068,62830.22635221128,64068.63176648761,0.0006449932778124421,0.0009224781841603984,62657.80586173341,62569.07753556826,6.838790130556803,7.769680535408377,344.00273588612816,62836.33291606115,63037.68643823025,62633.909285517664,-201.35352216910542,-35.09507508132667,414.803726219796,-206.30586033716827,-218.60700722389447,-122.18152253187145,63193.89431591439,62072.42425512094,False,True,61540.84,64068.63176648761,61690.84,61640.84,,False,2024-04-19 04:45:00,2024-04-19 04:35:27,2024-04-19 09:48:19,0.02,success,True,181.67,2163.8500000000004,4,0,16,4
2024-04-26 14:00:00,64053.738,64166.637,64050.543,64137.84,1725,36422,0,2024-04-26 14:00:00,2024-04-26 14:00:00,-85.86389285720361,-22.158543136851222,64235.22990476194,0.00010350013692886402,-0.00026679479856745716,64264.846380952375,64042.25395573439,64426.339176694484,64042.5083427523,64688.410876303984,0.00026835575752061033,0.00011537842111171515,64564.09569077618,64330.74906686371,15.771809175872448,21.170785618218286,12.215380532380003,64270.95908801548,64306.01755627923,64268.31964086688,-35.05846826374909,-7.45119009206862,111.98962853321301,-38.836852425207326,-53.037134502890694,-17.075892328910413,64419.50563938672,64115.63364234704,False,True,63637.84,64492.72375246253,63787.84,63737.84,,False,2024-04-26 18:15:00,2024-04-26 16:32:23,2024-04-26 16:58:58,0.02,success,True,181.67,2345.5200000000004,5,0,17,4
2024-04-30 01:30:00,63463.738,63857.738,63455.84,63702.383,3076,36422,0,2024-04-30 01:00:00,2024-04-30 01:00:00,-25.396904761924816,41.00661362289975,63250.87239285719,0.00012381697023491255,0.001893728325766378,62955.28125000002,62547.62170051081,64401.48879501318,63304.6324421766,63148.22044320266,-0.00010547608467584443,0.00213910307674493,63331.4918250564,62966.13386511983,94.58681204570911,91.12504428940827,-74.40837377539113,63124.36031165288,62962.11692101892,63235.131148606764,162.24339063396474,96.68416295736606,238.844070894254,143.37994152039755,118.22296250428917,55.598775369813666,63559.07064431401,62912.69165289952,True,False,64202.383,64052.383,64052.383,64102.383,2024-04-30 03:45:00,True,2024-04-30 03:45:00,2024-04-30 03:46:12,2024-04-30 04:33:24,0.02,success,True,181.67,2527.1900000000005,6,0,18,4
2024-04-30 01:45:00,63701.371,63907.738,63696.422,63837.75,2509,36422,0,2024-04-30 01:00:00,2024-04-30 01:00:00,-25.396904761924816,41.00661362289975,63250.87239285719,0.00012381697023491255,0.001893728325766378,62955.28125000002,62547.62170051081,64401.48879501318,63304.6324421766,63148.22044320266,-0.00010547608467584443,0.00213910307674493,63331.4918250564,62966.13386511983,94.40314544059618,94.17839535208698,-74.40837377539113,63234.1125713986,63026.97863057307,63394.9250299278,207.13394082552986,118.77411853099882,296.5778985826883,159.79388132103486,143.37994152039755,118.22296250428917,63796.80519301443,62994.54486684117,True,False,64337.75,63304.6324421766,64187.75,64237.75,,False,2024-04-30 04:00:00,2024-04-30 03:47:13,2024-04-30 05:01:32,0.02,success,True,181.67,2708.8600000000006,7,0,18,4
2024-05-01 11:00:00,57459.238,57552.34,56903.887,57315.539,6246,36422,0,2024-05-01 11:00:00,2024-05-01 11:00:00,-801.8433809524722,-615.2814923076439,58265.97010714291,-0.008098775745034772,-0.0036274695627845606,59048.00489285712,54737.72590233091,58792.11886533356,55377.58244652382,59004.63853485079,-0.003627214537935917,-0.0073798926694545195,61255.40335442572,60177.47658271106,15.198839587879185,19.452738113906218,-465.9477805894979,58639.71824050239,59284.60504071143,58060.33945958035,-644.8868002090385,-358.14589174097046,932.7668190826722,-362.8553914688455,-390.41926659786986,-381.4430309597301,59319.574665341956,56799.60425381874,False,True,56815.539,59794.10510073236,56965.539,56915.539,,False,2024-05-01 11:45:00,2024-05-01 11:20:42,2024-05-03 05:13:15,0.02,success,True,181.67,2890.5300000000007,8,0,18,5
2024-05-07 11:30:00,64208.438,64373.07,64056.969,64091.84,3084,36422,0,2024-05-07 11:00:00,2024-05-07 11:00:00,1.2905714285152499,23.363211270545435,63728.5445357143,0.0019163828519739145,0.0009946857677221674,63517.326761904726,63890.29494148048,64634.17729711203,63371.718966676286,63726.097864432566,-0.00031292159925818156,0.001145173481827608,62777.6552033767,63466.43106564496,88.06739545954349,86.3915484736895,11.166569343765083,63758.84672987611,63614.24510844248,63905.34165737871,144.60162143362686,78.26615187081615,282.5334771806847,66.66294048843702,106.9759982800606,37.24188888885692,64288.261851572635,63523.921463184786,True,False,64591.84,63371.718966676286,64441.84,64491.84,,False,,,2024-05-07 14:47:30,0.02,fail,False,-262.04,2628.4900000000007,0,1,19,5
2024-05-09 00:00:00,61512.121,61602.039,61412.414,61453.738,1748,56422,0,2024-05-09 00:00:00,2024-05-09 00:00:00,-306.3799880952647,-178.95816972754983,61799.38317857142,-0.0014734456638922748,-0.0012332839052201859,62062.336047619036,60919.62921495056,62182.99629736075,61166.35893664176,62638.371439847375,-0.00022702334860785572,-0.0008350436309035918,62577.279534802765,62385.092552096634,8.987097893892473,11.606766629093245,-141.93401632966808,61917.314149654405,62106.92904845672,61710.683372548985,-189.61489880231238,-81.26277286352197,336.397098944096,-149.74157000340347,-146.52563880293746,-141.2778716890607,62164.819456123514,61255.047288974456,False,True,60953.738,62650.305459805924,61103.738,61053.738,,False,2024-05-09 02:30:00,2024-05-09 02:07:02,2024-05-10 00:01:28,0.02,success,True,181.67,2810.1600000000008,1,0,19,5
2024-05-09 18:30:00,62155.738,62206.039,61888.84,62060.539,3502,36422,0,2024-05-09 18:00:00,2024-05-09 18:00:00,139.84609523806284,-135.19429823690007,61566.59748809526,0.001371691811764004,0.0019146559282501624,61264.52819047617,61194.02087450874,62718.49766350025,60193.266899083304,61568.27135730429,-4.736957063454229e-05,-0.0007778157542094413,61961.22940297426,61609.233651809045,89.83808637240271,86.6904243944,-198.2452394304672,61565.11589287869,61408.469971186336,61723.88949329205,156.64592169235402,47.20081165627124,339.07235618293333,108.4089986240433,131.6376900584437,107.11636773305509,62183.13717413901,61266.141812445094,True,False,62560.539,60193.266899083304,62410.539,62460.539,,False,2024-05-09 19:30:00,2024-05-09 19:21:58,2024-05-10 19:06:19,0.02,success,True,181.67,2991.830000000001,2,0,19,5
2024-05-09 18:45:00,62055.82,62149.438,61883.938,62104.34,3041,36422,0,2024-05-09 18:00:00,2024-05-09 18:00:00,139.84609523806284,-135.19429823690007,61566.59748809526,0.001371691811764004,0.0019146559282501624,61264.52819047617,61194.02087450874,62718.49766350025,60193.266899083304,61568.27135730429,-4.736957063454229e-05,-0.0007778157542094413,61961.22940297426,61609.233651809045,90.65821996762106,89.92252473714808,-198.2452394304672,61648.073447820425,61460.0158992466,61822.4901895425,188.05754857382271,75.37215903978154,374.28896322841695,98.60069625044707,108.4089986240433,131.6376900584437,62329.28028990086,61317.20008918414,True,False,62604.34,60193.266899083304,62454.34,62504.34,,False,2024-05-10 00:00:00,2024-05-09 19:25:01,2024-05-10 19:06:19,0.02,success,True,181.67,3173.500000000001,3,0,19,5
2024-05-09 19:00:00,62104.34,62457.738,62042.738,62395.707,3409,36422,0,2024-05-09 19:00:00,2024-05-09 19:00:00,302.06929761909123,-29.535653866150824,61725.56057142862,0.0025215065012673277,0.002989440977416621,61566.59748809526,61917.28764517905,63378.334229946515,61194.02087450874,62718.49766350025,0.0019146559282501624,0.001371691811764004,61955.147347955666,61624.98591966433,91.47252934926145,90.656278563095,-164.50332231760393,61763.09399430959,61529.32635115426,61974.49103611969,233.76764315532637,107.05125586289051,432.5794320129898,152.0008465771898,98.60069625044707,108.4089986240433,62559.97326933723,61390.50880290215,True,False,62895.707,60193.266899083304,62745.707,62795.707,,False,2024-05-10 01:45:00,2024-05-10 01:38:21,2024-05-10 19:06:19,0.02,success,True,181.67,3355.170000000001,4,0,19,5
2024-05-17 18:00:00,66758.109,66901.734,66499.633,66844.734,3318,36421,0,2024-05-17 18:00:00,2024-05-17 18:00:00,151.0316428571823,232.9514039085043,66637.82895238097,-0.0007250219219081884,0.002044015546616939,66345.04140476194,65473.92615217785,67951.2505051115,65647.9400586557,67023.45011275311,0.0007630611086164795,-0.00034823300016879487,65372.2978204778,65962.61808838196,87.16072895358951,75.65761717827661,168.69125107278327,66354.4246857148,66225.84721453617,66360.14848366014,128.57747117862164,81.94102796286441,205.45405862058698,123.78570863434288,117.24818163053715,18.833136566943722,66639.01146279793,66082.78550452236,True,False,67344.734,65908.59766875797,67194.734,67244.734,,False,2024-05-17 18:30:00,2024-05-17 18:29:58,,0.02,success,True,181.67,3536.840000000001,5,0,20,5
2024-05-17 18:30:00,67345.438,67382.141,67115.734,67143.641,2931,36421,0,2024-05-17 18:00:00,2024-05-17 18:00:00,151.0316428571823,232.9514039085043,66637.82895238097,-0.0007250219219081884,0.002044015546616939,66345.04140476194,65473.92615217785,67951.2505051115,65647.9400586557,67023.45011275311,0.0007630611086164795,-0.00034823300016879487,65372.2978204778,65962.61808838196,93.23258157184824,92.26290675525705,168.69125107278327,66604.62840811533,66370.50455841579,66723.88697076026,234.12384969953564,130.94262393097034,339.7798142427942,144.18102063982224,219.55746646029002,123.78570863434288,67184.08971998803,66265.18422153249,True,False,67643.641,65647.9400586557,67493.641,67543.641,,False,2024-05-20 19:30:00,2024-05-20 19:02:38,,0.02,success,True,181.67,3718.510000000001,6,0,20,5
2024-05-20 08:00:00,67075.992,67251.734,67061.836,67088.133,2155,36421,0,2024-05-20 08:00:00,2024-05-20 08:00:00,258.5676666666841,135.46342181027285,66918.42974999997,0.0021306928453446025,0.001797946502022625,66758.45701190479,67143.23232927892,67750.39007974883,66390.79214083134,67593.00078717242,0.001744268168195142,0.000846007344565948,65924.72717165622,66451.43871404293,91.87132484650623,90.92785232846173,129.10254132200433,66757.95925939234,66614.83299536898,66907.80179084968,143.12626402336173,76.95752192928532,278.44098074361335,72.97123942209873,71.98643790853384,70.97478328170837,67285.19711485357,66531.9064668458,True,False,67588.133,66093.34743118654,67438.133,67488.133,,False,2024-05-20 19:30:00,2024-05-20 19:01:49,,0.02,success,True,181.67,3900.180000000001,7,0,21,5
2024-05-20 19:45:00,68188.938,68200.336,68001.273,68148.539,2232,36421,0,2024-05-20 19:00:00,2024-05-20 19:00:00,135.00941666669678,161.49683496945363,67476.37504761906,7.511550924103373e-05,0.0022117465356473577,67122.85822619048,66729.25517061312,68831.90126558527,66695.24578389175,67580.45186551928,0.0004438009432589365,-9.647747424619833e-06,66326.39615605057,66842.63149374482,94.88342541651254,86.21583699937344,132.16562891435868,67498.8873809208,67236.00737915677,67716.23602235984,262.8800017640315,133.94052361268018,390.4214774927097,170.94495940837078,213.58189026487526,141.37875404195802,68244.80501697499,67189.16702774468,True,False,68648.539,66695.24578389175,68498.539,68548.539,,False,2024-05-20 21:45:00,2024-05-20 21:40:54,,0.02,success,True,181.67,4081.8500000000013,8,0,21,5
2024-05-20 20:00:00,68143.68,68410.961,67985.836,68343.938,2557,36421,0,2024-05-20 20:00:00,2024-05-20 20:00:00,353.51682142858044,270.6774531652336,67804.25804761903,0.0021675744641120945,0.0026759419098587012,67476.37504761906,67738.21837058022,69342.55677952824,66729.25517061312,68831.90126558527,0.0022117465356473577,7.511550924103373e-05,66402.66403228388,66956.91913424522,97.29736088534834,92.02052051590243,159.86799376453368,67628.89516847144,67318.07631403404,67896.63110767114,310.81885443739884,169.31618977762392,457.37712161548745,180.3950853113056,170.94495940837078,213.58189026487526,68515.59022185205,67279.17199349024,True,False,68843.938,66695.24578389175,68693.938,68743.938,,False,2024-05-20 22:30:00,2024-05-20 22:21:12,,0.02,success,True,181.67,4263.520000000001,9,0,21,5
2024-05-22 13:30:00,70140.938,70233.734,70114.102,70219.039,1356,36421,0,2024-05-22 13:00:00,2024-05-22 13:00:00,63.40304761903826,-46.19880458024272,70038.18432142858,0.0015803546048002754,0.0004888817221947874,69921.15888095235,70343.90487745707,70461.90008069956,70080.8812013371,70124.57157147354,-0.0003467026751832861,0.0013443083343034825,69460.32680174829,69985.8624019766,82.96693583204463,72.11075631571681,-61.30962343555121,70026.76432589011,69974.78712343698,70088.4677963536,51.977202453126665,16.941044078147197,176.07966726536057,53.78775782592129,40.08095287242031,29.022530787653523,70327.67534716183,69850.76024554536,True,False,70719.039,70080.8812013371,70569.039,70619.039,,False,2024-05-22 19:15:00,,2024-05-22 14:27:07,0.02,fail,False,-50.22,4213.300000000001,0,1,21,5
2024-05-22 13:45:00,70217.688,70264.836,70140.336,70208.438,968,36421,0,2024-05-22 13:00:00,2024-05-22 13:00:00,63.40304761903826,-46.19880458024272,70038.18432142858,0.0015803546048002754,0.0004888817221947874,69921.15888095235,70343.90487745707,70461.90008069956,70080.8812013371,70124.57157147354,-0.0003467026751832861,0.0013443083343034825,69460.32680174829,69985.8624019766,89.46270660857003,81.51432890560811,-61.30962343555121,70054.71412190702,69992.09459577498,70132.75736773304,62.61952613203903,26.076740488925566,145.75944803266856,44.28957137944235,53.78775782592129,40.08095287242031,70331.03262257714,69935.98211288893,True,False,70708.438,70080.8812013371,70558.438,70608.438,,False,2024-05-22 19:15:00,,2024-05-22 14:27:07,0.02,fail,False,-46.4,4166.9000000000015,0,2,21,5
2024-05-22 14:00:00,70208.438,70302.336,70164.688,70214.453,1590,36421,0,2024-05-22 14:00:00,2024-05-22 14:00:00,117.0254404762236,-11.528555215729284,69986.36819047618,0.0010764350313997497,0.0007826375358619174,70038.18432142858,70059.58699944342,70645.09850428275,70343.90487745707,70461.90008069956,0.0004888817221947874,0.0015803546048002754,69471.76649579738,69967.15652981847,90.86932728737192,87.76632324266211,-51.35340979158683,70079.28933392132,70008.56558868053,70173.49199724797,70.72374524078623,35.0061414392977,141.43842572433982,40.73462951493275,44.28957137944235,53.78775782592129,70365.93387197582,69982.55012252012,True,False,70714.453,70080.8812013371,70564.453,70614.453,,False,2024-05-22 19:15:00,,2024-05-22 14:27:07,0.02,fail,False,-48.59,4118.310000000001,0,3,21,5
2024-05-22 18:45:00,70526.438,70624.539,70366.234,70467.438,2918,36421,0,2024-05-22 18:00:00,2024-05-22 18:00:00,92.27110714283481,-44.888468448698404,70035.46334523805,8.547707267386311e-05,0.0007595420253620787,69865.69404761904,69484.12628099453,70848.20028669709,69301.77755613557,70424.99852119546,0.00024353964810013972,-0.00040540033477037016,69547.14493931064,69975.77533359855,89.77037425156414,84.26522851250837,-56.32009951967599,70073.91008878863,69987.92171941425,70100.3412659098,85.9883693743759,1.1317805397490517,267.1198933749062,124.29514275879774,151.3829074647074,97.74169659447216,70462.45312196593,69739.72940985367,True,False,70967.438,69301.77755613557,70817.438,70867.438,,False,,,2024-05-22 21:22:01,0.02,fail,False,-424.18,3694.1300000000015,0,4,21,5
2024-05-22 19:00:00,70469.836,70684.336,70309.445,70684.336,2188,36421,0,2024-05-22 19:00:00,2024-05-22 19:00:00,169.76929761901556,24.265594543190673,70131.3014285714,8.545338318756898e-05,0.0010212046982153017,70035.46334523805,69490.03744215966,70996.99747288888,69484.12628099453,70848.20028669709,0.0007595420253620787,8.547707267386311e-05,69574.75627502396,69997.81202691066,92.62838452189139,88.06692387152837,-40.20296070710266,70167.82176743653,70039.50796242061,70255.43848538009,128.31380501591775,26.56818543498279,302.3893845364111,155.09721947029175,124.29514275879774,151.3829074647074,70665.16415450424,69847.21281625594,True,False,71184.336,69301.77755613557,71034.336,71084.336,,False,,,2024-05-22 21:22:01,0.02,fail,False,-503.16,3190.9700000000016,0,5,21,5
2024-05-23 17:00:00,68044.539,68229.734,67686.047,68229.734,3207,36421,0,2024-05-23 17:00:00,2024-05-23 17:00:00,-559.0649999999587,-179.18712739458715,68580.26861904767,-0.0040964885230284145,-0.00015577183877712707,69129.59188095242,66373.89253433977,70045.98384230884,66852.58245938644,70276.12019282416,0.0004536285073763063,-0.00334413639257908,69446.50493069513,69396.5855717618,15.67400270612025,20.249645370272464,-60.73115774966027,69138.65903160584,69405.98478159029,68956.42574372201,-267.3257499844476,-69.64213794261903,503.9215681759791,-248.74492260065745,-301.6055696594558,-176.22648675610253,69636.71986075958,68274.63162668444,False,True,67729.734,70244.89815331133,67879.734,67829.734,,False,2024-05-23 18:00:00,2024-05-23 17:49:48,,0.02,success,True,181.67,3372.6400000000017,1,0,21,5
2024-05-27 04:00:00,68833.336,68836.734,68745.641,68745.641,1120,36421,0,2024-05-27 04:00:00,2024-05-27 04:00:00,-9.661059523830772,239.61338346617413,68750.03817857141,7.293064769551893e-05,0.00015813919032269235,68631.77021428567,68166.21169863839,69358.76196851608,67673.56791536909,68460.77781976345,-0.0013087212905743839,-0.0009327716721305582,68435.294751516,68350.42139902232,91.70102648150714,84.90630211215561,194.79261183867874,68648.24254983607,68600.74740960685,68630.36878775372,47.49514022922085,46.28993100716682,203.65786189681577,59.74186446508975,68.41951943591994,57.47247162014537,68906.80690131441,68355.43067419302,True,False,69245.641,68365.91410644051,69095.641,69145.641,,False,2024-05-27 05:30:00,2024-05-27 04:40:58,2024-05-27 08:29:32,0.02,success,True,181.67,3554.3100000000018,2,0,22,5
2024-05-27 04:15:00,68745.648,68816.938,68741.234,68786.734,797,36421,0,2024-05-27 04:00:00,2024-05-27 04:00:00,-9.661059523830772,239.61338346617413,68750.03817857141,7.293064769551893e-05,0.00015813919032269235,68631.77021428567,68166.21169863839,69358.76196851608,67673.56791536909,68460.77781976345,-0.0013087212905743839,-0.0009327716721305582,68435.294751516,68350.42139902232,91.10591171133365,90.72475290303036,194.79261183867874,68669.54892678437,68614.52419408041,68687.12041038868,55.024732703954214,48.0368913465243,202.34400044540436,56.75162263496895,59.74186446508975,68.41951943591994,68961.78481098998,68413.95600978739,True,False,69286.734,67673.56791536909,69136.734,69186.734,,False,2024-05-27 18:00:00,2024-05-27 04:47:20,2024-05-28 07:29:17,0.02,success,True,181.67,3735.980000000002,3,0,22,5
2024-05-27 14:45:00,68354.664,68495.734,68321.836,68439.758,1513,36421,0,2024-05-27 14:00:00,2024-05-27 14:00:00,21.606392857123865,55.18821491759445,68530.80980952382,-0.00011892857904630984,-0.00010235309902460702,68557.75592857138,68226.86525674419,68884.72395313715,68367.49707877688,68591.29652057397,-0.0008131739906721871,9.347082180955098e-05,68503.46691184271,68506.10098525776,19.33957414885072,22.95881583964253,124.37016491226179,68524.13257700019,68583.58724281887,68461.65209631922,-59.45466581868823,-45.14879999420771,109.90800625194944,-34.43792053661309,-62.57440660473367,-38.75797282428539,68610.02790475935,68311.77628787908,False,True,67939.758,68591.29652057397,68089.758,68039.758,,False,2024-05-28 06:45:00,2024-05-28 06:36:03,2024-05-27 15:34:41,0.02,fail,False,-55.14,3680.840000000002,0,1,22,5
2024-05-27 19:00:00,70403.234,70671.539,70393.852,70583.438,2379,36421,0,2024-05-27 19:00:00,2024-05-27 19:00:00,534.7646309524571,305.8607426538074,69875.93079761903,0.0034616216325448965,0.0045442475325270515,69511.25061904767,70325.35871708626,72240.5988916812,69266.19130564835,71555.35716820908,0.003343135550074994,0.00179211151271568,68698.00167191512,68884.43861606451,93.15503901456646,90.68491203590746,139.95181429958785,69702.52355749304,69260.95981900125,70154.09980976951,441.56373849179363,259.88432356556524,674.6945880573817,210.5120381837187,216.92288923282467,247.72475679397758,71066.43750364697,69243.26211589205,True,False,71083.438,68406.41031262038,70933.438,70983.438,,False,,,2024-05-28 06:09:04,0.02,fail,False,-792.31,2888.530000000002,0,2,22,5
2024-05-28 06:45:00,67832.539,68132.336,67832.539,68045.039,1825,36421,0,2024-05-28 06:00:00,2024-05-28 06:00:00,-188.51489285712887,-42.76014142605709,68562.88491666672,-0.0030049011961045717,-0.001170087198243905,68990.30164285716,66907.38794804298,69112.40293185155,68019.22920020949,69139.7236987215,-0.0013187967845234747,-0.00139185140873354,68903.23796850989,69071.99577512465,9.498170809404089,10.372215263639962,153.93363865094014,68572.76015911697,68960.70332078607,68226.20613966291,-387.94316166909994,-274.0012717112394,560.1269479156931,-138.03723942209035,-193.06875644993852,-134.53136738904868,68982.3775193491,67468.53475997673,False,True,67545.039,69139.7236987215,67695.039,67645.039,,False,2024-05-28 07:45:00,2024-05-28 07:30:38,2024-05-30 20:24:55,0.02,success,True,181.67,3070.200000000002,1,0,22,5
2024-05-29 11:00:00,67979.641,68027.836,67658.844,67792.141,2225,36421,0,2024-05-29 11:00:00,2024-05-29 11:00:00,-250.36777380952844,10.450371108061518,68214.59440476193,-0.0014807931973500692,-0.001259929647143719,68451.82441666666,67206.81482114029,68248.24866960528,67767.04519567391,68958.99697056352,1.5796493028931533e-05,-0.0006818700096729304,68497.43721641808,68416.09220196688,9.383222346959549,9.45565305512862,45.715409498248626,68323.42221226126,68470.60435051227,68136.05738871689,-147.18213825100975,-40.86875623179696,299.5955649269142,-130.11309150318266,-118.5013770210935,-74.40321018232498,68540.51140136822,67730.10337606556,False,True,67292.141,69030.74119097224,67442.141,67392.141,,False,2024-05-29 19:15:00,2024-05-29 19:03:18,2024-05-30 20:23:23,0.02,success,True,181.67,3251.870000000002,2,0,22,5
2024-05-29 18:45:00,67462.227,67600.438,67302.961,67402.836,2341,36421,0,2024-05-29 18:00:00,2024-05-29 18:00:00,-38.624940476205666,-173.29014814313268,67665.25895238093,-0.0006658421644137982,0.0006857491304327204,67814.34455952374,67119.30240330503,68598.35730170147,67473.75414505102,68094.13975879276,-0.0006193641929044939,-0.00021103271595074562,68325.11387417345,68133.7207113563,17.868930510731314,18.47666551714201,-99.47017635630232,67680.76922119208,67832.56590873316,67594.64634124523,-151.79668754107843,-122.08713726837601,182.80421362905852,-67.61672170623206,-66.6059453044727,-17.320156518777367,67841.43202964446,67346.360652846,False,True,66902.836,68094.13975879276,67052.836,67002.836,,False,2024-05-31 19:15:00,2024-05-31 19:07:17,2024-05-30 05:24:57,0.02,fail,False,-251.67,3000.200000000002,0,1,22,5
2024-05-29 19:00:00,67402.836,67421.938,67111.227,67231.836,2629,36421,0,2024-05-29 19:00:00,2024-05-29 19:00:00,-149.0856071428134,-214.5100582070736,67597.58432142861,-0.0012572962481391713,-0.00010129722620550954,67665.25895238093,66764.3970882773,68261.88299828328,67119.30240330503,68598.35730170147,0.0006857491304327204,-0.0006658421644137982,68295.86031048038,68089.35489444781,10.065077706893076,15.281952124138911,-122.47815272645659,67611.70257177792,67788.06739697515,67500.1406040591,-176.36482519723359,-132.94267485414753,218.31133150606084,-94.50573718613305,-67.61672170623206,-66.6059453044727,67794.86090159228,67203.9203065259,False,True,66731.836,68094.13975879276,66881.836,66831.836,,False,,2024-05-31 19:19:02,2024-05-30 05:24:57,0.02,fail,False,-313.91,2686.2900000000022,0,2,22,5
2024-05-30 05:30:00,68119.602,68231.734,68060.938,68085.641,1921,36421,0,2024-05-30 05:00:00,2024-05-30 05:00:00,96.57892857138359,-82.07488379545975,67834.36698809524,0.000979493470419885,0.000965062467562378,67733.49310714281,67821.92190299893,68503.38550358971,67757.12595697244,68068.94587333329,0.0004322010803074817,0.0009833411936942698,68082.06612624793,67849.31372707537,87.69126360497067,85.5884672336825,-144.1313706463423,67843.4437772116,67744.48060048134,67890.70210629524,98.96317673026351,57.28665146880823,170.60259639967194,53.011044719678466,72.9188087375951,25.296041279652854,68122.51561143479,67660.38860115569,True,False,68585.641,67757.12595697244,68435.641,68485.641,,False,2024-05-30 17:00:00,2024-05-30 16:47:07,2024-05-30 09:35:31,0.02,fail,False,-119.56,2566.7300000000023,0,3,22,5
2024-05-30 14:15:00,67988.039,68135.836,67870.0,68109.109,1711,36421,0,2024-05-30 14:00:00,2024-05-30 14:00:00,15.88260714293574,2.5087294999684673,67777.10351190479,-0.001431264423805146,-0.0006690666776385765,67775.8368452381,66467.56033404764,67947.40053625198,66199.38351379587,67728.63282036976,-0.0010534727448335984,-0.0023243477468007766,68027.9384695795,67871.38059678362,91.77897929704227,86.07304592331347,-10.642959169778685,67848.38235669854,67827.48258487259,67860.53134778123,20.899771825948847,-31.924574615506042,238.41676757112765,84.51013381492521,73.53179738561448,63.87539972482773,68183.89398400225,67538.66871156021,True,False,68609.109,66199.38351379587,68459.109,68509.109,,False,2024-05-30 17:00:00,2024-05-30 16:47:08,,0.02,success,True,181.67,2748.4000000000024,1,0,22,5
2024-05-30 15:30:00,68046.336,68303.039,67881.914,68245.234,3022,36421,0,2024-05-30 15:00:00,2024-05-30 15:00:00,1.26666666669189,0.9893794060917571,67911.45511904759,0.0005499097297059743,0.0002921528725332511,67777.10351190479,67449.6994662614,68441.66405396769,66467.56033404764,67947.40053625198,-0.0006690666776385765,-0.001431264423805146,68033.04503939992,67894.32262904094,85.15661141425245,77.71833621253141,-8.316491454604597,67960.3867545541,67892.91777068697,68099.0059325766,67.46898386713292,19.545927490523606,234.2613765552249,38.703976608259836,44.33066838658124,67.8449786722922,68416.75879092616,67782.75307422705,True,False,68745.234,66467.56033404764,68595.234,68645.234,,False,2024-05-30 17:30:00,2024-05-30 17:02:10,,0.02,success,True,181.67,2930.0700000000024,2,0,22,5
2024-05-30 15:45:00,68255.539,68359.141,68136.836,68158.156,2861,36421,0,2024-05-30 15:00:00,2024-05-30 15:00:00,1.26666666669189,0.9893794060917571,67911.45511904759,0.0005499097297059743,0.0002921528725332511,67777.10351190479,67449.6994662614,68441.66405396769,66467.56033404764,67947.40053625198,-0.0006690666776385765,-0.001431264423805146,68033.04503939992,67894.32262904094,85.3468863508624,81.52154644963201,-8.316491454604597,67990.81279231502,67912.56504693237,68122.14646508433,78.24774538264319,31.286291068947524,241.97531193649883,23.14053250772122,38.703976608259836,44.33066838658124,68450.3131361986,67795.47979397005,True,False,68658.156,66467.56033404764,68508.156,68558.156,,False,2024-05-30 17:00:00,2024-05-30 16:47:10,,0.02,success,True,181.67,3111.7400000000025,3,0,22,5
2024-05-31 10:45:00,68198.438,68218.836,68105.727,68207.938,908,36421,0,2024-05-31 10:00:00,2024-05-31 10:00:00,-79.8552499999787,17.29682616960781,68355.30676190475,-0.0003984079383424476,-0.0006452179088588755,68455.13055952381,67994.39372048025,68359.83471091777,68214.8090145945,68628.79556274723,-0.00024156102183474492,-6.434732539286791e-05,68305.54314417974,68385.35115452136,18.782588486050216,21.937695188134455,76.67834044537815,68354.1389665286,68422.78205013317,68266.78484004129,-68.64308360457653,-41.6913099524722,125.51183295627098,-40.23314654282876,-46.74399621604243,-9.85152390782605,68436.22581453226,68095.84386555033,False,True,67707.938,68628.79556274723,67857.938,67807.938,,False,2024-05-31 17:30:00,2024-05-31 17:26:02,2024-05-31 15:30:04,0.02,fail,False,-153.22,2958.5200000000027,0,1,22,5
2024-05-31 11:00:00,68214.641,68315.836,68194.234,68285.836,1082,36421,0,2024-05-31 11:00:00,2024-05-31 11:00:00,-99.82379761905759,-13.388160275426344,68262.28736904761,-0.0005354533820557412,-0.0008575172480099318,68355.30676190475,67919.5768183659,68198.64961754582,67994.39372048025,68359.83471091777,-0.0006452179088588755,-0.0003984079383424476,68299.4369816629,68366.50994215965,18.85523363343639,19.623630750279514,58.66504030121726,68343.63081783189,68412.63789827145,68253.98724527007,-69.00708043956547,-47.15446404989086,130.7443893888329,-12.797594771225704,-40.23314654282876,-46.74399621604243,68430.49217094498,68075.98231959515,False,True,67785.836,68628.79556274723,67935.836,67885.836,,False,2024-05-31 17:15:00,2024-05-31 17:02:28,2024-05-31 15:30:04,0.02,fail,False,-124.83,2833.690000000003,0,2,22,5
2024-05-31 17:15:00,67836.039,67981.438,67691.836,67784.688,2951,36421,0,2024-05-31 17:00:00,2024-05-31 17:00:00,-46.08166666665056,-31.81138302803447,68076.4267380952,-0.00174475689280866,0.001782451915294794,68319.0125,66797.6748184965,69819.24748026508,68088.56222118312,69548.33715987977,0.0013689925150260115,0.00035895391804201325,68267.72506589738,68276.9643801446,5.672418158017233,19.013724284545717,-12.149016029520386,68273.41797092685,68327.15066101613,68328.54305366357,-53.73269008928037,18.256187786687654,277.69988428057724,-149.05846130021382,-137.7020856554591,-91.01336016507412,68703.43789744235,67952.14820988479,False,True,67284.688,67434.688,67434.688,67384.688,2024-05-31 17:45:00,True,2024-05-31 17:45:00,2024-05-31 17:47:15,2024-05-31 17:45:17,0.02,even,True,127.17,2960.860000000003,1,0,22,5
2024-06-03 04:30:00,68244.641,68371.734,68193.664,68193.914,1546,36421,0,2024-06-03 04:00:00,2024-06-03 04:00:00,15.993392857097206,-79.4513258827501,68101.16863095232,0.0010580701220644579,0.0013912548430004238,67883.06966666666,67991.64980297213,68996.5545328842,67919.07887979271,68104.7087642911,0.00011941369812639525,0.0010581574625881456,68076.53035564342,67975.44535691295,80.64871712207805,69.16427939341942,-139.84837921271333,67966.0803584543,67867.26249172185,67997.39409287923,98.8178667324537,64.6536237147431,153.91573884662378,54.90372205020685,57.3344341244665,48.76922841416672,68206.68034032217,67789.60784543629,True,False,68693.914,67919.07887979271,68543.914,68593.914,,False,2024-06-03 05:15:00,2024-06-03 05:02:23,,0.02,success,True,181.67,3142.530000000003,2,0,23,6
2024-06-03 05:00:00,68503.234,68762.438,68503.234,68715.734,2066,36421,0,2024-06-03 05:00:00,2024-06-03 05:00:00,218.09896428565844,9.611557821845054,68241.78445238093,0.0007626130357396273,0.0016697370945050146,68101.16863095232,67940.32650961328,69306.4584598483,67991.64980297213,68996.5545328842,0.0013912548430004238,0.0010580701220644579,68090.86802797114,68012.78100835992,87.36759141846794,83.73024259958704,-109.95639180580166,68151.33701404124,67973.731678088,68238.44342414863,177.60533595323795,98.39504843136424,253.30991794158118,136.94635087723145,104.10298039217014,54.90372205020685,68581.91181336976,67896.4750349275,True,False,69215.734,69065.734,69065.734,69115.734,2024-06-03 09:30:00,True,2024-06-03 09:30:00,2024-06-03 09:38:47,2024-06-03 09:32:25,0.02,even,True,127.17,3269.700000000003,3,0,23,6
2024-06-06 23:00:00,70507.555,70518.641,70074.133,70424.641,2021,36421,0,2024-06-06 23:00:00,2024-06-06 23:00:00,-227.42748809524346,-55.49284500509384,70802.3150714286,-0.0018901297540171698,-0.0020541606937807973,70909.6387142857,69524.41614778925,70358.53440091685,70120.857640581,70951.58668859015,-0.0012784165037178137,-0.0012060176575562512,70789.90055016705,71018.98747630615,19.90972238235589,20.402672738922046,11.063209409036931,70854.20959334553,70995.03116863167,70748.5306105951,-140.82157528614334,-70.24481322821259,282.4315844786384,-72.34180839352484,-62.72189955275098,-44.87598658417119,71129.81324964126,70365.74797154895,False,True,69924.641,71726.5344662832,70074.641,70024.641,,False,2024-06-07 21:00:00,2024-06-07 20:58:33,2024-06-07 14:55:34,0.02,fail,False,-473.86,2795.840000000003,0,1,23,6
2024-06-07 07:00:00,71012.539,71230.539,71010.836,71198.836,1233,36421,0,2024-06-07 07:00:00,2024-06-07 07:00:00,33.02452380952309,-38.73213189668604,71033.56444047616,8.839415605653303e-05,0.0008226123075444539,70924.74526190475,70720.41903181018,71525.38445531369,71168.1812910753,71121.77377772845,0.0002619166560402173,0.001386858780667982,70827.76624838656,70980.17439032668,87.00032698044582,84.90008346906093,-50.65727221392941,70933.64238115387,70890.6836748783,70963.53787891295,42.958706275574514,2.5763655662376284,99.40758142477371,64.71617750257428,30.941499139968073,26.88222497420793,71099.23811383639,70829.33764398951,True,False,71698.836,71108.29675792006,71548.836,71598.836,,False,2024-06-07 15:00:00,2024-06-07 14:55:32,2024-06-07 07:25:16,0.02,fail,False,-32.94,2762.900000000003,0,2,23,6
2024-06-07 07:15:00,71196.641,71255.641,71075.734,71179.836,799,36421,0,2024-06-07 07:00:00,2024-06-07 07:00:00,33.02452380952309,-38.73213189668604,71033.56444047616,8.839415605653303e-05,0.0008226123075444539,70924.74526190475,70720.41903181018,71525.38445531369,71168.1812910753,71121.77377772845,0.0002619166560402173,0.001386858780667982,70827.76624838656,70980.17439032668,90.89769240541877,88.94142733737583,-50.65727221392941,70971.51832251482,70912.10236562806,71016.21226246991,59.415956886761705,13.944283830342444,117.1331053894545,52.67438355696504,64.71617750257428,30.941499139968073,71175.84195474567,70858.08257019415,True,False,71679.836,71168.1812910753,71529.836,71579.836,,False,2024-06-07 15:00:00,2024-06-07 14:52:58,2024-06-07 07:35:16,0.02,fail,False,-4.19,2758.7100000000028,0,3,23,6
2024-06-07 14:45:00,71557.938,71749.305,71557.938,71731.734,1487,36421,0,2024-06-07 14:00:00,2024-06-07 14:00:00,31.836678571475204,86.92001950454141,71434.63255952376,0.00019707394001980242,0.0006803155309827209,71296.1431666667,71168.1647979867,71953.66394417855,71363.92720225666,71454.61010685349,-4.764415268983897e-06,0.0007641914883663439,70952.16757257626,71143.08396692012,91.17960238124891,85.88382894684425,37.899936716282696,71406.11034980514,71292.75179164273,71500.32611592706,113.35855816240655,77.49805734701808,142.63281696175633,89.80949432410125,55.55494530434953,38.086945304399705,71694.38041882543,71307.7718130287,True,False,72231.734,71363.92720225666,72081.734,72131.734,,False,,,2024-06-07 15:30:10,0.02,fail,False,-133.93,2624.780000000003,0,4,23,6
2024-06-07 15:00:00,71731.734,71981.734,71726.641,71905.938,2289,36421,0,2024-06-07 15:00:00,2024-06-07 15:00:00,138.48939285705274,135.21573470706062,71401.08713095236,-0.0010616003953520207,0.001149665451842367,71434.63255952376,70337.47435571242,72380.91241103393,71168.1647979867,71953.66394417855,0.0006803155309827209,0.00019707394001980242,70963.84880502426,71151.6403695665,91.27971930323288,88.7297413509075,57.36309631443828,71483.00691137358,71338.1729922618,71602.15821121431,144.83391911178478,90.96522969997142,189.7772402022846,101.83209528724547,89.80949432410125,55.55494530434953,71859.85748548739,71345.95893694123,True,False,72405.938,71363.92720225666,72255.938,72305.938,,False,,,2024-06-07 15:30:10,0.02,fail,False,-197.26,2427.520000000003,0,5,23,6
2024-06-07 20:30:00,70465.539,70555.641,70261.938,70286.836,1768,36421,0,2024-06-07 20:00:00,2024-06-07 20:00:00,-187.9939285715227,24.407475151499966,70689.42297619041,-0.002400979660956522,-0.0024409425356683085,71200.01963095235,69114.04856000292,70442.75541980505,70595.15137211455,71535.94652922718,-0.0008500240826298222,-9.478719961393528e-05,70959.33576045292,71066.96448147712,4.151619654406354,8.18996627016152,74.290441566507,70889.16169964884,71089.09148442691,70679.3634183007,-199.929784778069,-93.3846708158921,397.23943387258066,-165.88655658751668,-140.92082628136268,-124.99773856210231,71215.63665402868,70141.5901825727,False,True,69786.836,69936.836,69936.836,69886.836,2024-06-07 21:00:00,True,2024-06-07 21:00:00,2024-06-07 21:00:37,2024-06-10 18:18:06,0.02,success,True,181.67,2609.1900000000032,1,0,23,6
2024-06-11 05:00:00,68721.836,68956.242,68521.422,68551.836,2442,36421,0,2024-06-11 05:00:00,2024-06-11 05:00:00,-247.19578571428428,-151.31487400707556,68870.62501190482,-0.003198029014858077,-0.0007361664303004536,69217.31329761907,66971.99737962922,69286.01732020144,67856.3353473811,69196.6785407575,-0.0012247113307703268,-0.0022175293524732804,69873.66815201082,69526.65414404558,9.722957484135126,19.37942706002786,-68.8964067308607,69245.05692239209,69417.3231986804,69151.7280894393,-172.26627628831193,-87.15334023397119,257.914099416576,-157.7262996215868,-142.61662229101057,-11.539972824219149,69499.91212365168,68802.04405522693,False,True,68051.836,69192.00048758708,68201.836,68151.836,,False,2024-06-11 05:45:00,2024-06-11 05:18:15,2024-06-12 15:31:00,0.02,success,True,181.67,2790.8600000000033,2,0,24,6
2024-06-12 15:45:00,69404.141,69466.734,69016.039,69321.836,2602,36421,0,2024-06-12 15:00:00,2024-06-12 15:00:00,82.10345238099399,111.13603885634802,68336.28533333335,0.0019460162441316629,0.004124108894412777,67748.9216904762,68270.7749317464,70667.92949416437,67648.61086911478,68427.51859256561,0.0010901424661095896,0.0007776453346074677,68069.30836423476,67675.95639786981,94.04630554894254,82.90293263750475,6.171439369147095,68226.27185490995,67892.00847979299,68480.52419504647,334.2633751169633,181.7333973578127,534.2327802694065,247.97597110428615,305.1081974544795,42.22162125897012,69203.23844841016,67759.30994168278,True,False,69821.836,67648.61086911478,69671.836,69721.836,,False,2024-06-12 17:30:00,2024-06-12 17:22:55,2024-06-12 22:47:20,0.02,success,True,181.67,2972.5300000000034,3,0,24,6
2024-06-12 16:00:00,69316.203,69641.039,69314.758,69361.539,2264,36421,0,2024-06-12 16:00:00,2024-06-12 16:00:00,587.3636428571481,290.294898885797,68774.16185714286,0.0019461681690745877,0.005097564121653589,68336.28533333335,68403.78480152713,71316.2888500545,68270.7749317464,70667.92949416437,0.004124108894412777,0.0019460162441316629,68117.83485975498,67806.41860604023,92.19762306022466,89.79681337522516,62.996131272477086,68400.92833876997,68000.86259240091,68710.14643412453,400.0657463690586,225.3998671600619,612.617887594771,229.62223907806037,247.97597110428615,305.1081974544795,69538.68058237748,67883.11228587158,True,False,69861.539,67648.61086911478,69711.539,69761.539,,False,2024-06-12 17:30:00,2024-06-12 17:23:53,2024-06-12 22:47:20,0.02,success,True,181.67,3154.2000000000035,4,0,24,6
2024-06-13 18:45:00,66586.039,66666.641,66337.273,66442.289,3263,36421,0,2024-06-13 18:00:00,2024-06-13 18:00:00,-111.7354642857099,-149.685643864781,67180.57990476192,-0.002031092857486006,0.001034451927676432,67551.42866666667,65786.59803898288,69079.6302752569,67099.84599267821,69646.77733022171,0.002537866907845472,-8.192344401007054e-05,67953.62518429046,67701.99286247145,4.125690021448249,6.701557830558208,-146.23392774260248,67178.92799758555,67402.76697883487,66969.29433677325,-223.83898124932603,-89.97242272302168,403.4179013200887,-180.7255445477349,-180.77707911928883,-126.14027382187487,67513.90850355537,66423.18016999113,False,True,65942.289,69646.77733022171,66092.289,66042.289,,False,2024-06-14 19:15:00,2024-06-14 19:08:34,,0.02,success,True,181.67,3335.8700000000035,5,0,24,6
2024-06-14 19:30:00,65291.539,65513.738,65181.84,65271.563,3418,36421,0,2024-06-14 19:00:00,2024-06-14 19:00:00,-218.52940476190997,-72.55714899518352,66264.38654761907,-0.0036579319895231562,-0.002224338242125839,66782.31570238095,64214.79146653539,66293.75919934524,66008.8061894453,67502.20751352858,0.000375630282483123,-0.0011290112576679344,67203.47729202782,66844.19059518924,8.365799549717337,9.451062645219887,-53.39068311061689,66265.92939160505,66596.06430387133,65981.39421878227,-330.13491226627957,-138.2003937418998,534.6505485102834,-251.19962229102384,-285.7682855176972,-205.86579394564615,66703.17245927115,65258.11597829338,False,True,64771.563,67502.20751352858,64921.563,64871.563,,False,2024-06-18 04:45:00,2024-06-18 04:43:56,,0.02,success,True,181.67,3517.5400000000036,6,0,24,6
2024-06-14 19:45:00,65266.633,65569.734,65181.84,65269.266,2863,36421,0,2024-06-14 19:00:00,2024-06-14 19:00:00,-218.52940476190997,-72.55714899518352,66264.38654761907,-0.0036579319895231562,-0.002224338242125839,66782.31570238095,64214.79146653539,66293.75919934524,66008.8061894453,67502.20751352858,0.000375630282483123,-0.0011290112576679344,67203.47729202782,66844.19059518924,3.0384076699090747,6.629665958390586,-53.39068311061689,66112.59656212735,66497.78294802901,65761.39650292402,-385.1863859016594,-187.59759217385175,611.7093417280608,-219.99771585824783,-251.19962229102384,-285.7682855176972,66587.2041142569,64934.08889159114,False,True,64769.266,67502.20751352858,64919.266,64869.266,,False,2024-06-18 04:45:00,2024-06-18 04:43:56,,0.02,success,True,181.67,3699.2100000000037,7,0,24,6
2024-06-17 21:00:00,66566.891,66966.938,66504.117,66833.336,2402,36421,0,2024-06-17 21:00:00,2024-06-17 21:00:00,344.2999285714104,-77.2450153879181,66313.07646428568,0.0002527967872746784,0.0026871782291680527,65837.84051190478,65211.34038641784,68009.3840600501,65194.70474060331,66973.70403113075,0.0014291926261306214,0.00025269471562855276,66438.4446777406,66109.98779738284,95.05833178622781,91.79368335731489,-167.35932422149008,66080.48265561943,65896.1203431563,66319.15792948059,184.36231246312673,31.207983177766284,399.4469388913518,189.4974447884888,181.47553147572035,165.19604334364703,66859.9112969839,65779.90456197727,True,False,67333.336,64649.79756339331,67183.336,67233.336,,False,,,2024-06-18 04:44:03,0.02,fail,False,-794.68,2904.530000000004,0,1,25,6
2024-06-18 14:15:00,65265.32,65305.637,65146.535,65148.738,1741,36422,0,2024-06-18 14:00:00,2024-06-18 14:00:00,-55.28438095240563,-151.1979106351937,65434.28278571432,-0.0005023796502550515,-0.0006135770523052831,65507.336499999976,64934.37583808011,65436.22987998831,65354.95524178135,65591.4075610419,-0.00036448247844357047,0.00019176443934352283,66078.12966427696,65755.53085143314,10.018324030611138,20.707509244083457,-132.1911589133356,65417.203893826256,65509.443223805654,65347.21196663223,-92.23932997939846,-57.89139743190029,145.46269318530292,-80.328596491192,-56.39167973860458,-34.04445132440742,65543.58660243239,65149.33733083207,False,True,64648.738,65591.4075610419,64798.738,64748.738,,False,2024-06-18 18:00:00,2024-06-18 16:39:47,2024-06-19 07:12:52,0.02,success,True,181.67,3086.200000000004,1,0,25,6
2024-06-18 14:30:00,65147.223,65284.34,65067.84,65198.34,2041,36422,0,2024-06-18 14:00:00,2024-06-18 14:00:00,-55.28438095240563,-151.1979106351937,65434.28278571432,-0.0005023796502550515,-0.0006135770523052831,65507.336499999976,64934.37583808011,65436.22987998831,65354.95524178135,65591.4075610419,-0.00036448247844357047,0.00019176443934352283,66078.12966427696,65755.53085143314,10.091486708449343,13.757601712250286,-132.1911589133356,65383.53252554529,65486.39854056079,65287.005037839765,-102.8660150154974,-66.88632094861971,153.70999095287408,-60.20692879246781,-80.328596491192,-56.39167973860458,65494.51352562614,65077.99655005339,False,True,64698.34,65591.4075610419,64848.34,64798.34,,False,2024-06-18 18:00:00,2024-06-18 16:32:29,2024-06-19 07:12:52,0.02,success,True,181.67,3267.870000000004,2,0,25,6
2024-06-20 17:15:00,64786.738,65019.238,64607.238,65019.238,2426,36422,0,2024-06-20 17:00:00,2024-06-20 17:00:00,-272.17045238093124,147.45105897912435,65426.188857142886,-0.0017872291283296212,0.00012134642313421214,65748.0059642857,64137.760744354666,66505.85254968985,64935.63282113073,67230.48394988886,0.0019225248912437402,-0.0005507374258286516,65367.447497466375,65371.49378380507,8.946228174699593,9.255208808333192,161.41634671105965,65453.934384568056,65586.44030339994,65311.79850808394,-132.50591883188463,17.637642608017245,399.944423596619,-154.72202786373964,-216.79937495701597,-168.15482284146128,65851.72347993938,64770.37353622851,False,True,64519.238,67230.48394988886,64669.238,64619.238,,False,2024-06-21 07:00:00,2024-06-20 19:22:28,,0.02,success,True,181.67,3449.540000000004,3,0,25,6
2024-06-21 02:15:00,64939.398,64975.84,64911.84,64917.34,816,36422,0,2024-06-21 02:00:00,2024-06-21 02:00:00,-5.547821428568568,-101.71490886705578,64951.8187857143,0.000675338511626545,-0.00016204997338232038,65017.88352380952,64992.25489655142,65075.02631332813,65198.88588782641,65239.450723427886,0.00013019714815010517,0.0010570717545611528,65238.5104879498,65145.06425281085,19.491592255163397,33.10785188774627,-56.75384843895726,64980.687484801274,65013.87534415538,64975.60426418982,-33.18785935410415,-32.15191446765128,99.74593656146455,-13.288905056760996,-15.001312349508225,-6.37329824565677,65110.26127854779,64839.44724983184,False,True,64417.34,65239.450723427886,64567.34,64517.34,,False,2024-06-21 07:00:00,2024-06-21 06:58:34,,0.02,success,True,181.67,3631.210000000004,4,0,25,6
2024-06-21 02:30:00,64916.438,64926.34,64883.801,64893.84,906,36422,0,2024-06-21 02:00:00,2024-06-21 02:00:00,-5.547821428568568,-101.71490886705578,64951.8187857143,0.000675338511626545,-0.00016204997338232038,65017.88352380952,64992.25489655142,65075.02631332813,65198.88588782641,65239.450723427886,0.00013019714815010517,0.0010570717545611528,65238.5104879498,65145.06425281085,11.000538096205368,21.6046788360661,-56.75384843895726,64967.326333293386,65004.98383718091,64954.634144822805,-37.65750388752349,-33.25303235162573,85.83775214819806,-20.970119367011648,-13.288905056760996,-15.001312349508225,65070.51511022287,64837.25317942274,False,True,64393.84,65239.450723427886,64543.84,64493.84,,False,2024-06-21 07:00:00,2024-06-21 06:58:34,,0.02,success,True,181.67,3812.880000000004,5,0,25,6
2024-06-21 02:45:00,64889.262,64909.438,64812.84,64829.676,734,36422,0,2024-06-21 02:00:00,2024-06-21 02:00:00,-5.547821428568568,-101.71490886705578,64951.8187857143,0.000675338511626545,-0.00016204997338232038,65017.88352380952,64992.25489655142,65075.02631332813,65198.88588782641,65239.450723427886,0.00013019714815010517,0.0010570717545611528,65238.5104879498,65145.06425281085,3.9141922546130594,11.468774201993844,-56.75384843895726,64946.14935894056,64991.99807146381,64926.60275748194,-45.84871252324956,-35.77216838595049,69.2293624918472,-28.031387340866786,-20.970119367011648,-13.288905056760996,65020.06239684593,64831.64311811794,False,True,64329.676,65239.450723427886,64479.676,64429.676,,False,2024-06-21 11:00:00,2024-06-21 06:58:36,,0.02,success,True,181.67,3994.5500000000043,6,0,25,6
2024-06-21 03:00:00,64829.664,64888.738,64657.504,64679.84,1108,36422,0,2024-06-21 03:00:00,2024-06-21 03:00:00,-66.0647380952214,-114.0537838322416,64879.98277380954,-0.0001313110392260117,-0.0001880944090479085,64951.8187857143,64547.96611595103,65046.76995692907,64992.25489655142,65075.02631332813,-0.00016204997338232038,0.000675338511626545,65221.005645285106,65116.83007258599,4.655321068305514,6.523350473041215,-68.21383551761414,64905.17868833432,64968.87525135538,64868.78217371862,-63.69656302105432,-41.35704731297126,93.27867440426311,-57.82058376332134,-28.031387340866786,-20.970119367011648,64994.70838416437,64741.355963272865,False,True,64179.84,65239.450723427886,64329.84,64279.84,,False,2024-06-21 11:00:00,2024-06-21 10:58:36,,0.02,success,True,181.67,4176.220000000004,7,0,25,6
2024-06-21 12:00:00,63594.398,63766.539,63510.281,63647.922,2743,36422,0,2024-06-21 12:00:00,2024-06-21 12:00:00,-315.0350714285378,-286.4953363553577,64042.851559523806,-0.0025739856833610843,-0.0010600518068865487,64110.59740476191,62644.361706619726,64274.89163065484,62809.74498246226,64343.56973453368,-0.0010600256250725682,-0.0025632108340379028,64968.612931737705,64711.855242786376,14.519561355566742,15.153625331315071,-173.29709171820912,64186.39118240186,64410.58330203692,64044.68291709661,-224.1921196350595,-136.59246658551743,302.35159518053973,-136.81251221193088,-165.86073168210714,-62.86925249404885,64452.857570590335,63635.00826360288,False,True,63147.922,64411.20591404148,63297.922,63247.922,,False,2024-06-24 03:00:00,2024-06-24 02:57:18,2024-06-21 23:20:00,0.02,fail,False,-277.87,3898.350000000004,0,1,25,6
2024-06-24 20:00:00,60111.832,60447.637,59790.137,60159.539,3746,36422,0,2024-06-24 20:00:00,2024-06-24 20:00:00,-238.30120238100062,-674.1977367001818,60537.3164404762,-0.0026962455742390663,-0.001183780296153873,60785.006142857135,59147.862659855586,61148.51440685471,59650.22310219531,60275.82279264543,-0.0037739451598897194,-0.0012581799634865873,63026.56036417835,62048.6536358465,15.424033564751545,17.045930805625655,-562.6672271679229,60745.32220796443,61077.826403004445,60572.47352046783,-332.50419504001184,-260.194704273265,346.49269006359987,-162.65863467490271,-168.73359236329998,-105.53147058819013,61040.23865205369,60103.20838888197,False,True,59659.539,60501.05097931575,59809.539,59759.539,,False,2024-06-24 23:00:00,2024-06-24 22:49:27,2024-06-24 20:16:36,0.02,fail,False,-124.29,3774.060000000004,0,2,26,6
2024-06-26 05:00:00,62047.039,62344.969,61952.863,62302.238,1757,36422,0,2024-06-26 05:00:00,2024-06-26 05:00:00,9.61490476191102,194.250331503521,61899.167630952354,-0.0005458535995506741,0.00016091928295589665,61840.895,61386.89577156476,62487.39642593772,62019.75959259633,61992.944658656364,-0.0006156303101545963,0.001380840802242756,61790.50121182306,61574.93028794137,81.7146526573373,72.80523759414585,189.59199176511416,61929.94525251762,61852.10851688044,61914.13798004817,77.83673563717457,40.52252252110939,155.98727192804324,89.56854798763379,41.72709184728592,21.09238321294106,62126.22079715103,61703.55516294532,True,False,62802.238,61933.70096897296,62652.238,62702.238,,False,,,2024-06-26 06:03:56,0.02,fail,False,-134.11,3639.950000000004,0,3,26,6
2024-06-26 05:15:00,62302.539,62446.84,62076.965,62153.637,2064,36422,0,2024-06-26 05:00:00,2024-06-26 05:00:00,9.61490476191102,194.250331503521,61899.167630952354,-0.0005458535995506741,0.00016091928295589665,61840.895,61386.89577156476,62487.39642593772,62019.75959259633,61992.944658656364,-0.0006156303101545963,0.001380840802242756,61790.50121182306,61574.93028794137,80.59608658476053,78.50594413942935,189.59199176511416,61964.3593675149,61874.44396007448,61968.54706570347,89.9154074404214,50.40109950497179,165.9669674068202,54.40908565529389,89.56854798763379,41.72709184728592,62194.102471702674,61744.49165970426,True,False,62653.637,62019.75959259633,62503.637,62553.637,,False,,,2024-06-26 05:47:51,0.02,fail,False,-48.77,3591.180000000004,0,4,26,6
2024-06-26 08:15:00,61722.34,61756.34,61537.938,61557.238,1295,36422,0,2024-06-26 08:00:00,2024-06-26 08:00:00,-69.99845238100534,135.075633986482,61734.664857142874,-0.00022778277674138738,0.00037844839058329095,61841.86945238091,61462.926642903265,62613.132091524785,61732.17038197084,62938.903546575646,0.001301733180374633,0.00028828598579438535,61778.96290826132,61598.8745323125,4.038419032956294,4.444228553204829,176.73839169859085,61776.11052916863,61821.19068430631,61702.03326487783,-45.08015513767896,2.8654629167443737,180.71842107145972,-82.44857241145655,-59.448656002750795,-55.6188734090174,61946.003133324295,61456.56339643136,False,True,61057.238,62938.903546575646,61207.238,61157.238,,False,2024-06-26 20:15:00,2024-06-26 20:03:53,,0.02,success,True,181.67,3772.850000000004,1,0,26,6
2024-06-26 08:45:00,61600.637,61645.039,61518.738,61519.637,1133,36422,0,2024-06-26 08:00:00,2024-06-26 08:00:00,-69.99845238100534,135.075633986482,61734.664857142874,-0.00022778277674138738,0.00037844839058329095,61841.86945238091,61462.926642903265,62613.132091524785,61732.17038197084,62938.903546575646,0.001301733180374633,0.00028828598579438535,61778.96290826132,61598.8745323125,2.9257612728266835,4.33813119550607,176.73839169859085,61713.302793073395,61783.45881439155,61581.921343653274,-70.15602131815831,-21.16527665171547,192.56077613558142,-61.17285483315209,-58.939066391401866,-82.44857241145655,61841.87839143631,61320.46429587024,False,True,61019.637,62938.903546575646,61169.637,61119.637,,False,2024-06-26 20:15:00,2024-06-26 20:03:54,,0.02,success,True,181.67,3954.520000000004,2,0,26,6
2024-06-26 20:15:00,60891.137,61129.188,60812.387,61113.148,2210,36422,0,2024-06-26 20:00:00,2024-06-26 20:00:00,-77.22673809521075,-50.51463906705612,61384.12873809525,-0.0007536694141486544,0.0005201879560716723,61469.749940476184,60626.68934999916,62167.80871618262,61089.01319692662,62491.21157774484,0.001468084493504346,-7.090174201372719e-05,61647.95696650076,61489.66527437822,16.25586162969681,21.6426121801647,-13.945752850511097,61303.1223459779,61388.33396463183,61216.55053869965,-85.21161865392787,-37.31066367322619,203.33260412162235,-69.43372652220569,-123.62044857243745,-54.196313037457,61491.049554263845,60940.55152313546,False,True,60613.148,60763.148,60763.148,60713.148,2024-06-27 09:45:00,True,2024-06-27 09:45:00,2024-06-27 09:47:52,2024-06-27 10:02:14,0.02,success,True,181.67,4136.190000000004,3,0,26,6
2024-06-28 10:45:00,61371.738,61376.34,61174.41,61299.738,1403,36422,0,2024-06-28 10:00:00,2024-06-28 10:00:00,-47.99313095240359,57.449704727187054,61520.09592857148,-0.000617433504919956,-0.0014389189843900805,61655.08909523807,61023.221132014,61295.26715327723,61458.41065396358,61422.0222110332,-0.0013687371646371332,2.9908957141923267e-05,61480.77489448678,61521.55960348911,13.90791731676138,17.307178085330737,93.04296684102128,61506.83568907462,61575.18607182493,61436.159234606166,-68.3503827503082,-36.89760158044925,161.47791053758303,-36.12654901957285,-36.46249329204147,-26.617849673173623,61654.1544138319,61216.66405538043,False,True,60799.738,61422.0222110332,60949.738,60899.738,,False,2024-06-28 17:45:00,2024-06-28 17:50:45,2024-06-28 11:58:32,0.02,fail,False,-44.58,4091.610000000004,0,1,26,6
2024-06-28 17:30:00,61043.137,61144.34,60831.84,60860.238,2251,36422,0,2024-06-28 17:00:00,2024-06-28 17:00:00,-65.1363571428883,-43.98886003813095,61241.99024999998,-0.0010146826071251297,-0.00016805713228027386,61409.08985714286,60494.92666643333,61761.643848549305,61140.73486358577,61771.973632800415,-0.0001680070225471823,-5.493705120271765e-05,61451.07713237243,61442.93560952929,8.78349705938374,19.1179858348611,7.239222142414155,61314.95758306187,61416.41336818141,61247.78860577916,-101.45578511954227,-36.521982345337186,203.25451254286438,-120.3111658066482,-88.86701547988196,-54.94295493645768,61522.18219771203,60971.8950138463,False,True,60360.238,61771.973632800415,60510.238,60460.238,,False,2024-06-28 22:30:00,2024-06-28 22:17:52,2024-07-01 00:00:02,0.02,success,True,181.67,4273.280000000004,1,0,26,6
2024-06-28 17:45:00,60860.238,60927.438,60741.996,60890.84,1760,36422,0,2024-06-28 17:00:00,2024-06-28 17:00:00,-65.1363571428883,-43.98886003813095,61241.99024999998,-0.0010146826071251297,-0.00016805713228027386,61409.08985714286,60494.92666643333,61761.643848549305,61140.73486358577,61771.973632800415,-0.0001680070225471823,-5.493705120271765e-05,61451.07713237243,61442.93560952929,7.9597128276646245,9.40241015009206,7.239222142414155,61249.708724129276,61377.48200757538,61144.24643446855,-127.77328344610578,-54.77224256549091,230.9153343866558,-103.5421713106116,-120.3111658066482,-88.86701547988196,61455.98213589054,60831.01073304656,False,True,60390.84,61771.973632800415,60540.84,60490.84,,False,2024-06-28 22:30:00,2024-06-28 22:17:52,2024-07-01 00:00:02,0.02,success,True,181.67,4454.950000000004,2,0,26,6
2024-06-28 18:00:00,60887.055,60944.738,60702.84,60779.84,1969,36422,0,2024-06-28 18:00:00,2024-06-28 18:00:00,-167.09960714288172,-101.7824487617545,61118.92072619043,-0.0011698610645915664,-0.00016804140176853306,61241.99024999998,60386.96990171496,61751.24879739396,60494.92666643333,61761.643848549305,-0.00016805713228027386,-0.0010146826071251297,61434.240303651946,61409.23980076695,7.82344821837938,8.188886035142493,-14.565112038419574,61177.421228109386,61333.212229236466,61031.90672067424,-155.79100112707965,-74.97599427780867,264.77330753976344,-112.33971379431023,-103.5421713106116,-120.3111658066482,61389.35068585292,60672.96275549556,False,True,60279.84,61771.973632800415,60429.84,60379.84,,False,2024-06-28 23:00:00,2024-06-28 22:17:52,2024-07-01 00:00:02,0.02,success,True,181.67,4636.620000000004,3,0,26,6
2024-07-01 01:00:00,61903.34,62097.637,61894.398,62076.938,754,56422,0,2024-07-01 01:00:00,2024-07-01 01:00:00,457.1354523809714,-139.4345681730556,61541.70841666663,-0.0007508380238369546,0.00409064115330291,60851.34673809524,59742.285378196364,63988.12793752727,59787.867623070844,62278.86573092344,0.0011829050314933628,-0.0007508102003177723,61360.51384996529,61309.901759496635,96.57462869445887,95.79448523689435,-165.20382499794474,61286.38800788102,61080.74514164111,61439.88523391815,205.64286623990483,-7.373625521003049,590.7402524155652,237.83103027181642,227.70428173364053,237.55782387348881,62238.88457467916,60642.38589315713,True,False,62576.938,59383.46292401379,62426.938,62476.938,,False,2024-07-01 01:30:00,2024-07-01 01:26:06,2024-07-04 00:01:43,0.02,success,True,181.67,4818.2900000000045,4,0,27,7
2024-07-01 01:30:00,62931.738,62937.039,62691.238,62830.238,2124,36422,0,2024-07-01 01:00:00,2024-07-01 01:00:00,457.1354523809714,-139.4345681730556,61541.70841666663,-0.0007508380238369546,0.00409064115330291,60851.34673809524,59742.285378196364,63988.12793752727,59787.867623070844,62278.86573092344,0.0011829050314933628,-0.0007508102003177723,61360.51384996529,61309.901759496635,98.45080532345712,97.78544018175023,-165.20382499794474,61737.908976056824,61337.19556313539,62132.687308565546,400.7134129214319,126.87180717724888,806.6688551603062,321.14121224632254,371.6608624010769,237.83103027181642,63223.19026303196,61043.68435409913,True,False,63330.238,59787.867623070844,63180.238,63230.238,,False,2024-07-01 04:15:00,2024-07-01 04:10:57,2024-07-03 13:33:15,0.02,success,True,181.67,4999.960000000005,5,0,27,7
2024-07-02 11:00:00,62591.84,62671.738,62368.297,62449.621,1167,36422,0,2024-07-02 11:00:00,2024-07-02 11:00:00,-126.05884523809073,-43.583353567053564,62748.00251190475,-0.0009361724284408231,-0.0009096454786417724,62840.68158333332,62132.55714031883,62747.23017396318,62432.39339958424,63062.35866083519,-0.0004000571308068009,-0.00045677624708746447,62584.2447817464,62865.37865449032,8.585317065961185,8.89440098149972,30.3088811037341,62738.42148575826,62856.55476618111,62604.880920880605,-118.13328042284411,-65.57877818246095,195.28653096025,-65.34152528379491,-50.25481492947438,-71.73042174061993,62868.51773767694,62339.74410408427,False,True,61949.621,63521.65759673663,62099.621,62049.621,,False,2024-07-02 17:45:00,2024-07-02 17:39:44,,0.02,success,True,181.67,5181.630000000005,6,0,27,7
2024-07-02 17:15:00,62345.41,62421.637,62194.344,62341.238,2335,36422,0,2024-07-02 17:00:00,2024-07-02 17:00:00,-21.084785714221653,-69.30823163026798,62498.878321428565,-0.0013605060357291794,0.0007993068260453134,62711.07894047623,61523.16083575338,63402.49739314945,62619.15894419889,63222.51072154845,0.0002921986015220348,0.0004438312173042715,62585.07405842701,62750.946934236505,11.132621499530183,28.678205247006414,-42.711807093720665,62654.49591983156,62711.74383940608,62679.05462882697,-57.247919574518164,-20.270697091558695,141.9302745088752,-79.6321365668773,-81.36412039914285,-35.33363742686197,62870.66049941395,62485.94875823999,False,True,61841.238,61991.238,61991.238,61941.238,2024-07-02 17:45:00,True,2024-07-02 17:45:00,2024-07-02 18:34:21,2024-07-02 17:45:54,0.02,even,True,127.17,5308.800000000005,7,0,27,7
2024-07-02 18:00:00,62012.848,62130.438,61972.469,62005.277,1601,36422,0,2024-07-02 18:00:00,2024-07-02 18:00:00,-212.20061904766771,-143.2843728808075,62272.186642857145,-0.0013573987609684442,0.0007843424950983707,62498.878321428565,61441.15837922432,63447.39505799523,61523.16083575338,63402.49739314945,0.0007993068260453134,-0.0013605060357291794,62559.260958096536,62685.01837949759,7.889682151430972,7.9921650850986135,-62.826320251138036,62385.77884264716,62558.64725431692,62271.99764981084,-172.86841166976228,-83.33742447774104,282.1099189779513,-111.70030718948692,-126.01246405226993,-169.3442077743748,62652.84604043107,61889.649259190606,False,True,61505.277,63222.51072154845,61655.277,61605.277,,False,2024-07-03 05:00:00,2024-07-03 04:55:10,,0.02,success,True,181.67,5490.470000000005,8,0,27,7
