time,open,high,low,close,tick_volume,spread,real_volume,hourly_time,time2,prev_hour_lsma_slope,prev_hour_macd_line,hour_lsma,fixed_support_gradient,fixed_resistance_gradient,prev_hour_lsma,fixed_support_trendline,fixed_resistance_trendline,ema_short,ema_long,lsma,macd_line,macd_signal,lsma_stddev,lsma_slope,prev_lsma_slope_1,prev_lsma_slope_2,lsma_upper_band,lsma_lower_band,stoch_k,stoch_d,is_buy2,is_sell2,tp,sl,be,be_condition,sl_updated,time_updated,time_to_trail,time_tp_hit,time_sl_hit,max_completion,max_floating_profit,type,success,profit,account_balance,win_streak,losing_streak,Week,Month
2024-03-12 19:00:00,70540.695,70673.438,69592.047,69869.055,6326,36421,0,2024-03-12 19:00:00,2024-03-12 19:00:00,-511.5082142857573,181.68155078834388,71267.815,-0.0013957711696019636,0.0003444109403486298,71471.443797619,70315.28113182737,72969.68634618743,71141.8711085683,71538.71436310478,70777.85148744409,-159.27147080043505,-71.0189033375167,652.0454998137615,-322.40279566559184,-254.10340075685235,-248.40493360848632,71658.11291219266,69896.09006269551,13.46842073082515,17.485724540194237,False,True,69369.055,70269.055,69769.055,69719.055,False,,2024-03-12 19:30:00,2024-03-12 19:20:34,2024-03-12 19:39:19,100.0,0.0,success,True,0.0,450.0,1,0,11,3
2024-03-13 11:00:00,73493.234,73681.734,73461.836,73671.836,1606,36421,0,2024-03-13 11:00:00,2024-03-13 11:00:00,310.370666666684,375.88623926215223,73210.29590476191,0.001215781033355791,0.00029614485956132747,72976.04509523814,68433.85148471722,73369.49809082845,73169.1443570739,72724.61213367646,73572.91805572758,235.3422896006523,195.48765569265223,563.9690226265614,126.89969900243159,103.31638011691393,158.56813484698068,74335.77623627344,72811.55987518173,91.99741290703211,91.31819826648916,True,False,74171.836,73271.836,73771.836,73821.836,False,,,,2024-03-13 11:48:02,1.1796000000002094,1.11,fail,False,-74.02,375.98,0,1,11,3
2024-03-13 12:00:00,73371.039,73465.734,73178.945,73432.141,1875,36421,0,2024-03-13 12:00:00,2024-03-13 12:00:00,234.25080952377175,430.7632994859305,73342.77255952382,0.0018186458055169444,0.00029614565861541654,73210.29590476191,68484.06657198144,73391.16562882347,73298.79563782498,72913.75463386033,73683.73490643276,226.96743136373698,216.94183241888004,575.582443796393,-1.9329556242737453,1.3550374956103042,33.220551427672035,74460.77120555789,72905.19860730763,75.3961307238273,80.54819049605202,True,False,73932.141,73032.141,73532.141,73582.141,False,,2024-03-14 06:15:00,,2024-03-13 14:29:37,21.17960000000021,19.61,fail,False,-74.02,301.96000000000004,0,2,11,3
2024-03-14 18:00:00,70886.234,71196.539,70231.836,70549.039,4763,36421,0,2024-03-14 18:00:00,2024-03-14 18:00:00,-577.5026428571146,-208.57058593569673,71405.75308333331,-0.000923397978810458,0.0002101788140644668,71657.79120238098,71050.41869161511,73710.42870136548,71552.99782626636,72120.67129274574,71031.40260096325,-267.99719943958917,-188.31327019023036,785.2244794378336,-245.70856828329852,-203.49873581025167,-203.26578018569853,72091.45564820433,69969.84955372218,16.320169808996216,17.44023673591843,False,True,70049.039,70449.039,70449.039,70399.039,True,2024-03-14 18:30:00,2024-03-14 18:30:00,2024-03-14 18:30:55,2024-03-14 18:32:53,100.0,101.58,success,True,92.51,394.47,1,0,11,3
2024-03-14 21:00:00,70137.359,70497.938,69738.336,70069.734,5576,36421,0,2024-03-14 21:00:00,2024-03-14 21:00:00,-466.1117976190144,-485.30294445982145,70172.5290238095,-0.0016876723200818676,-0.0003338988938071352,70701.05159523814,70691.27930351323,73991.29186021037,70704.10048402264,71240.57253008979,70407.46610251114,-309.51721603820624,-285.3820253300504,750.9441721074154,-91.21374028212449,-74.76599002412695,-50.5103240453318,71421.24073485615,69392.19147016613,33.26615054292094,33.003747623877274,False,True,69569.734,70469.734,69969.734,69919.734,False,,2024-03-14 21:30:00,2024-03-14 21:21:43,2024-03-14 22:17:22,100.0,117.12,success,True,92.51,486.98,2,0,11,3
2024-03-15 06:00:00,68247.836,68529.734,67369.398,68511.016,6695,36421,0,2024-03-15 06:00:00,2024-03-15 06:00:00,-1079.4284999999654,-722.8647343726043,68833.54929761907,-0.0032176179692295194,-0.0010975081941767982,69914.30496428577,70363.3022513673,73593.11764879028,69454.4537419965,70247.44057564494,68514.40575301,-329.80830635424354,-170.45977756723482,1460.154504060749,-317.5955218437739,-428.4757523220469,-456.3848517371662,70485.614333492,66541.69717252799,29.97996454155133,25.564984610228183,False,True,68011.016,68911.016,68411.016,68361.016,False,,2024-03-15 06:30:00,2024-03-15 06:25:14,2024-03-15 20:41:24,100.0,93.25,success,True,92.51,579.49,3,0,11,3
2024-03-15 07:00:00,67459.695,68276.539,67395.383,68034.141,4878,36421,0,2024-03-15 07:00:00,2024-03-15 07:00:00,-1080.7556666666933,-925.0966750997904,67999.10733333336,-0.0032540217175604166,-0.0010973714344717689,68833.54929761907,70177.05476038251,73512.56216975304,68591.1850800242,69566.9053126637,67199.38986618508,-456.78103713564633,-323.0327250460406,1827.4354841154181,-142.33601375992293,-303.2692177502322,-521.6935380116774,69666.4277697409,64730.85196262927,16.057100831530608,18.676971520273852,False,True,67534.141,67934.141,67934.141,67884.141,True,2024-03-15 07:30:00,2024-03-15 07:30:00,2024-03-15 07:41:20,2024-03-15 07:30:44,57.765600000001726,53.47,even,True,18.5,597.99,4,0,11,3
2024-03-15 08:00:00,67465.641,67905.539,67434.977,67786.734,3936,36421,0,2024-03-15 08:00:00,2024-03-15 08:00:00,-834.4419642857101,-1073.372620967537,67855.39184523807,-0.003254275405741861,-0.001097422049597477,67999.10733333336,69948.340940898,73431.46792080553,68109.31945753419,69045.54186627163,66967.03457722733,-492.02320337630226,-420.319622413407,1926.7177078906902,79.573510147864,-51.214351909206016,-133.12534674917697,69569.60348287976,64365.96567157489,23.70414507929613,21.14231987528461,False,True,67286.734,68186.734,67686.734,67636.734,False,,2024-03-15 10:45:00,2024-03-15 10:46:40,2024-03-15 08:26:26,19.434200000000416,17.94,fail,False,-74.02,523.97,0,1,11,3
2024-03-15 10:00:00,68475.836,68645.758,68324.695,68389.539,2584,36421,0,2024-03-15 10:00:00,2024-03-15 10:00:00,-64.95767857138708,-1089.1319750626571,67515.47304761906,-0.003606454804293429,-0.0010974564080160614,67790.43416666669,69812.01116587047,73270.57611436567,68393.91998513529,68795.61170964132,68446.18217303061,-309.5007168293814,-367.3755784707356,1019.6422258403342,71.54549914004747,24.298675266531063,224.46532094948634,69824.19917791506,67069.66516814617,83.23238883516153,83.010311782764,False,True,67889.539,68789.539,68289.539,68239.539,False,,2024-03-15 10:30:00,2024-03-15 10:24:11,2024-03-15 20:41:03,100.0,100.45,success,True,92.5,616.47,1,0,11,3
2024-03-15 11:00:00,67099.234,67381.836,65561.836,66163.695,7432,36421,0,2024-03-15 11:00:00,2024-03-15 11:00:00,-274.961119047628,-1194.6490031538124,67741.79524999995,-0.0036066059396511704,-0.0011934992684153117,67515.47304761906,69566.40908497496,73253.17318528148,67727.09447961787,68342.37786724893,67748.55881561746,-374.65318956106785,-352.2441113398265,671.9799545896509,-423.81814379086427,-158.94531131751137,-55.888862401014194,68655.73175431348,66839.88587692144,14.980033278366847,26.19860708541451,False,True,65663.695,66563.695,66063.695,66013.695,False,,2024-03-19 04:00:00,2024-03-19 04:04:38,2024-03-15 11:16:50,36.034400000001185,33.3,fail,False,-74.02,542.45,0,1,11,3
2024-03-15 12:00:00,67836.563,68137.938,67343.836,67491.539,4574,36421,0,2024-03-15 12:00:00,2024-03-15 12:00:00,226.32220238089212,-1203.7698086023884,67635.38267857143,-0.003606354907844567,-0.0014137930757034069,67741.79524999995,69309.38178998776,73292.78268776729,67625.06460320317,68119.77023831077,67367.49870313036,-334.5799129935913,-352.0807399225134,640.8349285028504,-117.58565187478962,-12.634078087372473,-46.15364981078892,68232.62585660921,66500.8715496515,62.27389839492671,53.685502119833494,False,True,66991.539,67891.539,67391.539,67341.539,False,,2024-03-15 13:00:00,2024-03-15 13:09:13,2024-03-15 12:20:31,10.217200000002048,9.43,fail,False,-74.02,468.43000000000006,0,2,11,3
2024-03-15 13:00:00,67290.641,67592.234,66781.836,67306.516,4709,36421,0,2024-03-15 13:00:00,2024-03-15 13:00:00,-106.41257142851828,-1240.9842993828788,67689.84116666667,-0.003606620483054783,-0.001740557124737089,67635.38267857143,69061.83470194251,73354.10508312848,67542.46782820972,67948.50044529146,67157.09955865153,-293.3411284922331,-321.9589518994294,613.973955345814,-21.624479876161786,-63.901898176802206,-62.13884657721792,67985.96439836838,66326.73471893469,55.29659418083585,58.89837924609762,False,True,66806.516,67206.516,67206.516,67156.516,True,2024-03-15 13:30:00,2024-03-15 13:30:00,2024-03-18 03:03:16,2024-03-15 13:31:11,86.1564000000013,79.73,even,True,18.5,486.93000000000006,1,0,11,3
2024-03-15 14:00:00,67799.125,67956.836,67520.391,67636.336,3539,36421,0,2024-03-15 14:00:00,2024-03-15 14:00:00,54.45848809523159,-1215.4875465826044,67706.71026190474,-0.003606370847890081,-0.002057286952293519,67689.84116666667,68810.32137882702,73362.53291352314,67525.55695587753,67824.79764417495,67349.75703164775,-244.02504391901311,-289.1977446326218,632.4691386066579,119.46378740966611,101.9292469900247,46.79905331964255,68205.09036876675,66495.92369452876,78.53014610661525,66.45717742961527,False,True,67136.336,68036.336,67536.336,67486.336,False,,2024-03-18 03:00:00,2024-03-18 03:02:03,2024-03-15 14:35:11,19.78759999999893,18.31,fail,False,-74.02,412.9100000000001,0,1,11,3
2024-03-15 15:00:00,67940.461,68404.539,67816.375,67981.734,4344,36421,0,2024-03-15 15:00:00,2024-03-15 15:00:00,16.869095238071168,-1170.3010018350178,67871.55282142854,-0.003606368700168258,-0.0023291444062964023,67706.71026190474,68562.95528704292,73307.33403180334,67694.22116484026,67834.98030835002,67852.86296284832,-166.90973356040195,-231.3159913602571,558.8677127252142,111.73330065356276,121.71668799457257,119.68075851387403,68608.83437502736,67098.39155066927,79.47752487841265,81.84803465725582,False,True,67481.734,67881.734,67881.734,67831.734,True,2024-03-15 15:30:00,2024-03-15 15:30:00,2024-03-15 15:30:41,2024-03-15 15:35:05,100.0,97.86,success,True,92.5,505.4100000000001,1,0,11,3
2024-03-15 16:00:00,68471.734,68597.734,67882.719,67981.734,4616,36421,0,2024-03-15 16:00:00,2024-03-15 16:00:00,164.84255952380772,-1079.213310060295,68207.61558333336,-0.003606274732498834,-0.0026209523194611964,67871.55282142854,68314.51161967128,73219.34126266616,67892.45321979014,67903.4043814708,68017.2781644307,-93.76845773386594,-163.07764278870442,482.86331966541303,43.272312349508866,108.23237770899141,-19.34049707603117,68670.643645979,67365.4126828824,77.00955223856708,75.59686201439114,False,True,67481.734,68381.734,67881.734,67831.734,False,,2024-03-15 18:15:00,2024-03-15 22:49:26,2024-03-15 16:25:09,14.45779999999795,13.32,fail,False,-74.02,431.3900000000001,0,1,11,3
2024-03-19 04:00:00,65880.938,66143.516,65583.703,66093.234,4186,36421,0,2024-03-19 04:00:00,2024-03-19 04:00:00,-487.7625952380913,-417.7856405554048,66538.49189285714,-0.0007662619197592832,-0.0006736972547034238,66982.39638095237,66434.51833427166,68893.3008435755,66804.34507716872,67129.95536791407,66529.5300206398,-129.53058860065357,-52.828538737549174,591.7583459657253,-214.43454626767198,-272.13408737523423,-259.6836174751079,67328.40378769352,65729.15625358607,11.52195000720028,10.894764944620144,False,True,65593.234,66493.234,65993.234,65943.234,False,,2024-03-19 05:00:00,2024-03-19 04:50:18,2024-03-20 22:08:21,100.0,93.79,success,True,92.5,523.8900000000001,1,0,12,3
2024-03-19 05:00:00,65898.383,66028.539,65665.102,65678.234,4215,36421,0,2024-03-19 05:00:00,2024-03-19 05:00:00,-443.90448809522786,-494.53456012804236,66155.5968690476,-0.0011232953671428357,-0.0006737014863735495,66538.49189285714,66193.50067511728,68847.15041263655,66391.11720796986,66824.58102401852,65807.9216580667,-194.48861623907578,-123.35951880966726,773.9879389935389,-213.70141864464676,-195.798497076059,-143.23897316824878,66852.80537570798,64761.53794042542,14.87715510794905,19.378753269282672,False,True,65178.234,66078.234,65578.234,65528.234,False,,2024-03-19 05:45:00,2024-03-19 05:35:04,2024-03-20 22:05:27,100.0,93.24,success,True,92.5,616.3900000000001,2,0,12,3
2024-03-19 06:00:00,65906.977,66020.938,65536.703,65583.336,3783,36421,0,2024-03-19 06:00:00,2024-03-19 06:00:00,-382.8950238095422,-548.123627484063,65719.11679761903,-0.0011232674096752898,-0.0006736332639241925,66155.5968690476,66118.9605076223,68800.75168786262,66004.64881817467,66497.71939977013,65344.90190436881,-243.92556990121375,-189.2067062690357,916.2363668347964,-61.81189886475477,-27.855486068190658,-195.00421465415275,66581.82099959579,64106.48280914183,24.140704189100557,15.597144248395873,False,True,65083.335999999996,65983.336,65483.335999999996,65433.335999999996,False,,2024-03-19 06:45:00,2024-03-19 06:18:12,2024-03-20 21:50:08,100.0,94.9,success,True,92.5,708.8900000000001,3,0,12,3
2024-03-19 07:00:00,65383.637,65654.836,65101.859,65107.137,3992,36421,0,2024-03-19 07:00:00,2024-03-19 07:00:00,-436.4800714285666,-626.0302229625959,65392.48178571432,-0.001164457210919537,-0.000673684269387305,65719.11679761903,66017.22955340633,68754.7236302491,65687.04280448498,66199.18651238276,65249.42270244233,-271.6663362655381,-231.49345024894166,971.1719866518704,-43.898806673591025,6.214160646733944,-19.48561369116942,66560.50488442235,63936.840520462305,23.94633285289805,27.289833232513555,False,True,64607.137,65007.137,65007.137,64957.137,True,2024-03-19 07:30:00,2024-03-19 07:30:00,2024-03-19 09:03:40,2024-03-19 07:32:15,85.05940000000119,78.62,even,True,18.5,727.3900000000001,4,0,12,3
2024-03-19 08:00:00,65247.637,65475.039,65061.738,65433.227,3495,36422,0,2024-03-19 08:00:00,2024-03-19 08:00:00,-326.6350119047129,-690.7829091869644,65123.52163095239,-0.0011644988954756866,-0.0006737076068532946,65392.48178571432,65940.40625864804,68708.56628554696,65417.01359225744,65909.83356408616,65083.36039250089,-283.40336760490027,-266.27905849328096,862.0834079184664,15.859476092242403,-12.175439972554159,-72.82331062940648,66248.67299319082,63919.547791810954,31.24546540904325,18.46591409971273,False,True,64933.227,65333.227,65333.227,65283.227,True,2024-03-19 08:30:00,2024-03-19 08:30:00,2024-03-19 08:35:29,2024-03-19 19:04:39,100.0,94.53,success,True,92.5,819.8900000000001,5,0,12,3
2024-03-19 11:00:00,63510.227,63883.84,63031.84,63833.141,6079,36422,0,2024-03-19 11:00:00,2024-03-19 11:00:00,-499.0589999999793,-954.5569335708715,64188.23751190475,-0.002509435439260598,-0.0008027372223797201,64430.44036904764,65889.03784289818,68649.76995947555,64240.07562877991,64863.02495113969,63828.840275885785,-361.6747841008546,-333.0472194329095,700.1463609804678,-83.57793945648154,-158.8678624011518,-160.76171001028706,64774.037863209414,62882.142688562155,19.011923489449458,15.965135544133124,False,True,63333.141,63733.141,63733.141,63683.141,True,2024-03-19 11:30:00,2024-03-19 11:30:00,2024-03-19 12:17:15,2024-03-19 11:30:16,39.94000000000087,37.0,even,True,18.5,838.3900000000001,6,0,12,3
2024-03-19 12:00:00,64166.238,64179.84,63640.645,63679.84,3947,36422,0,2024-03-19 12:00:00,2024-03-19 12:00:00,-242.20285714288912,-997.7375166952916,63756.189273809585,-0.002717634389436859,-0.0010519264964845506,64188.23751190475,65876.37083000064,68730.42706157883,64016.74690385374,64574.88317720865,63540.12449294808,-348.21265076939744,-346.6397850555296,707.0110292217979,-78.97923873406398,-4.030765393828915,-108.43597454419069,64494.589382397506,62584.15960349866,36.675870855979696,32.569606772867196,False,True,63179.84,64079.84,63579.84,63529.84,False,,2024-03-19 12:30:00,2024-03-19 12:18:06,2024-03-19 17:48:59,100.0,100.45,success,True,92.49,930.8800000000001,7,0,12,3
2024-03-19 13:00:00,63282.41,63347.738,62662.859,62713.273,4855,36422,0,2024-03-19 13:00:00,2024-03-19 13:00:00,-432.0482380951653,-1090.738845163767,63427.310488095245,-0.002742877813122016,-0.0013603480217233668,63756.189273809585,65683.17584005998,68806.16766959315,63541.524137226384,64172.120742406274,63130.572832473306,-379.49169586794596,-360.27987944885757,754.0341533096761,-151.96927106987278,-52.07355314756569,-69.36804127959476,64148.51893944137,62111.126725505244,12.67914353050253,13.587567716961452,False,True,62213.273,63113.273,62613.273,62563.273,False,,2024-03-20 01:15:00,2024-03-20 01:04:13,2024-03-19 13:44:31,37.36160000000091,34.59,fail,False,-74.02,856.8600000000001,0,1,12,3
2024-03-19 14:00:00,63111.762,63680.738,63024.387,63343.84,5010,36422,0,2024-03-19 14:00:00,2024-03-19 14:00:00,-328.87878571433976,-1164.1777453010145,63365.78546428567,-0.002743005391539596,-0.0017192446127926551,63427.310488095245,65501.97832466739,68858.59396868337,63311.879458461946,63873.35526999695,62903.13532335736,-362.34791474964004,-370.3771899637919,757.306238337277,16.41639697280334,-20.545891296918853,-91.97299071209272,63926.99874511269,61880.771901602035,36.57419897846768,22.87744592681274,False,True,62843.84,63243.84,63243.84,63193.84,True,2024-03-19 14:30:00,2024-03-19 14:30:00,2024-03-19 16:10:15,2024-03-19 14:30:39,40.400000000000006,37.37,even,True,18.5,875.3600000000001,1,0,12,3
2024-03-19 15:00:00,63648.738,63748.738,63331.84,63369.84,4052,36422,0,2024-03-19 15:00:00,2024-03-19 15:00:00,-61.52502380957594,-1166.1851144079628,63368.099666666676,-0.002742992786086785,-0.0021335253288381054,63365.78546428567,65322.37290340507,68880.88634673748,63405.49744887579,63774.87028218101,63208.73001100795,-285.9719825153734,-333.8637286861281,537.0516482255646,21.793301341560436,79.07196594440757,157.65800687989395,63935.24973611246,62483.71028590344,62.89440828929716,58.475203692157955,False,True,62869.84,63769.84,63269.84,63219.84,False,,2024-03-19 15:45:00,2024-03-19 16:10:07,2024-03-19 15:24:38,24.527399999999034,22.75,fail,False,-74.02,801.3400000000001,0,1,12,3
2024-03-19 17:00:00,62910.238,63081.863,62631.84,62814.238,4577,36422,0,2024-03-19 17:00:00,2024-03-19 17:00:00,-168.30019047622045,-1195.1512464723783,63507.85363095237,-0.003065284621635412,-0.0030003806459340194,63199.799476190456,65259.1818842478,68761.3897189783,63120.1344118627,63449.08970572308,63137.03010079117,-239.89471796593716,-259.07540466691603,422.1040219430582,-70.33805813558138,-64.1938572411018,23.82987444095488,63706.8705304143,62565.68967116804,35.661993977240016,29.934142094416448,False,True,62314.238,63214.238,62714.238,62664.238,False,,2024-03-20 01:15:00,2024-03-20 01:03:32,2024-03-19 17:32:13,40.115599999998814,37.18,fail,False,-74.02,727.3200000000002,0,2,12,3
2024-03-19 18:00:00,64060.188,64653.137,63983.867,64334.48,4386,36422,0,2024-03-19 18:00:00,2024-03-19 18:00:00,308.0541547619141,-1116.875718843592,63987.28027380953,-0.0030654626645278986,-0.002906979406829074,63507.85363095237,65055.283069367615,68540.30885361014,63511.32058842765,63562.98902517511,63497.990282077684,-125.32097192345827,-206.22705505349236,466.1846850352514,170.21872721012187,99.93435810115625,110.21087753698521,64128.83960687528,62868.64095728009,91.5605800057719,73.80432248077678,False,True,63834.48,64734.48,64234.48,64184.48,False,,2024-03-19 22:15:00,2024-03-19 22:06:34,2024-03-19 18:41:45,32.06399999999994,29.6,fail,False,-74.02,653.3000000000002,0,3,12,3
2024-03-19 22:00:00,64416.84,64520.938,63695.91,63807.539,4017,36422,0,2024-03-19 22:00:00,2024-03-19 22:00:00,15.82667857130582,-705.5605620592905,64495.99954761901,-0.0031861526940886817,-0.0020874596533598227,64693.3838928571,64333.14149571161,67864.51357353662,64526.849745143576,64369.574923276276,64642.57873890601,89.99514605329023,100.64213750083891,881.9942505083861,-241.64870897834044,-192.4949625043737,-125.15547024420812,65833.27097709234,63450.386500719695,17.71648175074788,31.554641650927284,False,True,63307.539,64207.539,63707.539,63657.539,False,,2024-03-20 00:15:00,2024-03-20 00:16:12,2024-03-19 22:36:17,49.413999999999945,45.69,fail,False,-74.02,579.2800000000002,0,4,12,3
2024-03-19 23:00:00,63782.203,63969.938,63695.727,63906.34,3112,56422,0,2024-03-19 23:00:00,2024-03-19 23:00:00,-197.38434523808974,-705.959434128883,64343.448392857135,-0.003286864753268871,-0.002087207450761787,64495.99954761901,64179.79963268416,67723.62439458002,64185.508307434866,64224.469126760625,63893.55353594765,14.147463948349468,60.596374503860595,680.8751500310941,-115.73101754394156,-198.96330890955142,-197.0751093910294,64812.734988489625,62972.87208340567,14.10664214452791,11.15367807961868,False,True,63406.34,63806.34,63806.34,63756.34,True,2024-03-20 00:15:00,2024-03-20 00:15:00,2024-03-20 00:15:41,2024-03-20 13:28:38,100.0,95.09,success,True,92.5,671.7800000000002,1,0,12,3
2024-03-20 00:00:00,63967.887,64058.637,63506.934,63518.84,4576,56422,0,2024-03-20 00:00:00,2024-03-20 00:00:00,-152.55115476187348,-683.5490753899212,63636.92085714287,-0.003286664901466513,-0.002087336362210789,64343.448392857135,63972.701087045476,67582.68202495264,63991.00354676496,64111.23936548153,63678.04090746478,-29.19431239239202,16.310177393096538,571.0892048728407,-99.39922119020048,15.310680770635372,-21.594438940563123,64449.01133404312,62905.57048088645,14.926043490682906,17.466463622252167,False,True,63018.84,63418.84,63418.84,63368.84,True,2024-03-20 00:30:00,2024-03-20 00:30:00,2024-03-20 00:31:05,2024-03-20 02:58:45,100.0,94.9,success,True,92.5,764.2800000000002,2,0,12,3
2024-03-20 01:00:00,62664.34,62831.738,61881.84,61956.738,4692,36422,0,2024-03-20 01:00:00,2024-03-20 01:00:00,-706.5275357142673,-762.0306339233139,62874.70744047616,-0.0032868244096652646,-0.002087394751367474,63636.92085714287,63765.9325690808,67444.53083884179,63280.83902490058,63703.45191093503,62777.01101616791,-160.85027795069618,-61.44841395755699,889.5759193385873,-287.37539215682773,-197.4996587547139,-244.2149858960911,63977.938507275,61574.58352506082,3.6393896477582826,2.3839791687997045,False,True,61456.738,61856.738,61856.738,61806.738,True,2024-03-20 01:30:00,2024-03-20 01:30:00,2024-03-20 06:34:13,2024-03-20 01:30:16,59.73980000000011,55.31,even,True,18.5,782.7800000000002,3,0,12,3
2024-03-20 02:00:00,61955.84,62268.34,61867.238,62156.238,4445,36422,0,2024-03-20 02:00:00,2024-03-20 02:00:00,-762.2134166667092,-871.3534432138913,62805.81251190471,-0.003035252212530676,-0.0020873804664156615,62874.70744047616,63476.310650515865,67302.55500782108,62651.65886473056,63245.57953435471,62040.804929136575,-263.3968241398834,-168.46451348519577,1039.5574886838165,-86.99791812865442,-155.40144547646923,-184.1618555211462,63444.20753885973,60635.90231941342,18.762099181092022,13.092199514145577,False,True,61656.238,62556.238,62056.238,62006.238,False,,2024-03-20 06:00:00,2024-03-20 05:57:33,2024-03-20 02:19:36,34.05999999999912,31.45,fail,False,-74.02,708.7600000000002,0,1,12,3
2024-03-20 03:00:00,63262.086,63286.039,62510.738,62737.039,4351,36422,0,2024-03-20 03:00:00,2024-03-20 03:00:00,-68.89492857144796,-842.6137246442304,62541.700083333315,-0.0027007527139058015,-0.0020874657080231156,62805.81251190471,63199.948894020854,67162.58840562211,62791.69733869683,63164.54752668933,62267.85558617129,-210.18851293885382,-201.9682037690754,933.6206408911563,25.649741658075072,111.39960577910824,41.59818403860845,63529.74345137435,61007.46772096823,55.20318769339514,51.04517827878831,False,True,62237.039,63137.039,62637.039,62587.039,False,,2024-03-20 03:30:00,2024-03-20 03:19:28,2024-03-20 05:06:42,100.0,93.98,success,True,92.5,801.2600000000002,1,0,12,3
2024-03-20 04:00:00,62411.84,62868.438,62257.375,62831.313,4063,36422,0,2024-03-20 04:00:00,2024-03-20 04:00:00,-264.11242857139587,-878.5798855979883,62570.64011904764,-0.0022734745079252025,-0.0020874566785034263,62541.700083333315,62948.79333900773,67022.99886155112,62636.25686390043,62976.04721534661,62367.32594048843,-207.54099879416754,-210.35166226347096,748.3377207521204,141.1220378397411,29.168767801776994,-47.279854833141144,63379.081863503794,61357.07001747307,46.34928371516802,38.75628100815063,False,True,62331.313,63231.313,62731.313,62681.313,False,,2024-03-20 06:00:00,2024-03-20 05:53:03,2024-03-20 05:21:00,28.533600000001023,26.45,fail,False,-74.02,727.2400000000002,0,1,12,3
2024-03-20 05:00:00,62911.738,63166.238,62783.84,62882.738,3656,36422,0,2024-03-20 05:00:00,2024-03-20 05:00:00,28.94003571432404,-856.868292207364,62312.97180952378,-0.00186149253876505,-0.002087302773526413,62570.64011904764,62756.26638760879,66882.2028675317,62774.592780727784,62962.34373421089,62913.25528001375,-149.83738381106377,-183.53253152395396,652.5144989425903,86.41699931198673,115.74188751287875,146.73142896458012,63795.64985358625,62032.36070644125,69.30649737491846,71.72329515799056,False,True,62382.738,63282.738,62782.738,62732.738,False,,2024-03-20 05:45:00,2024-03-20 05:48:29,2024-03-20 05:21:27,16.362399999999617,15.17,fail,False,-74.02,653.2200000000003,0,2,12,3
2024-03-20 06:00:00,61866.648,62365.438,61708.816,62309.738,5103,36422,0,2024-03-20 06:00:00,2024-03-20 06:00:00,-257.66830952386226,-913.5858724032296,62053.57199999995,-0.0015380152338466404,-0.002087494798451294,62312.97180952378,62620.766362362316,66745.35897290299,62634.92931930379,62847.96111390376,62711.93669177841,-147.82122067348246,-156.07463718397315,498.5096416958691,-111.79011317518598,-228.32623701401462,-35.450188510534645,63384.92470806783,62037.44867548898,32.27297308010049,51.31474027242664,False,True,61809.738,62709.738,62209.738,62159.738,False,,2024-03-20 06:30:00,2024-03-20 06:24:39,2024-03-20 09:28:14,100.0,98.23,success,True,92.5,745.7200000000003,1,0,12,3
2024-03-20 07:00:00,61670.238,61810.137,61034.852,61273.539,4599,36422,0,2024-03-20 07:00:00,2024-03-20 07:00:00,-259.39980952382757,-962.6687871161994,61914.358357142846,-0.001571560228747927,-0.002088094833284015,62053.57199999995,62524.98630681082,66607.2976112244,62084.10806876253,62496.0733282578,61862.52014138279,-222.9025399630118,-182.1129123966436,593.1424006048719,-197.4795531477066,-151.49222772616486,-288.63589129676984,62663.26238219937,61060.27790056621,14.614532024701278,16.10002042000129,False,True,60773.539,61173.539,61173.539,61123.539,True,2024-03-20 07:30:00,2024-03-20 07:30:00,,2024-03-20 07:34:39,98.31559999999881,91.02,even,True,18.5,764.2200000000003,2,0,12,3
2024-03-20 08:00:00,61577.086,61869.738,61546.531,61831.137,3999,36422,0,2024-03-20 08:00:00,2024-03-20 08:00:00,-139.21364285710297,-997.6754264256015,61795.232750000025,-0.0015716032200829115,-0.0013905929984885583,61914.358357142846,62425.5725645019,66238.3941542305,61817.42801459166,62234.689358541604,61374.524420020665,-240.1218144710365,-219.6286781290026,674.2220871447081,-77.6567007223639,-109.38748538013897,-110.42309563115123,62284.72423766602,60462.82460237531,31.596262641985124,22.60683520758363,False,True,61331.137,62231.137,61731.137,61681.137,False,,,,2024-03-20 09:06:47,31.735199999999896,29.41,fail,False,-74.02,690.2000000000003,0,1,12,3
2024-03-20 09:00:00,61780.539,62335.816,61744.379,62191.738,3399,36422,0,2024-03-20 09:00:00,2024-03-20 09:00:00,-119.12560714282154,-998.3853298568938,62025.296547619066,-0.001571641746427695,-0.001521956120581579,61795.232750000025,62327.22213207834,66178.95433910715,61899.024942531294,62166.95127989431,61506.21571792224,-189.71813668651885,-211.86546951280872,626.7041750259202,106.16236945304263,20.472928792478342,16.707758858101442,62353.76635420723,60660.16508163725,48.920596079668336,44.09013780012592,False,True,61691.738,62591.738,62091.738,62041.738,False,,,,2024-03-20 09:25:44,15.582799999999406,14.43,fail,False,-74.02,616.1800000000003,0,2,12,3
2024-03-20 23:00:00,67066.438,67338.539,66926.836,67323.047,3160,56421,0,2024-03-20 23:00:00,2024-03-20 23:00:00,911.1057023809044,443.1564933802729,66645.50490476187,0.0013327511797758995,0.0011375820500674574,65770.53455952379,60629.159512586826,66544.81631389378,66153.39889965793,65234.23978589306,67121.59993154451,449.2059584276212,331.9683267845396,1397.817961483507,234.80371276222286,213.05912796698976,448.0638641210826,69010.15417954724,65234.54568354177,86.82679586116065,91.00091394779683,True,False,67823.047,66923.047,67423.047,67473.047,False,,2024-03-20 23:30:00,2024-03-20 23:27:00,,100.0,92.68,success,True,92.5,708.6800000000003,1,0,12,3
