time,open,high,low,close,tick_volume,spread,real_volume,ema_50,ema_50_grad,lsma,lsma_high,lsma_high_grad,lsma_low,lsma_long,long_smooth,long_smooth_grad,lsma2,lsma2_grad,lsma2_smooth,lsma2_smooth_grad,lsma3,lsma3_grad,lsma3_smooth,lsma3_smooth_grad,lsma_grad,lsma_long_grad,support_trendline_15,resistance_trendline_15,support_gradient_15,resistance_gradient_15,supertrend_dir,Span_A,Span_B,sr_levels,fixed_resistance_gradient_15,fixed_support_gradient_15,fixed_support_trendline_15,fixed_resistance_trendline_15,ema_short,ema_long,macd_line,macd_signal,lsma_stddev,lsma_slope,prev_lsma_slope_1,prev_lsma_slope_2,lsma_upper_band,lsma_lower_band,stoch_k,stoch_d,be_increment,be_condition_increment,ticket,sr_cross_signal_sell,sr_cross_signal_buy,in_session,retest_buy,retest_sell,is_buy2,is_sell2,signal,tp,sl,be,be_condition,conditions_arr,order_type,lot,first_time_to_trail,last_time_to_trail,sl_updated,time_to_trail,time_tp_hit,time_sl_hit,entry_time,entry_price,exit_time,exit,exit_price,lot_size,type,profit,duration,account_balance,success,win_streak,losing_streak,Week,Month
2024-10-29 01:01:00,2741.8,2741.9,2741.68,2741.83,129,33,0,2741.3839437387423,0.01820637801074554,2741.5141075268803,2742.0054761904744,0.014571428569524869,2741.634166666669,2741.5141075268803,,,2741.659802002228,0.045141268079078145,2741.6372313681877,0.051064516132100835,2741.3615061179053,0.041055988134303334,2741.340978123837,0.03139710789491801,0.017089358535940846,0.04945050055039246,,,,,,,,[],7.780071648639531e-06,1.1050556662181209e-05,2741.196003996309,2741.898868379152,2741.665964898554,2741.5625972322323,0.08885122166338988,0.05175320620595092,0.20007141582548432,0.04945050055039246,0.032361142014451616,0.048208379682819213,2741.9142503585313,2741.1139646952292,70.52090125334213,75.21208870653415,2.0,3.0,,,,True,False,False,False,True,1.0,2740.83,2749.83,2739.83,2711.83,"3.0,2.0,2711.83",1,0.01,,,False,,2024-10-29 00:01:54,2024-10-29 03:09:32,2024-10-29 01:02:00,2741.83,2024-10-29 00:01:54,auto,2740.88,0.01,success,17.19,-1 days +22:59:54,717.19,True,1,0,44,10
2024-10-29 01:03:00,2741.67,2741.71,2741.52,2741.55,45,27,0,2741.400856946067,0.006087471589125926,2741.553873934001,2741.9823095238103,-0.03338095237995731,2741.6547142857144,2741.553873934001,,,2741.7162550982557,0.01851093807590587,2741.7069996292166,0.028226548013662978,2741.431560993699,0.02305450500534789,2741.420033741195,0.0350274378965878,-0.025967371154365537,0.006899517983129044,,,,,,,,[],1.622754105157247e-05,9.497633879357312e-06,2741.2314177736644,2741.8048076445343,2741.6473476492606,2741.56834467784,0.06634908769501635,0.059404500195564224,0.15615354166102566,0.006899517983129044,0.03286688913749458,0.04945050055039246,2741.866181017323,2741.2415668506787,47.18023255813252,58.355158298911114,2.0,3.0,,,,True,False,False,False,True,1.0,2740.55,2749.55,2739.55,2711.55,"3.0,2.0,2711.55",1,0.01,,,False,,2024-10-29 00:08:16,2024-10-29 03:06:41,2024-10-29 01:04:00,2741.55,2024-10-29 00:08:16,auto,2740.54,0.01,success,18.27,-1 days +23:04:16,735.46,True,2,0,44,10
2024-10-29 01:27:00,2741.77,2741.8,2741.6,2741.62,83,27,0,2741.7049133086884,-0.0034658493341339636,2741.9567371153116,2741.8818571428556,-0.10347619047843182,2741.5105952380973,2741.9567371153116,2741.733958750463,0.008650760103591892,2742.1317011494243,-0.03849981460643903,2742.1509510567244,-0.03605042640128886,2741.753777530588,-0.02483203559722824,2741.766193548385,-0.053646644419586664,-0.011718205414126714,-0.04492398961838262,,,,,,,,[],-1.526538820816703e-05,-1.088372535447936e-05,2741.4308505233485,2742.661636092909,2741.829041169222,2741.8348465780014,-0.012383114667500195,0.05568741147579877,0.25776165624599584,-0.04492398961838262,-0.033205784204255906,-0.07003262885154982,2742.4722604278036,2741.4412138028197,25.774384499651287,25.464604387662728,2.0,3.0,,,,True,False,False,True,False,0.0,2742.62,2733.62,2743.62,2771.62,"3.0,2.0,2771.62",0,0.01,2024-10-29 19:04:00,2024-10-29 19:04:00,False,2024-10-29 19:04:00,2024-10-29 01:15:44,2024-10-31 17:00:30,2024-10-29 01:28:00,2741.62,2024-10-29 01:15:44,auto,2742.55,0.01,success,16.82,-1 days +23:47:44,752.2800000000001,True,3,0,44,10
2024-10-29 01:32:00,2742.01,2742.01,2741.64,2741.75,79,30,0,2741.704631407964,0.0018517792668717448,2741.8509284390084,2741.841333333334,0.04928571428581563,2741.3890952380953,2741.8509284390084,2741.7840130329987,0.010584556915091525,2742.0556826103048,-0.005061179092990642,2742.058213199848,0.00025769373269213247,2741.62310567297,-0.005766407120972872,2741.625988876529,-0.026185391174294637,-0.04381831664704805,-0.022197997774128453,,,,,,,,[],-1.4981423238099884e-05,-1.9847389698874232e-05,2741.4065861559106,2742.4569105479486,2741.764370535788,2741.793877931838,-0.03127861077837224,-0.005244606617832556,0.2422513452760558,-0.022197997774128453,0.021620318872919597,-0.07023433444555849,2742.3354311295607,2741.366425748456,50.128841460098556,40.8469702199452,2.0,3.0,,,,True,False,False,True,False,0.0,2742.75,2733.75,2743.75,2771.75,"3.0,2.0,2771.75",0,0.01,2024-10-29 19:04:00,2024-10-29 19:04:00,False,2024-10-29 19:04:00,2024-10-29 01:53:31,2024-10-31 17:00:02,2024-10-29 01:33:00,2741.75,2024-10-29 01:53:31,auto,2742.67,0.01,success,16.64,0 days 00:20:31,768.9200000000001,True,4,0,44,10
2024-10-29 01:35:00,2741.36,2741.48,2741.29,2741.4,44,28,0,2741.663619124737,-0.010759964275166567,2741.6095609936983,2741.6523571428575,-0.07271428571539218,2741.2700238095226,2741.6095609936983,2741.807874471635,0.005985891731597803,2741.8223959955476,-0.0883159065633663,2741.8665539488265,-0.09292139414174017,2741.43991620319,-0.05902113459387692,2741.4694267704854,-0.06164145346701844,0.0030782350672780012,-0.07438042269359357,,,,,,,,[],-1.3676825888802228e-05,-1.859121193753685e-05,2741.236193216366,2742.3356744023667,2741.600317334153,2741.7010894012583,-0.09540476151141775,-0.04386329101098631,0.270871609021709,-0.07438042269359357,-0.07745865776087157,-0.08952836485559601,2742.1513042117417,2741.067817775655,20.588235294106727,34.05117032566799,2.0,3.0,,,,True,False,False,True,False,0.0,2742.4,2733.4,2743.4,2771.4,"3.0,2.0,2771.4",0,0.01,2024-10-29 19:04:00,2024-10-29 19:04:00,False,2024-10-29 19:04:00,2024-10-29 01:15:07,2024-10-31 17:00:30,2024-10-29 01:36:00,2741.4,2024-10-29 01:15:07,auto,2742.31,0.01,success,16.46,-1 days +23:39:07,785.3800000000001,True,5,0,44,10
2024-10-29 05:08:00,2750.59,2750.83,2750.2,2750.35,189,27,0,2752.5230177299513,-0.08869460122241435,2750.783687059696,2750.920071428573,-0.2719285714279067,2750.111047619048,2750.783687059696,2753.1293798665183,-0.12675761957689247,2751.2264397478675,-0.12922728958574226,2751.291053392657,-0.12822691879955528,2750.392086021506,-0.11082017055923643,2750.447496106788,-0.11876900259630929,-0.034995921400877705,-0.14609417871952246,,,,,,7.920245261714582,7.9205637729763385,[],-2.3654473057655176e-05,-1.4124039326021678e-05,2750.270048512345,2753.385500465167,2751.1523033209864,2751.922227552387,-0.6768233200896248,-0.6012957728045174,0.33894531794491195,-0.14609417871952246,-0.11109825731864476,-0.1915402298909612,2751.461577695586,2750.105796423806,15.277777777781404,17.862953653278264,2.0,3.0,,,,True,False,False,True,False,0.0,2751.35,2742.35,2752.35,2780.35,"3.0,2.0,2780.35",0,0.01,2024-10-30 03:39:00,2024-10-30 03:39:00,False,2024-10-30 03:39:00,2024-10-29 03:37:47,2024-10-31 16:43:30,2024-10-29 05:09:00,2750.35,2024-10-29 03:37:47,auto,2751.27,0.01,success,16.64,-1 days +22:28:47,802.0200000000001,True,6,0,44,10
2024-10-29 05:17:00,2750.22,2750.46,2749.76,2750.07,188,27,0,2751.8684936224977,-0.07340790295893385,2750.1171338524264,2750.538809523811,-0.07071428571271099,2749.929880952383,2750.1171338524264,2751.965572376715,-0.12302801260693741,2750.51044345569,-0.09837226548143008,2750.5596295884275,-0.10776121616663659,2749.870587319244,-0.10794512420852698,2749.9245598813504,-0.09985613644721525,-0.04835001853780341,-0.12838635521029573,,,,,,7.9197867755515725,7.920095572300877,[],-5.5578248924123686e-05,-2.4663268124258114e-05,2749.895467645019,2752.191394154902,2750.4877426358703,2751.1319019903385,-0.5541620978237916,-0.5825640674450976,0.3032414172376202,-0.12838635521029573,-0.08003633667249233,-0.12177678902298794,2750.7236166869016,2749.510651017951,15.990675990683505,20.190586572702323,2.0,3.0,,,,True,False,False,True,False,0.0,2751.07,2742.07,2752.07,2780.07,"3.0,2.0,2780.07",0,0.01,2024-10-30 03:38:00,2024-10-30 03:38:00,False,2024-10-30 03:38:00,2024-10-29 03:37:42,2024-10-31 16:43:38,2024-10-29 05:18:00,2750.07,2024-10-29 03:37:42,auto,2751.06,0.01,success,17.91,-1 days +22:19:42,819.9300000000001,True,7,0,44,10
2024-10-29 05:24:00,2749.54,2750.04,2749.53,2749.84,116,30,0,2751.2859306299065,-0.05901757673109387,2749.135852428626,2749.6397857142865,-0.020595238096575486,2749.072095238097,2749.135852428626,2751.1314056915094,-0.11913602150571023,2749.450273637377,-0.06842565813258261,2749.48448646644,-0.10246199480752693,2748.8975639599525,-0.04173526140402828,2748.9184315906577,-0.0920630330010681,0.055612161658245896,-0.03290174267749535,,,,,,7.919533190317614,7.9197829900444505,[],-2.8935366320526003e-05,-2.6494319353788494e-05,2749.3859306198283,2750.9956211110166,2749.7983474992598,2750.445025892834,-0.5542120943323425,-0.5909234803181034,0.4227271156097509,-0.03290174267749535,-0.08851390433574124,-0.15356025213168323,2749.981306659846,2748.2903981974064,36.89922480620174,22.49167301459005,2.0,3.0,,,,True,False,False,True,False,0.0,2750.84,2741.84,2751.84,2779.84,"3.0,2.0,2779.84",0,0.01,2024-10-30 03:38:00,2024-10-30 03:38:00,False,2024-10-30 03:38:00,2024-10-29 03:37:39,2024-10-31 16:43:40,2024-10-29 05:25:00,2749.84,2024-10-29 03:37:39,auto,2750.72,0.01,success,15.92,-1 days +22:12:39,835.85,True,8,0,44,10
2024-10-29 05:32:00,2749.09,2749.59,2748.98,2749.5,118,27,0,2750.7851196409465,-0.05245386289561793,2749.1764553207267,2749.6160476190485,0.003928571429241856,2749.0097857142828,2749.1764553207267,2750.4230956062283,-0.06632182054136138,2749.4720511679648,-0.04876529477132863,2749.4964338153477,-0.06383908045881981,2748.9282232109754,-0.04199258435255615,2748.9492195031544,-0.05437449017426843,0.0375928809803554,-0.022832777159237594,,,,,,7.919460491490527,7.919695778785485,[],-5.229418928598826e-06,-1.1622445511900793e-05,2748.7725821727818,2750.7330853629082,2749.4775870010544,2749.977005672272,-0.42196926229553355,-0.45964830086579495,0.6203167393587228,-0.022832777159237594,-0.060425658139593,-0.09046792732624453,2750.417088799444,2747.9358218420093,24.34640522876252,16.086541292777323,2.0,3.0,,,,True,False,False,True,False,0.0,2750.5,2741.5,2751.5,2779.5,"3.0,2.0,2779.5",0,0.01,2024-10-30 03:02:00,2024-10-30 03:02:00,False,2024-10-30 03:02:00,2024-10-29 03:37:24,2024-10-31 16:44:20,2024-10-29 05:33:00,2749.5,2024-10-29 03:37:24,auto,2750.2,0.01,success,12.66,-1 days +22:04:24,848.51,True,9,0,44,10
2024-10-29 06:21:00,2753.72,2753.92,2753.53,2753.91,86,27,0,2752.805817600497,0.04506866936753795,2754.609434186133,2754.6189761904766,-0.13416666666671517,2753.8930476190462,2754.609434186133,2752.8509079347427,0.09212893956237167,2754.9562031887294,0.014818687429851707,2754.9487938450093,0.08687875417081159,2754.305921394138,0.05006599925445698,2754.280888394511,0.06869855394779734,0.000136447912609583,0.04440044494185713,,,,,,7.9207323044437015,7.920498858639753,[],3.0398134619349992e-05,3.499254212767826e-05,2752.490210214395,2754.5696574261447,2753.961472870423,2753.4467679312806,0.4418212299233346,0.5084544740751104,0.3491187886231441,0.04440044494185713,0.04426399702924755,0.18100111234844007,2755.3076717633794,2753.9111966088867,34.38470728792626,54.77664018775216,2.0,3.0,,,,True,False,False,False,True,1.0,2752.91,2761.91,2751.91,2723.91,"3.0,2.0,2723.91",1,0.01,,,False,,2024-10-29 04:45:48,2024-10-29 15:46:53,2024-10-29 06:22:00,2753.91,2024-10-29 04:45:48,auto,2752.83,0.01,success,19.54,-1 days +22:23:48,868.05,True,10,0,44,10
2024-10-29 07:33:00,2753.0,2753.12,2752.61,2753.11,185,28,0,2753.8536724938995,-0.030353979342635284,2752.3112851316278,2752.8403809523807,0.10500000000092768,2752.3009523809537,2752.3112851316278,2754.6552724323324,-0.03246062291418639,2752.6486525769374,-0.11605042639985186,2752.706677790133,-0.13871227289610033,2751.9311108639195,-0.10159881349954958,2751.981910270669,-0.1256818687447776,0.044837226552772336,-0.06791991100953965,,,,,,7.920610628871142,7.9209037403324345,"[2754.1728392432747, 2753.019118665381, 2754.255266354669, 2750.7131271847466]",-6.569115728445383e-05,-6.708781165319152e-05,2752.3939597324065,2755.097207384241,2753.0753520233266,2753.5986507570537,-0.4690023829580241,-0.4704353228780707,0.21278762045054608,-0.06791991100953965,-0.11275713756231198,-0.18167222840293107,2752.736860372529,2751.8857098907265,38.39598156352445,27.59935527800899,2.0,3.0,,,buy,True,False,False,True,False,0.0,2754.11,2745.11,2755.11,2783.11,"3.0,2.0,2783.11",0,0.01,2024-10-30 07:44:00,2024-10-30 07:44:00,False,2024-10-30 07:44:00,2024-10-29 06:09:45,2024-10-31 16:34:38,2024-10-29 07:34:00,2753.11,2024-10-29 06:09:45,auto,2754.11,0.01,success,18.09,-1 days +22:35:45,886.14,True,11,0,44,10
2024-10-29 07:42:00,2752.32,2752.7,2751.68,2751.81,196,28,0,2753.445233149737,-0.0667442101935194,2751.865956247685,2752.6911190476203,-0.0870952380955714,2751.7910952380944,2751.865956247685,2754.213197812384,-0.07234065628472308,2752.247756766778,-0.010280311455971969,2752.2528969225013,-0.056126436783415556,2751.435074527252,-0.04701001112061931,2751.458579532811,-0.0783103448275142,-0.00742602891750721,-0.04706488690817423,,,,,,7.920572393461763,7.9207710909602875,"[2754.1728392432747, 2753.019118665381, 2754.255266354669, 2750.7131271847466]",2.0665280378226807e-05,-1.9077721500624633e-05,2751.674131602339,2754.1177793823776,2752.467010662593,2753.018026814186,-0.4868916154014187,-0.4271085364164135,0.7888101346692469,-0.04706488690817423,-0.03963885799066702,-0.1571560993725143,2753.4435765170238,2750.2883359783464,20.430107526883326,17.342745355553166,2.0,3.0,,,,True,False,False,True,False,0.0,2752.81,2743.81,2753.81,2781.81,"3.0,2.0,2781.81",0,0.01,2024-10-30 07:34:00,2024-10-30 07:34:00,False,2024-10-30 07:34:00,2024-10-29 05:43:22,2024-10-31 16:38:59,2024-10-29 07:43:00,2751.81,2024-10-29 05:43:22,auto,2752.74,0.01,success,16.82,-1 days +22:00:22,902.96,True,12,0,44,10
2024-10-29 07:46:00,2751.87,2752.4,2751.82,2751.95,160,29,0,2753.2202669760795,-0.051847631676537276,2751.9288038561385,2752.071166666668,-0.08778571428410942,2751.3109285714313,2751.9288038561385,2753.880784742306,-0.08893153503959184,2752.22283870968,0.025897664072090265,2752.209889877639,0.003908045977823349,2751.4940845383767,0.0660318872805874,2751.4610685947355,0.0225695216895474,0.01047089358598896,0.021320726732938056,,,,,,7.920477963344304,7.920751099647418,"[2754.1728392432747, 2753.019118665381, 2754.255266354669, 2750.7131271847466]",-4.477081697339493e-05,-3.05872192163677e-05,2751.593360546126,2754.3598571584416,2752.1977228777364,2752.727306369459,-0.4630540499470044,-0.45371890235527806,0.2926205489993958,0.021320726732938056,0.010849833146949095,-0.002054875785688637,2752.5140449541373,2751.34356275814,19.8663450909465,21.15733762101166,2.0,3.0,,,,True,False,False,True,False,0.0,2752.95,2743.95,2753.95,2781.95,"3.0,2.0,2781.95",0,0.01,2024-10-30 07:34:00,2024-10-30 07:34:00,False,2024-10-30 07:34:00,2024-10-29 06:04:25,2024-10-31 16:38:56,2024-10-29 07:47:00,2751.95,2024-10-29 06:04:25,auto,2752.81,0.01,success,15.56,-1 days +22:17:25,918.52,True,13,0,44,10
2024-10-29 08:01:00,2750.63,2751.17,2750.31,2750.92,221,27,0,2752.2873082906326,-0.05580850165870288,2750.5338954393756,2750.5698333333344,-0.07535714285495487,2749.6601666666675,2750.5338954393756,2752.2535237856887,-0.1114163700408426,2750.993394883204,-0.1009143492747171,2751.043852057836,-0.14303262884777723,2750.154418984052,-0.1083952539920574,2750.2086166110475,-0.14992806822465354,0.03509529106258924,-0.08894104560658889,,,,,,7.919880354811981,7.920093744820123,"[2754.1728392432747, 2753.019118665381, 2754.255266354669, 2750.7131271847466]",-6.471974054686946e-05,-4.420446897319328e-05,2750.5691899649178,2753.1161237534934,2750.92893258419,2751.5693787704045,-0.5590291777580205,-0.5279444476473595,0.46466577847877016,-0.08894104560658889,-0.12403633666917813,-0.204315906562897,2751.463226996333,2749.604563882418,23.15592903828113,17.044597739125024,2.0,3.0,,,buy,True,False,False,True,False,0.0,2751.92,2742.92,2752.92,2780.92,"3.0,2.0,2780.92",0,0.01,2024-10-30 03:42:00,2024-10-30 03:42:00,False,2024-10-30 03:42:00,2024-10-29 06:02:09,2024-10-31 16:39:50,2024-10-29 08:02:00,2750.92,2024-10-29 06:02:09,auto,2751.86,0.01,success,17.0,-1 days +22:00:09,935.52,True,14,0,44,10
2024-10-29 08:41:00,2752.91,2753.39,2752.47,2753.35,180,27,0,2752.365310622917,0.04019140314630931,2753.5839606970703,2753.8870952380953,-0.014500000000680302,2753.2508095238077,2753.5839606970703,2751.567439766409,0.07625163144257385,2753.908519836857,0.01846644419765653,2753.899286614753,0.06244716351557145,2753.22628846867,-0.0332035595065463,2753.242890248423,-0.006836484982613911,-0.006401928067589324,0.009098257322875725,,,,,,7.920189184775042,7.91989923798731,"[2754.1728392432747, 2753.019118665381, 2754.255266354669, 2750.7131271847466]",1.767141370675099e-05,2.997609912501804e-05,2751.5834487672323,2753.578077777279,2753.1566654250487,2752.6784966174414,0.42235031491281916,0.426539900709811,0.2737275757157467,0.009098257322875725,0.015500185390465049,0.1305710048227411,2754.131415848502,2753.0365055456386,73.58359993646941,79.43185170058882,2.0,3.0,,,buy,True,False,False,False,True,1.0,2752.35,2761.35,2751.35,2723.35,"3.0,2.0,2723.35",1,0.01,2024-11-06 08:28:00,2024-11-06 08:28:00,False,2024-11-06 08:28:00,2024-10-29 07:24:27,2024-10-29 15:46:08,2024-10-29 08:42:00,2753.35,2024-10-29 07:24:27,auto,2752.38,0.01,success,17.55,-1 days +22:42:27,953.0699999999999,True,15,0,44,10
2024-10-29 08:55:00,2755.04,2755.14,2754.05,2754.66,246,27,0,2753.4776291255826,0.04826003569041859,2755.53510270671,2756.1859523809535,-0.057690476190146,2755.4429285714295,2755.53510270671,2753.1165906748256,0.1307989247311525,2755.8495721171703,0.05694104560870983,2755.8211015943607,0.08935928810115001,2755.1369988876545,0.009889506860417896,2755.132054134224,0.07242009640322067,-0.044651093810443854,0.04709158323794327,,,,,,7.920934615473062,7.920640330025828,"[2754.1728392432747, 2753.019118665381, 2754.255266354669, 2750.7131271847466]",7.069778290605074e-05,4.028153814216315e-05,2752.821204557943,2755.270485858604,2754.9270529277196,2754.22461688083,0.609892379453413,0.6666949715095183,0.47089390677787135,0.04709158323794327,0.09174267704838712,0.14855394883625195,2756.476890520266,2754.593314893154,64.53804600541324,71.82050961833855,2.0,3.0,,,,True,False,False,False,True,1.0,2753.66,2762.66,2752.66,2724.66,"3.0,2.0,2724.66",1,0.01,2024-11-06 08:27:00,2024-11-06 08:27:00,False,2024-11-06 08:27:00,2024-10-29 07:19:40,2024-10-29 15:49:04,2024-10-29 08:56:00,2754.66,2024-10-29 07:19:40,auto,2753.68,0.01,success,17.73,-1 days +22:23:40,970.8,True,16,0,44,10
2024-10-29 08:58:00,2755.3,2755.59,2755.22,2755.39,179,27,0,2753.708268230135,0.06864211305583012,2755.8302424916565,2756.033785714285,-0.15321428571633078,2755.241190476188,2755.8302424916565,2753.509221542456,0.12927055988166103,2756.1759117538018,0.05016314423437507,2756.1508301816793,0.09409566184785945,2755.4086051167956,0.08998591027057046,2755.36361216166,0.09070745272492786,0.002069707081773231,0.057664812754865125,,,,,,7.920979143845022,7.920729386769748,"[2754.1728392432747, 2753.019118665381, 2754.255266354669, 2750.7131271847466]",5.647069920968663e-05,4.02788613738779e-05,2753.153977197979,2755.9364758593983,2755.1519924655413,2754.489877496467,0.5707859125327559,0.6318936292389464,0.3522478835125115,0.057664812754865125,0.055595105673091894,0.1818798665185568,2756.5347382586815,2755.1257467246314,75.52069028654391,71.74370570002888,2.0,3.0,,,,True,False,False,False,True,1.0,2754.39,2763.39,2753.39,2725.39,"3.0,2.0,2725.39",1,0.01,2024-11-05 04:47:00,2024-11-05 04:47:00,False,2024-11-05 04:47:00,2024-10-29 07:18:42,2024-10-29 15:50:31,2024-10-29 08:59:00,2755.39,2024-10-29 07:18:42,auto,2754.38,0.01,success,18.27,-1 days +22:19:42,989.0699999999999,True,17,0,44,10
2024-10-29 09:17:00,2754.46,2754.97,2754.43,2754.59,182,27,0,2754.2920877686242,0.012159682913534198,2754.4659770114936,2754.5121666666632,-0.07311904762309496,2753.868666666667,2754.4659770114936,2754.963157879126,0.02839820170584062,2754.855866518356,-0.07900778642351725,2754.8953704115625,-0.11557508342548317,2754.2442944011887,-0.04807934742257203,2754.2683340749,-0.0967830923245856,0.035857619578109734,-0.06639896181104632,,,,,,7.921022829373122,7.920941968330682,"[2753.019118665381, 2754.1728392432747, 2754.255266354669, 2756.151770926552, 2750.7131271847466]",-3.152581320627754e-05,-6.685878596867505e-06,2753.969389148232,2756.019974967463,2754.5826941522337,2754.671776159531,-0.10344205428100395,0.029260330948840334,0.3190583242670463,-0.06639896181104632,-0.10225658138915605,-0.1940682239473972,2755.1040936600275,2753.8278603629597,22.17327459618548,14.929025942245097,2.0,3.0,,,,True,False,False,True,False,0.0,2755.59,2746.59,2756.59,2784.59,"3.0,2.0,2784.59",0,0.01,2024-10-30 08:11:00,2024-10-30 08:11:00,False,2024-10-30 08:11:00,2024-10-29 08:48:42,2024-10-29 10:27:08,2024-10-29 09:18:00,2754.59,2024-10-29 08:48:42,auto,2755.55,0.01,success,17.37,-1 days +23:30:42,1006.4399999999999,True,18,0,44,10
2024-10-29 09:30:00,2753.82,2754.31,2753.72,2754.19,179,27,0,2754.22650585155,-0.001490034757352987,2753.7906355209493,2754.111523809522,-0.07176190476457123,2753.437761904762,2753.7906355209493,2755.0587070263273,-0.028341713014015113,2754.142545050054,-0.04288913607570066,2754.163989618086,-0.06932665925069159,2753.572329996292,-0.08164108268556447,2753.6131505376347,-0.0985613644793375,-0.02632777160124533,-0.07255172413988475,,,,,,7.920930274407684,7.921032789754671,"[2753.019118665381, 2754.1728392432747, 2754.255266354669, 2756.151770926552, 2750.7131271847466]",-9.671276927315424e-06,-1.8744787246951878e-05,2753.5001723599153,2755.1753998436775,2754.058017701163,2754.3005325484905,-0.22505026385670135,-0.17438242192160675,0.38204104116783677,-0.07255172413988475,-0.04622395253863942,-0.12157656655654137,2754.554717603285,2753.0265534386135,34.39350198170297,21.275433546477977,2.0,3.0,,,buy,True,False,False,True,False,0.0,2755.19,2746.19,2756.19,2784.19,"3.0,2.0,2784.19",0,0.01,2024-10-30 07:54:00,2024-10-30 07:54:00,False,2024-10-30 07:54:00,2024-10-29 08:47:51,2024-10-31 16:34:35,2024-10-29 09:31:00,2754.19,2024-10-29 08:47:51,auto,2755.14,0.01,success,17.19,-1 days +23:16:51,1023.63,True,19,0,44,10
2024-10-29 09:36:00,2753.46,2753.84,2753.28,2753.84,194,27,0,2754.105762970557,-0.010847468186057085,2753.547755283646,2753.8573571428597,-0.02061904761558253,2753.1966904761907,2753.547755283646,2754.7871484797943,-0.05423068223944938,2753.8787289581032,-0.037444568034516124,2753.8974512421137,-0.054967741935797676,2753.2662506488664,-0.028797923620459187,2753.280649610677,-0.03732628846955777,0.06064219502650303,0.028640711899242888,,,,,,7.9208840000071685,7.921005578129858,"[2753.019118665381, 2754.1728392432747, 2754.255266354669, 2756.151770926552, 2750.7131271847466]",-1.2069762980569072e-05,-4.186789829097573e-05,2753.450220390441,2754.9621381719767,2753.793182422733,2754.061139783914,-0.24148584523391037,-0.22362394084974102,0.3836944468767257,0.028640711899242888,-0.032001483127260144,-0.046289951800190465,2754.3151441773994,2752.7803663898926,28.622598019938703,23.76220103371313,2.0,3.0,,,,True,False,False,True,False,0.0,2754.84,2745.84,2755.84,2783.84,"3.0,2.0,2783.84",0,0.01,2024-10-30 07:53:00,2024-10-30 07:53:00,False,2024-10-30 07:53:00,2024-10-29 08:47:03,2024-10-31 16:34:38,2024-10-29 09:37:00,2753.84,2024-10-29 08:47:03,auto,2754.84,0.01,success,18.09,-1 days +23:10:03,1041.72,True,20,0,44,10
2024-10-29 09:55:00,2753.36,2753.4,2753.1,2753.16,161,27,0,2753.746914440348,-0.023955691442552052,2753.3057864293633,2753.510904761906,-0.10078571428221039,2753.0343571428543,2753.3057864293633,2753.760734835004,-0.03322115313312679,2753.53369225065,-0.04502929180398496,2753.5562068965446,-0.036912495364958886,2753.0794809047106,-0.002280311457980133,2753.0806210604396,-0.02405821282764009,-0.02288172043790837,-0.0281653689335144,,,,,,7.920735164751954,7.920785984400457,"[2753.019118665381, 2754.1728392432747, 2754.255266354669, 2756.151770926552, 2750.7131271847466]",-3.37866608533254e-06,-3.958731805307432e-06,2752.88727423486,2754.5793533875844,2753.343646910515,2753.553613929559,-0.18252725145976,-0.16514879709790212,0.21950837924547956,-0.0281653689335144,-0.00528364849560603,-0.06122358175844056,2753.7448031878544,2752.866769670872,19.15916863983168,16.045361004452815,2.0,3.0,,,,True,False,False,True,False,0.0,2754.16,2745.16,2755.16,2783.16,"3.0,2.0,2783.16",0,0.01,2024-10-30 07:44:00,2024-10-30 07:44:00,False,2024-10-30 07:44:00,2024-10-29 08:45:36,2024-10-31 16:34:38,2024-10-29 09:56:00,2753.16,2024-10-29 08:45:36,auto,2753.86,0.01,success,12.66,-1 days +22:49:36,1054.38,True,21,0,44,10
2024-10-29 10:42:00,2751.19,2752.01,2751.16,2751.74,253,27,0,2751.120237886018,0.025296412815350777,2750.8721142009617,2752.5248809523823,-0.13511904761935511,2751.5967142857157,2750.8721142009617,2750.2764226918816,-0.03982751205057866,2751.253688542824,0.25538450130034107,2751.1259962921636,0.24369299221370966,2750.132550982574,0.2964975899176352,2749.984302187615,0.27509306637148256,0.11137041157280692,0.3222817945870702,,,,,,7.919514851136543,7.919191913501381,"[2753.019118665381, 2754.1728392432747, 2754.255266354669, 2756.151770926552, 2750.7131271847466]",9.746306430089082e-05,0.0001163432559913228,2747.5132293999864,2751.485653054795,2751.110907765682,2750.780127432713,0.32791407790818994,0.1062488635349902,0.44400571099871977,0.3222817945870702,0.21091138301426327,0.3151790878819156,2751.760125622959,2749.9841027789644,82.58343718874447,83.14647033405494,2.0,3.0,,,,True,False,False,False,True,1.0,2750.74,2759.74,2749.74,2721.74,"3.0,2.0,2721.74",1,0.01,2024-11-06 08:28:00,2024-11-06 08:28:00,False,2024-11-06 08:28:00,2024-10-29 10:15:54,2024-10-29 15:44:26,2024-10-29 10:43:00,2751.74,2024-10-29 10:15:54,auto,2750.94,0.01,success,14.47,-1 days +23:32:54,1068.8500000000001,True,22,0,44,10
2024-10-29 10:44:00,2751.37,2751.99,2751.32,2751.64,158,27,0,2751.1496544268853,0.02001410502498402,2751.328313681868,2752.302547619048,-0.0683333333331575,2751.440190476188,2751.328313681868,2750.2250992769764,-0.020617315536128444,2751.74691360771,0.22605190952617704,2751.6338876529367,0.2466125324431232,2750.681365962178,0.26001186503435747,2750.551360029661,0.274407489801888,0.040232109750832024,0.24821579532863325,,,,,,7.919514851136543,7.919191913501381,"[2753.019118665381, 2754.1728392432747, 2754.255266354669, 2756.151770926552, 2750.7131271847466, 2751.5364737524596]",9.195309285387962e-05,0.00010838273333765618,2748.04497106852,2752.0535731435066,2751.224732778979,2750.8835934779772,0.330710921647551,0.18535352981312153,0.42947642539543435,0.24821579532863325,0.20798368557780123,0.3222817945870702,2752.187266532659,2750.469360831077,72.40151106314195,76.31182630762378,2.0,3.0,,,buy,True,False,False,False,True,1.0,2750.64,2759.64,2749.64,2721.64,"3.0,2.0,2721.64",1,0.01,2024-11-06 08:28:00,2024-11-06 08:28:00,False,2024-11-06 08:28:00,2024-10-29 10:16:04,2024-10-29 15:44:26,2024-10-29 10:45:00,2751.64,2024-10-29 10:16:04,auto,2750.73,0.01,success,16.46,-1 days +23:31:04,1085.3100000000002,True,23,0,44,10
2024-10-29 11:06:00,2753.94,2754.13,2753.53,2753.79,267,27,0,2752.750775261325,0.042417336272592365,2754.975971820543,2755.0348571428594,-0.1670238095202876,2754.3697619047625,2754.975971820543,2751.736961308864,0.15223581757527427,2755.316035595104,0.026113459395219252,2755.3029788653967,0.09992955135385273,2754.727103448278,0.034701520210091985,2754.709752688172,0.07482461994868572,-0.03535187245279303,0.013708565072647616,,,,,,7.920327561029482,7.919685742495151,"[2753.019118665381, 2754.1728392432747, 2754.255266354669, 2756.151770926552, 2750.7131271847466, 2751.5364737524596]",3.869430710730816e-05,3.140592405384295e-05,2752.572063226327,2754.4612799340266,2754.180686724241,2753.45521365047,0.6285467471202537,0.7283033977594315,0.5239956379218274,0.013708565072647616,0.04906043752544065,0.20629291805425964,2756.0239630963865,2753.927980544699,51.05698333546363,72.55696167968189,2.0,3.0,,,,False,False,False,False,True,1.0,2752.79,2761.79,2751.79,2723.79,"3.0,2.0,2723.79",1,0.01,2024-11-06 08:27:00,2024-11-06 08:27:00,False,2024-11-06 08:27:00,2024-10-29 09:54:01,2024-10-29 15:46:53,2024-10-29 11:07:00,2753.79,2024-10-29 09:54:01,auto,2752.8,0.01,success,17.91,-1 days +22:47:01,1103.2200000000003,True,24,0,44,10
2024-10-29 11:22:00,2755.21,2755.89,2754.84,2755.38,350,27,0,2753.7987731704875,0.06453987059239807,2755.2883351872424,2755.8425238095224,0.05257142857135477,2755.080523809523,2755.2883351872424,2754.097780329999,0.11040552465692599,2755.663449017427,0.07632035595179332,2755.6252888394397,0.10517055988248103,2754.949227289583,0.00957137560180854,2754.944441601782,0.03726103077542575,0.042838709671741526,0.07287727103721409,,,,,,7.921021773065232,7.920718445506951,"[2753.019118665381, 2754.1728392432747, 2754.255266354669, 2756.151770926552, 2750.7131271847466, 2751.5364737524596]",2.0009030535938044e-05,3.8913225121168457e-05,2753.6801543217075,2755.7867513770757,2755.1008539306226,2754.5723943559647,0.4499390224768831,0.4639646780476164,0.3102044256769549,0.07287727103721409,0.03003856136547256,0.09251093807870348,2755.9087440385965,2754.6679263358883,67.03482340745845,80.23652646887368,2.0,3.0,,,,False,False,False,False,True,1.0,2754.38,2763.38,2753.38,2725.38,"3.0,2.0,2725.38",1,0.01,2024-11-05 04:47:00,2024-11-05 04:47:00,False,2024-11-05 04:47:00,2024-10-29 09:23:55,2024-10-29 15:50:31,2024-10-29 11:23:00,2755.38,2024-10-29 09:23:55,auto,2754.39,0.01,success,17.91,-1 days +22:00:55,1121.1300000000003,True,25,0,44,10
2024-10-29 11:25:00,2755.22,2755.22,2754.27,2754.27,297,30,0,2753.956293165786,0.012804360580048524,2755.3272065257684,2755.983333333334,-0.1297142857115432,2755.0431428571433,2755.3272065257684,2754.403232146832,0.09486883574345484,2755.8040763811637,-0.031499443825850904,2755.819826103065,0.02112124582799879,2754.9949069336294,-0.05851909529292243,2755.0241664812756,-0.003958101594434993,-0.11027512050713995,-0.0958642936607248,,,,,,7.9210472347294925,7.920805674778408,"[2753.019118665381, 2754.1728392432747, 2754.255266354669, 2756.151770926552, 2750.7131271847466, 2751.5364737524596]",4.104815512292362e-05,1.9821592304644173e-05,2753.6652142564603,2755.56916022777,2755.1054058177783,2754.695286379716,0.3408373897841557,0.4405748088888319,0.5403107571405452,-0.0958642936607248,0.014410826846415148,0.12032480534026035,2756.4078280400495,2754.2465850114872,44.34841628959799,57.63521105209759,2.0,3.0,,,,False,False,False,False,True,1.0,2753.27,2762.27,2752.27,2724.27,"3.0,2.0,2724.27",1,0.01,2024-11-06 08:27:00,2024-11-06 08:27:00,False,2024-11-06 08:27:00,2024-10-29 09:27:56,2024-10-29 15:46:55,2024-10-29 11:26:00,2754.27,2024-10-29 09:27:56,auto,2753.34,0.01,success,16.82,-1 days +22:01:56,1137.9500000000003,True,26,0,44,10
2024-10-29 11:58:00,2751.64,2752.32,2751.62,2752.16,222,27,0,2752.8845021634775,-0.02957151687678561,2751.1844568038605,2751.7235476190463,0.020714285713438585,2750.8551190476164,2751.1844568038605,2753.5886836670393,-0.09706442343303934,2751.5119977753043,0.002895068594625627,2751.510550240997,1.446051010134397e-05,2750.7641475713763,0.004923248052818963,2750.761685947349,-0.06631850204030343,0.0637493511358116,0.022710418988026504,,,,,,7.9201945135679,7.920553031561592,"[2753.019118665381, 2754.1728392432747, 2754.255266354669, 2756.151770926552, 2750.7131271847466, 2751.5364737524596]",-3.401940546574097e-05,-4.5485589130358574e-05,2751.3560829285248,2753.330140910591,2751.8444342260973,2752.4013719076647,-0.485215069035803,-0.5414546124939285,0.39228042079796,0.022710418988026504,-0.04103893214778509,-0.0705406006704834,2751.9690176454565,2750.3998959622645,43.56636271529522,28.433648612962262,2.0,3.0,,,,False,False,False,True,False,0.0,2753.16,2744.16,2754.16,2782.16,"3.0,2.0,2782.16",0,0.01,2024-10-30 07:34:00,2024-10-30 07:34:00,False,2024-10-30 07:34:00,2024-10-29 10:50:53,2024-10-31 16:38:54,2024-10-29 11:59:00,2752.16,2024-10-29 10:50:53,auto,2753.12,0.01,success,17.37,-1 days +22:51:53,1155.3200000000002,True,27,0,44,10
2024-10-29 12:17:00,2750.47,2750.86,2750.37,2750.76,226,27,0,2751.825027258256,-0.04347050033675259,2750.4189773822795,2750.4410238095265,0.07919047619361663,2749.8803333333317,2750.4189773822795,2751.7005755839846,-0.09577710418989227,2750.7561794586563,-0.026863181313729,2750.769611049304,-0.04975046347817624,2750.0978709677406,-0.013998516870742606,2750.104870226175,-0.04828216536952823,0.0009781238454706909,-0.019919169444165163,,,,,,7.919756849939047,7.9199303251354225,"[2753.019118665381, 2754.1728392432747, 2754.255266354669, 2756.151770926552, 2753.3487037917876, 2753.431106238388, 2750.7131271847466, 2751.5364737524596]",-5.6715723326054646e-05,-4.0005797600126496e-05,2750.198863674318,2752.561871607668,2750.61716566892,2751.1496407346763,-0.4592030868616348,-0.4759414480031125,0.39867414185708383,-0.019919169444165163,-0.020897293289635854,-0.10465406006869671,2751.2163256659937,2749.6216290985653,29.773570918237084,15.15782154733148,2.0,3.0,,,buy,False,False,False,True,False,0.0,2751.76,2742.76,2752.76,2780.76,"3.0,2.0,2780.76",0,0.01,2024-10-30 03:42:00,2024-10-30 03:42:00,False,2024-10-30 03:42:00,2024-10-29 10:34:31,2024-10-31 16:39:53,2024-10-29 12:18:00,2750.76,2024-10-29 10:34:31,auto,2751.77,0.01,success,18.27,-1 days +22:16:31,1173.5900000000001,True,28,0,44,10
2024-10-29 12:28:00,2749.24,2749.24,2748.31,2748.7,222,27,0,2750.9245627788955,-0.09079848077135466,2748.7962654801654,2749.181904761905,-0.12730952380798044,2748.3289285714295,2748.7962654801654,2750.7920071561016,-0.0820190396734688,2749.1437656655535,-0.1188846866853055,2749.203208008887,-0.13871338524313614,2748.498671116057,-0.15048794957192513,2748.573915090842,-0.2368898776403512,-0.020421950315721915,-0.12614534668045962,,,,,,7.919255801418709,7.919511986213941,"[2753.019118665381, 2754.1728392432747, 2754.255266354669, 2756.151770926552, 2753.3487037917876, 2753.431106238388, 2750.7131271847466, 2751.5364737524596]",-4.653585599875558e-05,-6.319601101517725e-05,2749.280971584107,2750.9483986269292,2749.3290917266695,2750.052749563482,-0.6314867935734583,-0.5667290838926713,0.6454220656279861,-0.12614534668045962,-0.10572339636473771,-0.2858346310727029,2750.0871096114215,2747.5054213489093,28.72872872872374,18.080479206056477,2.0,3.0,,,,False,False,False,True,False,0.0,2749.7,2740.7,2750.7,2778.7,"3.0,2.0,2778.7",0,0.01,2024-10-30 02:33:00,2024-10-30 02:33:00,False,2024-10-30 02:33:00,2024-10-29 10:29:57,2024-10-31 16:44:38,2024-10-29 12:29:00,2748.7,2024-10-29 10:29:57,auto,2749.4,0.01,success,12.66,-1 days +22:00:57,1186.2500000000002,True,29,0,44,10
2024-10-29 12:30:00,2749.39,2749.91,2749.07,2749.1,274,27,0,2750.793685210353,-0.06913000858594387,2748.8137567667786,2749.1510952380954,0.036285714287714654,2748.2329523809512,2748.8137567667786,2750.6388465702653,-0.07492871709337123,2749.1497367445286,0.05117093065928202,2749.1241512791903,0.0029855394877813524,2748.437259918429,0.03137041156878695,2748.4215747126436,-0.03070559881416557,0.02384056359915121,0.020665925106186478,,,,,,7.919241258238184,7.919511986213941,"[2753.019118665381, 2754.1728392432747, 2754.255266354669, 2756.151770926552, 2753.3487037917876, 2753.431106238388, 2750.7131271847466, 2751.5364737524596]",-2.644010895176974e-05,-6.463534613322991e-05,2748.965454734413,2750.7157923985383,2749.2965686327043,2749.9339759632044,-0.5502250268295938,-0.5654594357802059,0.40911053336690834,0.020665925106186478,-0.003174638492964732,-0.12614534668045962,2749.6319778335123,2747.995535700045,45.645645645637025,40.440440440433456,2.0,3.0,,,,False,False,False,True,False,0.0,2750.1,2741.1,2751.1,2779.1,"3.0,2.0,2779.1",0,0.01,2024-10-30 03:02:00,2024-10-30 03:02:00,False,2024-10-30 03:02:00,2024-10-29 10:32:11,2024-10-31 16:44:20,2024-10-29 12:31:00,2749.1,2024-10-29 10:32:11,auto,2750.1,0.01,success,18.09,-1 days +22:01:11,1204.3400000000001,True,30,0,44,10
2024-10-29 12:52:00,2750.01,2750.34,2749.78,2749.9,177,27,0,2750.0938622439185,-0.007912744649729575,2750.077983685576,2750.77538095238,0.008380952379866358,2750.12642857143,2750.077983685576,2749.326830459772,-0.0195121245824339,2750.3131071560992,0.11203559510477135,2750.257089358538,0.15804004449546483,2749.717271041897,0.14663477938211145,2749.643953652205,0.16001594363979166,-0.025288097882821603,0.10638116425707267,,,,,,7.919247860387424,7.919097770601938,"[2753.019118665381, 2754.1728392432747, 2754.255266354669, 2756.151770926552, 2753.3487037917876, 2753.431106238388, 2750.7131271847466, 2751.5364737524596]",3.064226000129557e-05,3.506632130445328e-05,2748.5558401885055,2750.257312577884,2749.9549077548654,2749.7639788991482,0.19224010481320875,0.06639886995717427,0.48331444950651825,0.10638116425707267,0.13166926213989427,0.24428772710689373,2751.044612584589,2749.111354786563,70.56928034371401,83.61530879910855,2.0,3.0,,,,False,False,False,False,True,1.0,2748.9,2757.9,2747.9,2719.9,"3.0,2.0,2719.9",1,0.01,2024-11-06 08:30:00,2024-11-06 08:30:00,False,2024-11-06 08:30:00,2024-10-29 12:24:10,2024-10-29 15:37:00,2024-10-29 12:53:00,2749.9,2024-10-29 12:24:10,auto,2748.48,0.01,success,25.69,-1 days +23:31:10,1230.0300000000002,True,31,0,44,10
2024-10-29 12:57:00,2750.03,2750.41,2749.9,2750.35,172,27,0,2750.100468542178,0.010184957462115563,2750.351791620318,2750.638166666665,-0.05257142857408326,2750.0275952380953,2750.351791620318,2749.292563830183,-0.0016796440486359643,2750.5731931776077,0.040114200966854696,2750.553136077115,0.035005932518743066,2750.013094549503,0.0005228031177466619,2750.0128331479427,0.02457619577580772,0.09758101594661639,0.08839006303333008,,,,,,7.9192678655524045,7.919097770601938,"[2753.019118665381, 2754.1728392432747, 2754.255266354669, 2756.151770926552, 2753.3487037917876, 2753.431106238388, 2750.7131271847466, 2751.5364737524596]",4.6365460400714475e-05,2.383093906851241e-05,2748.9361181434865,2750.5295642509614,2750.0683003149234,2749.883378374185,0.1773123842235691,0.13717908247361324,0.38151717799041013,0.08839006303333008,-0.00919095291328631,0.09092547274576646,2751.114825976299,2749.5887572643373,60.08557278554547,59.79498644454139,2.0,3.0,,,,False,False,False,False,True,1.0,2749.35,2758.35,2748.35,2720.35,"3.0,2.0,2720.35",1,0.01,2024-11-06 08:29:00,2024-11-06 08:29:00,False,2024-11-06 08:29:00,2024-10-29 12:23:38,2024-10-29 15:37:04,2024-10-29 12:58:00,2750.35,2024-10-29 12:23:38,auto,2749.52,0.01,success,15.02,-1 days +23:25:38,1245.0500000000002,True,32,0,44,10
2024-10-29 13:12:00,2750.49,2750.62,2750.2,2750.59,189,27,0,2750.2257443122385,0.014867579092424421,2750.528383388952,2750.684166666668,-0.0009999999970204954,2750.2447857142884,2750.528383388952,2749.7062935854665,0.044354152762480226,2750.7318034853524,-0.03166852057984215,2750.7476377456333,-0.020444197255528707,2750.2743678160896,-0.030597701148963097,2750.289666666664,-0.015573971079902549,0.03932814239033178,0.00550982573759029,,,,,,7.919385205828711,7.919254250319076,"[2753.019118665381, 2754.1728392432747, 2754.255266354669, 2756.151770926552, 2753.3487037917876, 2753.431106238388, 2750.7131271847466, 2751.5364737524596]",5.181619904513857e-06,1.3757327281309308e-05,2749.699569294909,2750.783107081426,2750.4260110022155,2750.238757543884,0.16707408413276426,0.15229337457143327,0.22424476414993816,0.00550982573759029,-0.03381831665274149,0.02665406006963167,2750.976872917252,2750.079893860652,72.6726726726802,74.78378378378743,2.0,3.0,,,,False,False,False,False,True,1.0,2749.59,2758.59,2748.59,2720.59,"3.0,2.0,2720.59",1,0.01,2024-11-06 08:29:00,2024-11-06 08:29:00,False,2024-11-06 08:29:00,2024-10-29 12:23:36,2024-10-29 15:37:04,2024-10-29 13:13:00,2750.59,2024-10-29 12:23:36,auto,2749.66,0.01,success,16.83,-1 days +23:10:36,1261.88,True,33,0,44,10
2024-10-29 13:19:00,2751.01,2751.02,2749.89,2749.92,188,27,0,2750.378182519785,-0.018701327338021656,2750.7975906562847,2751.234404761903,-0.012285714288282179,2750.632214285713,2750.7975906562847,2750.0738512792004,0.05573943270246673,2751.017423804226,0.04548757879047116,2750.9946800148214,0.05590507971783154,2750.511379310344,-0.028932888392773748,2750.52584575454,0.018798294399857696,-0.10846866889414741,-0.04853096032911708,,,,,,7.9194824522095715,7.91936514727461,"[2753.019118665381, 2754.1728392432747, 2754.255266354669, 2756.151770926552, 2753.3487037917876, 2753.431106238388, 2750.9601052827206, 2750.7131271847466, 2751.5364737524596]",1.5126550634258439e-05,6.227361835470416e-07,2749.8710249006335,2751.072088823802,2750.6792994006223,2750.487113218556,0.16684019472722866,0.20430624306366058,0.4199999999619036,-0.04853096032911708,0.059937708565030334,0.08966184649852948,2751.6375906562084,2749.957590656361,51.19290202072801,74.71508344996126,2.0,3.0,,sell,,False,False,False,False,True,1.0,2748.92,2757.92,2747.92,2719.92,"3.0,2.0,2719.92",1,0.01,2024-11-06 08:30:00,2024-11-06 08:30:00,False,2024-11-06 08:30:00,2024-10-29 12:24:10,2024-10-29 15:37:00,2024-10-29 13:20:00,2749.92,2024-10-29 12:24:10,auto,2748.48,0.01,success,26.05,-1 days +23:04:10,1287.93,True,34,0,44,10
2024-10-29 13:44:00,2750.08,2750.46,2749.99,2750.42,240,27,0,2749.8797196421992,0.022052259502288507,2749.913110863922,2751.3448571428585,-0.17123809523582167,2750.679785714283,2749.913110863922,2749.7102497775327,-0.01618203559473841,2750.2391027067124,0.11683203559687172,2750.180686688905,0.18605339265968723,2749.4338353726343,0.18412829069075087,2749.3417712272876,0.1739955506127444,0.06349944383146067,0.1837345198391631,,,,,,7.919299496633066,7.918977444186782,"[2753.019118665381, 2754.1728392432747, 2754.255266354669, 2756.151770926552, 2753.3487037917876, 2753.431106238388, 2750.9601052827206, 2751.0424362431486, 2750.7131271847466, 2751.5364737524596]",7.082690114318953e-05,7.655733763079777e-05,2747.6851710236515,2750.112144612238,2750.245834771815,2749.9147762135035,0.3098111391459497,0.1643883349307932,0.5558776843604281,0.1837345198391631,0.12023507600770245,0.28967741935503,2751.024866232643,2748.8013554952013,73.86690828551092,84.63718376166817,2.0,3.0,,,,False,False,False,False,True,1.0,2749.42,2758.42,2748.42,2720.42,"3.0,2.0,2720.42",1,0.01,2024-11-06 08:29:00,2024-11-06 08:29:00,False,2024-11-06 08:29:00,2024-10-29 12:23:38,2024-10-29 15:37:04,2024-10-29 13:45:00,2750.42,2024-10-29 12:23:38,auto,2749.52,0.01,success,16.28,-1 days +22:38:38,1304.21,True,35,0,44,10
2024-10-29 13:46:00,2749.87,2751.42,2749.54,2751.41,285,27,0,2749.9393644217303,0.06002594197025246,2750.3495380051922,2751.2707857142864,0.04849999999851207,2750.3189523809533,2750.3495380051922,2749.691523655916,-0.005089822024274326,2750.6067578791235,0.24844123099592252,2750.482537263617,0.1838275862055525,2749.7339065628516,0.1398457545428755,2749.6639836855784,0.15003559510842024,0.20689210232967525,0.3216596217998813,,,,,,7.9192785849186755,7.918977444186782,"[2753.019118665381, 2754.1728392432747, 2754.255266354669, 2756.151770926552, 2753.3487037917876, 2753.431106238388, 2750.9601052827206, 2751.0424362431486, 2750.7131271847466, 2751.5364737524596]",5.964216494289143e-05,5.5209465665424806e-05,2747.858543404072,2750.5008964975177,2750.376011878045,2750.022462460137,0.3269294753536087,0.21175799672783918,0.6128096884496633,0.3216596217998813,0.11476751947020603,0.1837345198391631,2751.5751573820917,2749.123918628293,68.85960596803703,67.13168430736165,2.0,3.0,,,buy,False,False,False,False,True,1.0,2750.41,2759.41,2749.41,2721.41,"3.0,2.0,2721.41",1,0.01,2024-11-06 08:29:00,2024-11-06 08:29:00,False,2024-11-06 08:29:00,2024-10-29 11:56:32,2024-10-29 15:44:25,2024-10-29 13:47:00,2751.41,2024-10-29 11:56:32,auto,2750.44,0.01,success,17.55,-1 days +22:09:32,1321.76,True,36,0,44,10
2024-10-29 13:50:00,2750.86,2751.6,2750.86,2751.25,179,27,0,2750.142424267624,0.04520717274999697,2751.3817115313313,2751.6180476190452,0.08590476190101981,2750.7465476190496,2751.3817115313313,2749.7462161475733,0.02062549128640967,2751.6364516129033,0.20331479421247423,2751.5347942157878,0.22959695958525117,2750.9250641453496,0.22773229514723425,2750.811197997774,0.2399098998903355,0.015275491291049548,0.19324657026618297,,,,,,7.9192785849186755,7.918977444186782,"[2753.019118665381, 2754.1728392432747, 2754.255266354669, 2756.151770926552, 2753.3487037917876, 2753.431106238388, 2750.9601052827206, 2751.0424362431486, 2750.7131271847466, 2751.5364737524596]",5.579940935565516e-05,4.0566786231190136e-05,2748.750389069636,2751.217100120198,2750.8214316692856,2750.362507594429,0.4162657207371012,0.330602002443933,0.6780592051502703,0.19324657026618297,0.17797107897513342,0.33029885057339925,2752.737829941632,2750.025593121031,79.68992248061483,85.38389000142438,2.0,3.0,,,buy,False,False,False,False,True,1.0,2750.25,2759.25,2749.25,2721.25,"3.0,2.0,2721.25",1,0.01,2024-11-06 08:29:00,2024-11-06 08:29:00,False,2024-11-06 08:29:00,2024-10-29 11:56:42,2024-10-29 15:44:24,2024-10-29 13:51:00,2751.25,2024-10-29 11:56:42,auto,2750.33,0.01,success,16.64,-1 days +22:05:42,1338.4,True,37,0,44,10
2024-10-29 13:57:00,2751.88,2752.77,2751.72,2751.9,237,27,0,2750.576666639878,0.05401360653559095,2752.335224323326,2752.714023809522,0.21707142857030703,2751.7910238095224,2752.335224323326,2749.9929702817963,0.03872601038165158,2752.804714126808,0.07374638487544871,2752.7678409343607,0.10086948461321299,2751.93415943641,0.028780126065157674,2751.919769373376,0.02383166481195076,-0.03310938079357584,0.015474972193260328,,,,,,7.919654716761162,7.919233584753604,"[2753.019118665381, 2754.1728392432747, 2754.255266354669, 2756.151770926552, 2753.3487037917876, 2753.431106238388, 2750.9601052827206, 2751.0424362431486, 2750.7131271847466, 2751.5364737524596]",4.017289639366149e-05,5.292815833237992e-05,2749.528364597161,2752.0959403087727,2751.618424154059,2751.0191035431217,0.5337387437134566,0.4737201555412235,0.5708827750461694,0.015474972193260328,0.048584352986836166,0.1780482017061331,2753.4769898734185,2751.193458773234,74.53183520599401,82.44854451061724,2.0,3.0,,,,False,False,False,False,True,1.0,2750.9,2759.9,2749.9,2721.9,"3.0,2.0,2721.9",1,0.01,2024-11-06 08:28:00,2024-11-06 08:28:00,False,2024-11-06 08:28:00,2024-10-29 12:06:35,2024-10-29 15:44:26,2024-10-29 13:58:00,2751.9,2024-10-29 12:06:35,auto,2750.89,0.01,success,18.27,-1 days +22:08:35,1356.67,True,38,0,44,10
2024-10-29 14:24:00,2750.95,2751.33,2750.26,2751.29,291,27,0,2751.5326729644257,-0.009905018956033018,2751.9806147571403,2751.900833333333,-0.33161904761846017,2750.8959047619046,2751.9806147571403,2752.0617928809816,0.051687597329873824,2752.3997515758238,-0.1382869855383433,2752.468895068583,-0.15291842788337817,2751.606382647387,-0.19174935112823732,2751.7022573229474,-0.2016073414897619,0.09549573599952055,-0.07807044864603085,,,,,,7.919944908261618,7.919893979145401,"[2753.019118665381, 2754.1728392432747, 2754.255266354669, 2756.151770926552, 2753.3487037917876, 2753.431106238388, 2753.101511248131, 2750.9601052827206, 2751.0424362431486, 2750.7131271847466, 2751.5364737524596]",-6.873936538007048e-06,-1.9403125815262028e-05,2750.851342033638,2753.3940007699,2751.7441480304033,2751.845102189358,-0.11492634376736532,0.1128697392364971,0.9035604177682336,-0.07807044864603085,-0.1735661846455514,-0.23891064145982455,2753.7877355926767,2750.173493921604,19.221021885113377,14.791394572351843,2.0,3.0,,,buy,False,False,False,True,False,0.0,2752.29,2743.29,2753.29,2781.29,"3.0,2.0,2781.29",0,0.01,2024-10-30 03:43:00,2024-10-30 03:43:00,False,2024-10-30 03:43:00,2024-10-29 13:54:13,2024-10-31 16:39:46,2024-10-29 14:25:00,2751.29,2024-10-29 13:54:13,auto,2752.27,0.01,success,17.73,-1 days +23:29:13,1374.4,True,39,0,44,10
2024-10-29 14:28:00,2751.05,2751.6,2750.89,2751.6,254,27,0,2751.39881162703,0.008211770325488033,2751.371915461626,2750.9493571428557,-0.005833333334066992,2749.84330952381,2751.371915461626,2752.1598853911782,0.009035539488650102,2751.8583752317345,-0.07135928810475889,2751.8940548757773,-0.09572376715004793,2750.878539859105,-0.055513533555767935,2750.906296625879,-0.11107526881505692,0.07665257694270622,-0.0251694475309705,,,,,,7.919832168463905,7.919846696273769,"[2753.019118665381, 2754.1728392432747, 2754.255266354669, 2756.151770926552, 2753.3487037917876, 2753.431106238388, 2753.101511248131, 2750.9601052827206, 2751.0424362431486, 2750.7131271847466, 2751.5364737524596]",-2.7112943058047307e-05,-5.3837675500098694e-05,2750.624312545149,2753.4899331042184,2751.2534046886713,2751.530984893371,-0.2670777483008351,-0.12946596402135063,0.6454898471924754,-0.0251694475309705,-0.10182202447367672,-0.22499147200460357,2752.662895156011,2750.080935767241,41.182158781017414,26.99601138941861,2.0,3.0,,,buy,False,False,False,True,False,0.0,2752.6,2743.6,2753.6,2781.6,"3.0,2.0,2781.6",0,0.01,2024-10-30 03:43:00,2024-10-30 03:43:00,False,2024-10-30 03:43:00,2024-10-29 13:55:15,2024-10-31 16:39:02,2024-10-29 14:29:00,2751.6,2024-10-29 13:55:15,auto,2752.57,0.01,success,17.55,-1 days +23:26:15,1391.95,True,40,0,44,10
2024-10-29 15:03:00,2751.33,2751.78,2751.14,2751.46,337,27,0,2751.285102655942,0.0071386671043001115,2751.11358694846,2750.5839523809545,0.09895238095668901,2749.3408571428567,2751.11358694846,2751.3754180941805,-0.023627456433587213,2751.633098257323,0.02395253985923773,2751.6211219873826,0.020285502407659806,2750.641748609568,0.06892473118341513,2750.6072862439714,0.0024560622928220255,-0.003053021877349238,0.03756321838955046,,,,,,7.919533113930364,7.919626658281468,"[2753.019118665381, 2754.1728392432747, 2754.255266354669, 2756.151770926552, 2753.3487037917876, 2753.431106238388, 2753.101511248131, 2750.9601052827206, 2751.0424362431486, 2750.7131271847466, 2751.5364737524596]",-4.276741878225312e-05,-7.416295095941762e-05,2750.1213302244905,2753.0842890357585,2750.844622364391,2751.1520279105725,-0.27967736936761867,-0.22239330248772943,0.932315665407339,0.03756321838955046,0.040616240266899695,-0.13529922135694505,2752.9782182792746,2749.2489556176456,53.804713804714346,34.232853741958046,2.0,3.0,,,,False,False,False,True,False,0.0,2752.46,2743.46,2753.46,2781.46,"3.0,2.0,2781.46",0,0.01,2024-10-30 03:43:00,2024-10-30 03:43:00,False,2024-10-30 03:43:00,2024-10-29 13:54:34,2024-10-31 16:39:02,2024-10-29 15:04:00,2751.46,2024-10-29 13:54:34,auto,2752.56,0.01,success,19.9,-1 days +22:50:34,1411.8500000000001,True,41,0,44,10
2024-10-29 15:32:00,2754.29,2756.07,2754.0,2755.88,398,27,0,2753.752045144395,0.08685530022876264,2755.744608083055,2754.8104999999987,0.20792857142760113,2753.3803571428557,2755.744608083055,2753.692061512794,0.08539859102711489,2756.2966421950277,-0.0683218390854563,2756.3308031145593,-0.18773526140330432,2755.032297367447,-0.2171501668503879,2755.1408724508683,-0.34334334445611603,0.24947126437746192,-0.017276974412652635,,,,,,7.920643638124453,7.920367060411493,"[2753.019118665381, 2754.1728392432747, 2754.255266354669, 2756.151770926552, 2753.3487037917876, 2753.431106238388, 2753.101511248131, 2750.9601052827206, 2751.0424362431486, 2750.7131271847466, 2751.5364737524596]",-3.040811086989922e-05,-3.7875289575666125e-05,2753.590917769209,2756.9712249059294,2754.8684687922737,2754.528177774383,0.27057557779426133,0.4481650562030366,0.7259562659196483,-0.017276974412652635,-0.26674823879011456,-0.39278605858180526,2757.1965206148943,2754.2926955512157,40.00982562259647,31.23511215163927,2.0,3.0,,,,False,False,False,True,False,0.0,2756.88,2747.88,2757.88,2785.88,"3.0,2.0,2785.88",0,0.01,2024-10-30 08:19:00,2024-10-30 08:19:00,False,2024-10-30 08:19:00,2024-10-29 15:17:16,2024-10-31 16:34:19,2024-10-29 15:33:00,2755.88,2024-10-29 15:17:16,auto,2756.93,0.01,success,19.0,-1 days +23:44:16,1430.8500000000001,True,42,0,44,10
2024-10-29 17:32:00,2763.46,2763.64,2761.21,2761.28,359,27,0,2765.2815443476316,-0.16332834071954494,2761.2363396366313,2762.3385,0.24835714285609356,2760.857166666666,2761.2363396366313,2766.5555529291837,-0.15332445309604736,2762.1089432702984,-0.1306429365963595,2762.174264738586,-0.11943270300571385,2760.702862439748,-0.30904708935622693,2760.857385984418,-0.2384961067855329,-0.17521839081155122,-0.317133852430743,,,,,,7.924463969701528,7.925040364868681,"[2753.047461210258, 2753.1224803245013, 2753.0851420685403, 2753.071688862906, 2753.074107949994, 2753.37267251062, 2753.382836200602, 2753.4128989748297, 2751.5364737524596, 2753.3670940924235, 2753.3622816257594, 2753.102957223495, 2753.11417373256, 2753.0914896958398, 2753.0932736973614, 2753.379061520599, 2752.995202480493, 2752.996669152352, 2752.9889240513503, 2753.3677302994997, 2753.0886810959537, 2753.36461091098, 2753.374752334956, 2753.086326046468, 2753.3875591121223, 2753.369801978024, 2753.0565526411538, 2753.3956025885896, 2753.344793568378, 2753.141546974778, 2753.100765063778, 2753.400047413162, 2753.361683055871, 2753.060605558197, 2753.11693078457, 2750.9601052827206, 2751.0424362431486, 2750.7131271847466, 2753.019118665381, 2754.1728392432747, 2754.255266354669, 2756.151770926552, 2753.3487037917876, 2753.431106238388, 2753.101511248131, 2753.360164939351, 2753.362329197124, 2753.4056002417997, 2753.087659972841, 2753.097696835537, 2753.34337659851, 2753.37400791497, 2753.0750022457296, 2753.064044877039, 2753.0427831886172, 2753.010629355056, 2753.0893113732554, 2753.017523756732, 2753.0188697357253, 2753.0806867491547, 2753.060856079465, 2753.087599569961, 2753.063411708956, 2753.0734533903856, 2753.0499368490496, 2753.036376089222, 2753.067677370595]",-8.412434698158998e-05,-0.00013675001868018453,2762.907395416635,2766.216380825238,2762.696753328698,2764.1551689544863,-1.2864006759591575,-1.2647616386426104,0.805896794262032,-0.317133852430743,-0.14191546161919177,-0.18335261402171454,2762.8481332251554,2759.6245460481073,27.512717732662164,21.420447665564364,2.0,3.0,,,,False,False,False,True,False,0.0,2762.28,2753.28,2763.28,2791.28,"3.0,2.0,2791.28",0,0.01,,,False,,2024-10-29 15:46:55,2024-10-31 16:01:01,2024-10-29 17:33:00,2761.28,2024-10-29 15:46:55,auto,2762.16,0.01,success,15.92,-1 days +22:13:55,1446.7700000000002,True,43,0,44,10
2024-10-29 17:35:00,2762.32,2762.76,2761.82,2762.57,356,27,0,2764.928194668374,-0.09625284360708974,2760.8970745272554,2762.4362619047606,0.07385714285646827,2761.0196190476195,2760.8970745272554,2766.05929543938,-0.16861457174627503,2761.610529477197,-0.07834556914940549,2761.6497022617614,-0.12296737115229917,2760.249707823507,-0.03948906192090362,2760.2694523544596,-0.11040563589267549,0.11714126807919456,0.025975528368235246,,,,,,7.92443231079276,7.925040364868681,"[2753.047461210258, 2753.1224803245013, 2753.0851420685403, 2753.071688862906, 2753.074107949994, 2753.37267251062, 2753.382836200602, 2753.4128989748297, 2751.5364737524596, 2753.3670940924235, 2753.3622816257594, 2753.102957223495, 2753.11417373256, 2753.0914896958398, 2753.0932736973614, 2753.379061520599, 2752.995202480493, 2752.996669152352, 2752.9889240513503, 2753.3677302994997, 2753.0886810959537, 2753.36461091098, 2753.374752334956, 2753.086326046468, 2753.3875591121223, 2753.369801978024, 2753.0565526411538, 2753.3956025885896, 2753.344793568378, 2753.141546974778, 2753.100765063778, 2753.400047413162, 2753.361683055871, 2753.060605558197, 2753.11693078457, 2750.9601052827206, 2751.0424362431486, 2750.7131271847466, 2753.019118665381, 2754.1728392432747, 2754.255266354669, 2756.151770926552, 2753.3487037917876, 2753.431106238388, 2753.101511248131, 2753.360164939351, 2753.362329197124, 2753.4056002417997, 2753.087659972841, 2753.097696835537, 2753.34337659851, 2753.37400791497, 2753.0750022457296, 2753.064044877039, 2753.0427831886172, 2753.010629355056, 2753.0893113732554, 2753.017523756732, 2753.0188697357253, 2753.0806867491547, 2753.060856079465, 2753.087599569961, 2753.063411708956, 2753.0734533903856, 2753.0499368490496, 2753.036376089222, 2753.067677370595]",-8.537346811385769e-05,-8.974985732458255e-05,2761.5044981766273,2765.518515210459,2762.5009916615822,2763.745850475733,-1.0813299239962362,-1.2154437762220547,0.8392588142456164,0.025975528368235246,-0.09116573971095931,-0.2740748980331773,2762.5755921557466,2759.2185568987643,30.8147742294146,24.11031734836247,2.0,3.0,,,,False,False,False,True,False,0.0,2763.57,2754.57,2764.57,2792.57,"3.0,2.0,2792.57",0,0.01,,,False,,2024-10-29 15:50:38,2024-10-31 16:00:03,2024-10-29 17:36:00,2762.57,2024-10-29 15:50:38,auto,2763.26,0.01,success,12.48,-1 days +22:14:38,1459.2500000000002,True,44,0,44,10
2024-10-29 18:21:00,2768.45,2769.04,2768.24,2768.87,176,27,0,2766.2749050804346,0.10592224161473496,2769.275755283651,2768.8792380952377,0.10419047619052435,2768.3286666666672,2769.275755283651,2765.4615153318528,0.17296062291461567,2769.577091583243,0.14384204671887346,2769.5051705598717,0.13409047089589876,2769.0022024471614,0.1047296996634941,2768.9498375973235,0.11846644419574659,0.03261179087894561,0.10361661105071107,,,,,,7.92543537138425,7.925057363072014,"[2753.047461210258, 2753.1224803245013, 2753.0851420685403, 2753.071688862906, 2753.074107949994, 2753.37267251062, 2753.382836200602, 2753.4128989748297, 2751.5364737524596, 2753.3670940924235, 2753.3622816257594, 2753.102957223495, 2753.11417373256, 2753.0914896958398, 2753.0932736973614, 2753.379061520599, 2752.995202480493, 2752.996669152352, 2752.9889240513503, 2753.3677302994997, 2753.0886810959537, 2753.36461091098, 2753.374752334956, 2753.086326046468, 2753.3875591121223, 2753.369801978024, 2753.0565526411538, 2753.3956025885896, 2753.344793568378, 2753.141546974778, 2753.100765063778, 2753.400047413162, 2753.361683055871, 2753.060605558197, 2753.11693078457, 2750.9601052827206, 2751.0424362431486, 2750.7131271847466, 2753.019118665381, 2754.1728392432747, 2754.255266354669, 2756.151770926552, 2753.3487037917876, 2753.431106238388, 2753.101511248131, 2753.360164939351, 2753.362329197124, 2753.4056002417997, 2753.087659972841, 2753.097696835537, 2753.34337659851, 2753.37400791497, 2753.0750022457296, 2753.064044877039, 2753.0427831886172, 2753.010629355056, 2753.0893113732554, 2753.017523756732, 2753.0188697357253, 2753.0806867491547, 2753.060856079465, 2753.087599569961, 2753.063411708956, 2753.0734533903856, 2753.0499368490496, 2753.036376089222, 2753.067677370595]",1.682593206320345e-05,4.239189932736487e-05,2766.3367935856572,2768.646313578718,2768.115818318776,2767.139432348693,0.8561163711274276,0.8578022277752335,0.3276730734619558,0.10361661105071107,0.07100482017176546,0.21424100853027994,2769.931101430575,2768.620409136727,82.99595141699683,84.07381259974677,2.0,3.0,,,,False,False,False,False,True,1.0,2767.87,2776.87,2766.87,2738.87,"3.0,2.0,2738.87",1,0.01,2024-10-31 16:48:00,2024-10-31 16:48:00,False,2024-10-31 16:48:00,2024-10-29 16:30:32,2024-10-30 02:06:48,2024-10-29 18:22:00,2768.87,2024-10-29 16:30:32,auto,2768.05,0.01,success,14.84,-1 days +22:08:32,1474.0900000000001,True,45,0,44,10
2024-10-29 18:24:00,2768.68,2768.9,2768.48,2768.76,149,27,0,2766.555082040905,0.08999665139162971,2769.4742929180597,2769.182714285716,0.02695238095429886,2768.637309523808,2769.4742929180597,2765.9587892473146,0.16184187986664256,2769.7738576195775,0.01663477937972857,2769.765540229876,0.057921394141885685,2769.2254542083774,0.05394364108042282,2769.198482387831,0.05587652947542665,-0.04661401557495992,0.026886911383826373,,,,,,7.925550107682504,7.925057363072014,"[2753.047461210258, 2753.1224803245013, 2753.0851420685403, 2753.071688862906, 2753.074107949994, 2753.37267251062, 2753.382836200602, 2753.4128989748297, 2751.5364737524596, 2753.3670940924235, 2753.3622816257594, 2753.102957223495, 2753.11417373256, 2753.0914896958398, 2753.0932736973614, 2753.379061520599, 2752.995202480493, 2752.996669152352, 2752.9889240513503, 2753.3677302994997, 2753.0886810959537, 2753.36461091098, 2753.374752334956, 2753.086326046468, 2753.3875591121223, 2753.369801978024, 2753.0565526411538, 2753.3956025885896, 2753.344793568378, 2753.141546974778, 2753.100765063778, 2753.400047413162, 2753.361683055871, 2753.060605558197, 2753.11693078457, 2750.9601052827206, 2751.0424362431486, 2750.7131271847466, 2753.019118665381, 2754.1728392432747, 2754.255266354669, 2756.151770926552, 2753.3487037917876, 2753.431106238388, 2753.101511248131, 2753.360164939351, 2753.362329197124, 2753.4056002417997, 2753.087659972841, 2753.097696835537, 2753.34337659851, 2753.37400791497, 2753.0750022457296, 2753.064044877039, 2753.0427831886172, 2753.010629355056, 2753.0893113732554, 2753.017523756732, 2753.0188697357253, 2753.0806867491547, 2753.060856079465, 2753.087599569961, 2753.063411708956, 2753.0734533903856, 2753.0499368490496, 2753.036376089222, 2753.067677370595]",1.6821556816739998e-05,5.532008860446951e-05,2766.721749269319,2768.785998629391,2768.365532172185,2767.4717629654187,0.7757393019742267,0.830928056228769,0.18208612621584652,0.026886911383826373,0.0735009269587863,0.09814979606608176,2769.8384651704914,2769.110120665628,87.9892037786744,87.67431399009776,2.0,3.0,,,,False,False,False,False,True,1.0,2767.76,2776.76,2766.76,2738.76,"3.0,2.0,2738.76",1,0.01,2024-10-31 16:48:00,2024-10-31 16:48:00,False,2024-10-31 16:48:00,2024-10-29 16:30:32,2024-10-30 02:06:48,2024-10-29 18:25:00,2768.76,2024-10-29 16:30:32,auto,2768.05,0.01,success,12.85,-1 days +22:05:32,1486.94,True,46,0,44,10
2024-10-29 18:27:00,2769.01,2769.39,2768.5,2768.53,247,27,0,2766.8313296321203,0.06933348440315967,2769.4363937708563,2769.564476190477,-0.024119047616295575,2768.7419761904753,2769.4363937708563,2766.4093595291088,0.142357285873004,2769.888547274749,-0.05606451612948149,2769.916579532802,0.02650871338437355,2769.205927326659,-0.04978272154176011,2769.2308186874234,-0.016797552837488183,-0.08700704486454924,-0.10872821653720166,,,,,,7.925791135507653,7.9252631674813,"[2753.047461210258, 2753.1224803245013, 2753.0851420685403, 2753.071688862906, 2753.074107949994, 2753.37267251062, 2753.382836200602, 2753.4128989748297, 2751.5364737524596, 2753.3670940924235, 2753.3622816257594, 2753.102957223495, 2753.11417373256, 2753.0914896958398, 2753.0932736973614, 2753.379061520599, 2752.995202480493, 2752.996669152352, 2752.9889240513503, 2753.3677302994997, 2753.0886810959537, 2753.36461091098, 2753.374752334956, 2753.086326046468, 2753.3875591121223, 2753.369801978024, 2753.0565526411538, 2753.3956025885896, 2753.344793568378, 2753.141546974778, 2753.100765063778, 2753.400047413162, 2753.361683055871, 2753.060605558197, 2753.11693078457, 2750.9601052827206, 2751.0424362431486, 2750.7131271847466, 2753.019118665381, 2754.1728392432747, 2754.255266354669, 2756.151770926552, 2753.3487037917876, 2753.431106238388, 2753.101511248131, 2753.360164939351, 2753.362329197124, 2753.4056002417997, 2753.087659972841, 2753.097696835537, 2753.34337659851, 2753.37400791497, 2753.0750022457296, 2753.064044877039, 2753.0427831886172, 2753.010629355056, 2753.0893113732554, 2753.017523756732, 2753.0188697357253, 2753.0806867491547, 2753.060856079465, 2753.087599569961, 2753.063411708956, 2753.0734533903856, 2753.0499368490496, 2753.036376089222, 2753.067677370595]",3.8667995427127256e-05,4.69165719786575e-05,2767.089644965792,2769.111114183679,2768.599391589066,2767.7840286711717,0.7009525585472147,0.7901854692942424,0.3313150209031739,-0.10872821653720166,-0.021721171672652417,0.09255024100639275,2770.099023812663,2768.7737637290497,65.10009454515836,78.6401857019302,2.0,3.0,,,,False,False,False,False,True,1.0,2767.53,2776.53,2766.53,2738.53,"3.0,2.0,2738.53",1,0.01,2024-10-31 16:48:00,2024-10-31 16:48:00,False,2024-10-31 16:48:00,2024-10-29 16:30:33,2024-10-30 02:06:46,2024-10-29 18:28:00,2768.53,2024-10-29 16:30:33,auto,2767.52,0.01,success,18.27,-1 days +22:02:33,1505.21,True,47,0,44,10
2024-10-29 18:55:00,2766.72,2767.1,2766.62,2767.06,171,27,0,2766.675408578551,0.015697609038852534,2766.203590656285,2767.753476190475,-0.060261904761318874,2766.9606428571415,2766.203590656285,2767.512143993329,-0.04758314794253238,2766.43449091583,0.12742899517934347,2766.370776418229,0.16881609195388592,2765.6753222098655,0.1580734149079035,2765.5962855024063,0.13836077122869028,0.09317686318490814,0.18399629217810798,,,,,,7.925552983864415,7.925652170477248,"[2753.047461210258, 2753.1224803245013, 2753.0851420685403, 2753.071688862906, 2753.074107949994, 2753.37267251062, 2753.382836200602, 2753.4128989748297, 2751.5364737524596, 2753.3670940924235, 2753.3622816257594, 2753.102957223495, 2753.11417373256, 2753.0914896958398, 2753.0932736973614, 2753.379061520599, 2752.995202480493, 2752.996669152352, 2752.9889240513503, 2753.3677302994997, 2753.0886810959537, 2753.36461091098, 2753.374752334956, 2753.086326046468, 2753.3875591121223, 2753.369801978024, 2753.0565526411538, 2753.3956025885896, 2753.344793568378, 2753.141546974778, 2753.100765063778, 2753.400047413162, 2753.361683055871, 2753.060605558197, 2753.11693078457, 2750.9601052827206, 2751.0424362431486, 2750.7131271847466, 2753.019118665381, 2754.1728392432747, 2754.255266354669, 2756.151770926552, 2753.3487037917876, 2753.431106238388, 2753.101511248131, 2753.360164939351, 2753.362329197124, 2753.4056002417997, 2753.087659972841, 2753.097696835537, 2753.34337659851, 2753.37400791497, 2753.0750022457296, 2753.064044877039, 2753.0427831886172, 2753.010629355056, 2753.0893113732554, 2753.017523756732, 2753.0188697357253, 2753.0806867491547, 2753.060856079465, 2753.087599569961, 2753.063411708956, 2753.0734533903856, 2753.0499368490496, 2753.036376089222, 2753.067677370595]",2.293988607268943e-05,4.6374843052194956e-05,2765.053322000183,2767.616179897381,2766.8625532145593,2766.779339049228,0.08302386883815416,-0.0763933875522905,0.5783967992176087,0.18399629217810798,0.09081942899319984,0.23129551353622446,2767.3603842547204,2765.0467970578497,71.35701987107548,82.87037929622561,2.0,3.0,,,,False,False,False,False,True,1.0,2766.06,2775.06,2765.06,2737.06,"3.0,2.0,2737.06",1,0.01,2024-10-31 16:48:00,2024-10-31 16:48:00,False,2024-10-31 16:48:00,2024-10-29 17:15:15,2024-10-30 00:26:07,2024-10-29 18:56:00,2767.06,2024-10-29 17:15:15,auto,2766.16,0.01,success,16.28,-1 days +22:19:15,1521.49,True,48,0,44,10
2024-10-29 19:27:00,2768.41,2769.79,2768.37,2769.22,292,27,0,2768.5677570662465,0.026622160561146302,2768.170295142753,2767.99545238095,0.2324761904742445,2766.5338809523823,2768.170295142753,2769.0750391175416,0.07158980348549449,2768.8642432332213,-0.16197552836547402,2768.9452309973935,-0.25847163514936256,2767.574621431221,-0.20210456062432058,2767.675673711528,-0.25922246941036065,0.12037004078320024,-0.1437856878023922,,,,,,7.926102868990526,7.92632025672971,"[2753.047461210258, 2753.1224803245013, 2753.0851420685403, 2753.071688862906, 2753.074107949994, 2753.37267251062, 2753.382836200602, 2753.4128989748297, 2751.5364737524596, 2753.3670940924235, 2753.3622816257594, 2753.102957223495, 2753.11417373256, 2753.0914896958398, 2753.0932736973614, 2753.379061520599, 2752.995202480493, 2752.996669152352, 2752.9889240513503, 2753.3677302994997, 2753.0886810959537, 2753.36461091098, 2753.374752334956, 2753.086326046468, 2753.3875591121223, 2753.369801978024, 2753.0565526411538, 2753.3956025885896, 2753.344793568378, 2753.141546974778, 2753.100765063778, 2753.400047413162, 2753.361683055871, 2753.060605558197, 2753.11693078457, 2750.9601052827206, 2751.0424362431486, 2750.7131271847466, 2753.019118665381, 2754.1728392432747, 2754.255266354669, 2756.151770926552, 2753.3487037917876, 2753.431106238388, 2753.101511248131, 2753.360164939351, 2753.362329197124, 2753.4056002417997, 2753.087659972841, 2753.097696835537, 2753.34337659851, 2753.37400791497, 2753.0750022457296, 2753.064044877039, 2753.0427831886172, 2753.010629355056, 2753.0893113732554, 2753.188179963774, 2753.1028286803157, 2753.017523756732, 2753.0188697357253, 2753.2064471272597, 2753.0806867491547, 2753.060856079465, 2753.087599569961, 2753.063411708956, 2753.0734533903856, 2753.0499368490496, 2753.036376089222, 2753.067677370595, 2753.0998366699373]",-4.365989834650522e-05,-0.00011247856379800095,2767.9302898848123,2771.129449930767,2768.4898305963634,2768.814876175614,-0.3155402569814214,-0.21478329929068124,0.8987441636191098,-0.1437856878023922,-0.26415572858559244,-0.3531716722309284,2769.967783469991,2766.3728068155147,46.72897196261773,38.65097155644609,2.0,3.0,,,,False,False,False,True,False,0.0,2770.22,2761.22,2771.22,2799.22,"3.0,2.0,2799.22",0,0.01,,,False,,2024-10-29 19:01:13,2024-10-29 17:28:59,2024-10-29 19:28:00,2769.22,2024-10-29 17:28:59,auto,2761.27,0.01,fail,-144.11,-1 days +22:00:59,1377.38,False,0,1,44,10
2024-10-29 20:07:00,2768.79,2769.21,2768.62,2768.63,149,27,0,2768.9821922418996,-0.014375193547039089,2769.2398146088267,2769.250499999998,-0.12421428571587967,2768.546571428572,2769.2398146088267,2768.800970652579,0.02673798665182403,2769.6533948832052,-0.050981831662284094,2769.678885799027,-0.04889988876357165,2768.9332999629246,-0.03270300333178966,2768.9496514645853,-0.04642343344312394,-0.02356395995366256,-0.07085947348787158,,,,,,7.926281161177192,7.926243200146708,"[2753.047461210258, 2753.1224803245013, 2753.0851420685403, 2753.071688862906, 2753.074107949994, 2753.37267251062, 2753.382836200602, 2753.4128989748297, 2751.5364737524596, 2753.3670940924235, 2753.3622816257594, 2753.102957223495, 2753.11417373256, 2753.0914896958398, 2753.0932736973614, 2753.379061520599, 2752.995202480493, 2752.996669152352, 2752.9889240513503, 2753.3677302994997, 2753.0886810959537, 2753.36461091098, 2753.374752334956, 2753.086326046468, 2753.3875591121223, 2753.369801978024, 2753.0565526411538, 2753.3956025885896, 2753.344793568378, 2753.141546974778, 2753.100765063778, 2753.400047413162, 2753.361683055871, 2753.060605558197, 2753.11693078457, 2750.9601052827206, 2751.0424362431486, 2750.7131271847466, 2753.019118665381, 2754.1728392432747, 2754.255266354669, 2756.151770926552, 2753.3487037917876, 2753.431106238388, 2753.101511248131, 2753.360164939351, 2753.362329197124, 2753.4056002417997, 2753.087659972841, 2753.097696835537, 2753.34337659851, 2753.37400791497, 2753.0750022457296, 2753.064044877039, 2753.0427831886172, 2753.010629355056, 2753.0893113732554, 2753.188179963774, 2753.1028286803157, 2753.017523756732, 2753.0188697357253, 2753.2064471272597, 2753.0806867491547, 2753.060856079465, 2753.087599569961, 2753.063411708956, 2753.0734533903856, 2753.0499368490496, 2753.036376089222, 2753.067677370595, 2753.0998366699373]",-2.3294039338735453e-05,-2.376412056007875e-06,2768.480748919928,2770.41476856032,2768.9998063152957,2769.0798929276675,-0.07993804156240003,0.02790901960921823,0.26944055839186104,-0.07085947348787158,-0.04729551353420902,-0.10914052651014572,2769.7786957256103,2768.700933492043,11.608623548920527,15.270940237725016,2.0,3.0,,,,False,False,False,True,False,0.0,2769.63,2760.63,2770.63,2798.63,"3.0,2.0,2798.63",0,0.01,,,False,,2024-10-29 18:25:23,2024-10-31 15:49:24,2024-10-29 20:08:00,2768.63,2024-10-29 18:25:23,auto,2769.56,0.01,success,16.83,-1 days +22:17:23,1394.21,True,1,0,44,10
2024-10-29 22:32:00,2772.06,2772.12,2771.97,2772.02,46,30,0,2772.3480875597197,-0.013391328968282323,2772.111670003711,2772.3069999999993,-0.055880952382267424,2772.042833333334,2772.111670003711,2772.504262384132,-0.010563663329776318,2772.243891731555,-0.028792732663987408,2772.2582880978766,-0.051278086762522435,2772.009711531332,-0.03295736002974081,2772.0261902113425,-0.05010196514558629,0.026827586210401932,-0.02323396366182351,,,,,,7.9274451851211385,7.927470429723323,"[2750.7131271847466, 2753.087659972841, 2753.0787266078087, 2751.0424362431486, 2752.996669152352, 2752.9889240513503, 2753.102957223495, 2753.11417373256, 2753.0914896958398, 2753.0932736973614, 2753.379061520599, 2753.3677302994997, 2753.0886810959537, 2753.36461091098, 2753.374752334956, 2753.086326046468, 2754.255266354669, 2753.18516696309, 2753.360164939351, 2753.093255806792, 2753.1020482965955, 2753.019118665381, 2753.101511248131, 2753.097696835537, 2753.37400791497, 2753.0427831886172, 2753.063411708956, 2770.1935348707234, 2770.205214964411, 2770.0912700371523, 2770.228771811843, 2770.2020098031016, 2770.2368338340907, 2770.1100671896047, 2770.103708716674, 2770.2007775393013, 2770.2237509970737, 2753.2064471272597, 2753.0806867491547, 2753.3875591121223, 2753.369801978024, 2753.0565526411538, 2753.3956025885896, 2753.344793568378, 2753.141546974778, 2753.100765063778, 2753.400047413162, 2753.361683055871, 2753.060605558197, 2753.11693078457, 2753.4056002417997, 2750.9601052827206, 2751.5364737524596, 2752.995202480493, 2753.047461210258, 2753.1224803245013, 2753.0851420685403, 2753.071688862906, 2753.074107949994, 2753.37267251062, 2753.382836200602, 2753.4128989748297, 2753.3670940924235, 2753.3622816257594, 2754.1728392432747, 2756.151770926552, 2753.3487037917876, 2753.34337659851, 2753.010629355056, 2770.173925885587, 2770.2005049140434, 2770.217404487861, 2770.1553846940355, 2770.2364975395085, 2770.1769628756424, 2770.1835758318125, 2770.1292667043213, 2770.1608328459124, 2770.2408664028603, 2773.086129554854, 2753.362329197124, 2753.060856079465, 2753.087599569961, 2753.0499368490496, 2753.036376089222, 2753.140961069665, 2753.1627093767606, 2753.0750022457296, 2753.017523756732, 2753.210777170979, 2753.22901747167, 2753.111418491252, 2753.113680314223, 2753.161091885611, 2753.1388529854466, 2753.105008479348, 2753.431106238388, 2753.067677370595, 2753.0998366699373, 2753.1061531466644, 2753.0893113732554, 2753.0188697357253, 2753.209455018764, 2753.1906985906926, 2753.064044877039, 2753.188179963774, 2753.1028286803157, 2753.224862060273, 2753.1001595311063, 2753.1858996000483, 2753.0734533903856]",-8.329689368997436e-07,-1.7388271156046898e-06,2771.8762510785887,2772.744025458079,2772.2025748643237,2772.2950486013096,-0.08337873540358487,-0.05346569737929107,0.25601339299095777,-0.02323396366182351,-0.05006154987222544,-0.07383537263376638,2772.623696789693,2771.599643217729,18.31895702861283,23.447715791260276,2.0,3.0,,,,False,False,False,True,False,0.0,2773.02,2764.02,2774.02,2802.02,"3.0,2.0,2802.02",0,0.01,,,False,,2024-10-29 20:33:45,2024-10-31 15:37:33,2024-10-29 22:33:00,2772.02,2024-10-29 20:33:45,auto,2773.04,0.01,success,18.45,-1 days +22:00:45,1412.66,True,2,0,44,10
